name	taxonomy_id	taxonomy_lvl	kraken_assigned_reads	added_reads	new_est_reads	fraction_total_reads
Bradyrhizobium_sp._CCBAU_51753	1325100	S	2382	551	2933	0.00070
Bradyrhizobium_sp._BTAi1	288000	S	2234	437	2671	0.00064
Bradyrhizobium_sp._A19	2898149	S	2154	401	2555	0.00061
Bradyrhizobium_sp._ORS_285	115808	S	2112	508	2620	0.00062
Bradyrhizobium_sp._ORS_278	114615	S	2066	504	2570	0.00061
Bradyrhizobium_sp._200	2782665	S	2016	478	2494	0.00059
Bradyrhizobium_sp._CCBAU_53351	1325114	S	1785	912	2697	0.00064
Bradyrhizobium_sp._SK17	2057741	S	1775	624	2399	0.00057
Bradyrhizobium_sp._170	2782641	S	1749	477	2226	0.00053
Bradyrhizobium_sp._CCBAU_051011	858422	S	1662	335	1997	0.00048
Bradyrhizobium_sp._186	2782654	S	1627	457	2084	0.00050
Bradyrhizobium_sp._CCBAU_53338	1325111	S	1506	624	2130	0.00051
Bradyrhizobium_sp._195	2782662	S	1464	543	2007	0.00048
Bradyrhizobium_sp._1(2017)	1404888	S	1343	433	1776	0.00042
Bradyrhizobium_sp._CCBAU_53421	1325120	S	1336	435	1771	0.00042
Bradyrhizobium_sp._CCBAU_53340	1325112	S	1266	497	1763	0.00042
Bradyrhizobium_sp._CCGE-LA001	1223566	S	1059	404	1463	0.00035
Bradyrhizobium_sp._6(2017)	1197460	S	929	460	1389	0.00033
Bradyrhizobium_sp._S2-11-2	2840472	S	910	734	1644	0.00039
Bradyrhizobium_sp._41S5	1404443	S	844	579	1423	0.00034
Bradyrhizobium_sp._I71	2590772	S	812	739	1551	0.00037
Bradyrhizobium_sp._S2-20-1	2840469	S	766	657	1423	0.00034
Bradyrhizobium_sp._CCBAU_51765	1325102	S	747	705	1452	0.00035
Bradyrhizobium_sp._191	2782659	S	745	764	1509	0.00036
Bradyrhizobium_sp._S2-11-4	2840473	S	667	629	1296	0.00031
Bradyrhizobium_sp._C-145	574727	S	430	422	852	0.00020
Bradyrhizobium_sp.	376	S	398	1288	1686	0.00040
Bradyrhizobium_sp._40	2782674	S	301	700	1001	0.00024
Bradyrhizobium_sp._144S4	2823807	S	296	727	1023	0.00024
Bradyrhizobium_sp._4	2782678	S	286	747	1033	0.00025
Bradyrhizobium_sp._192	2782660	S	269	646	915	0.00022
Bradyrhizobium_sp._323S2	1404649	S	238	596	834	0.00020
Bradyrhizobium_sp._LCT2	2493093	S	167	459	626	0.00015
Bradyrhizobium_sp._SG09	2599805	S	111	785	896	0.00021
Bradyrhizobium_sp._TM102	2599819	S	104	705	809	0.00019
Bradyrhizobium_sp._187	2782655	S	85	415	500	0.00012
Bradyrhizobium_sp._38S5	2819348	S	65	790	855	0.00020
Bradyrhizobium_sp._172	2782643	S	63	761	824	0.00020
Bradyrhizobium_sp._131	2782609	S	53	859	912	0.00022
Bradyrhizobium_sp._CW1	2782686	S	51	784	835	0.00020
Bradyrhizobium_sp._1S5	2816456	S	36	404	440	0.00010
Bradyrhizobium_sp._155	2782629	S	29	518	547	0.00013
Bradyrhizobium_erythrophlei	1437360	S	6916	615	7531	0.00179
Bradyrhizobium_diazoefficiens	1355477	S	5591	11889	17480	0.00416
Bradyrhizobium_canariense	255045	S	2099	3242	5341	0.00127
Bradyrhizobium_lablabi	722472	S	2085	2472	4557	0.00108
Bradyrhizobium_guangxiense	1325115	S	2020	885	2905	0.00069
Bradyrhizobium_genosp._L	83637	S	1892	408	2300	0.00055
Bradyrhizobium_oligotrophicum	44255	S	1878	351	2229	0.00053
Bradyrhizobium_guangdongense	1325090	S	1827	686	2513	0.00060
Bradyrhizobium_japonicum	375	S	1763	2474	4237	0.00101
Bradyrhizobium_icense	1274631	S	1752	266	2018	0.00048
Bradyrhizobium_paxllaeri	190148	S	1628	320	1948	0.00046
Bradyrhizobium_arachidis	858423	S	1491	436	1927	0.00046
Bradyrhizobium_vignae	1549949	S	1296	316	1612	0.00038
Bradyrhizobium_cosmicum	1404864	S	1201	400	1601	0.00038
Bradyrhizobium_genosp._B	83627	S	1201	267	1468	0.00035
Bradyrhizobium_guangzhouense	1325095	S	1178	452	1630	0.00039
Bradyrhizobium_quebecense	2748629	S	1168	666	1834	0.00044
Bradyrhizobium_daqingense	993502	S	886	481	1367	0.00033
Bradyrhizobium_amphicarpaeae	1404768	S	867	367	1234	0.00029
Bradyrhizobium_septentrionale	1404411	S	844	517	1361	0.00032
Bradyrhizobium_betae	244734	S	827	485	1312	0.00031
Bradyrhizobium_symbiodeficiens	1404367	S	654	969	1623	0.00039
Bradyrhizobium_zhanjiangense	1325107	S	475	468	943	0.00022
Bradyrhizobium_elkanii	29448	S	313	1290	1603	0.00038
Bradyrhizobium_ottawaense	931866	S	201	1252	1453	0.00035
Rhodopseudomonas_palustris	1076	S	7583	2932	10515	0.00250
Rhodopseudomonas_sp._SK50-23	340268	S	1098	261	1359	0.00032
Rhodopseudomonas_boonkerdii	475937	S	1008	313	1321	0.00031
Nitrobacter_hamburgensis	912	S	2279	422	2701	0.00064
Nitrobacter_winogradskyi	913	S	1168	214	1382	0.00033
Tardiphaga_sp._37S4	1404741	S	583	453	1036	0.00025
Tardiphaga_sp._vice154	2592814	S	43	728	771	0.00018
Tardiphaga_sp._vice278	2592815	S	21	559	580	0.00014
Tardiphaga_sp._vice304	2592817	S	11	228	239	0.00006
Tardiphaga_sp._vice352	2592816	S	10	331	341	0.00008
Tardiphaga_robiniae	943830	S	533	369	902	0.00021
Afipia_carboxidovorans	40137	S	1930	549	2479	0.00059
Afipia_sp._GAS231	1882747	S	858	724	1582	0.00038
Variibacter_gotjawalensis	1333996	S	2245	191	2436	0.00058
Mesorhizobium_sp._J8	2777475	S	8684	2445	11129	0.00265
Mesorhizobium_sp._B2-8-5	2589903	S	5137	1495	6632	0.00158
Mesorhizobium_sp._M2A.F.Ca.ET.043.05.1.1	2493671	S	3932	2465	6397	0.00152
Mesorhizobium_sp._8	2584466	S	1727	421	2148	0.00051
Mesorhizobium_sp._M2A.F.Ca.ET.046.03.2.1	2493674	S	1647	2946	4593	0.00109
Mesorhizobium_sp._M2A.F.Ca.ET.043.02.1.1	2493670	S	1563	2667	4230	0.00101
Mesorhizobium_sp._M1B.F.Ca.ET.045.04.1.1	2493673	S	1543	498	2041	0.00049
Mesorhizobium_sp._M1E.F.Ca.ET.045.02.1.1	2493672	S	1501	613	2114	0.00050
Mesorhizobium_sp._B1-1-8	2589976	S	1420	328	1748	0.00042
Mesorhizobium_sp._M1D.F.Ca.ET.043.01.1.1	2493669	S	1394	667	2061	0.00049
Mesorhizobium_sp._M1A.F.Ca.IN.022.06.1.1	2493680	S	1356	366	1722	0.00041
Mesorhizobium_sp._M3A.F.Ca.ET.080.04.2.1	2493676	S	1257	341	1598	0.00038
Mesorhizobium_sp._DCY119	2108445	S	952	222	1174	0.00028
Mesorhizobium_sp._B2-1-1	2589974	S	942	203	1145	0.00027
Mesorhizobium_sp._131-2-1	2744518	S	903	404	1307	0.00031
Mesorhizobium_sp._M4B.F.Ca.ET.058.02.1.1	2493675	S	902	327	1229	0.00029
Mesorhizobium_sp._Pch-S	2082387	S	894	125	1019	0.00024
Mesorhizobium_sp._PAMC28654	2880934	S	882	158	1040	0.00025
Mesorhizobium_sp._INR15	2654248	S	807	111	918	0.00022
Mesorhizobium_sp._B4-1-4	2589888	S	743	168	911	0.00022
Mesorhizobium_sp._B2-1-8	2589967	S	722	197	919	0.00022
Mesorhizobium_sp._M9A.F.Ca.ET.002.03.1.2	2493668	S	661	248	909	0.00022
Mesorhizobium_sp._L-2-11	2744521	S	603	208	811	0.00019
Mesorhizobium_sp._M8A.F.Ca.ET.057.01.1.1	2493679	S	565	183	748	0.00018
Mesorhizobium_sp._M7D.F.Ca.US.005.01.1.1	2493678	S	538	169	707	0.00017
Mesorhizobium_sp._M6A.T.Cr.TU.016.01.1.1	2493677	S	535	157	692	0.00016
Mesorhizobium_sp._NZP2077	2483404	S	522	156	678	0.00016
Mesorhizobium_sp._113-3-3	2744516	S	507	242	749	0.00018
Mesorhizobium_sp._M7A.F.Ce.TU.012.03.2.1	2493681	S	425	142	567	0.00014
Mesorhizobium_sp._113-1-2	2744515	S	421	184	605	0.00014
Mesorhizobium_sp._113-3-9	2744517	S	408	247	655	0.00016
Mesorhizobium_sp._L-8-10	2744523	S	395	803	1198	0.00029
Mesorhizobium_sp._L-8-3	2744522	S	394	825	1219	0.00029
Mesorhizobium_sp._NBSH29	2654249	S	357	24	381	0.00009
Mesorhizobium_sp._NZP2298	2483403	S	326	162	488	0.00012
Mesorhizobium_sp._AA22	1854057	S	308	181	489	0.00012
Mesorhizobium_sp._WSM1497	278153	S	124	248	372	0.00009
Mesorhizobium_sp._131-3-5	2744520	S	65	195	260	0.00006
Mesorhizobium_sp._131-2-5	2744519	S	45	288	333	0.00008
Mesorhizobium_sp._NZP2234	2483402	S	43	149	192	0.00005
Mesorhizobium_terrae	2725666	S	992	342	1334	0.00032
Mesorhizobium_opportunistum	593909	S	914	390	1304	0.00031
Mesorhizobium_amorphae	71433	S	704	174	878	0.00021
Mesorhizobium_loti	381	S	517	4260	4777	0.00114
Mesorhizobium_australicum	536018	S	496	157	653	0.00016
Mesorhizobium_huakuii	28104	S	463	386	849	0.00020
Mesorhizobium_erdmanii	1777866	S	426	124	550	0.00013
Mesorhizobium_ciceri	39645	S	416	1045	1461	0.00035
Mesorhizobium_japonicum	2066070	S	380	292	672	0.00016
Aquibium_microcysteis	675281	S	1670	476	2146	0.00051
Aquibium_oceanicum	1670800	S	1296	310	1606	0.00038
Aminobacter_sp._MSH1	374606	S	789	488	1277	0.00030
Aminobacter_sp._SR38	2774562	S	190	836	1026	0.00024
Aminobacter_sp._MDW-2	2666139	S	107	528	635	0.00015
Aminobacter_aminovorans	83263	S	100	351	451	0.00011
Nitratireductor_sp._SY7	2599600	S	1071	204	1275	0.00030
Nitratireductor_sp._OM-1	1756988	S	565	102	667	0.00016
Nitratireductor_kimnyeongensis	430679	S	342	53	395	0.00009
Phyllobacterium_sp._T1018	555316	S	373	51	424	0.00010
Phyllobacterium_sp._628	2718938	S	198	28	226	0.00005
Phyllobacterium_sp._T1293	555317	S	187	24	211	0.00005
Phyllobacterium_zundukense	1867719	S	347	54	401	0.00010
Roseitalea_porphyridii	1852022	S	899	160	1059	0.00025
Hoeflea_sp._IMCC20628	1620421	S	360	36	396	0.00009
Hoeflea_phototrophica	244596	S	324	40	364	0.00009
Oricola_thermophila	2742145	S	657	95	752	0.00018
Salaquimonas_pukyongi	2712698	S	288	13	301	0.00007
Rhizobium_sp._WYJ-E13	2849093	S	1032	141	1173	0.00028
Rhizobium_sp._BG4	2613770	S	721	148	869	0.00021
Rhizobium_sp._AB2/73	2795216	S	644	361	1005	0.00024
Rhizobium_sp._NXC24	2048897	S	475	74	549	0.00013
Rhizobium_sp._ACO-34A	1571470	S	459	104	563	0.00013
Rhizobium_sp._11515TR	2028343	S	438	114	552	0.00013
Rhizobium_sp._SL42	2806346	S	390	76	466	0.00011
Rhizobium_sp._CIAT894	2020312	S	374	172	546	0.00013
Rhizobium_sp._WL3	2603277	S	364	75	439	0.00010
Rhizobium_sp._NZLR1	2731096	S	335	120	455	0.00011
Rhizobium_sp._NXC14	1981173	S	316	137	453	0.00011
Rhizobium_sp._K102	2918527	S	308	219	527	0.00013
Rhizobium_sp._NLR16a	2731112	S	287	135	422	0.00010
Rhizobium_sp._C104	2917727	S	225	128	353	0.00008
Rhizobium_sp._L51/94	2819999	S	181	264	445	0.00011
Rhizobium_sp._Kim5	2020311	S	128	298	426	0.00010
Rhizobium_sp._X9	2815360	S	115	251	366	0.00009
Rhizobium_sp._IE4771	1301032	S	100	213	313	0.00007
Rhizobium_sp._TAL182	2020313	S	96	287	383	0.00009
Rhizobium_sp._007	2785056	S	90	161	251	0.00006
Rhizobium_sp._Y9	1914541	S	40	154	194	0.00005
Rhizobium_sp._NIBRBAC000502774	2590777	S	38	163	201	0.00005
Rhizobium_sp._ZX09	2291939	S	34	152	186	0.00004
Rhizobium_sp._N324	1703969	S	18	429	447	0.00011
Rhizobium_sp._B230/85	2819994	S	16	199	215	0.00005
Rhizobium_sp._CCGE531	2364271	S	13	532	545	0.00013
Rhizobium_leguminosarum	384	S	2932	3972	6904	0.00164
Rhizobium_etli	29449	S	869	1120	1989	0.00047
Rhizobium_phaseoli	396	S	607	1289	1896	0.00045
Rhizobium_jaguaris	1312183	S	546	74	620	0.00015
Rhizobium_pseudoryzae	379684	S	523	119	642	0.00015
Rhizobium_bangladeshense	1138189	S	491	124	615	0.00015
Rhizobium_gallicum	56730	S	394	523	917	0.00022
Rhizobium_tropici	398	S	364	101	465	0.00011
Rhizobium_binae	1138190	S	359	139	498	0.00012
Rhizobium_lentis	1138194	S	346	113	459	0.00011
Rhizobium_daejeonense	240521	S	295	113	408	0.00010
Rhizobium_rosettiformans	1368430	S	285	138	423	0.00010
Rhizobium_pusense	648995	S	244	982	1226	0.00029
Rhizobium_rhizoryzae	451876	S	232	33	265	0.00006
Rhizobium_indicum	2583231	S	205	185	390	0.00009
Rhizobium_acidisoli	1538158	S	171	145	316	0.00008
Rhizobium_oryzihabitans	2267833	S	130	181	311	0.00007
Rhizobium_hidalgonense	1538159	S	79	186	265	0.00006
Rhizobium_laguerreae	1076926	S	72	126	198	0.00005
Rhizobium_ruizarguesonis	2081791	S	55	414	469	0.00011
Agrobacterium_tumefaciens	358	S	1309	1269	2578	0.00061
Agrobacterium_fabrum	1176649	S	148	191	339	0.00008
Agrobacterium_fabacearum	1183401	S	36	468	504	0.00012
Agrobacterium_vitis	373	S	755	98	853	0.00020
Agrobacterium_sp._T29	2580515	S	104	81	185	0.00004
Agrobacterium_sp._RAC06	1842536	S	78	158	236	0.00006
Agrobacterium_sp._MA01	2664893	S	69	137	206	0.00005
Agrobacterium_sp._CGMCC_11546	2579248	S	42	86	128	0.00003
Agrobacterium_sp._S7/73	2820002	S	32	166	198	0.00005
Agrobacterium_vaccinii	2735528	S	338	49	387	0.00009
Agrobacterium_larrymoorei	160699	S	208	37	245	0.00006
Agrobacterium_rubi	28099	S	178	52	230	0.00005
Agrobacterium_salinitolerans	1183413	S	161	61	222	0.00005
Agrobacterium_rhizogenes	359	S	131	314	445	0.00011
Neorhizobium_galegae	399	S	1689	510	2199	0.00052
Neorhizobium_sp._NCHU2750	1825976	S	454	111	565	0.00013
Neorhizobium_sp._SOG26	2060726	S	422	90	512	0.00012
Pseudorhizobium_banfieldiae	1125847	S	329	169	498	0.00012
Pseudorhizobium_flavum	1335061	S	317	183	500	0.00012
Sinorhizobium_fredii	380	S	1618	2402	4020	0.00096
Sinorhizobium_meliloti	382	S	1309	500	1809	0.00043
Sinorhizobium_americanum	194963	S	582	236	818	0.00019
Sinorhizobium_medicae	110321	S	568	78	646	0.00015
Sinorhizobium_sp._BG8	2613773	S	448	83	531	0.00013
Sinorhizobium_sp._CCBAU_05631	794846	S	74	122	196	0.00005
Ensifer_adhaerens	106592	S	1385	869	2254	0.00054
Ensifer_mexicanus	375549	S	851	146	997	0.00024
Ensifer_sp._PDNC004	2811423	S	504	219	723	0.00017
Ensifer_sp._T173	555315	S	113	447	560	0.00013
Ensifer_alkalisoli	1752398	S	575	125	700	0.00017
Ensifer_sojae	716925	S	525	228	753	0.00018
Shinella_sp._HZN7	879274	S	896	873	1769	0.00042
Shinella_sp._PSBB067	2715959	S	782	678	1460	0.00035
Shinella_sp._XGS7	2877941	S	647	647	1294	0.00031
Shinella_sp._H4-D48	2925841	S	281	121	402	0.00010
Shinella_zoogloeoides	352475	S	792	1233	2025	0.00048
Shinella_oryzae	2871820	S	377	181	558	0.00013
Ciceribacter_thiooxidans	1969821	S	649	149	798	0.00019
Georhizobium_profundi	2341112	S	595	144	739	0.00018
Peteryoungia_desertarenae	1813451	S	197	41	238	0.00006
Methylobacterium_sp._17Sr1-1	2202826	S	1034	563	1597	0.00038
Methylobacterium_sp._WL1	2603276	S	1022	236	1258	0.00030
Methylobacterium_sp._C1	1479019	S	117	1008	1125	0.00027
Methylobacterium_sp._XJLW	739141	S	55	814	869	0.00021
Methylobacterium_nodulans	114616	S	2149	308	2457	0.00058
Methylobacterium_aquaticum	270351	S	1974	995	2969	0.00071
Methylobacterium_radiodurans	2202828	S	1521	416	1937	0.00046
Methylobacterium_durans	2202825	S	1440	233	1673	0.00040
Methylobacterium_currus	2051553	S	1287	616	1903	0.00045
Methylobacterium_organophilum	410	S	1171	693	1864	0.00044
Methylobacterium_mesophilicum	39956	S	1150	275	1425	0.00034
Methylobacterium_terrae	2202827	S	1074	568	1642	0.00039
Methylobacterium_brachiatum	269660	S	1031	416	1447	0.00034
Methylobacterium_tardum	374432	S	1027	412	1439	0.00034
Methylobacterium_indicum	1775910	S	975	557	1532	0.00036
Methylobacterium_oryzae	334852	S	781	1066	1847	0.00044
Methylobacterium_radiotolerans	31998	S	351	2024	2375	0.00057
Methylobacterium_phyllosphaerae	418223	S	119	492	611	0.00015
Microvirga_sp._VF16	2807101	S	2233	400	2633	0.00063
Microvirga_sp._17_mud_1-3	2082949	S	1235	296	1531	0.00036
Microvirga_ossetica	1882682	S	2243	456	2699	0.00064
Microvirga_thermotolerans	2651334	S	1640	510	2150	0.00051
Methylorubrum_populi	223967	S	1750	920	2670	0.00064
Methylorubrum_extorquens	408	S	1293	2251	3544	0.00084
Methylorubrum_sp._B1-46	2897334	S	657	295	952	0.00023
Methylorubrum_zatmanii	29429	S	37	199	236	0.00006
Pseudolabrys_taiwanensis	331696	S	14921	2833	17754	0.00423
Pseudolabrys_sp._FHR47	2562284	S	8628	1755	10383	0.00247
Xanthobacter_dioxanivorans	2528964	S	1688	680	2368	0.00056
Xanthobacter_sp._YC-JY1	2419844	S	573	618	1191	0.00028
Xanthobacter_autotrophicus	280	S	559	651	1210	0.00029
Starkeya_sp._ORNL1	2709380	S	1892	437	2329	0.00055
Starkeya_novella	921	S	1607	700	2307	0.00055
Ancylobacter_sp._TS-1	1850374	S	1184	568	1752	0.00042
Ancylobacter_polymorphus	223390	S	1102	643	1745	0.00042
Ancylobacter_pratisalsi	1745854	S	899	232	1131	0.00027
Labrys_sp._KNU-23	2789216	S	1289	149	1438	0.00034
Azorhizobium_caulinodans	7	S	1198	289	1487	0.00035
Rhodoplanes_sp._Z2-YC6860	674703	S	20123	2183	22306	0.00531
Hyphomicrobium_denitrificans	53399	S	1611	174	1785	0.00043
Hyphomicrobium_nitrativorans	1427356	S	870	75	945	0.00023
Hyphomicrobium_sp._MC1	717785	S	795	52	847	0.00020
Methyloceanibacter_sp._wino2	2170729	S	582	133	715	0.00017
Methyloceanibacter_caenitepidi	1384459	S	566	120	686	0.00016
Aquabacter_sp._L1I39	2820278	S	980	182	1162	0.00028
Rhodomicrobium_vannielii	1069	S	826	58	884	0.00021
Methyloligella_sp._GL2	2742204	S	776	98	874	0.00021
Caenibius_sp._WL	2872646	S	352	74	426	0.00010
Caenibius_tardaugens	169176	S	267	251	518	0.00012
Candidatus_Filomicrobium_marinum	1608628	S	303	8	311	0.00007
Devosia_sp._A16	1736675	S	3528	487	4015	0.00096
Devosia_sp._JXJ_CY_41	2917991	S	812	189	1001	0.00024
Devosia_sp._SL43	2806348	S	717	168	885	0.00021
Devosia_sp._1566	2499144	S	668	85	753	0.00018
Devosia_sp._I507	2083786	S	541	201	742	0.00018
Devosia_sp._MC521	2759954	S	264	50	314	0.00007
Devosia_ginsengisoli	400770	S	887	192	1079	0.00026
Devosia_beringensis	2657486	S	820	142	962	0.00023
Devosia_oryziradicis	2801335	S	801	176	977	0.00023
Devosia_salina	2860336	S	769	310	1079	0.00026
Devosia_rhizoryzae	2774137	S	699	86	785	0.00019
Youhaiella_tibetensis	1447062	S	1279	323	1602	0.00038
Paradevosia_shaoguanensis	1335043	S	1239	526	1765	0.00042
Pelagibacterium_halotolerans	531813	S	520	65	585	0.00014
Maritalea_myrionectae	454601	S	101	3	104	0.00002
Bosea_sp._Tri-49	1867715	S	1655	434	2089	0.00050
Bosea_sp._RAC05	1842539	S	1436	529	1965	0.00047
Bosea_sp._F3-2	2599640	S	1384	511	1895	0.00045
Bosea_sp._AS-1	2015316	S	1258	460	1718	0.00041
Bosea_sp._ANAM02	2020412	S	1196	516	1712	0.00041
Bosea_sp._PAMC_26642	1792307	S	1070	259	1329	0.00032
Bosea_vaviloviae	1526658	S	1214	326	1540	0.00037
Aureimonas_sp._SA4125	2826993	S	1092	228	1320	0.00031
Aureimonas_sp._AU20	1349819	S	944	153	1097	0.00026
Aureimonas_sp._OT7	2816454	S	453	419	872	0.00021
Aureimonas_populi	1701758	S	805	173	978	0.00023
Aureimonas_mangrovi	2758041	S	798	186	984	0.00023
Aureimonas_altamirensis	370622	S	477	173	650	0.00015
Martelella_sp._AD-3	686597	S	314	882	1196	0.00028
Martelella_mediterranea	293089	S	555	226	781	0.00019
Martelella_endophytica	1486262	S	450	110	560	0.00013
Martelella_lutilitoris	2583532	S	279	256	535	0.00013
Aurantimonas_sp._HBX-1	2906072	S	1315	444	1759	0.00042
Methylocystis_bryophila	655015	S	872	98	970	0.00023
Methylocystis_parvus	134	S	837	109	946	0.00023
Methylocystis_heyeri	391905	S	771	94	865	0.00021
Methylocystis_sp._SC2	187303	S	548	156	704	0.00017
Methylocystis_sp._SB2	743836	S	161	272	433	0.00010
Methylocystis_rosea	173366	S	491	403	894	0.00021
Methylosinus_trichosporium	426	S	1049	226	1275	0.00030
Methylosinus_sp._C49	2699395	S	860	181	1041	0.00025
Pseudorhodoplanes_sinuspersici	1235591	S	2838	235	3073	0.00073
Nordella_sp._HKS_07	2712222	S	1901	117	2018	0.00048
Terrihabitans_soli	708113	S	1315	166	1481	0.00035
Phreatobacter_stygius	1940610	S	2040	341	2381	0.00057
Phreatobacter_cathodiphilus	1868589	S	1700	558	2258	0.00054
Phreatobacter_sp._NMCR1094	2570229	S	1326	278	1604	0.00038
Stappia_indica	538381	S	1363	361	1724	0.00041
Stappia_sp._ES.058	1881061	S	668	92	760	0.00018
Roseibium_aggregatum	187304	S	761	120	881	0.00021
Roseibium_alexandrii	388408	S	203	20	223	0.00005
Pannonibacter_phragmitetus	121719	S	953	763	1716	0.00041
Labrenzia_sp._VG12	2021862	S	389	51	440	0.00010
Labrenzia_sp._PHM005	2590016	S	203	17	220	0.00005
Labrenzia_sp._THAF82	2587861	S	148	10	158	0.00004
Pseudovibrio_brasiliensis	1898042	S	68	31	99	0.00002
Pseudovibrio_sp._FO-BEG1	911045	S	48	22	70	0.00002
Kaustia_mangrovi	2593653	S	1587	174	1761	0.00042
Parvibaculum_lavamentivorans	256618	S	984	769	1753	0.00042
Pyruvatibacter_mobilis	1712261	S	740	108	848	0.00020
Candidatus_Phaeomarinobacter_ectocarpi	1458461	S	211	12	223	0.00005
Blastochloris_tepida	2233851	S	1627	607	2234	0.00053
Blastochloris_viridis	1079	S	1436	427	1863	0.00044
Methylocella_silvestris	199596	S	739	94	833	0.00020
Methylocella_tundrae	227605	S	672	72	744	0.00018
Methylovirgula_ligni	569860	S	674	88	762	0.00018
Methylovirgula_sp._HY1	2822761	S	612	39	651	0.00015
Beijerinckia_indica	533	S	335	27	362	0.00009
Chelatococcus_sp._CO-6	1702325	S	1408	911	2319	0.00055
Chelatococcus_daeguensis	444444	S	794	504	1298	0.00031
Kaistia_sp._32K	2795690	S	1731	480	2211	0.00053
Brucella_anthropi	529	S	299	202	501	0.00012
Brucella_intermedia	94625	S	274	52	326	0.00008
Brucella_sp._BTU1	2840456	S	62	13	75	0.00002
Brucella_sp._BO3	2691913	S	20	35	55	0.00001
Brucella_sp._10RB9215	1149953	S	18	21	39	0.00001
Brucella_sp._09RB8910	1844051	S	17	19	36	0.00001
Brucella_sp._09RB8471	1149952	S	13	26	39	0.00001
Brucella_sp._6810	2769351	S	12	21	33	0.00001
Brucella_sp._BO2	693750	S	11	27	38	0.00001
Brucella_sp._2280	2592625	S	10	21	31	0.00001
[Ochrobactrum]_quorumnocens	271865	S	119	19	138	0.00003
Brucella_pseudogrignonensis	419475	S	73	27	100	0.00002
Brucella_pituitosa	571256	S	40	16	56	0.00001
Brucella_melitensis	29459	S	14	760	774	0.00018
Brucella_inopinata	1218315	S	13	16	29	0.00001
Pseudochrobactrum_sp._Wa41.01b-1	2864102	S	32	34	66	0.00002
Pseudochrobactrum_sp._XF203	2879116	S	26	26	52	0.00001
Pseudochrobactrum_algeriensis	2834768	S	23	26	49	0.00001
Acuticoccus_sp._I52.16.1	2928472	S	1634	196	1830	0.00044
Hartmannibacter_diazotrophicus	1482074	S	1078	217	1295	0.00031
Breoghania_sp._L-A4	2304600	S	1009	149	1158	0.00028
Lichenihabitans_psoromatis	2528642	S	365	199	564	0.00013
Lichenihabitans_sp._PAMC28606	2880932	S	291	184	475	0.00011
Cohaesibacter_sp._ES.047	1798205	S	184	8	192	0.00005
Bartonella_apis	1686310	S	73	17	90	0.00002
Bartonella_sp._HY038	2759660	S	14	9	23	0.00001
Sphingomonas_sp._S8-45	2938948	S	4381	605	4986	0.00119
Sphingomonas_sp._HDW15A	2714942	S	3841	343	4184	0.00100
Sphingomonas_sp._DM2-R-LB4	2899123	S	3621	1372	4993	0.00119
Sphingomonas_sp._Cra20	1327635	S	3166	569	3735	0.00089
Sphingomonas_sp._LM7	1938607	S	2744	685	3429	0.00082
Sphingomonas_sp._AK-PDB1-5	2872652	S	2470	457	2927	0.00070
Sphingomonas_sp._CL5.1	2653203	S	2335	907	3242	0.00077
Sphingomonas_sp._MM-1	745310	S	2184	3111	5295	0.00126
Sphingomonas_sp._AP4-R1	2735134	S	2168	312	2480	0.00059
Sphingomonas_sp._S2-65	2903960	S	1787	401	2188	0.00052
Sphingomonas_sp._AAP5	1523415	S	1705	508	2213	0.00053
Sphingomonas_sp._NBWT7	2596913	S	1543	579	2122	0.00051
Sphingomonas_sp._FARSPH	2219696	S	1499	1387	2886	0.00069
Sphingomonas_sp._PAMC26645	2565555	S	1294	492	1786	0.00043
Sphingomonas_sp._HMP9	1517554	S	1246	629	1875	0.00045
Sphingomonas_sp._KC8	1030157	S	1184	167	1351	0.00032
Sphingomonas_sp._HMP6	1517551	S	1042	234	1276	0.00030
Sphingomonas_sp._LK11	1390395	S	736	909	1645	0.00039
Sphingomonas_sp._NIC1	1961362	S	702	2711	3413	0.00081
Sphingomonas_sp._IC081	304378	S	178	1265	1443	0.00034
Sphingomonas_sediminicola	386874	S	15512	1722	17234	0.00410
Sphingomonas_lutea	1045317	S	12401	1830	14231	0.00339
Sphingomonas_daechungensis	1176646	S	11252	1262	12514	0.00298
Sphingomonas_sabuli	2764186	S	9738	1362	11100	0.00264
Sphingomonas_sinipercae	2714944	S	8050	1229	9279	0.00221
Sphingomonas_ginsengisoli_An_et_al._2013	363835	S	6879	1083	7962	0.00190
Sphingomonas_piscis	2714943	S	5114	536	5650	0.00134
Sphingomonas_rhizophila	2071607	S	4852	1449	6301	0.00150
Sphingomonas_xanthus	2594473	S	3580	932	4512	0.00107
Sphingomonas_alpina	653931	S	2667	257	2924	0.00070
Sphingomonas_profundi	2681549	S	2400	442	2842	0.00068
Sphingomonas_sanxanigenens	397260	S	2319	1290	3609	0.00086
Sphingomonas_changnyeongensis	2698679	S	1891	415	2306	0.00055
Sphingomonas_koreensis	93064	S	1820	1613	3433	0.00082
Sphingomonas_hengshuiensis	1609977	S	1791	272	2063	0.00049
Sphingomonas_taxi	1549858	S	1748	644	2392	0.00057
Sphingomonas_panacisoli	1813879	S	1660	261	1921	0.00046
Sphingomonas_panacis	1560345	S	1618	276	1894	0.00045
Sphingomonas_suaedae	2599297	S	1372	207	1579	0.00038
Sphingomonas_radiodurans	2890321	S	1312	199	1511	0.00036
Sphingomonas_aliaeris	2759526	S	1154	166	1320	0.00031
Sphingomonas_insulae	424800	S	1100	371	1471	0.00035
Sphingomonas_paucimobilis	13689	S	914	715	1629	0.00039
Sphingomonas_sanguinis	33051	S	802	870	1672	0.00040
Sphingomonas_melonis	152682	S	651	2735	3386	0.00081
Sphingomonas_lacunae	2698828	S	549	77	626	0.00015
Sphingomonas_paeninsulae	2319844	S	485	22	507	0.00012
Sphingobium_sp._EP60837	1855519	S	1275	388	1663	0.00040
Sphingobium_sp._SYK-6	627192	S	1214	359	1573	0.00037
Sphingobium_sp._Cam5-1	2789327	S	1042	409	1451	0.00035
Sphingobium_sp._TKS	1315974	S	821	1296	2117	0.00050
Sphingobium_sp._YG1	2082188	S	708	326	1034	0.00025
Sphingobium_sp._CAP-1	2676077	S	660	444	1104	0.00026
Sphingobium_sp._SCG-1	2072936	S	653	51	704	0.00017
Sphingobium_sp._RAC03	1843368	S	611	121	732	0.00017
Sphingobium_sp._MI1205	407020	S	559	860	1419	0.00034
Sphingobium_sp._KCTC_72723	2733867	S	467	86	553	0.00013
Sphingobium_sp._PAMC28499	2565554	S	151	291	442	0.00011
Sphingobium_sp._RSMS	520734	S	94	558	652	0.00016
Sphingobium_sp._YBL2	484429	S	89	593	682	0.00016
Sphingobium_sp._LF-16	2185111	S	12	188	200	0.00005
Sphingobium_yanoikuyae	13690	S	1106	2145	3251	0.00077
Sphingobium_indicum	332055	S	896	752	1648	0.00039
Sphingobium_phenoxybenzoativorans	1592790	S	862	397	1259	0.00030
Sphingobium_amiense	135719	S	777	1073	1850	0.00044
Sphingobium_cloacae	120107	S	716	1174	1890	0.00045
Sphingobium_xenophagum	121428	S	674	483	1157	0.00028
Sphingobium_herbicidovorans	76947	S	594	563	1157	0.00028
Sphingobium_chlorophenolicum	46429	S	575	286	861	0.00021
Sphingobium_baderi	1332080	S	575	638	1213	0.00029
Sphingobium_fuliginis	336203	S	290	1118	1408	0.00034
Sphingopyxis_sp._QXT-31	1357916	S	1632	470	2102	0.00050
Sphingopyxis_sp._YF1	2482763	S	1193	290	1483	0.00035
Sphingopyxis_sp._OPL5	2486273	S	1083	216	1299	0.00031
Sphingopyxis_sp._PAMC25046	2565556	S	1035	507	1542	0.00037
Sphingopyxis_sp._BSN-002	2911495	S	978	186	1164	0.00028
Sphingopyxis_sp._113P3	292913	S	951	409	1360	0.00032
Sphingopyxis_sp._FD7	1914525	S	824	372	1196	0.00028
Sphingopyxis_sp._EG6	1874061	S	761	409	1170	0.00028
Sphingopyxis_sp._MG	1866325	S	39	389	428	0.00010
Sphingopyxis_macrogoltabida	33050	S	1873	1030	2903	0.00069
Sphingopyxis_terrae	33052	S	1070	609	1679	0.00040
Sphingopyxis_lindanitolerans	2054227	S	993	533	1526	0.00036
Sphingopyxis_fribergensis	1515612	S	809	355	1164	0.00028
Sphingopyxis_granuli	267128	S	760	2276	3036	0.00072
Sphingopyxis_alaskensis	117207	S	706	179	885	0.00021
Novosphingobium_sp._Gsoil_351	2675225	S	1248	113	1361	0.00032
Novosphingobium_sp._Sx8-5	2896849	S	1130	168	1298	0.00031
Novosphingobium_sp._EMRT-2	2571749	S	1047	677	1724	0.00041
Novosphingobium_sp._P6W	1609758	S	813	140	953	0.00023
Novosphingobium_sp._THN1	1016987	S	640	238	878	0.00021
Novosphingobium_sp._ES2-1	2780074	S	623	334	957	0.00023
Novosphingobium_sp._PP1Y	702113	S	383	468	851	0.00020
Novosphingobium_sp._KA1	164608	S	203	1172	1375	0.00033
Novosphingobium_resinovorum	158500	S	1029	563	1592	0.00038
Novosphingobium_aromaticivorans	48935	S	930	457	1387	0.00033
Novosphingobium_decolorationis	2698673	S	905	538	1443	0.00034
Novosphingobium_ginsenosidimutans	1176536	S	665	73	738	0.00018
Novosphingobium_pentaromativorans	205844	S	352	646	998	0.00024
Rhizorhabdus_wittichii	160791	S	2703	1842	4545	0.00108
Rhizorhabdus_dicambivorans	1850238	S	1651	1580	3231	0.00077
Rhizorhabdus_phycosphaerae	2711156	S	1293	186	1479	0.00035
Allosphingosinicella_indica	941907	S	3075	416	3491	0.00083
Sphingosinithalassobacter_sp._CS137	2762748	S	1572	354	1926	0.00046
Sphingosinithalassobacter_tenebrarum	2711215	S	1029	342	1371	0.00033
Parasphingopyxis_algicola	2026624	S	1338	96	1434	0.00034
Parasphingopyxis_sp._CP4	2724527	S	327	15	342	0.00008
Sphingorhabdus_sp._YGSMI21	2077182	S	388	66	454	0.00011
Sphingorhabdus_sp._SMR4y	2584094	S	281	49	330	0.00008
Sphingorhabdus_sp._M41	1806885	S	247	32	279	0.00007
Sphingorhabdus_lacus	392610	S	226	9	235	0.00006
Sphingorhabdus_lutea	1913578	S	37	2	39	0.00001
Blastomonas_sp._RAC04	1842535	S	282	385	667	0.00016
Blastomonas_fulva	1550728	S	275	499	774	0.00018
Hankyongella_ginsenosidimutans	1763828	S	873	188	1061	0.00025
Tardibacter_chloracetimidivorans	1921510	S	870	787	1657	0.00039
Novosphingopyxis_iocasae	2762729	S	664	388	1052	0.00025
Citromicrobium_sp._JL477	1634516	S	611	295	906	0.00022
Aquisediminimonas_profunda	1550733	S	420	17	437	0.00010
Parasphingorhabdus_sp._JHSY0214	2806553	S	118	11	129	0.00003
Parasphingorhabdus_halotolerans	2725558	S	116	5	121	0.00003
Parasphingorhabdus_litoris	394733	S	103	10	113	0.00003
Erythrobacter_sp._HL-111	1798193	S	785	156	941	0.00022
Erythrobacter_sp._JK5	2829500	S	662	206	868	0.00021
Erythrobacter_sp._HKB08	2502843	S	644	151	795	0.00019
Erythrobacter_sp._SDW2	2907154	S	543	151	694	0.00017
Erythrobacter_sp._THAF29	2587851	S	393	97	490	0.00012
Erythrobacter_sp._3-20A1M	2653850	S	343	575	918	0.00022
Erythrobacter_sp._A30-3	2785907	S	313	263	576	0.00014
Erythrobacter_sp._LQ02-29	2920384	S	287	342	629	0.00015
Erythrobacter_sp._KY5	2011159	S	282	23	305	0.00007
Erythrobacter_sp._SCSIO_43205	2779361	S	144	28	172	0.00004
Erythrobacter_litoralis	39960	S	1122	509	1631	0.00039
Erythrobacter_neustonensis	1112	S	489	114	603	0.00014
Erythrobacter_mangrovi	2739433	S	481	179	660	0.00016
Erythrobacter_aureus	2182384	S	368	70	438	0.00010
Porphyrobacter_sp._CACIAM_03H1	2003315	S	843	256	1099	0.00026
Porphyrobacter_sp._HT-58-2	2023229	S	432	106	538	0.00013
Porphyrobacter_sp._LM_6	1896196	S	420	157	577	0.00014
Porphyrobacter_sp._GA68	2883480	S	414	184	598	0.00014
Qipengyuania_flava	192812	S	1287	769	2056	0.00049
Qipengyuania_sediminis	1532023	S	800	120	920	0.00022
Qipengyuania_soli	2782568	S	537	105	642	0.00015
Qipengyuania_aurantiaca	2867233	S	451	157	608	0.00014
Qipengyuania_gelatinilytica	2867231	S	394	78	472	0.00011
Qipengyuania_seohaensis	266951	S	331	76	407	0.00010
Qipengyuania_psychrotolerans	2867238	S	244	32	276	0.00007
Qipengyuania_aquimaris	255984	S	241	240	481	0.00011
Qipengyuania_xiapuensis	2867236	S	239	234	473	0.00011
Tsuneonella_amylolytica	2338327	S	1089	336	1425	0.00034
Tsuneonella_dongtanensis	692370	S	1018	216	1234	0.00029
Tsuneonella_mangrovi	1982042	S	721	118	839	0.00020
Tsuneonella_flava	2055955	S	316	101	417	0.00010
Altererythrobacter_sp._TH136	2067415	S	987	197	1184	0.00028
Altererythrobacter_sp._B11	2060312	S	901	462	1363	0.00032
Altererythrobacter_sp._BO-6	2604537	S	448	74	522	0.00012
Altererythrobacter_sp._ZODW24	2185142	S	166	8	174	0.00004
Altererythrobacter_epoxidivorans	361183	S	383	120	503	0.00012
Altererythrobacter_ishigakiensis	476157	S	135	10	145	0.00003
Croceicoccus_sp._YJ47	2798724	S	545	324	869	0.00021
Croceicoccus_sp._Ery5	1703340	S	186	229	415	0.00010
Croceicoccus_sp._Ery15	1703338	S	129	229	358	0.00009
Croceicoccus_marinus	450378	S	1007	585	1592	0.00038
Croceicoccus_naphthovorans	1348774	S	427	540	967	0.00023
Aurantiacibacter_gangjinensis	502682	S	396	40	436	0.00010
Aurantiacibacter_atlanticus	1648404	S	165	60	225	0.00005
Paraurantiacibacter_namhicola	645517	S	481	67	548	0.00013
Pelagerythrobacter_marensis	543877	S	452	68	520	0.00012
Croceibacterium_atlanticum	1267766	S	438	207	645	0.00015
Sphingosinicella_sp._BN140058	1892855	S	3268	316	3584	0.00085
Sphingosinicella_flava	2771430	S	1425	218	1643	0.00039
Sphingosinicella_microcystinivorans	335406	S	926	128	1054	0.00025
Polymorphobacter_sp._PAMC_29334	2862331	S	592	411	1003	0.00024
Polymorphobacter_sp._PAMC_29362	2835787	S	589	397	986	0.00023
Sandaracinobacter_sp._M6	2759707	S	783	61	844	0.00020
Zymomonas_mobilis	542	S	64	50	114	0.00003
Azospirillum_sp._B510	137722	S	890	352	1242	0.00030
Azospirillum_sp._TSA2s	709810	S	841	686	1527	0.00036
Azospirillum_sp._TSH100	652764	S	769	374	1143	0.00027
Azospirillum_sp._TSH58	664962	S	456	654	1110	0.00026
Azospirillum_brasilense	192	S	2536	2395	4931	0.00117
Azospirillum_thermophilum	2202148	S	2069	508	2577	0.00061
Azospirillum_thiophilum	528244	S	1117	394	1511	0.00036
Azospirillum_ramasamyi	682998	S	676	419	1095	0.00026
Azospirillum_humicireducens	1226968	S	555	351	906	0.00022
Azospirillum_lipoferum	193	S	543	433	976	0.00023
Azospirillum_oryzae	286727	S	453	423	876	0.00021
Azospirillum_baldaniorum	1064539	S	329	719	1048	0.00025
Skermanella_mucosa	1789672	S	899	666	1565	0.00037
Skermanella_sp._TT6	2775420	S	857	955	1812	0.00043
Skermanella_rosea	1817965	S	807	783	1590	0.00038
Skermanella_pratensis	2233999	S	791	468	1259	0.00030
Nitrospirillum_amazonense	28077	S	1440	183	1623	0.00039
Indioceanicola_profundi	2220096	S	1080	162	1242	0.00030
Niveispirillum_cyanobacteriorum	1612173	S	618	74	692	0.00016
Roseomonas_sp._OT10	2897332	S	2295	618	2913	0.00069
Roseomonas_sp._S08	1750527	S	2046	135	2181	0.00052
Roseomonas_sp._FDAARGOS_362	2018065	S	144	789	933	0.00022
Roseomonas_gilardii	257708	S	1629	792	2421	0.00058
Roseomonas_haemaphysalidis	2768162	S	1451	171	1622	0.00039
Roseomonas_marmotae	2768161	S	1396	162	1558	0.00037
Roseomonas_mucosa	207340	S	118	757	875	0.00021
Rhodovastum_atsumiense	504468	S	2136	229	2365	0.00056
Komagataeibacter_xylinus	28448	S	432	913	1345	0.00032
Komagataeibacter_saccharivorans	265959	S	182	72	254	0.00006
Komagataeibacter_europaeus	33995	S	128	74	202	0.00005
Komagataeibacter_nataicola	265960	S	126	68	194	0.00005
Komagataeibacter_oboediens	65958	S	125	67	192	0.00005
Komagataeibacter_medellinensis	1177712	S	100	90	190	0.00005
Roseococcus_microcysteis	2771361	S	1436	138	1574	0.00037
Acidiphilium_multivorum	62140	S	291	1341	1632	0.00039
Acidiphilium_cryptum	524	S	57	423	480	0.00011
Lichenicola_cladoniae	1484109	S	947	47	994	0.00024
Sediminicoccus_rosea	1225128	S	939	50	989	0.00024
Acidibrevibacterium_fodinaquatile	1969806	S	928	89	1017	0.00024
Acetobacter_aceti	435	S	341	137	478	0.00011
Acetobacter_sp._KACC_21233	2592655	S	84	18	102	0.00002
Acetobacter_persici	1076596	S	84	12	96	0.00002
Acetobacter_ghanensis	431306	S	57	15	72	0.00002
Acetobacter_pasteurianus	438	S	33	76	109	0.00003
Acetobacter_ascendens	481146	S	22	30	52	0.00001
Acetobacter_tropicalis	104102	S	20	32	52	0.00001
Acetobacter_senegalensis	446692	S	15	25	40	0.00001
Acetobacter_orientalis	146474	S	14	2	16	0.00000
Gluconacetobacter_diazotrophicus	33996	S	611	134	745	0.00018
Gluconobacter_oxydans	442	S	219	225	444	0.00011
Gluconobacter_albidus	318683	S	97	17	114	0.00003
Gluconobacter_sphaericus	574987	S	65	15	80	0.00002
Gluconobacter_frateurii	38308	S	59	15	74	0.00002
Gluconobacter_thailandicus	257438	S	23	17	40	0.00001
Granulibacter_bethesdensis	364410	S	396	37	433	0.00010
Asaia_bogorensis	91915	S	284	50	334	0.00008
Neoasaia_chiangmaiensis	320497	S	241	51	292	0.00007
Kozakia_baliensis	153496	S	172	64	236	0.00006
Novacetimonas_hansenii	436	S	146	77	223	0.00005
Oecophyllibacter_saccharovorans	2558360	S	118	4	122	0.00003
Parasaccharibacter_apium	1510841	S	14	80	94	0.00002
Swingsia_sp._F3b2	2558361	S	54	1	55	0.00001
Swingsia_samuiensis	1293412	S	12	2	14	0.00000
Neokomagataea_tanensis	661191	S	31	5	36	0.00001
Entomobacter_blattae	2762277	S	15	1	16	0.00000
Hypericibacter_adhaerens	2602016	S	3100	606	3706	0.00088
Hypericibacter_terrae	2602015	S	2585	397	2982	0.00071
Magnetospirillum_sp._XM-1	1663591	S	705	229	934	0.00022
Magnetospirillum_sp._ME-1	1639348	S	593	209	802	0.00019
Magnetospirillum_gryphiswaldense	55518	S	721	62266	62987	0.01499
Magnetospirillum_magneticum	84159	S	641	72	713	0.00017
Rhodospirillum_centenum	34018	S	1381	209	1590	0.00038
Rhodospirillum_rubrum	1085	S	695	54	749	0.00018
Tistrella_mobilis	171437	S	1480	725	2205	0.00052
Ferrovibrio_terrae	2594003	S	1408	98	1506	0.00036
Defluviicoccus_vanus	111831	S	747	73	820	0.00020
Pararhodospirillum_photometricum	1084	S	471	37	508	0.00012
Haematospirillum_jordaniae	1549855	S	54	4	58	0.00001
Candidatus_Endolissoclinum_faulkneri	1263979	S	25	0	25	0.00001
Stella_humosa	94	S	3514	267	3781	0.00090
Elioraea_tepida	2843330	S	1491	79	1570	0.00037
Thalassospira_sp._A40-3	2785908	S	86	36	122	0.00003
Thalassospira_sp._B30-1	2785911	S	42	67	109	0.00003
Thalassospira_marina	2048283	S	119	7	126	0.00003
Thalassospira_indica	1891279	S	72	46	118	0.00003
Thalassospira_xiamenensis	220697	S	52	77	129	0.00003
Magnetospira_sp._QH-2	1288970	S	273	9	282	0.00007
Terasakiella_sp._SH-1	2560057	S	40	1	41	0.00001
Caulobacter_sp._S6	2823693	S	4395	511	4906	0.00117
Caulobacter_sp._FWC26	69665	S	1241	617	1858	0.00044
Caulobacter_segnis	88688	S	4225	2000	6225	0.00148
Caulobacter_mirabilis	69666	S	3830	755	4585	0.00109
Caulobacter_rhizosphaerae	2010972	S	3106	1007	4113	0.00098
Caulobacter_flavus	1679497	S	2630	805	3435	0.00082
Caulobacter_vibrioides	155892	S	2615	1209	3824	0.00091
Caulobacter_soli	2708539	S	2026	719	2745	0.00065
Caulobacter_henricii	69395	S	1122	209	1331	0.00032
Phenylobacterium_zucineum	284016	S	16743	3635	20378	0.00485
Phenylobacterium_parvum	2201350	S	2618	304	2922	0.00070
Brevundimonas_sp._PAMC22021	2861285	S	958	224	1182	0.00028
Brevundimonas_sp._M20	2591463	S	935	151	1086	0.00026
Brevundimonas_sp._LM2	1938605	S	833	150	983	0.00023
Brevundimonas_sp._MF30-B	2561924	S	817	136	953	0.00023
Brevundimonas_sp._AJA228-03	2752515	S	583	81	664	0.00016
Brevundimonas_sp._SGAir0440	2579977	S	205	222	427	0.00010
Brevundimonas_sp._CS1	2813778	S	178	199	377	0.00009
Brevundimonas_sp._Bb-A	2560058	S	175	421	596	0.00014
Brevundimonas_sp._'scallop'	2562582	S	148	295	443	0.00011
Brevundimonas_sp._GW460-12-10-14-LB2	1827469	S	132	259	391	0.00009
Brevundimonas_sp._DS20	1532555	S	123	351	474	0.00011
Brevundimonas_naejangsanensis	588932	S	1484	547	2031	0.00048
Brevundimonas_albigilva	1312364	S	1032	615	1647	0.00039
Brevundimonas_goettingensis	2774190	S	896	147	1043	0.00025
Brevundimonas_subvibrioides	74313	S	809	153	962	0.00023
Brevundimonas_pondensis	2774189	S	654	216	870	0.00021
Brevundimonas_vitisensis	2800818	S	585	75	660	0.00016
Brevundimonas_diminuta	293	S	563	1187	1750	0.00042
Brevundimonas_mediterranea	74329	S	516	217	733	0.00017
Brevundimonas_nasdae	172043	S	461	314	775	0.00018
Brevundimonas_vesicularis	41276	S	153	372	525	0.00013
Brevundimonas_vancanneytii	1325724	S	133	576	709	0.00017
Terricaulis_silvestris	2686094	S	2085	79	2164	0.00052
Asticcacaulis_excentricus	78587	S	559	93	652	0.00016
Asticcacaulis_sp._AND118	2840468	S	532	87	619	0.00015
Paracoccus_sp._MC1862	2760307	S	487	54	541	0.00013
Paracoccus_sp._MA	2895796	S	368	188	556	0.00013
Paracoccus_sp._AK26	2589076	S	342	59	401	0.00010
Paracoccus_sp._S8-55	2903900	S	200	27	227	0.00005
Paracoccus_sp._H4-D09	2812658	S	196	41	237	0.00006
Paracoccus_sp._Arc7-R13	2500532	S	166	154	320	0.00008
Paracoccus_sanguinis	1545044	S	709	193	902	0.00021
Paracoccus_yeei	147645	S	510	768	1278	0.00030
Paracoccus_liaowanqingii	2560053	S	452	53	505	0.00012
Paracoccus_aminovorans	34004	S	436	131	567	0.00014
Paracoccus_denitrificans	266	S	433	595	1028	0.00024
Paracoccus_pantotrophus	82367	S	428	234	662	0.00016
Paracoccus_zhejiangensis	1077935	S	420	108	528	0.00013
Paracoccus_suum	2259340	S	398	78	476	0.00011
Paracoccus_jeotgali	2065379	S	364	72	436	0.00010
Paracoccus_contaminans	1945662	S	358	83	441	0.00010
Paracoccus_aminophilus	34003	S	298	30	328	0.00008
Paracoccus_tegillarcae	1529068	S	200	12	212	0.00005
Paracoccus_kondratievae	135740	S	192	38	230	0.00005
Paracoccus_marcusii	59779	S	131	107	238	0.00006
Paracoccus_mutanolyticus	1499308	S	59	175	234	0.00006
Cereibacter_sphaeroides	1063	S	1467	837	2304	0.00055
Cereibacter_azotoformans	43057	S	116	466	582	0.00014
Rhodobacter_sp._CZR27	2033869	S	562	185	747	0.00018
Rhodobacter_sp._LPB0142	1850250	S	470	346	816	0.00019
Rhodobacter_sp._N10	2807096	S	417	53	470	0.00011
Rhodobacter_capsulatus	1061	S	565	117	682	0.00016
Rhodovulum_sp._P5	1564506	S	334	38	372	0.00009
Rhodovulum_sp._MB263	308754	S	266	113	379	0.00009
Rhodovulum_sulfidophilum	35806	S	433	243	676	0.00016
Polymorphum_gilvum	991904	S	1020	284	1304	0.00031
Paroceanicella_profunda	2579971	S	997	277	1274	0.00030
Thioclava_electrotropha	1549850	S	313	85	398	0.00009
Thioclava_nitratireducens	1915078	S	307	113	420	0.00010
Pikeienuella_piscinae	2748098	S	652	70	722	0.00017
Pontivivens_ytuae	2789856	S	611	49	660	0.00016
Silicimonas_algicola	1826607	S	604	38	642	0.00015
Pelagovum_pacificum	2588711	S	500	67	567	0.00014
Frigidibacter_mobilis	1335048	S	458	211	669	0.00016
Pukyongiella_litopenaei	2605946	S	420	106	526	0.00013
Brevirhabdus_pacifica	1267768	S	413	203	616	0.00015
Falsirhodobacter_sp._PG104	2692330	S	328	49	377	0.00009
Fuscovulum_blasticum	1075	S	322	43	365	0.00009
Gymnodinialimonas_ceratoperidinii	2856823	S	318	32	350	0.00008
Haematobacter_massiliensis	195105	S	305	136	441	0.00010
Gemmobacter_aquarius	2169400	S	288	62	350	0.00008
Pacificitalea_manganoxidans	1411902	S	281	65	346	0.00008
Pseudopuniceibacterium_antarcticum	2613965	S	267	22	289	0.00007
Pseudooceanicola_algae	1537215	S	238	24	262	0.00006
Roseicitreum_antarcticum	564137	S	232	12	244	0.00006
Tabrizicola_piscis	2494374	S	221	21	242	0.00006
Monaibacterium_sp._h42	2758038	S	215	52	267	0.00006
Tritonibacter_mobilis	379347	S	163	77	240	0.00006
Yoonia_vestfoldensis	245188	S	156	36	192	0.00005
Qingshengfaniella_alkalisoli	2599296	S	132	7	139	0.00003
Pseudohalocynthiibacter_aestuariivivens	1591409	S	128	26	154	0.00004
Rhodophyticola_sp._CCM32	2916397	S	123	3	126	0.00003
Profundibacter_amoris	2171755	S	115	4	119	0.00003
Pseudorhodobacter_turbinis	2500533	S	99	6	105	0.00003
Rhodobaca_barguzinensis	441209	S	92	4	96	0.00002
Cognatishimia_activa	1715691	S	68	3	71	0.00002
Aestuarium_zhoushanense	2820523	S	66	28	94	0.00002
Parasedimentitalea_marina	2483033	S	62	3	65	0.00002
Planktomarina_temperata	1284658	S	49	1	50	0.00001
Roseovarius_sp._SCSIO_43702	2823043	S	484	41	525	0.00012
Roseovarius_sp._THAF9	2587847	S	213	54	267	0.00006
Roseovarius_sp._THAF8	2587846	S	108	159	267	0.00006
Roseovarius_sp._THAF27	2587850	S	83	132	215	0.00005
Roseovarius_sp._TM1035	391613	S	30	75	105	0.00002
Roseovarius_indicus	540747	S	552	184	736	0.00018
Roseovarius_faecimaris	2494550	S	189	8	197	0.00005
Roseovarius_mucosus	215743	S	34	84	118	0.00003
Sulfitobacter_sp._THAF37	2587855	S	234	102	336	0.00008
Sulfitobacter_sp._JK7-1	2829501	S	229	13	242	0.00006
Sulfitobacter_sp._D7	1968541	S	122	46	168	0.00004
Sulfitobacter_sp._JL08	2070369	S	106	2	108	0.00003
Sulfitobacter_sp._SK011	1389004	S	89	2	91	0.00002
Sulfitobacter_sp._SK012	1389005	S	89	1	90	0.00002
Sulfitobacter_sp._DSM_110093	2883127	S	80	21	101	0.00002
Sulfitobacter_sp._BSw21498	664426	S	67	10	77	0.00002
Sulfitobacter_sp._SK025	1389011	S	22	43	65	0.00002
Sulfitobacter_sp._CB2047	1525218	S	19	48	67	0.00002
Sulfitobacter_sp._B30-2	2785912	S	15	29	44	0.00001
Sulfitobacter_alexandrii	1917485	S	321	173	494	0.00012
Sulfitobacter_mediterraneus	83219	S	152	16	168	0.00004
Sulfitobacter_indolifex	225422	S	109	24	133	0.00003
Sulfitobacter_dubius	218673	S	77	33	110	0.00003
Sulfitobacter_pontiacus	60137	S	45	92	137	0.00003
Salipiger_profundus	1229727	S	627	293	920	0.00022
Salipiger_abyssi	1250539	S	465	198	663	0.00016
Salipiger_sp._CCB-MM3	1792508	S	392	58	450	0.00011
Roseivivax_marinus	1379903	S	667	113	780	0.00019
Roseivivax_sp._THAF30	2587852	S	343	86	429	0.00010
Roseivivax_sp._THAF40	2587858	S	10	281	291	0.00007
Celeribacter_indicus	1208324	S	544	280	824	0.00020
Celeribacter_ethanolicus	1758178	S	206	73	279	0.00007
Celeribacter_baekdonensis	875171	S	106	29	135	0.00003
Celeribacter_marinus	1397108	S	63	2	65	0.00002
Leisingera_aquaemixtae	1396826	S	294	57	351	0.00008
Leisingera_sp._NJS201	2508306	S	61	93	154	0.00004
Leisingera_sp._NJS204	2508307	S	46	74	120	0.00003
Leisingera_methylohalidivorans	133924	S	192	45	237	0.00006
Phaeobacter_gallaeciensis	60890	S	261	112	373	0.00009
Phaeobacter_inhibens	221822	S	193	77	270	0.00006
Phaeobacter_piscinae	1580596	S	101	81	182	0.00004
Phaeobacter_porticola	1844006	S	27	8	35	0.00001
Phaeobacter_sp._LSS9	681157	S	10	14	24	0.00001
Ruegeria_sp._TM1040	292414	S	114	20	134	0.00003
Ruegeria_sp._THAF33	2587853	S	92	29	121	0.00003
Ruegeria_sp._AD91A	2293862	S	85	12	97	0.00002
Ruegeria_sp._SCSIO_43209	2793010	S	80	17	97	0.00002
Ruegeria_pomeroyi	89184	S	308	57	365	0.00009
Sagittula_sp._P11	2009329	S	567	252	819	0.00020
Yangia_pacifica	311180	S	562	101	663	0.00016
Sulfitobacter_pseudonitzschiae	1402135	S	356	131	487	0.00012
Pseudosulfitobacter_sp._DSM_107133	2883100	S	137	58	195	0.00005
Ponticoccus_alexandrii	1943633	S	374	60	434	0.00010
Roseobacter_ponti	1891787	S	140	3	143	0.00003
Roseobacter_denitrificans	2434	S	116	33	149	0.00004
Roseobacter_litoralis	42443	S	89	6	95	0.00002
Dinoroseobacter_shibae	215813	S	362	138	500	0.00012
Mameliella_alba	561184	S	361	71	432	0.00010
Oceanicola_sp._D3	2587163	S	319	17	336	0.00008
Octadecabacter_sp._SW4	2602067	S	124	19	143	0.00003
Octadecabacter_arcticus	53946	S	79	11	90	0.00002
Octadecabacter_antarcticus	1217908	S	49	5	54	0.00001
Octadecabacter_temperatus	1458307	S	47	1	48	0.00001
Ketogulonicigenium_vulgare	92945	S	160	92	252	0.00006
Ketogulonicigenium_robustum	92947	S	143	15	158	0.00004
Roseibacterium_elongatum	159346	S	293	26	319	0.00008
Actibacterium_sp._EMB200-NS6	1609966	S	279	142	421	0.00010
Maribius_sp._THAF1	2587842	S	228	12	240	0.00006
Tateyamaria_omphalii	299262	S	203	7	210	0.00005
Thalassococcus_sp._S3	2017482	S	197	5	202	0.00005
Jannaschia_sp._CCS1	290400	S	191	5	196	0.00005
Antarctobacter_heliothermus	74033	S	169	9	178	0.00004
Thalassobius_gelatinovorus	53501	S	113	6	119	0.00003
Falsihalocynthiibacter_arcticus	1579316	S	44	1	45	0.00001
Hyphomonas_sp._CACIAM_19H1	1873716	S	380	51	431	0.00010
Hyphomonas_sp._Mor2	1906738	S	180	4	184	0.00004
Hyphomonas_sp._KY3	2016196	S	152	19	171	0.00004
Hyphomonas_neptunium	81032	S	322	29	351	0.00008
Candidatus_Viadribacter_manganicus	1759059	S	895	26	921	0.00022
Hirschia_baltica	2724	S	20	0	20	0.00000
Marinicauda_algicola	2029849	S	931	172	1103	0.00026
Glycocaulis_alkaliphilus	1434191	S	313	17	330	0.00008
Maricaulis_maris	74318	S	293	19	312	0.00007
Hyphobacterium_sp._CCMP332	2749086	S	241	10	251	0.00006
Aquisalinus_flavus	1526572	S	375	18	393	0.00009
Parvularcula_bermudensis	208216	S	131	17	148	0.00004
Luteithermobacter_gelatinilyticus	2582913	S	154	26	180	0.00004
Paremcibacter_congregatus	2043170	S	138	4	142	0.00003
Anaplasma_ovis	142058	S	12	16	28	0.00001
Ehrlichia_ruminantium	779	S	12	8	20	0.00000
Rickettsia_tillamookensis	2761623	S	17	33	50	0.00001
Candidatus_Midichloria_mitochondrii	234827	S	12	3	15	0.00000
Micavibrio_aeruginosavorus	349221	S	189	2	191	0.00005
Candidatus_Puniceispirillum_marinum	767892	S	34	1	35	0.00001
Candidatus_Hydrogenosomobacter_endosymbioticus	2558174	S	10	2	12	0.00000
Candidatus_Nucleicultrix_amoebiphila	1509244	S	23	1	24	0.00001
Candidatus_Paracaedibacter_acanthamoebae	91604	S	17	0	17	0.00000
Candidatus_Fonsibacter_ubiquis	1925548	S	35	0	35	0.00001
Candidatus_Pelagibacter_sp._RS40	1977865	S	12	10	22	0.00001
Magnetococcus_marinus	1124597	S	68	1	69	0.00002
Kordiimonas_pumila	2161677	S	27	0	27	0.00001
Paraburkholderia_sp._PGU16	2735433	S	2323	961	3284	0.00078
Paraburkholderia_sp._PGU19	2735434	S	1529	936	2465	0.00059
Paraburkholderia_sp._SOS3	1926494	S	1172	142	1314	0.00031
Paraburkholderia_phymatum	148447	S	4861	943	5804	0.00138
Paraburkholderia_caribensis	75105	S	4245	2277	6522	0.00155
Paraburkholderia_terrae	311230	S	2064	1585	3649	0.00087
Paraburkholderia_hospita	169430	S	1691	1316	3007	0.00072
Paraburkholderia_aromaticivorans	2026199	S	1556	546	2102	0.00050
Paraburkholderia_pallida	2547399	S	1266	200	1466	0.00035
Paraburkholderia_edwinii	2861782	S	1208	137	1345	0.00032
Paraburkholderia_phenoliruptrix	252970	S	1198	263	1461	0.00035
Paraburkholderia_acidisoli	2571748	S	1136	179	1315	0.00031
Paraburkholderia_tropica	92647	S	1044	201	1245	0.00030
Paraburkholderia_acidiphila	2571747	S	1026	177	1203	0.00029
Paraburkholderia_atlantica	2654982	S	1018	201	1219	0.00029
Paraburkholderia_terricola	169427	S	1005	244	1249	0.00030
Paraburkholderia_phytofirmans	261302	S	985	322	1307	0.00031
Paraburkholderia_graminis	60548	S	938	181	1119	0.00027
Paraburkholderia_megapolitana	420953	S	885	77	962	0.00023
Paraburkholderia_sprentiae	948107	S	856	153	1009	0.00024
Paraburkholderia_fungorum	134537	S	794	146	940	0.00022
Paraburkholderia_ginsengisoli	311231	S	790	193	983	0.00023
Paraburkholderia_caledonica	134536	S	661	98	759	0.00018
Paraburkholderia_xenovorans	36873	S	556	625	1181	0.00028
Paraburkholderia_caffeinilytica	1761016	S	522	104	626	0.00015
Paraburkholderia_dokdonella	2211211	S	488	111	599	0.00014
Paraburkholderia_dioscoreae	2604047	S	394	183	577	0.00014
Burkholderia_multivorans	87883	S	2064	905	2969	0.00071
Burkholderia_ubonensis	101571	S	1839	1309	3148	0.00075
Burkholderia_cenocepacia	95486	S	1561	5217	6778	0.00161
Burkholderia_cepacia	292	S	1224	1207	2431	0.00058
Burkholderia_pyrrocinia	60550	S	771	462	1233	0.00029
Burkholderia_contaminans	488447	S	708	516	1224	0.00029
Burkholderia_ambifaria	152480	S	674	569	1243	0.00030
Burkholderia_stagnalis	1503054	S	616	228	844	0.00020
Burkholderia_dolosa	152500	S	552	315	867	0.00021
Burkholderia_anthina	179879	S	541	520	1061	0.00025
Burkholderia_stabilis	95485	S	530	423	953	0.00023
Burkholderia_lata	482957	S	469	514	983	0.00023
Burkholderia_territorii	1503055	S	418	217	635	0.00015
Burkholderia_seminalis	488731	S	340	175	515	0.00012
Burkholderia_vietnamiensis	60552	S	332	893	1225	0.00029
Burkholderia_metallica	488729	S	278	149	427	0.00010
Burkholderia_diffusa	488732	S	197	106	303	0.00007
Burkholderia_pseudomultivorans	1207504	S	160	222	382	0.00009
Burkholderia_latens	488446	S	108	306	414	0.00010
Burkholderia_aenigmatica	2015348	S	89	234	323	0.00008
Burkholderia_pseudomallei	28450	S	862	10624	11486	0.00273
Burkholderia_thailandensis	57975	S	662	383	1045	0.00025
Burkholderia_mayonis	1385591	S	601	121	722	0.00017
Burkholderia_oklahomensis	342113	S	454	440	894	0.00021
Burkholderia_savannae	1637837	S	84	69	153	0.00004
Burkholderia_mallei	13373	S	35	21547	21582	0.00514
Burkholderia_sp._MSMB617WGS	1637831	S	35	56	91	0.00002
Burkholderia_sp._MSMB1588	1636423	S	21	45	66	0.00002
Burkholderia_sp._DHOD12	2571746	S	1269	130	1399	0.00033
Burkholderia_sp._Bp7605	1740163	S	625	88	713	0.00017
Burkholderia_sp._NRF60-BP8	1637853	S	243	126	369	0.00009
Burkholderia_sp._MSMB0856	1637869	S	233	146	379	0.00009
Burkholderia_sp._JP2-270	2217913	S	209	133	342	0.00008
Burkholderia_sp._LA-2-3-30-S1-D2	1637862	S	190	109	299	0.00007
Burkholderia_sp._MS455	2811788	S	153	108	261	0.00006
Burkholderia_sp._PAMC_26561	1795043	S	139	191	330	0.00008
Burkholderia_sp._PAMC_28687	1795874	S	121	257	378	0.00009
Burkholderia_sp._IDO3	1705310	S	104	152	256	0.00006
Burkholderia_sp._KBS0801	1179675	S	43	88	131	0.00003
Burkholderia_sp._LAS2	2813843	S	31	154	185	0.00004
Burkholderia_sp._MS389	2811789	S	19	152	171	0.00004
Burkholderia_sp._KJ006	416344	S	18	124	142	0.00003
Burkholderia_sp._MBR-1	2732364	S	16	71	87	0.00002
Burkholderia_gladioli	28095	S	2280	675	2955	0.00070
Burkholderia_glumae	337	S	871	356	1227	0.00029
Burkholderia_plantarii	41899	S	664	244	908	0.00022
Burkholderia_perseverans	2615214	S	488	193	681	0.00016
Cupriavidus_taiwanensis	164546	S	3654	3221	6875	0.00164
Cupriavidus_pauculus	82633	S	3609	1621	5230	0.00124
Cupriavidus_oxalaticus	96344	S	1508	707	2215	0.00053
Cupriavidus_sp._EM10	2839983	S	736	455	1191	0.00028
Cupriavidus_sp._MP-37	2884455	S	382	418	800	0.00019
Cupriavidus_sp._KK10	1478019	S	100	326	426	0.00010
Cupriavidus_sp._USMAHM13	1389192	S	76	578	654	0.00016
Cupriavidus_sp._ISTL7	2771360	S	76	531	607	0.00014
Cupriavidus_sp._USMAA2-4	876364	S	67	498	565	0.00013
Cupriavidus_basilensis	68895	S	1426	829	2255	0.00054
Cupriavidus_campinensis	151783	S	1401	523	1924	0.00046
Cupriavidus_necator	106590	S	1302	1104	2406	0.00057
Cupriavidus_metallidurans	119219	S	944	642	1586	0.00038
Cupriavidus_pinatubonensis	248026	S	803	144	947	0.00023
Cupriavidus_gilardii	82541	S	279	1567	1846	0.00044
Cupriavidus_neocaledonicus	1040979	S	266	352	618	0.00015
Cupriavidus_nantongensis	1796606	S	204	583	787	0.00019
Cupriavidus_malaysiensis	367825	S	67	483	550	0.00013
Caballeronia_sp._Lep1P3	2878150	S	730	161	891	0.00021
Caballeronia_sp._TF1N1	2878153	S	615	68	683	0.00016
Caballeronia_sp._SL2Y3	2878151	S	334	193	527	0.00013
Caballeronia_sp._M1242	2814653	S	321	236	557	0.00013
Caballeronia_sp._Sq4a	2878152	S	307	231	538	0.00013
Caballeronia_sp._SBC2	2705547	S	28	259	287	0.00007
Caballeronia_sp._SBC1	2705548	S	25	323	348	0.00008
Caballeronia_zhejiangensis	871203	S	1802	387	2189	0.00052
Caballeronia_insecticola	758793	S	768	148	916	0.00022
Caballeronia_grimmiae	1071679	S	673	341	1014	0.00024
Ralstonia_solanacearum	305	S	1864	4080	5944	0.00141
Ralstonia_insidiosa	190721	S	551	430	981	0.00023
Ralstonia_sp._56D2	2842456	S	454	75	529	0.00013
Ralstonia_mannitolilytica	105219	S	405	518	923	0.00022
Ralstonia_pickettii	329	S	335	168	503	0.00012
Ralstonia_syzygii	28097	S	29	192	221	0.00005
Pandoraea_pnomenusa	93220	S	794	401	1195	0.00028
Pandoraea_thiooxydans	445709	S	657	56	713	0.00017
Pandoraea_pulmonicola	93221	S	595	137	732	0.00017
Pandoraea_sp._XY-2	2518599	S	441	245	686	0.00016
Pandoraea_faecigallinarum	656179	S	436	124	560	0.00013
Pandoraea_norimbergensis	93219	S	411	69	480	0.00011
Pandoraea_vervacti	656178	S	404	125	529	0.00013
Pandoraea_apista	93218	S	353	212	565	0.00013
Pandoraea_fibrosis	1891094	S	332	117	449	0.00011
Pandoraea_sputorum	93222	S	323	152	475	0.00011
Pandoraea_oxalativorans	573737	S	291	145	436	0.00010
Lautropia_mirabilis	47671	S	465	94	559	0.00013
Polynucleobacter_sp._MWH-UH24A	2689110	S	74	7	81	0.00002
Polynucleobacter_sp._AP-Nino-20-G2	2576917	S	16	32	48	0.00001
Polynucleobacter_sp._MWH-Braz-FAM2G	1855883	S	10	17	27	0.00001
Polynucleobacter_necessarius	576610	S	41	11	52	0.00001
Polynucleobacter_difficilis	556054	S	27	3	30	0.00001
Polynucleobacter_asymbioticus	576611	S	20	4	24	0.00001
Polynucleobacter_acidiphobus	556053	S	15	1	16	0.00000
Polynucleobacter_paneuropaeus	2527775	S	14	2	16	0.00000
Polynucleobacter_wuianus	1743168	S	10	4	14	0.00000
Mycetohabitans_rhizoxinica	412963	S	369	26	395	0.00009
Chitinimonas_arctica	2594795	S	330	29	359	0.00009
Mycoavidus_sp._HKI	2840467	S	23	2	25	0.00001
Mycoavidus_sp._B2-EB	2651972	S	16	3	19	0.00000
Mycoavidus_cysteinexigens	1553431	S	28	4	32	0.00001
Limnobacter_sp._SAORIC-580	2732163	S	62	3	65	0.00002
Candidatus_Vallotia_sp._(ex_Adelges_kitamiensis)	2864217	S	19	4	23	0.00001
Candidatus_Vallotia_lariciata	2018052	S	16	3	19	0.00000
Candidatus_Vallotia_cooleyia	1177211	S	13	1	14	0.00000
Ephemeroptericola_cinctiostellae	2268024	S	34	2	36	0.00001
Variovorax_sp._HW608	1034889	S	2104	408	2512	0.00060
Variovorax_sp._PBS-H4	434008	S	1241	845	2086	0.00050
Variovorax_sp._PBL-H6	434009	S	1160	1182	2342	0.00056
Variovorax_sp._RA8	662548	S	1055	892	1947	0.00046
Variovorax_sp._WDL1	207745	S	957	1648	2605	0.00062
Variovorax_sp._PAMC_28711	1795631	S	895	174	1069	0.00025
Variovorax_sp._RKNM96	2681552	S	889	379	1268	0.00030
Variovorax_sp._PAMC26660	2762322	S	655	185	840	0.00020
Variovorax_sp._PAMC28562	2762323	S	644	63	707	0.00017
Variovorax_sp._SRS16	282217	S	609	1440	2049	0.00049
Variovorax_sp._38R	2774875	S	497	673	1170	0.00028
Variovorax_sp._PBL-E5	434014	S	481	1319	1800	0.00043
Variovorax_sp._PDNC026	2811425	S	29	1158	1187	0.00028
Variovorax_paradoxus	34073	S	4505	4547	9052	0.00215
Variovorax_boronicumulans	436515	S	614	502	1116	0.00027
Hydrogenophaga_sp._YM1	2806262	S	1099	662	1761	0.00042
Hydrogenophaga_sp._BA0156	2716225	S	1053	861	1914	0.00046
Hydrogenophaga_sp._PBC	795665	S	976	1273	2249	0.00054
Hydrogenophaga_sp._BPS33	2651974	S	955	805	1760	0.00042
Hydrogenophaga_sp._SL48	2806347	S	767	218	985	0.00023
Hydrogenophaga_sp._PBL-H3	434010	S	593	611	1204	0.00029
Hydrogenophaga_sp._RAC07	1842537	S	538	217	755	0.00018
Hydrogenophaga_sp._PAMC20947	2565558	S	276	21	297	0.00007
Hydrogenophaga_sp._NH-16	2184519	S	267	672	939	0.00022
Hydrogenophaga_taeniospiralis	65656	S	629	224	853	0.00020
Hydrogenophaga_pseudoflava	47421	S	288	568	856	0.00020
Hydrogenophaga_crassostreae	1763535	S	242	17	259	0.00006
Acidovorax_sp._YS12	2738413	S	642	652	1294	0.00031
Acidovorax_sp._RAC01	1842533	S	414	381	795	0.00019
Acidovorax_sp._HDW3	2714923	S	348	291	639	0.00015
Acidovorax_sp._KKS102	358220	S	344	289	633	0.00015
Acidovorax_sp._JMULE5	2518343	S	344	110	454	0.00011
Acidovorax_sp._1608163	2478662	S	279	69	348	0.00008
Acidovorax_sp._T1	1858609	S	207	864	1071	0.00026
Acidovorax_avenae	80867	S	1356	998	2354	0.00056
Acidovorax_monticola	1926868	S	848	400	1248	0.00030
Acidovorax_antarcticus	2743470	S	701	628	1329	0.00032
Acidovorax_carolinensis	553814	S	454	436	890	0.00021
Acidovorax_citrulli	80869	S	398	445	843	0.00020
Acidovorax_cattleyae	80868	S	349	296	645	0.00015
Acidovorax_radicis	758826	S	274	67	341	0.00008
Ramlibacter_tataouinensis	94132	S	6298	2920	9218	0.00219
Comamonas_sp._NLF-7-7	2597701	S	491	435	926	0.00022
Comamonas_sp._NLF-1-9	2853163	S	465	304	769	0.00018
Comamonas_sp._B21-038	2918299	S	273	83	356	0.00008
Comamonas_sp._Y33R10-2	2853257	S	66	14	80	0.00002
Comamonas_serinivorans	1082851	S	673	222	895	0.00021
Comamonas_aquatica	225991	S	564	632	1196	0.00028
Comamonas_testosteroni	285	S	354	608	962	0.00023
Comamonas_koreensis	160825	S	234	162	396	0.00009
Comamonas_odontotermitis	379895	S	228	53	281	0.00007
Comamonas_piscis	1562974	S	157	37	194	0.00005
Comamonas_thiooxydans	363952	S	155	414	569	0.00014
Comamonas_kerstersii	225992	S	116	71	187	0.00004
Comamonas_fluminis	2796366	S	101	50	151	0.00004
Rhodoferax_sp._BAB1	2741720	S	793	254	1047	0.00025
Rhodoferax_sp._AJA081-3	2752316	S	254	20	274	0.00007
Rhodoferax_sp._PAMC_29310	2822760	S	149	18	167	0.00004
Rhodoferax_sp._MIZ03	2798804	S	123	14	137	0.00003
Rhodoferax_koreense	1842727	S	1125	678	1803	0.00043
Rhodoferax_sediminis	2509614	S	981	174	1155	0.00027
Rhodoferax_ferrireducens	192843	S	345	25	370	0.00009
Rhodoferax_saidenbachensis	1484693	S	288	35	323	0.00008
Rhodoferax_antarcticus	81479	S	146	12	158	0.00004
Rhodoferax_aquaticus	2527691	S	104	11	115	0.00003
Schlegelella_thermodepolymerans	215580	S	1958	1112	3070	0.00073
Schlegelella_brevitalea	413882	S	1611	272	1883	0.00045
Diaphorobacter_sp._HDW4A	2714924	S	462	497	959	0.00023
Diaphorobacter_sp._HDW4B	2714925	S	380	56	436	0.00010
Diaphorobacter_sp._MNS-0	2866628	S	57	531	588	0.00014
Diaphorobacter_sp._JS3051	2792224	S	45	813	858	0.00020
Diaphorobacter_sp._JS3050	2735554	S	35	424	459	0.00011
Diaphorobacter_ruginosibacter	1715720	S	557	119	676	0.00016
Diaphorobacter_aerolatus	1288495	S	418	748	1166	0.00028
[Acidovorax]_ebreus	721785	S	75	491	566	0.00013
Diaphorobacter_nitroreducens	164759	S	60	180	240	0.00006
Delftia_tsuruhatensis	180282	S	518	1595	2113	0.00050
Delftia_acidovorans	80866	S	353	724	1077	0.00026
Delftia_lacustris	558537	S	201	1274	1475	0.00035
Delftia_sp._Cs1-4	742013	S	52	129	181	0.00004
Delftia_sp._HK171	1920191	S	30	86	116	0.00003
Kinneretia_sp._DAIF2	2714952	S	1567	659	2226	0.00053
Kinneretia_sp._XES5	2877940	S	412	597	1009	0.00024
Polaromonas_sp._JS666	296591	S	676	678	1354	0.00032
Polaromonas_naphthalenivorans	216465	S	603	110	713	0.00017
Polaromonas_vacuolata	37448	S	56	6	62	0.00001
Ottowia_sp._27C	2816950	S	683	168	851	0.00020
Ottowia_sp._oral_taxon_894	1658672	S	250	47	297	0.00007
Ottowia_oryzae	2109914	S	557	143	700	0.00017
Alicycliphilus_denitrificans	179636	S	1412	2735	4147	0.00099
Melaminivora_sp._SC2-9	2109913	S	628	823	1451	0.00035
Melaminivora_jejuensis	1267217	S	483	421	904	0.00022
Serpentinimonas_maccroryi	1458426	S	382	140	522	0.00012
Serpentinimonas_raichei	1458425	S	363	147	510	0.00012
Verminephrobacter_eiseniae	364317	S	565	80	645	0.00015
Hylemonella_gracilis	80880	S	529	88	617	0.00015
Pulveribacter_suum	2116657	S	519	314	833	0.00020
Simplicispira_suum	2109915	S	359	150	509	0.00012
Limnohabitans_sp._63ED37-2	1678128	S	173	21	194	0.00005
Limnohabitans_sp._103DPR2	1678129	S	79	6	85	0.00002
Candidatus_Symbiobacter_mobilis	1436290	S	190	7	197	0.00005
Curvibacter_sp._AEP1-3	1844971	S	143	11	154	0.00004
Massilia_sp._WG5	1707785	S	1812	862	2674	0.00064
Massilia_sp._HC52	2852099	S	1030	322	1352	0.00032
Massilia_sp._DM-R-R2A-13	2899220	S	1013	258	1271	0.00030
Massilia_sp._LPB0304	2769491	S	970	283	1253	0.00030
Massilia_sp._YMA4	1593482	S	743	402	1145	0.00027
Massilia_sp._NP310	2861282	S	708	488	1196	0.00028
Massilia_sp._PAMC28688	2861283	S	514	87	601	0.00014
Massilia_sp._MB5	2919578	S	115	862	977	0.00023
Massilia_sp._NR_4-1	1678028	S	107	774	881	0.00021
Massilia_putida	1141883	S	4336	1459	5795	0.00138
Massilia_flava	871742	S	1271	331	1602	0.00038
Massilia_violaceinigra	2045208	S	1177	342	1519	0.00036
Massilia_lutea	321985	S	844	269	1113	0.00027
Massilia_albidiflava	321983	S	810	333	1143	0.00027
Massilia_umbonata	864828	S	774	322	1096	0.00026
Massilia_armeniaca	2072590	S	767	412	1179	0.00028
Massilia_plicata	321984	S	699	194	893	0.00021
Massilia_oculi	945844	S	615	397	1012	0.00024
Massilia_antarctica	2765360	S	560	211	771	0.00018
Duganella_sp._GN2-R2	2728020	S	1204	522	1726	0.00041
Duganella_sp._AF9R3	2728021	S	648	141	789	0.00019
Herbaspirillum_robiniae	2014887	S	735	306	1041	0.00025
Herbaspirillum_seropedicae	964	S	506	207	713	0.00017
Herbaspirillum_frisingense	92645	S	462	164	626	0.00015
Herbaspirillum_hiltneri	341045	S	446	85	531	0.00013
Herbaspirillum_rubrisubalbicans	80842	S	385	193	578	0.00014
Herbaspirillum_huttiense	863372	S	318	144	462	0.00011
Herbaspirillum_sp._meg3	2025949	S	239	31	270	0.00006
Janthinobacterium_sp._17J80-10	2497863	S	435	72	507	0.00012
Janthinobacterium_sp._1_2014MBL_MicDiv	1644131	S	345	141	486	0.00012
Janthinobacterium_sp._LM6	1938606	S	160	112	272	0.00006
Janthinobacterium_sp._PAMC25594	2861284	S	143	98	241	0.00006
Janthinobacterium_sp._Marseille	375286	S	124	34	158	0.00004
Janthinobacterium_sp._HH102	1537274	S	79	136	215	0.00005
Janthinobacterium_sp._B9-8	1236179	S	20	6	26	0.00001
Janthinobacterium_agaricidamnosum	55508	S	598	1009	1607	0.00038
Janthinobacterium_svalbardensis	368607	S	128	69	197	0.00005
Janthinobacterium_lividum	29581	S	122	132	254	0.00006
Janthinobacterium_tructae	2590869	S	100	55	155	0.00004
Collimonas_fungivorans	158899	S	557	164	721	0.00017
Collimonas_arenae	279058	S	421	60	481	0.00011
Collimonas_pratensis	279113	S	376	85	461	0.00011
Noviherbaspirillum_sp._UKPF54	2601898	S	1123	214	1337	0.00032
Undibacterium_sp._KW1	2058624	S	48	18	66	0.00002
Undibacterium_sp._YM2	2058625	S	40	15	55	0.00001
Undibacterium_parvum	401471	S	51	7	58	0.00001
Herminiimonas_arsenitoxidans	1809410	S	88	14	102	0.00002
Glaciimonas_sp._PAMC28666	2807626	S	79	5	84	0.00002
Oxalobacter_formigenes	847	S	43	4	47	0.00001
Bordetella_bronchialis	463025	S	2481	395	2876	0.00068
Bordetella_sp._H567	1697043	S	933	135	1068	0.00025
Bordetella_sp._N	1746199	S	635	87	722	0.00017
Bordetella_genomosp._13	463040	S	903	758	1661	0.00040
Bordetella_genomosp._8	1416806	S	882	125	1007	0.00024
Bordetella_genomosp._9	1416803	S	781	236	1017	0.00024
Bordetella_flabilis	463014	S	766	76	842	0.00020
Bordetella_petrii	94624	S	607	969	1576	0.00038
Bordetella_hinzii	103855	S	564	295	859	0.00020
Bordetella_trematum	123899	S	430	214	644	0.00015
Bordetella_pseudohinzii	1331258	S	379	206	585	0.00014
Bordetella_bronchiseptica	518	S	350	1831	2181	0.00052
Bordetella_holmesii	35814	S	205	75	280	0.00007
Bordetella_avium	521	S	203	27	230	0.00005
Bordetella_genomosp._6	463024	S	113	286	399	0.00009
Bordetella_pertussis	520	S	61	747	808	0.00019
Bordetella_parapertussis	519	S	33	439	472	0.00011
Achromobacter_xylosoxidans	85698	S	2106	4124	6230	0.00148
Achromobacter_sp._AONIH1	1758194	S	656	981	1637	0.00039
Achromobacter_sp._MFA1_R4	1881016	S	563	196	759	0.00018
Achromobacter_sp._77	2756133	S	137	391	528	0.00013
Achromobacter_sp._B7	2282475	S	83	208	291	0.00007
Achromobacter_sp._ES-001	2860286	S	62	218	280	0.00007
Achromobacter_spanius	217203	S	1073	513	1586	0.00038
Achromobacter_denitrificans	32002	S	1046	888	1934	0.00046
Achromobacter_deleyi	1353891	S	686	562	1248	0.00030
Achromobacter_insolitus	217204	S	561	183	744	0.00018
Achromobacter_pestifer	1353889	S	397	315	712	0.00017
Achromobacter_mucicolens	1389922	S	294	516	810	0.00019
Pigmentiphaga_sp._H8	2488560	S	1409	213	1622	0.00039
Pigmentiphaga_aceris	1940612	S	307	24	331	0.00008
Orrella_dioscoreae	1851544	S	731	309	1040	0.00025
Orrella_marina	2163011	S	92	19	111	0.00003
Orrella_sp._f23	2782176	S	45	3	48	0.00001
Castellaniella_defragrans	75697	S	848	676	1524	0.00036
Alcaligenes_faecalis	511	S	140	121	261	0.00006
Alcaligenes_sp._SORT26	2813780	S	31	5	36	0.00001
Alcaligenes_sp._DN25	1367435	S	11	23	34	0.00001
Alcaligenes_aquatilis	323284	S	33	118	151	0.00004
Pusillimonas_thiosulfatoxidans	2028345	S	163	47	210	0.00005
Pusillimonas_sp._T7-7	1007105	S	118	21	139	0.00003
Pusillimonas_sp._DMV24BSW_D	2716226	S	40	3	43	0.00001
Paralcaligenes_sp._KSB-10	2901142	S	221	10	231	0.00006
Kerstersia_gyiorum	206506	S	188	47	235	0.00006
Advenella_mimigardefordensis	302406	S	87	5	92	0.00002
Advenella_kashmirensis	310575	S	71	4	75	0.00002
Paenalcaligenes_hominis	643674	S	22	1	23	0.00001
Oligella_urethralis	90245	S	13	0	13	0.00000
Pelistega_ratti	2652177	S	14	2	16	0.00000
Rhizobacter_sp._AJA081-3	2753607	S	2134	650	2784	0.00066
Rhizobacter_gummiphilus	946333	S	1916	451	2367	0.00056
Sphaerotilus_sp._FB-5	2914710	S	1459	1097	2556	0.00061
Sphaerotilus_natans	34103	S	1210	573	1783	0.00042
Methylibium_sp._Pch-M	2082386	S	857	907	1764	0.00042
Methylibium_petroleiphilum	105560	S	827	947	1774	0.00042
Rubrivivax_gelatinosus	28068	S	2118	796	2914	0.00069
Aquincola_tertiaricarbonis	391953	S	1799	753	2552	0.00061
Mitsuaria_sp._7	1658665	S	1797	431	2228	0.00053
Thiomonas_sp._X19	1050370	S	615	228	843	0.00020
Thiomonas_intermedia	926	S	393	65	458	0.00011
Thiomonas_arsenitoxydans	426114	S	129	273	402	0.00010
Leptothrix_cholodnii	34029	S	1290	497	1787	0.00043
Xylophilus_rhododendri	2697032	S	1018	361	1379	0.00033
Ideonella_dechloratans	36863	S	810	593	1403	0.00033
Tepidimonas_taiwanensis	307486	S	784	339	1123	0.00027
Roseateles_depolymerans	76731	S	673	155	828	0.00020
Aquabacterium_olei	1296669	S	668	214	882	0.00021
Inhella_inkyongensis	392593	S	450	86	536	0.00013
Paucibacter_sp._KCTC_42545	1768242	S	346	71	417	0.00010
Candidatus_Ichthyocystis_hellenicum	1561003	S	11	0	11	0.00000
Sutterella_megalosphaeroides	2494234	S	270	61	331	0.00008
Sutterella_faecalis	2584944	S	188	37	225	0.00005
Sutterella_wadsworthensis	40545	S	75	12	87	0.00002
Turicimonas_muris	1796652	S	22	1	23	0.00001
Usitatibacter_rugosus	2732067	S	11299	1436	12735	0.00303
Usitatibacter_palustris	2732487	S	8589	1162	9751	0.00232
Denitratisoma_sp._DHT3	1981880	S	743	655	1398	0.00033
Denitratisoma_oestradiolicum	311182	S	351	71	422	0.00010
Sulfuritalea_hydrogenivorans	748811	S	989	168	1157	0.00028
Methyloversatilis_sp._RAC08	1842540	S	711	110	821	0.00020
Sterolibacterium_denitrificans	157592	S	526	170	696	0.00017
Thiobacillus_denitrificans	36861	S	1232	272	1504	0.00036
Sulfuritortus_calidifontis	1914471	S	725	359	1084	0.00026
Sulfuriferula_sp._AH1	1985873	S	575	123	698	0.00017
Sulfuriferula_plumbiphila	171865	S	308	59	367	0.00009
Sulfuriferula_nivalis	2675298	S	23	1	24	0.00001
Sulfurimicrobium_lacus	2715678	S	559	81	640	0.00015
Sulfuricella_denitrificans	649841	S	238	24	262	0.00006
Sideroxydans_sp._MIZ01	2764705	S	391	87	478	0.00011
Sideroxydans_lithotrophicus	63745	S	331	54	385	0.00009
Ferrigenium_kumadai	1682490	S	540	124	664	0.00016
Ferriphaselus_amnicola	1188319	S	152	22	174	0.00004
Gallionella_capsiferriformans	370405	S	92	9	101	0.00002
Candidatus_Nitrotoga_arctica	453162	S	35	13	48	0.00001
Candidatus_Nitrotoga_sp._AM1P	2559597	S	33	13	46	0.00001
Nitrosospira_multiformis	1231	S	154	5	159	0.00004
Nitrosospira_lacus	1288494	S	146	6	152	0.00004
Nitrosospira_briensis	35799	S	53	52	105	0.00003
Nitrosospira_sp._NRS527	155925	S	45	41	86	0.00002
Nitrosomonas_communis	44574	S	51	2	53	0.00001
Nitrosomonas_ureae	44577	S	47	1	48	0.00001
Nitrosomonas_europaea	915	S	36	7	43	0.00001
Nitrosomonas_eutropha	916	S	28	19	47	0.00001
Nitrosomonas_stercoris	1444684	S	10	7	17	0.00000
Methylovorus_sp._MP688	887061	S	65	51	116	0.00003
Methylovorus_glucosotrophus	266009	S	51	36	87	0.00002
Methylobacillus_flagellatus	405	S	162	46	208	0.00005
Candidatus_Methylopumilus_rimovensis	2588535	S	42	6	48	0.00001
Candidatus_Methylopumilus_universalis	2588536	S	13	4	17	0.00000
Candidatus_Methylopumilus_turicensis	1581680	S	12	1	13	0.00000
Methylophilus_medardicus	2588534	S	30	4	34	0.00001
Methylophilus_sp._TWE2	1662285	S	30	3	33	0.00001
Methyloradius_palustris	2778876	S	41	3	44	0.00001
Methylotenera_mobilis	359408	S	16	1	17	0.00000
Thauera_sp._MZ1T	85643	S	1158	1339	2497	0.00059
Thauera_sp._K11	2005884	S	1142	782	1924	0.00046
Thauera_humireducens	1134435	S	720	473	1193	0.00028
Thauera_chlorobenzoica	96773	S	619	616	1235	0.00029
Thauera_aromatica	59405	S	499	761	1260	0.00030
Thauera_hydrothermalis	2184083	S	303	101	404	0.00010
Azoarcus_sp._KH32C	748247	S	1255	265	1520	0.00036
Azoarcus_sp._DD4	2027405	S	770	592	1362	0.00032
Azoarcus_olearius	418699	S	1028	462	1490	0.00035
Azoarcus_communis	41977	S	746	331	1077	0.00026
Nitrogeniibacter_mangrovi	2016596	S	851	202	1053	0.00025
Nitrogeniibacter_aestuarii	2815343	S	393	47	440	0.00010
Aromatoleum_petrolei	76116	S	1113	321	1434	0.00034
Aromatoleum_aromaticum	551760	S	854	655	1509	0.00036
Aromatoleum_bremense	76115	S	794	523	1317	0.00031
Aromatoleum_pumilum	2067960	S	771	323	1094	0.00026
Azospira_restricta	404405	S	2107	1246	3353	0.00080
Azospira_inquinata	2785627	S	150	14	164	0.00004
Azospira_oryzae	146939	S	118	323	441	0.00011
Azospira_sp._I09	1765049	S	110	365	475	0.00011
Niveibacterium_microcysteis	2811415	S	689	111	800	0.00019
Oryzomicrobium_terrae	1735038	S	538	157	695	0.00017
Rugosibacter_aromaticivorans	1565605	S	150	30	180	0.00004
Dechloromonas_denitrificans	281362	S	610	175	785	0.00019
Dechloromonas_sp._HYN0024	2231055	S	193	45	238	0.00006
Dechloromonas_sp._TW-R-39-2	2654218	S	126	65	191	0.00005
Ferribacterium_limneticum	76259	S	826	163	989	0.00024
Quatrionicoccus_australiensis	138118	S	418	144	562	0.00013
Fluviibacter_phosphoraccumulans	1751046	S	56	20	76	0.00002
Chromobacterium_sp._ATCC_53434	2059672	S	401	156	557	0.00013
Chromobacterium_sp._Rain0013	2292447	S	88	115	203	0.00005
Chromobacterium_sp._Beijing	2735795	S	66	198	264	0.00006
Chromobacterium_violaceum	536	S	441	307	748	0.00018
Chromobacterium_vaccinii	1108595	S	433	208	641	0.00015
Chromobacterium_paludis	2605945	S	275	121	396	0.00009
Chromobacterium_phragmitis	2202141	S	242	118	360	0.00009
Chromobacterium_rhizoryzae	1778675	S	79	438	517	0.00012
Chromobacterium_haemolyticum	394935	S	49	338	387	0.00009
Iodobacter_fluviatilis	537	S	25	9	34	0.00001
Iodobacter_ciconiae	2496266	S	18	6	24	0.00001
Jeongeupia_sp._USM3	1906741	S	684	198	882	0.00021
Jeongeupia_sp._HS-3	1009682	S	278	59	337	0.00008
Paludibacterium_paludis	1225769	S	313	69	382	0.00009
Paludibacterium_yongneupense	400061	S	292	47	339	0.00008
Paludibacterium_sp._B53371	2806263	S	199	47	246	0.00006
Pseudogulbenkiania_sp._NH8B	748280	S	683	261	944	0.00022
Vogesella_sp._LIG4	1192162	S	427	129	556	0.00013
Vogesella_sp._XCS3	2877939	S	158	48	206	0.00005
Microvirgula_aerodenitrificans	57480	S	404	87	491	0.00012
Aquitalea_aquatilis	1537400	S	114	38	152	0.00004
Aquitalea_denitrificans	519081	S	75	40	115	0.00003
Aquitalea_sp._USM4	1590041	S	65	36	101	0.00002
Aquitalea_magnusonii	332411	S	37	21	58	0.00001
Laribacter_hongkongensis	168471	S	303	305	608	0.00014
Aquaspirillum_sp._LM1	1938604	S	200	33	233	0.00006
Deefgea_sp._D13	2864875	S	29	11	40	0.00001
Deefgea_sp._D17	2739061	S	23	10	33	0.00001
Deefgea_sp._D25	2865840	S	18	3	21	0.00001
Chitinibacter_fontanus	1737446	S	36	6	42	0.00001
Chitinibacter_bivalviorum	2739434	S	28	24	52	0.00001
Neisseria_sp._KEM232	655307	S	100	16	116	0.00003
Neisseria_sp._oral_taxon_014	641148	S	36	17	53	0.00001
Neisseria_sp._ZJ785	2709396	S	23	3	26	0.00001
Neisseria_sp._Dent_CA1/247	2912675	S	19	8	27	0.00001
Neisseria_bacilliformis	267212	S	81	22	103	0.00002
Neisseria_shayeganii	607712	S	69	11	80	0.00002
Neisseria_elongata	495	S	64	41	105	0.00003
Neisseria_dentiae	194197	S	62	8	70	0.00002
Neisseria_chenwenguii	1853278	S	60	8	68	0.00002
Neisseria_meningitidis	487	S	44	408	452	0.00011
Neisseria_musculi	1815583	S	38	3	41	0.00001
Neisseria_gonorrhoeae	485	S	26	63	89	0.00002
Neisseria_animalis	492	S	26	4	30	0.00001
Neisseria_lactamica	486	S	22	34	56	0.00001
Neisseria_dumasiana	1931275	S	21	8	29	0.00001
Neisseria_weaveri	28091	S	19	8	27	0.00001
Neisseria_wadsworthii	607711	S	19	4	23	0.00001
Neisseria_animaloris	326522	S	19	4	23	0.00001
Neisseria_brasiliensis	2666100	S	17	17	34	0.00001
Neisseria_zoodegmatis	326523	S	17	11	28	0.00001
Neisseria_mucosa	488	S	16	40	56	0.00001
Neisseria_sicca	490	S	14	30	44	0.00001
Neisseria_canis	493	S	13	3	16	0.00000
Neisseria_weixii	1853276	S	13	1	14	0.00000
Neisseria_macacae	496	S	12	30	42	0.00001
Neisseria_zalophi	640030	S	12	1	13	0.00000
Neisseria_arctica	1470200	S	11	1	12	0.00000
Crenobacter_cavernae	2290923	S	883	326	1209	0.00029
Chitinolyticbacter_meiyuanensis	682798	S	539	75	614	0.00015
Vitreoscilla_filiformis	63	S	199	43	242	0.00006
Vitreoscilla_massiliensis	1689272	S	26	16	42	0.00001
Eikenella_corrodens	539	S	94	73	167	0.00004
Eikenella_exigua	2528037	S	16	14	30	0.00001
Kingella_potus	265175	S	56	8	64	0.00002
Kingella_denitrificans	502	S	42	30	72	0.00002
Kingella_oralis	505	S	36	6	42	0.00001
Kingella_kingae	504	S	12	2	14	0.00000
Uruburuella_testudinis	1282863	S	64	13	77	0.00002
Uruburuella_suis	252130	S	59	10	69	0.00002
Paralysiella_testudinis	2809020	S	52	12	64	0.00002
Alysiella_crassa	153491	S	12	4	16	0.00000
Alysiella_filiformis	194196	S	12	4	16	0.00000
Neisseriaceae_bacterium_CCUG_44465	2917790	S	15	2	17	0.00000
Conchiformibius_steedae	153493	S	12	2	14	0.00000
Snodgrassella_alvi	1196083	S	10	3	13	0.00000
Casimicrobium_huifangae	2591109	S	572	312	884	0.00021
Lysobacter_sp._TY2-98	2290922	S	1819	322	2141	0.00051
Lysobacter_sp._KIS68-7	2904252	S	1567	340	1907	0.00045
Lysobacter_sp._CECT_30171	2822368	S	911	246	1157	0.00028
Lysobacter_sp._5GHs7-4	2904253	S	911	311	1222	0.00029
Lysobacter_sp._S4-A87	2925843	S	777	283	1060	0.00025
Lysobacter_sp._K5869	2820808	S	641	336	977	0.00023
Lysobacter_sp._CW239	2762611	S	566	342	908	0.00022
Lysobacter_sp._H21R4	2781021	S	194	401	595	0.00014
Lysobacter_sp._CJ11	2764185	S	160	14	174	0.00004
Lysobacter_sp._HDW10	2714936	S	123	36	159	0.00004
Lysobacter_sp._H23M47	2781024	S	123	641	764	0.00018
Lysobacter_enzymogenes	69	S	2584	1041	3625	0.00086
Lysobacter_solisilvae_(ex_Woo_and_Kim_2022)	2865112	S	1881	626	2507	0.00060
Lysobacter_soli	453783	S	1575	369	1944	0.00046
Lysobacter_capsici	435897	S	1542	1732	3274	0.00078
Lysobacter_lycopersici	1324796	S	1402	340	1742	0.00041
Lysobacter_solisilvae_(ex_Kim_et_al._2021)	2763317	S	1273	287	1560	0.00037
Lysobacter_maris	1605891	S	957	261	1218	0.00029
Lysobacter_antibioticus	84531	S	930	216	1146	0.00027
Lysobacter_arenosi	2795387	S	742	265	1007	0.00024
Lysobacter_oculi	2698682	S	710	223	933	0.00022
Lysobacter_alkalisoli	2591633	S	687	139	826	0.00020
Lysobacter_ciconiae	2781022	S	151	291	442	0.00011
Lysobacter_gummosus	262324	S	143	1250	1393	0.00033
Lysobacter_avium	2781023	S	84	400	484	0.00012
Xanthomonas_translucens	343	S	1031	1414	2445	0.00058
Xanthomonas_campestris	339	S	875	967	1842	0.00044
Xanthomonas_sacchari	56458	S	636	249	885	0.00021
Xanthomonas_sp._SS	2724122	S	112	193	305	0.00007
Xanthomonas_sp._GW	2724121	S	108	160	268	0.00006
Xanthomonas_sp._SI	2724123	S	91	158	249	0.00006
Xanthomonas_sp._MLO165	2081477	S	23	26	49	0.00001
Xanthomonas_arboricola	56448	S	463	446	909	0.00022
Xanthomonas_theicola	56464	S	416	150	566	0.00013
Xanthomonas_oryzae	347	S	387	149	536	0.00013
Xanthomonas_hyacinthi	56455	S	318	208	526	0.00013
Xanthomonas_citri	346	S	303	4024	4327	0.00103
Xanthomonas_albilineans	29447	S	261	53	314	0.00007
Xanthomonas_vesicatoria	56460	S	239	141	380	0.00009
Xanthomonas_fragariae	48664	S	228	48	276	0.00007
Xanthomonas_hortorum	56454	S	218	143	361	0.00009
Xanthomonas_cucurbitae	56453	S	206	39	245	0.00006
Xanthomonas_vasicola	56459	S	181	59	240	0.00006
Xanthomonas_cassavae	56450	S	160	39	199	0.00005
Xanthomonas_euroxanthea	2259622	S	117	109	226	0.00005
Xanthomonas_axonopodis	53413	S	116	345	461	0.00011
Xanthomonas_hydrangeae	2775159	S	112	35	147	0.00004
Xanthomonas_phaseoli	1985254	S	77	361	438	0.00010
Xanthomonas_euvesicatoria	456327	S	45	480	525	0.00013
Xanthomonas_perforans	442694	S	12	653	665	0.00016
Stenotrophomonas_maltophilia	40324	S	2477	3796	6273	0.00149
Stenotrophomonas_sp._ESTM1D_MKCIP4_1	2072414	S	162	72	234	0.00006
Stenotrophomonas_sp._SAU14A_NAIMI4_5	2072413	S	145	98	243	0.00006
Stenotrophomonas_sp._ZAC14D2_NAIMI4_7	2072405	S	101	115	216	0.00005
Stenotrophomonas_sp._ZAC14A_NAIMI4_1	2072412	S	63	124	187	0.00004
Stenotrophomonas_sp._YAU14D1_LEIMI4_1	2072407	S	61	110	171	0.00004
Stenotrophomonas_sp._ZAC14D2_NAIMI4_6	2072406	S	52	106	158	0.00004
Stenotrophomonas_sp._SAU14A_NAIMI4_8	2072409	S	20	118	138	0.00003
Stenotrophomonas_sp._YAU14A_MKIMI4_1	2072408	S	12	71	83	0.00002
Stenotrophomonas_sp._169	2770322	S	311	57	368	0.00009
Stenotrophomonas_sp._LM091	1904944	S	310	135	445	0.00011
Stenotrophomonas_sp._364	2691571	S	215	93	308	0.00007
Stenotrophomonas_sp._NA06056	2742129	S	100	54	154	0.00004
Stenotrophomonas_sp._WZN-1	2005046	S	73	96	169	0.00004
Stenotrophomonas_sp._DR822	2871174	S	30	55	85	0.00002
Stenotrophomonas_sp._Pemsol	2040586	S	26	88	114	0.00003
Stenotrophomonas_sp._CW117	2775920	S	26	641	667	0.00016
Stenotrophomonas_sp._SI-NJAU-1	2886359	S	19	94	113	0.00003
Stenotrophomonas_sp._pho	2211160	S	14	72	86	0.00002
Stenotrophomonas_sp._MYb57	1827305	S	13	62	75	0.00002
Stenotrophomonas_sp._NY11291	2939415	S	13	157	170	0.00004
Stenotrophomonas_sp._G4	2303750	S	13	62	75	0.00002
Stenotrophomonas_sp._ASS1	2282124	S	12	61	73	0.00002
Stenotrophomonas_rhizophila	216778	S	1072	360	1432	0.00034
Stenotrophomonas_acidaminiphila	128780	S	603	1570	2173	0.00052
Stenotrophomonas_indicatrix	2045451	S	28	124	152	0.00004
Luteimonas_sp._MC1750	2799326	S	786	330	1116	0.00027
Luteimonas_sp._D4P002	2901869	S	719	215	934	0.00022
Luteimonas_sp._S4-F44	2925842	S	716	159	875	0.00021
Luteimonas_sp._YGD11-2	2508168	S	699	347	1046	0.00025
Luteimonas_sp._JM171	1896164	S	689	158	847	0.00020
Luteimonas_sp._MC1572	2799325	S	678	368	1046	0.00025
Luteimonas_sp._MC1825	2761107	S	620	346	966	0.00023
Luteimonas_granuli	1176533	S	815	324	1139	0.00027
Luteimonas_yindakuii	2565782	S	645	292	937	0.00022
Luteimonas_chenhongjianii	2006110	S	628	157	785	0.00019
Pseudoxanthomonas_suwonensis	314722	S	1492	915	2407	0.00057
Pseudoxanthomonas_mexicana	128785	S	868	1494	2362	0.00056
Pseudoxanthomonas_sp._X-1	2571115	S	787	802	1589	0.00038
Pseudoxanthomonas_daejeonensis	266062	S	587	175	762	0.00018
Pseudoxanthomonas_spadix	415229	S	499	211	710	0.00017
Thermomonas_sp._XSG	2771436	S	615	304	919	0.00022
Thermomonas_sp._HDW16	2714945	S	476	145	621	0.00015
Thermomonas_brevis	215691	S	953	441	1394	0.00033
Thermomonas_aquatica	2202149	S	906	532	1438	0.00034
Thermomonas_carbonis	1463158	S	643	155	798	0.00019
Arenimonas_daejeonensis	370777	S	974	226	1200	0.00029
Pseudolysobacter_antarcticus	2511995	S	703	21	724	0.00017
Xylella_fastidiosa	2371	S	61	23	84	0.00002
Xylella_taiwanensis	1444770	S	48	2	50	0.00001
Frateuria_sp._5GH9-34	2898793	S	3101	1031	4132	0.00098
Frateuria_sp._5GH9-11	1542730	S	2629	1112	3741	0.00089
Frateuria_aurantia	81475	S	253	35	288	0.00007
Luteibacter_sp._321	2911537	S	941	296	1237	0.00029
Luteibacter_sp._EIF3	2780091	S	759	127	886	0.00021
Luteibacter_sp._335	2911538	S	594	137	731	0.00017
Luteibacter_sp._353	2911539	S	516	166	682	0.00016
Luteibacter_pinisoli	2589080	S	735	213	948	0.00023
Luteibacter_rhizovicinus	242606	S	617	95	712	0.00017
Luteibacter_anthropi	564369	S	553	111	664	0.00016
Rhodanobacter_denitrificans	666685	S	1539	672	2211	0.00053
Rhodanobacter_sp._FDAARGOS_1247	2778082	S	1044	385	1429	0.00034
Rhodanobacter_thiooxydans	416169	S	928	491	1419	0.00034
Rhodanobacter_glycinis	582702	S	799	157	956	0.00023
Dyella_thiooxydans	445710	S	1271	423	1694	0.00040
Dyella_japonica	231455	S	733	254	987	0.00023
Dyella_telluris	2763498	S	663	203	866	0.00021
Dyella_terrae	522259	S	566	91	657	0.00016
Dyella_caseinilytica	1849581	S	412	35	447	0.00011
Dyella_sp._M7H15-1	2501295	S	326	37	363	0.00009
Dokdonella_koreensis	323415	S	2165	422	2587	0.00062
Aerosticca_soli	2010829	S	1099	1608	2707	0.00064
Ahniella_affigens	2021234	S	380	10	390	0.00009
Pseudomonas_sp._PDNC002	2811422	S	342	95	437	0.00010
Pseudomonas_sp._ATCC_13867	1294143	S	329	135	464	0.00011
Pseudomonas_sp._SCB32	2653853	S	313	80	393	0.00009
Pseudomonas_sp._CC6-YY-74	1930532	S	280	37	317	0.00008
Pseudomonas_sp._TCU-HL1	1856685	S	275	45	320	0.00008
Pseudomonas_sp._KNUC1026	2893890	S	268	28	296	0.00007
Pseudomonas_sp._LPB0260	2614442	S	250	57	307	0.00007
Pseudomonas_sp._p1(2021b)	2874628	S	238	151	389	0.00009
Pseudomonas_sp._DY-1	1755504	S	230	34	264	0.00006
Pseudomonas_sp._Ost2	2678260	S	226	39	265	0.00006
Pseudomonas_sp._ABC1	2748080	S	203	32	235	0.00006
Pseudomonas_sp._StFLB209	1028989	S	180	50	230	0.00005
Pseudomonas_sp._MTM4	2705472	S	172	34	206	0.00005
Pseudomonas_sp._MM211	2866808	S	171	17	188	0.00004
Pseudomonas_sp._7SR1	1881017	S	148	32	180	0.00004
Pseudomonas_sp._Pc102	2678261	S	139	95	234	0.00006
Pseudomonas_sp._OIL-1	2706126	S	135	31	166	0.00004
Pseudomonas_sp._B11D7D	2735906	S	135	31	166	0.00004
Pseudomonas_sp._CMR5c	658630	S	134	51	185	0.00004
Pseudomonas_sp._MSPm1	2726956	S	133	36	169	0.00004
Pseudomonas_sp._LAB-08	143813	S	127	29	156	0.00004
Pseudomonas_sp._L5B5	2883205	S	125	28	153	0.00004
Pseudomonas_sp._15A4	2804761	S	118	38	156	0.00004
Pseudomonas_sp._MPC6	2498848	S	115	31	146	0.00003
Pseudomonas_sp._S09G_359	2054919	S	99	31	130	0.00003
Pseudomonas_sp._HN2-3	2886360	S	98	26	124	0.00003
Pseudomonas_sp._ADPe	2774873	S	97	299	396	0.00009
Pseudomonas_sp._HLS-6	2049589	S	96	32	128	0.00003
Pseudomonas_sp._Seg1	2678259	S	94	28	122	0.00003
Pseudomonas_sp._Marseille-Q3773	2866592	S	94	39	133	0.00003
Pseudomonas_sp._ADAK13	2730847	S	92	28	120	0.00003
Pseudomonas_sp._DG56-2	2320270	S	87	11	98	0.00002
Pseudomonas_sp._Leaf58	1736226	S	86	20	106	0.00003
Pseudomonas_sp._gcc21	2726989	S	86	42	128	0.00003
Pseudomonas_sp._SK	2729423	S	81	92	173	0.00004
Pseudomonas_sp._M1	95619	S	79	237	316	0.00008
Pseudomonas_sp._NIBR-H-19	2901380	S	79	22	101	0.00002
Pseudomonas_sp._S35	1573719	S	78	27	105	0.00003
Pseudomonas_sp._URMO17WK12:I11	1283291	S	77	69	146	0.00003
Pseudomonas_sp._Tri1	2823875	S	77	24	101	0.00002
Pseudomonas_sp._RtIB026	2749999	S	76	59	135	0.00003
Pseudomonas_sp._DTU12.3	2073078	S	75	25	100	0.00002
Pseudomonas_sp._S34	1573718	S	74	22	96	0.00002
Pseudomonas_sp._MM213	2866807	S	74	20	94	0.00002
Pseudomonas_sp._ACM7	2052956	S	72	17	89	0.00002
Pseudomonas_sp._2hn	2866626	S	69	62	131	0.00003
Pseudomonas_sp._31-12	2201356	S	66	22	88	0.00002
Pseudomonas_sp._LS.1a	2920387	S	65	36	101	0.00002
Pseudomonas_sp._OE_28.3	2745519	S	65	20	85	0.00002
Pseudomonas_sp._R5-89-07	658644	S	63	26	89	0.00002
Pseudomonas_sp._R2A2	2213057	S	63	100	163	0.00004
Pseudomonas_sp._ADAK18	2730848	S	62	13	75	0.00002
Pseudomonas_sp._M30-35	1981174	S	62	4	66	0.00002
Pseudomonas_sp._CCOS_191	1649877	S	60	68	128	0.00003
Pseudomonas_sp._PP3	2815936	S	59	28	87	0.00002
Pseudomonas_sp._DR48	2871095	S	59	45	104	0.00002
Pseudomonas_sp._LG1E9	2219057	S	58	22	80	0.00002
Pseudomonas_sp._RC3H12	2834406	S	58	48	106	0.00003
Pseudomonas_sp._LPH1	1898684	S	54	65	119	0.00003
Pseudomonas_sp._NS1(2017)	2025658	S	52	18	70	0.00002
Pseudomonas_sp._St316	2678257	S	50	21	71	0.00002
Pseudomonas_sp._HS6	2850559	S	50	18	68	0.00002
Pseudomonas_sp._DNDY-54	2870860	S	49	31	80	0.00002
Pseudomonas_sp._HN11	1344094	S	49	14	63	0.00002
Pseudomonas_sp._NIBRBAC000502773	2590776	S	48	32	80	0.00002
Pseudomonas_sp._IzPS59	2774459	S	47	29	76	0.00002
Pseudomonas_sp._CYM-20-01	2870750	S	46	30	76	0.00002
Pseudomonas_sp._SCA2728.1_7	2825975	S	45	35	80	0.00002
Pseudomonas_sp._14181154	2662033	S	44	59	103	0.00002
Pseudomonas_sp._Z003-0.4C(8344-21)	1855380	S	44	41	85	0.00002
Pseudomonas_sp._UW4	1207075	S	43	37	80	0.00002
Pseudomonas_sp._SK3(2021)	2841064	S	42	35	77	0.00002
Pseudomonas_sp._THAF7b	2587845	S	42	110	152	0.00004
Pseudomonas_sp._R84	1573712	S	41	27	68	0.00002
Pseudomonas_sp._HS-18	2879114	S	40	105	145	0.00003
Pseudomonas_sp._AO-1	2855434	S	39	55	94	0.00002
Pseudomonas_sp._BIGb0427	2724470	S	38	136	174	0.00004
Pseudomonas_sp._SORT22	2813842	S	38	145	183	0.00004
Pseudomonas_sp._MRSN12121	1611770	S	34	60	94	0.00002
Pseudomonas_sp._FIT81	2837969	S	34	27	61	0.00001
Pseudomonas_sp._R76	1573711	S	31	20	51	0.00001
Pseudomonas_sp._phDV1	253237	S	31	128	159	0.00004
Pseudomonas_sp._RBPA9	2746321	S	27	75	102	0.00002
Pseudomonas_sp._LTJR-52	2479392	S	26	11	37	0.00001
Pseudomonas_sp._HN2	2884805	S	26	30	56	0.00001
Pseudomonas_sp._C27(2019)	2604941	S	25	4	29	0.00001
Pseudomonas_sp._B10	118613	S	24	23	47	0.00001
Pseudomonas_sp._FGI182	1259844	S	24	35	59	0.00001
Pseudomonas_sp._02C_26	2054914	S	23	81	104	0.00002
Pseudomonas_sp._MYb193	1827300	S	22	35	57	0.00001
Pseudomonas_sp._SDM007	2812000	S	22	19	41	0.00001
Pseudomonas_sp._FDAARGOS_380	2018067	S	21	23	44	0.00001
Pseudomonas_sp._ArH3a	2862945	S	21	83	104	0.00002
Pseudomonas_sp._MPFS	2795724	S	21	50	71	0.00002
Pseudomonas_sp._PONIH3	1636610	S	20	133	153	0.00004
Pseudomonas_sp._Cab53	2678258	S	20	42	62	0.00001
Pseudomonas_sp._Y5-11	2749808	S	20	90	110	0.00003
Pseudomonas_sp._3-2	2867408	S	19	36	55	0.00001
Pseudomonas_sp._S07E_245	2866278	S	19	71	90	0.00002
Pseudomonas_sp._09C_129	2054915	S	18	29	47	0.00001
Pseudomonas_sp._RU47	2005388	S	18	73	91	0.00002
Pseudomonas_sp._J380	2605424	S	15	28	43	0.00001
Pseudomonas_sp._St29	1500687	S	15	96	111	0.00003
Pseudomonas_sp._LG1D9	2083054	S	15	88	103	0.00002
Pseudomonas_sp._DR_5-09	1534110	S	14	28	42	0.00001
Pseudomonas_sp._IAC-BECa141	2793103	S	14	38	52	0.00001
Pseudomonas_sp._R3-18-08	1173283	S	13	60	73	0.00002
Pseudomonas_sp._Os17	1500686	S	13	102	115	0.00003
Pseudomonas_sp._S49	1573720	S	13	53	66	0.00002
Pseudomonas_sp._SW-3	147212	S	12	61	73	0.00002
Pseudomonas_sp._GR_6-02	1659194	S	12	45	57	0.00001
Pseudomonas_sp._7-41	2898483	S	11	66	77	0.00002
Pseudomonas_sp._HN8-3	2886361	S	11	29	40	0.00001
Pseudomonas_sp._SXM-1	2169583	S	11	47	58	0.00001
Pseudomonas_sp._S150	2559074	S	11	23	34	0.00001
Pseudomonas_sp._SC3(2021)	2871493	S	11	16	27	0.00001
Pseudomonas_sp._ATCC_43928	676210	S	11	42	53	0.00001
Pseudomonas_sp._MPDS	2762896	S	10	53	63	0.00002
Pseudomonas_sp._ADAK22	2730851	S	10	40	50	0.00001
Pseudomonas_sp._R4-35-07	658643	S	10	107	117	0.00003
Pseudomonas_sp._R2-37-08W	1173273	S	10	75	85	0.00002
Pseudomonas_aeruginosa	287	S	1717	15906	17623	0.00419
Pseudomonas_mendocina	300	S	756	303	1059	0.00025
Pseudomonas_alcaligenes	43263	S	536	386	922	0.00022
Pseudomonas_furukawaii	1149133	S	404	134	538	0.00013
Pseudomonas_oleovorans	301	S	70	254	324	0.00008
Pseudomonas_resinovorans	53412	S	375	91	466	0.00011
Pseudomonas_multiresinivorans	95301	S	220	85	305	0.00007
Pseudomonas_nitroreducens	46680	S	48	119	167	0.00004
Pseudomonas_citronellolis	53408	S	198	350	548	0.00013
Pseudomonas_fluorescens	294	S	1506	1511	3017	0.00072
Pseudomonas_protegens	380021	S	370	394	764	0.00018
Pseudomonas_orientalis	76758	S	278	87	365	0.00009
Pseudomonas_azotoformans	47878	S	185	86	271	0.00006
Pseudomonas_synxantha	47883	S	164	143	307	0.00007
Pseudomonas_rhodesiae	76760	S	145	62	207	0.00005
Pseudomonas_poae	200451	S	137	80	217	0.00005
Pseudomonas_tolaasii	29442	S	106	23	129	0.00003
Pseudomonas_mediterranea	183795	S	101	28	129	0.00003
Pseudomonas_corrugata	47879	S	100	24	124	0.00003
Pseudomonas_cedrina	651740	S	99	29	128	0.00003
Pseudomonas_trivialis	200450	S	99	40	139	0.00003
Pseudomonas_migulae	78543	S	97	56	153	0.00004
Pseudomonas_congelans	200452	S	73	26	99	0.00002
Pseudomonas_mucidolens	46679	S	60	9	69	0.00002
Pseudomonas_brenneri	129817	S	53	22	75	0.00002
Pseudomonas_veronii	76761	S	39	125	164	0.00004
Pseudomonas_mandelii	75612	S	38	125	163	0.00004
Pseudomonas_ogarae	1114970	S	38	34	72	0.00002
Pseudomonas_libanensis	75588	S	34	43	77	0.00002
Pseudomonas_extremorientalis	169669	S	13	38	51	0.00001
Pseudomonas_stutzeri	316	S	2794	2088	4882	0.00116
Pseudomonas_chloritidismutans	203192	S	40	59	99	0.00002
Pseudomonas_balearica	74829	S	436	589	1025	0.00024
Pseudomonas_xanthomarina	271420	S	150	27	177	0.00004
Pseudomonas_luteola	47886	S	36	19	55	0.00001
Pseudomonas_putida	303	S	1943	2889	4832	0.00115
Pseudomonas_oryzihabitans	47885	S	677	168	845	0.00020
Pseudomonas_fulva	47880	S	450	1345	1795	0.00043
Pseudomonas_plecoglossicida	70775	S	123	112	235	0.00006
Pseudomonas_mosselii	78327	S	78	155	233	0.00006
Pseudomonas_monteilii	76759	S	76	288	364	0.00009
Pseudomonas_sp._SGAir0191	2217867	S	41	31	72	0.00002
Pseudomonas_shirazica	1940636	S	10	151	161	0.00004
Pseudomonas_syringae	317	S	398	759	1157	0.00028
Pseudomonas_viridiflava	33069	S	268	33	301	0.00007
Pseudomonas_cichorii	36746	S	197	19	216	0.00005
Pseudomonas_asturiensis	1190415	S	112	12	124	0.00003
Pseudomonas_syringae_group_genomosp._7	251699	S	99	10	109	0.00003
Pseudomonas_amygdali	47877	S	39	208	247	0.00006
Pseudomonas_savastanoi	29438	S	16	104	120	0.00003
Pseudomonas_fuscovaginae	50340	S	47	33	80	0.00002
Pseudomonas_avellanae	46257	S	37	41	78	0.00002
Pseudomonas_syringae_group_genomosp._3	251701	S	22	213	235	0.00006
Pseudomonas_coronafaciens	53409	S	15	36	51	0.00001
Pseudomonas_chlororaphis	587753	S	975	1189	2164	0.00052
Pseudomonas_lundensis	86185	S	84	11	95	0.00002
Pseudomonas_fragi	296	S	61	59	120	0.00003
Pseudomonas_otitidis	319939	S	665	168	833	0.00020
Pseudomonas_knackmussii	65741	S	641	658	1299	0.00031
Pseudomonas_psychrotolerans	237610	S	615	156	771	0.00018
Pseudomonas_oryzae	1392877	S	557	201	758	0.00018
Pseudomonas_entomophila	312306	S	469	239	708	0.00017
Pseudomonas_cavernae	2320867	S	452	81	533	0.00013
Pseudomonas_guangdongensis	1245526	S	388	142	530	0.00013
Pseudomonas_lalkuanensis	2604832	S	315	66	381	0.00009
Pseudomonas_campi	2731681	S	260	41	301	0.00007
Pseudomonas_qingdaonensis	2056231	S	246	56	302	0.00007
Pseudomonas_parafulva	157782	S	241	80	321	0.00008
Pseudomonas_eucalypticola	2599595	S	230	32	262	0.00006
Pseudomonas_vanderleydeniana	2745495	S	204	32	236	0.00006
Pseudomonas_nanhaiensis	2830842	S	188	24	212	0.00005
Pseudomonas_alkylphenolica	237609	S	185	41	226	0.00005
Pseudomonas_muyukensis	2842357	S	181	61	242	0.00006
Pseudomonas_zhaodongensis	1176257	S	178	93	271	0.00006
Pseudomonas_saudiphocaensis	1499686	S	168	38	206	0.00005
Pseudomonas_brassicacearum	930166	S	166	392	558	0.00013
Pseudomonas_rhizosphaerae	216142	S	163	22	185	0.00004
Pseudomonas_frederiksbergensis	104087	S	157	55	212	0.00005
Pseudomonas_cremoricolorata	157783	S	153	25	178	0.00004
Pseudomonas_tohonis	2725477	S	145	136	281	0.00007
Pseudomonas_yamanorum	515393	S	143	37	180	0.00004
Pseudomonas_argentinensis	289370	S	142	37	179	0.00004
Pseudomonas_umsongensis	198618	S	136	24	160	0.00004
Pseudomonas_pohangensis	364197	S	135	10	145	0.00003
Pseudomonas_phragmitis	1931241	S	129	11	140	0.00003
Pseudomonas_palleroniana	191390	S	128	24	152	0.00004
Pseudomonas_fakonensis	2842355	S	127	46	173	0.00004
Pseudomonas_koreensis	198620	S	120	55	175	0.00004
Pseudomonas_vancouverensis	95300	S	117	21	138	0.00003
Pseudomonas_marincola	437900	S	114	19	133	0.00003
Pseudomonas_xantholysinigenes	2745490	S	114	36	150	0.00004
Pseudomonas_alvandae	2842348	S	109	19	128	0.00003
Pseudomonas_xanthosomae	2842356	S	105	39	144	0.00003
Pseudomonas_wenzhouensis	2906062	S	101	44	145	0.00003
Pseudomonas_silesiensis	1853130	S	99	24	123	0.00003
Pseudomonas_granadensis	1421430	S	99	56	155	0.00004
Pseudomonas_tructae	2518644	S	98	19	117	0.00003
Pseudomonas_hamedanensis	2745504	S	94	19	113	0.00003
Pseudomonas_agarici	46677	S	92	5	97	0.00002
Pseudomonas_graminis	158627	S	92	30	122	0.00003
Pseudomonas_thivervalensis	86265	S	91	23	114	0.00003
Pseudomonas_sediminis	1691904	S	89	29	118	0.00003
Pseudomonas_promysalinigenes	485898	S	88	15	103	0.00002
Pseudomonas_arsenicoxydans	702115	S	85	21	106	0.00003
Pseudomonas_prosekii	1148509	S	83	15	98	0.00002
Pseudomonas_asgharzadehiana	2842349	S	82	22	104	0.00002
Pseudomonas_antarctica	219572	S	81	23	104	0.00002
Pseudomonas_maumuensis	2842354	S	78	44	122	0.00003
Pseudomonas_extremaustralis	359110	S	78	19	97	0.00002
Pseudomonas_anuradhapurensis	485870	S	77	82	159	0.00004
Pseudomonas_lurida	244566	S	76	20	96	0.00002
Pseudomonas_versuta	1788301	S	73	12	85	0.00002
Pseudomonas_simiae	321846	S	63	18	81	0.00002
Pseudomonas_reinekei	395598	S	62	20	82	0.00002
Pseudomonas_allokribbensis	2774460	S	62	28	90	0.00002
Pseudomonas_viciae	2505979	S	61	17	78	0.00002
Pseudomonas_taetrolens	47884	S	58	8	66	0.00002
Pseudomonas_toyotomiensis	554344	S	58	64	122	0.00003
Pseudomonas_psychrophila	122355	S	56	8	64	0.00002
Pseudomonas_alcaliphila	101564	S	55	70	125	0.00003
Pseudomonas_lini	163011	S	55	12	67	0.00002
Pseudomonas_sihuiensis	1274359	S	54	85	139	0.00003
Pseudomonas_chengduensis	489632	S	54	123	177	0.00004
Pseudomonas_tritici	2745518	S	52	19	71	0.00002
Pseudomonas_khazarica	2502979	S	49	72	121	0.00003
Pseudomonas_kribbensis	1628086	S	49	56	105	0.00003
Pseudomonas_tensinigenes	2745511	S	46	29	75	0.00002
Pseudomonas_gozinkensis	2774461	S	45	25	70	0.00002
Pseudomonas_asplenii	53407	S	43	32	75	0.00002
Pseudomonas_iranensis	2745503	S	41	37	78	0.00002
Pseudomonas_kunmingensis	1211807	S	40	69	109	0.00003
Pseudomonas_oryziphila	2894079	S	38	35	73	0.00002
Pseudomonas_azerbaijanoriens	2842350	S	34	27	61	0.00001
Pseudomonas_moraviensis	321662	S	33	58	91	0.00002
Pseudomonas_atacamensis	2565368	S	33	39	72	0.00002
Pseudomonas_zeae	2745510	S	31	18	49	0.00001
Pseudomonas_zarinae	2745498	S	26	23	49	0.00001
Pseudomonas_germanica	2815720	S	25	16	41	0.00001
Pseudomonas_salmasensis	2745514	S	23	18	41	0.00001
Pseudomonas_monsensis	2745509	S	18	23	41	0.00001
Pseudomonas_juntendi	2666183	S	14	141	155	0.00004
Pseudomonas_lactis	1615674	S	13	11	24	0.00001
Pseudomonas_soli	1306993	S	12	52	64	0.00002
Pseudomonas_sessilinigenes	658629	S	11	34	45	0.00001
Pseudomonas_glycinae	1785145	S	11	23	34	0.00001
Pseudomonas_cerasi	1583341	S	10	25	35	0.00001
Pseudomonas_asiatica	2219225	S	10	67	77	0.00002
Azotobacter_chroococcum	353	S	483	359	842	0.00020
Azotobacter_vinelandii	354	S	309	0	309	0.00007
Azotobacter_salinestris	69964	S	295	184	479	0.00011
Halopseudomonas_xinjiangensis	487184	S	178	20	198	0.00005
Halopseudomonas_sabulinigri	472181	S	142	12	154	0.00004
Halopseudomonas_aestusnigri	857252	S	118	86	204	0.00005
Halopseudomonas_sp._RR6	2918528	S	103	14	117	0.00003
Halopseudomonas_litoralis	797277	S	74	20	94	0.00002
Halopseudomonas_salegens	1434072	S	66	5	71	0.00002
Permianibacter_aggregans	1510150	S	128	4	132	0.00003
Thiopseudomonas_alkaliphila	1697053	S	18	4	22	0.00001
Marinobacter_sp._CA1	2817656	S	131	10	141	0.00003
Marinobacter_sp._NP-4(2019)	2488665	S	111	22	133	0.00003
Marinobacter_sp._Arc7-DN-1	2304594	S	96	14	110	0.00003
Marinobacter_sp._LPB0319	2769486	S	75	5	80	0.00002
Marinobacter_sp._LQ44	1749259	S	45	75	120	0.00003
Marinobacter_sp._LV10R510-11A	1415568	S	39	1	40	0.00001
Marinobacter_sp._JH2	2547598	S	39	12	51	0.00001
Marinobacter_sp._CP1	1671721	S	37	78	115	0.00003
Marinobacter_sp._es.042	1761794	S	29	31	60	0.00001
Marinobacter_sp._BSs20148	490759	S	25	16	41	0.00001
Marinobacter_fonticola	2603215	S	122	6	128	0.00003
Marinobacter_nauticus	2743	S	97	40	137	0.00003
Marinobacter_salarius	1420917	S	89	12	101	0.00002
Marinobacter_salsuginis	418719	S	69	10	79	0.00002
Marinobacter_salinus	1874317	S	58	4	62	0.00001
Marinobacter_similis	1420916	S	55	5	60	0.00001
Marinobacter_adhaerens	1033846	S	27	45	72	0.00002
Enterobacter_cloacae	550	S	646	1212	1858	0.00044
Enterobacter_hormaechei	158836	S	90	1704	1794	0.00043
Enterobacter_cancerogenus	69218	S	73	27	100	0.00002
Enterobacter_asburiae	61645	S	62	306	368	0.00009
Enterobacter_roggenkampii	1812935	S	45	196	241	0.00006
Enterobacter_ludwigii	299767	S	28	70	98	0.00002
Enterobacter_chuandaensis	2497875	S	24	17	41	0.00001
Enterobacter_chengduensis	2494701	S	21	15	36	0.00001
Enterobacter_cloacae_complex_sp.	2027919	S	10	276	286	0.00007
Enterobacter_sichuanensis	2071710	S	11	10	21	0.00001
Enterobacter_sp._SA187	1914861	S	79	16	95	0.00002
Enterobacter_sp._JUb54	2724468	S	69	16	85	0.00002
Enterobacter_sp._RHBSTW-00994	2742676	S	31	8	39	0.00001
Enterobacter_sp._E76	2596949	S	28	67	95	0.00002
Enterobacter_sp._RHBSTW-00175	2742639	S	23	24	47	0.00001
Enterobacter_sp._Colony194	2866201	S	16	29	45	0.00001
Enterobacter_sp._SGAir0187	2836161	S	14	19	33	0.00001
Enterobacter_sp._JBIWA008	2831892	S	13	9	22	0.00001
Enterobacter_mori	539813	S	45	62	107	0.00003
Enterobacter_huaxiensis	2494702	S	37	12	49	0.00001
Enterobacter_bugandensis	881260	S	27	52	79	0.00002
Enterobacter_soli	885040	S	26	7	33	0.00001
Enterobacter_oligotrophicus	2478464	S	23	7	30	0.00001
Klebsiella_pneumoniae	573	S	249	18411	18660	0.00444
Klebsiella_quasipneumoniae	1463165	S	120	397	517	0.00012
Klebsiella_oxytoca	571	S	96	69	165	0.00004
Klebsiella_aerogenes	548	S	95	58	153	0.00004
Klebsiella_michiganensis	1134687	S	55	214	269	0.00006
Klebsiella_variicola	244366	S	43	153	196	0.00005
Klebsiella_quasivariicola	2026240	S	33	38	71	0.00002
Klebsiella_huaxiensis	2153354	S	24	24	48	0.00001
Klebsiella_africana	2489010	S	20	12	32	0.00001
Klebsiella_grimontii	2058152	S	12	85	97	0.00002
Raoultella_sp._HC6	2923366	S	59	40	99	0.00002
Raoultella_planticola	575	S	47	50	97	0.00002
Raoultella_terrigena	577	S	46	86	132	0.00003
Raoultella_ornithinolytica	54291	S	44	309	353	0.00008
Raoultella_electrica	1259973	S	15	38	53	0.00001
Citrobacter_freundii	546	S	61	364	425	0.00010
Citrobacter_werkmanii	67827	S	13	45	58	0.00001
Citrobacter_freundii_complex_sp._CFNIH2	2066049	S	10	16	26	0.00001
Citrobacter_sp._RHB25-C09	2742624	S	36	20	56	0.00001
Citrobacter_sp._R56	1573676	S	23	9	32	0.00001
Citrobacter_rodentium	67825	S	69	0	69	0.00002
Citrobacter_amalonaticus	35703	S	34	242	276	0.00007
Citrobacter_farmeri	67824	S	32	18	50	0.00001
Citrobacter_koseri	545	S	21	40	61	0.00001
Citrobacter_pasteurii	1563222	S	14	17	31	0.00001
Citrobacter_tructae	2562449	S	14	7	21	0.00001
Cronobacter_sakazakii	28141	S	107	109	216	0.00005
Cronobacter_dublinensis	413497	S	89	38	127	0.00003
Cronobacter_universalis	535744	S	59	50	109	0.00003
Cronobacter_condimenti	1163710	S	57	19	76	0.00002
Cronobacter_malonaticus	413503	S	24	28	52	0.00001
Cronobacter_sp._JZ38	1906275	S	15	54	69	0.00002
Leclercia_sp._29361	2714951	S	49	27	76	0.00002
Leclercia_sp._G3L	2898725	S	11	93	104	0.00002
Leclercia_adecarboxylata	83655	S	113	271	384	0.00009
Leclercia_pneumoniae	2815358	S	25	12	37	0.00001
Kosakonia_sp._SMBL-WEM22	2725560	S	43	21	64	0.00002
Kosakonia_sp._CCTCC_M2018092	2492396	S	21	22	43	0.00001
Kosakonia_sp._MUSA4	2067958	S	20	12	32	0.00001
Kosakonia_cowanii	208223	S	64	55	119	0.00003
Kosakonia_sacchari	1158459	S	53	30	83	0.00002
Kosakonia_radicincitans	283686	S	23	18	41	0.00001
Kosakonia_arachidis	551989	S	22	7	29	0.00001
Kosakonia_oryzae	497725	S	21	17	38	0.00001
Kosakonia_pseudosacchari	1646340	S	20	12	32	0.00001
Salmonella_enterica	28901	S	259	7793	8052	0.00192
Salmonella_bongori	54736	S	27	12	39	0.00001
Pluralibacter_gergoviae	61647	S	209	59	268	0.00006
[Enterobacter]_lignolyticus	1334193	S	92	26	118	0.00003
Escherichia_coli	562	S	158	2553	2711	0.00065
Escherichia_albertii	208962	S	21	19	40	0.00001
Escherichia_fergusonii	564	S	14	24	38	0.00001
Escherichia_marmotae	1499973	S	12	7	19	0.00000
Cedecea_neteri	158822	S	107	26	133	0.00003
Cedecea_lapagei	158823	S	35	11	46	0.00001
Cedecea_sp._FDAARGOS_727	2545798	S	35	8	43	0.00001
Lelliottia_amnigena	61646	S	109	33	142	0.00003
Lelliottia_sp._WB101	2153385	S	14	17	31	0.00001
Lelliottia_sp._AC1	2067959	S	13	13	26	0.00001
Kluyvera_ascorbata	51288	S	30	57	87	0.00002
Kluyvera_intermedia	61648	S	22	17	39	0.00001
Candidatus_Symbiopectobacterium_sp._SyEd1	2871826	S	37	4	41	0.00001
Pseudescherichia_vulneris	566	S	70	4	74	0.00002
Atlantibacter_hermannii	565	S	67	15	82	0.00002
Jejubacter_calystegiae	2579935	S	58	7	65	0.00002
Plesiomonas_shigelloides	703	S	57	19	76	0.00002
Buttiauxella_agrestis	82977	S	25	24	49	0.00001
Yokenella_regensburgei	158877	S	44	20	64	0.00002
Shimwellia_blattae	563	S	44	9	53	0.00001
Phytobacter_ursingii	1972431	S	35	49	84	0.00002
Scandinavium_goeteborgense	1851514	S	38	7	45	0.00001
Pseudocitrobacter_sp._G163CM	2891570	S	37	10	47	0.00001
Serratia_marcescens	615	S	402	1112	1514	0.00036
Serratia_plymuthica	82996	S	128	75	203	0.00005
Serratia_sp._ATCC_39006	104623	S	37	4	41	0.00001
Serratia_sp._FDAARGOS_506	2420306	S	21	27	48	0.00001
Serratia_sp._FGI94	671990	S	14	21	35	0.00001
Serratia_sp._P2ACOL2	2482769	S	11	42	53	0.00001
Serratia_entomophila	42906	S	85	25	110	0.00003
Serratia_rubidaea	61652	S	76	107	183	0.00004
Serratia_proteamaculans	28151	S	62	17	79	0.00002
Serratia_odorifera	618	S	57	11	68	0.00002
Serratia_fonticola	47917	S	47	51	98	0.00002
Serratia_surfactantfaciens	2741499	S	37	26	63	0.00002
Serratia_liquefaciens	614	S	34	59	93	0.00002
Serratia_symbiotica	138074	S	32	5	37	0.00001
Serratia_quinivorans	137545	S	25	11	36	0.00001
Serratia_inhibens	2338073	S	19	12	31	0.00001
Serratia_grimesii	82995	S	17	2	19	0.00000
Serratia_rhizosphaerae	2597702	S	15	17	32	0.00001
Serratia_ficaria	61651	S	11	62	73	0.00002
Serratia_ureilytica	300181	S	11	180	191	0.00005
Rahnella_aquatilis	34038	S	77	101	178	0.00004
Rahnella_victoriana	1510570	S	61	10	71	0.00002
Rahnella_inusitata	58169	S	55	16	71	0.00002
Rahnella_sp._ERMR1:05	1805933	S	37	6	43	0.00001
Yersinia_pseudotuberculosis	633	S	11	37	48	0.00001
Yersinia_enterocolitica	630	S	22	21	43	0.00001
Yersinia_ruckeri	29486	S	16	4	20	0.00000
Yersinia_aldovae	29483	S	13	5	18	0.00000
Yersinia_frederiksenii	29484	S	12	34	46	0.00001
Nissabacter_sp._SGAir0207	2126321	S	191	32	223	0.00005
Gibbsiella_quercinecans	929813	S	92	14	106	0.00003
Ewingella_americana	41202	S	63	10	73	0.00002
Rouxiella_badensis	1646377	S	45	4	49	0.00001
Chania_multitudinisentens	1639108	S	21	2	23	0.00001
Pantoea_sp._Z09	2886821	S	143	52	195	0.00005
Pantoea_sp._SO10	2575375	S	50	10	60	0.00001
Pantoea_sp._CCBC3-3-1	2490851	S	49	10	59	0.00001
Pantoea_sp._At-9b	592316	S	41	8	49	0.00001
Pantoea_sp._MSR2	2052056	S	32	3	35	0.00001
Pantoea_agglomerans	549	S	278	107	385	0.00009
Pantoea_dispersa	59814	S	252	75	327	0.00008
Pantoea_deleyi	470932	S	76	21	97	0.00002
Pantoea_vagans	470934	S	70	138	208	0.00005
Pantoea_ananatis	553	S	58	20	78	0.00002
Pantoea_alhagi	1891675	S	57	20	77	0.00002
Pantoea_cypripedii	55209	S	49	3	52	0.00001
Pantoea_rwandensis	1076550	S	39	10	49	0.00001
Pantoea_stewartii	66269	S	35	9	44	0.00001
Erwinia_sp._E602	2675378	S	144	28	172	0.00004
Erwinia_sp._J780	2681984	S	25	5	30	0.00001
Erwinia_persicina	55211	S	64	15	79	0.00002
Erwinia_gerundensis	1619313	S	64	13	77	0.00002
Erwinia_rhapontici	55212	S	57	12	69	0.00002
Erwinia_amylovora	552	S	43	16	59	0.00001
Erwinia_billingiae	182337	S	35	96	131	0.00003
Erwinia_tasmaniensis	338565	S	32	7	39	0.00001
[Pantoea]_beijingensis	1324864	S	25	5	30	0.00001
Erwinia_tracheiphila	65700	S	24	3	27	0.00001
Candidatus_Erwinia_haradaeae	1922217	S	13	0	13	0.00000
Mixta_gaviniae	665914	S	122	47	169	0.00004
Mixta_calida	665913	S	68	37	105	0.00003
Mixta_theicola	1458355	S	66	20	86	0.00002
Mixta_intestinalis	1615494	S	34	9	43	0.00001
Mixta_sp._X22927	2872648	S	27	15	42	0.00001
Buchnera_aphidicola	9	S	38	5	43	0.00001
Tatumella_ptyseos	82987	S	15	2	17	0.00000
Tatumella_citrea	53336	S	13	2	15	0.00000
Dickeya_dadantii	204038	S	86	46	132	0.00003
Dickeya_dianthicola	204039	S	81	130	211	0.00005
Dickeya_zeae	204042	S	69	79	148	0.00004
Dickeya_chrysanthemi	556	S	67	11	78	0.00002
Dickeya_fangzhongdai	1778540	S	28	114	142	0.00003
Dickeya_sp._NCPPB_3274	568766	S	21	13	34	0.00001
Dickeya_solani	1089444	S	21	11	32	0.00001
Dickeya_poaceiphila	568768	S	17	2	19	0.00000
Pectobacterium_carotovorum	554	S	40	116	156	0.00004
Pectobacterium_sp._LJ1	2878098	S	23	7	30	0.00001
Pectobacterium_brasiliense	180957	S	34	51	85	0.00002
Pectobacterium_atrosepticum	29471	S	24	9	33	0.00001
Pectobacterium_polaris	2042057	S	21	19	40	0.00001
Pectobacterium_parmentieri	1905730	S	18	12	30	0.00001
Pectobacterium_punjabense	2108399	S	13	3	16	0.00000
Pectobacterium_wasabiae	55208	S	11	4	15	0.00000
Pectobacterium_odoriferum	78398	S	10	9	19	0.00000
Brenneria_izadpanahii	2722756	S	73	72	145	0.00003
Brenneria_goodwinii	1109412	S	60	57	117	0.00003
Brenneria_rubrifaciens	55213	S	48	18	66	0.00002
Lonsdalea_populi	1172565	S	72	24	96	0.00002
Lonsdalea_britannica	1082704	S	57	18	75	0.00002
Musicola_paradisiaca	69223	S	74	0	74	0.00002
Edwardsiella_tarda	636	S	89	78	167	0.00004
Edwardsiella_hoshinae	93378	S	52	14	66	0.00002
Edwardsiella_ictaluri	67780	S	42	27	69	0.00002
Edwardsiella_piscicida	1263550	S	12	203	215	0.00005
Hafnia_alvei	569	S	23	21	44	0.00001
Hafnia_paralvei	546367	S	14	5	19	0.00000
Obesumbacterium_proteus	82983	S	12	8	20	0.00000
Morganella_morganii	582	S	120	110	230	0.00005
Xenorhabdus_hominickii	351679	S	17	3	20	0.00000
Xenorhabdus_bovienii	40576	S	16	5	21	0.00001
Xenorhabdus_nematophila	628	S	13	2	15	0.00000
Xenorhabdus_doucetiae	351671	S	11	1	12	0.00000
Xenorhabdus_poinarii	40577	S	10	2	12	0.00000
Providencia_rettgeri	587	S	17	40	57	0.00001
Providencia_alcalifaciens	126385	S	17	8	25	0.00001
Proteus_mirabilis	584	S	17	68	85	0.00002
Photorhabdus_thracensis	230089	S	12	2	14	0.00000
Sodalis_sp._dw_23	2697027	S	129	9	138	0.00003
Sodalis_praecaptivus	1239307	S	72	42	114	0.00003
Sodalis_glossinidius	63612	S	64	9	73	0.00002
Candidatus_Sodalis_pierantonius	1486991	S	23	14	37	0.00001
Leminorella_richardii	158841	S	34	6	40	0.00001
Thioalkalivibrio_paradoxus	108010	S	488	154	642	0.00015
Thioalkalivibrio_sulfidiphilus	1033854	S	472	300	772	0.00018
Thioalkalivibrio_nitratireducens	186931	S	451	128	579	0.00014
Thioalkalivibrio_sp._K90mix	396595	S	347	45	392	0.00009
Thioalkalivibrio_versutus	106634	S	309	41	350	0.00008
Spiribacter_sp._E85	2182432	S	888	85	973	0.00023
Spiribacter_sp._2438	2666185	S	185	19	204	0.00005
Spiribacter_curvatus	1335757	S	251	15	266	0.00006
Spiribacter_salinus	1335746	S	139	12	151	0.00004
Acidihalobacter_aeolianus	2792603	S	427	65	492	0.00012
Acidihalobacter_ferrooxydans	1765967	S	278	32	310	0.00007
Acidihalobacter_yilgarnensis	2819280	S	233	17	250	0.00006
Alkalilimnicola_ehrlichii	351052	S	533	69	602	0.00014
Halorhodospira_halophila	1053	S	381	45	426	0.00010
Halorhodospira_halochloris	1052	S	57	2	59	0.00001
Aquisalimonas_sp._2447	2740807	S	434	31	465	0.00011
Ectothiorhodospira_sp._BSL-9	1442136	S	163	51	214	0.00005
Ectothiorhodospira_haloalkaliphila	421628	S	154	51	205	0.00005
Ectothiorhodosinus_mongolicus	233100	S	55	3	58	0.00001
Allochromatium_tepidum	553982	S	359	186	545	0.00013
Allochromatium_vinosum	1049	S	353	146	499	0.00012
Marichromatium_purpuratum	37487	S	765	158	923	0.00022
Candidatus_Thiodictyon_syntrophicum	1166950	S	726	41	767	0.00018
Thioflavicoccus_mobilis	80679	S	702	68	770	0.00018
Thiocapsa_bogorovii	521689	S	534	30	564	0.00013
Thiocystis_violascens	73141	S	371	34	405	0.00010
Thermochromatium_tepidum	1050	S	257	69	326	0.00008
Nitrosococcus_halophilus	133539	S	46	6	52	0.00001
Nitrosococcus_wardiae	1814290	S	45	5	50	0.00001
Nitrosococcus_watsonii	473531	S	40	10	50	0.00001
Nitrosococcus_oceani	1229	S	26	6	32	0.00001
Caldichromatium_japonicum	2699430	S	164	20	184	0.00004
Rheinheimera_sp._F8	1763998	S	27	2	29	0.00001
Rheinheimera_mangrovi	2498451	S	12	1	13	0.00000
Wenzhouxiangella_marina	1579979	S	452	31	483	0.00012
Wenzhouxiangella_sp._AB-CW3	2771012	S	271	13	284	0.00007
Thiohalobacter_sp._COW1	2795687	S	89	223	312	0.00007
Thiohalobacter_thiocyanaticus	585455	S	88	273	361	0.00009
Guyparkeria_halophila	47960	S	487	118	605	0.00014
Sulfurivermis_fontis	1972068	S	465	190	655	0.00016
Halothiobacillus_sp._LS2	1860122	S	196	16	212	0.00005
Halothiobacillus_neapolitanus	927	S	148	15	163	0.00004
Woeseia_oceani	1548547	S	173	3	176	0.00004
Granulosicoccus_antarcticus	437505	S	67	1	68	0.00002
Sulfuriflexus_mobilis	1811807	S	62	1	63	0.00002
Halomonas_sp._THAF5a	2587844	S	388	163	551	0.00013
Halomonas_sp._1513	1883416	S	306	77	383	0.00009
Halomonas_sp._MCCC_1A13316	2733487	S	260	38	298	0.00007
Halomonas_sp._HG01	1609967	S	254	121	375	0.00009
Halomonas_sp._JS92-SW72	2306583	S	240	297	537	0.00013
Halomonas_sp._THAF12	2587849	S	237	158	395	0.00009
Halomonas_sp._YLGW01	2773308	S	236	43	279	0.00007
Halomonas_sp._PGE1	2730360	S	154	233	387	0.00009
Halomonas_sp._Y2R2	2562282	S	82	4	86	0.00002
Halomonas_sp._A40-4	2785909	S	64	18	82	0.00002
Halomonas_sp._SH5A2	2749040	S	54	10	64	0.00002
Halomonas_sp._KO116	1504981	S	41	19	60	0.00001
Halomonas_sp._SS10-MC5	2854257	S	37	389	426	0.00010
Halomonas_sp._FeN2	2832500	S	32	16	48	0.00001
Halomonas_sp._GFAJ-1	1118153	S	31	6	37	0.00001
Halomonas_sp._SF2003	2136172	S	30	119	149	0.00004
Halomonas_sp._R57-5	1610576	S	29	13	42	0.00001
Halomonas_sp._18071143	2855441	S	29	73	102	0.00002
Halomonas_sp._HL-93	1666906	S	11	78	89	0.00002
Halomonas_sp._TD01	999141	S	11	6	17	0.00000
Halomonas_sp._NyZ770	2883106	S	11	53	64	0.00002
Halomonas_sp._hl-4	1761789	S	10	69	79	0.00002
Halomonas_beimenensis	475662	S	389	85	474	0.00011
Halomonas_aestuarii	1897729	S	333	78	411	0.00010
Halomonas_socia	1081866	S	261	56	317	0.00008
Halomonas_tianxiuensis	2497861	S	257	65	322	0.00008
Halomonas_elongata	2746	S	213	24	237	0.00006
Halomonas_sulfidivorans	2733488	S	208	47	255	0.00006
Halomonas_chromatireducens	507626	S	187	16	203	0.00005
Halomonas_subglaciescola	29571	S	135	16	151	0.00004
Halomonas_meridiana	29570	S	111	100	211	0.00005
Halomonas_huangheensis	1178482	S	81	5	86	0.00002
Halomonas_piezotolerans	2609667	S	71	43	114	0.00003
Halomonas_profundi	2852117	S	34	5	39	0.00001
Halomonas_titanicae	664683	S	33	196	229	0.00005
Halomonas_sulfidoxydans	2733484	S	31	320	351	0.00008
Halomonas_hydrothermalis	115561	S	21	71	92	0.00002
Halomonas_venusta	44935	S	14	20	34	0.00001
Cobetia_sp._L2A1	2686360	S	69	8	77	0.00002
Cobetia_sp._cqz5-12	2609415	S	53	69	122	0.00003
Cobetia_sp._4B	2758724	S	28	112	140	0.00003
Cobetia_sp._AM6	2661553	S	22	119	141	0.00003
Cobetia_amphilecti	1055104	S	33	196	229	0.00005
Cobetia_pacifica	1055101	S	22	72	94	0.00002
Salinicola_tamaricis	1771309	S	434	52	486	0.00012
Halotalea_alkalilenta	376489	S	386	83	469	0.00011
Chromohalobacter_salexigens	158080	S	320	36	356	0.00008
Kushneria_phosphatilytica	657387	S	104	4	108	0.00003
Kushneria_konosiri	698828	S	87	20	107	0.00003
Kushneria_marisflavi	157779	S	66	14	80	0.00002
Pistricoccus_aurantiacus	1883414	S	211	15	226	0.00005
Zymobacter_palmae	33074	S	41	5	46	0.00001
Alcanivorax_sp._N3-2A	2014542	S	296	322	618	0.00015
Alcanivorax_pacificus	1306787	S	220	85	305	0.00007
Alcanivorax_xenomutans	1094342	S	150	112	262	0.00006
Alcanivorax_dieselolei	285091	S	104	55	159	0.00004
Ketobacter_alkanivorans	1917421	S	40	3	43	0.00001
Marinobacterium_aestuarii	1821621	S	133	11	144	0.00003
Marinobacterium_georgiense	48076	S	84	28	112	0.00003
Marinobacterium_sediminicola	518898	S	74	10	84	0.00002
Marinobacterium_sp._LSUCC0821	2668067	S	13	1	14	0.00000
Marinomonas_primoryensis	178399	S	18	3	21	0.00001
Marinomonas_mediterranea	119864	S	10	1	11	0.00000
Marinomonas_foliarum	491950	S	10	5	15	0.00000
Marinomonas_profundi	2726122	S	10	3	13	0.00000
Thalassolituus_sp._C2-1	2597518	S	34	3	37	0.00001
Thalassolituus_oleivorans	187493	S	23	7	30	0.00001
Bacterioplanes_sanyensis	1249553	S	42	3	45	0.00001
Venatorbacter_cucullus	2661630	S	28	8	36	0.00001
Nitrincola_iocasae	2614693	S	26	5	31	0.00001
Neptunomonas_japonica	417574	S	11	0	11	0.00000
Amphritea_japonica	452627	S	16	1	17	0.00000
Hahella_chejuensis	158327	S	106	14	120	0.00003
Hahella_sp._KA22	1628392	S	90	14	104	0.00002
Saccharospirillum_mangrovi	2161747	S	110	6	116	0.00003
Reinekea_forsetii	1336806	S	53	2	55	0.00001
Gynuella_sunshinyii	1445505	S	29	0	29	0.00001
Litoricola_lipolytica	418701	S	84	4	88	0.00002
Spartinivicinus_ruber	2683272	S	40	1	41	0.00001
Endozoicomonas_montiporae	1027273	S	19	1	20	0.00000
Oleiphilus_messinensis	141451	S	18	1	19	0.00000
Methylococcus_sp._EFPC2	2812648	S	362	26	388	0.00009
Methylococcus_sp._Mc7	2860258	S	353	116	469	0.00011
Methylococcus_capsulatus	414	S	359	93	452	0.00011
Methylococcus_geothermalis	2681310	S	292	85	377	0.00009
Methylomonas_sp._LL1	2785785	S	87	4	91	0.00002
Methylomonas_sp._LW13	107637	S	41	21	62	0.00001
Methylomonas_sp._EFPC1	2812647	S	35	19	54	0.00001
Methylomonas_sp._DH-1	1727196	S	33	75	108	0.00003
Methylomonas_koyamae	702114	S	110	136	246	0.00006
Methylomonas_rhizoryzae	2608981	S	92	4	96	0.00002
Methylomonas_methanica	421	S	89	5	94	0.00002
Methylomonas_denitrificans	1538553	S	89	7	96	0.00002
Methylomonas_paludis	1173101	S	23	1	24	0.00001
Methylomagnum_ishizawai	1760988	S	465	22	487	0.00012
Methylocaldum_marinum	1432792	S	410	26	436	0.00010
Methylomicrobium_album	39775	S	331	14	345	0.00008
Methylomicrobium_sp._wino1	2049332	S	55	52	107	0.00003
Methylogaea_oryzae	1295382	S	367	31	398	0.00009
Candidatus_Methylospira_mobilis	1808979	S	124	5	129	0.00003
Methylotuvimicrobium_buryatense	95641	S	31	37	68	0.00002
Methylotuvimicrobium_alcaliphilum	271065	S	29	41	70	0.00002
Methylovulum_psychrotolerans	1704499	S	42	1	43	0.00001
Methylobacter_sp._S3L5C	2839024	S	15	1	16	0.00000
Aeromonas_sp._FDAARGOS_1415	2778064	S	72	51	123	0.00003
Aeromonas_sp._CA23	2033032	S	69	36	105	0.00003
Aeromonas_sp._FDAARGOS_1409	2778058	S	39	75	114	0.00003
Aeromonas_sp._CU5	2033033	S	32	16	48	0.00001
Aeromonas_sp._1805	2560028	S	17	64	81	0.00002
Aeromonas_sp._FDAARGOS_1405	2778054	S	16	37	53	0.00001
Aeromonas_sp._FDAARGOS_1407	2778056	S	12	45	57	0.00001
Aeromonas_sp._FDAARGOS_1410	2778059	S	10	30	40	0.00001
Aeromonas_hydrophila	644	S	323	861	1184	0.00028
Aeromonas_veronii	654	S	204	548	752	0.00018
Aeromonas_schubertii	652	S	174	57	231	0.00006
Aeromonas_simiae	218936	S	155	164	319	0.00008
Aeromonas_media	651	S	144	358	502	0.00012
Aeromonas_encheleia	73010	S	143	58	201	0.00005
Aeromonas_salmonicida	645	S	129	120	249	0.00006
Aeromonas_caviae	648	S	98	953	1051	0.00025
Aeromonas_enteropelogenes	29489	S	85	88	173	0.00004
Aeromonas_rivuli	648794	S	85	27	112	0.00003
Aeromonas_jandaei	650	S	77	102	179	0.00004
Aeromonas_dhakensis	196024	S	62	162	224	0.00005
Aeromonas_sanarellii	633415	S	28	162	190	0.00005
Aeromonas_allosaccharophila	656	S	14	28	42	0.00001
Aeromonas_rivipollensis	948519	S	13	26	39	0.00001
Zobellella_denitrificans	347534	S	313	78	391	0.00009
Oceanimonas_sp._GK1	511062	S	135	31	166	0.00004
Dongshaea_marina	2047966	S	38	3	41	0.00001
Oceanisphaera_profunda	1416627	S	15	4	19	0.00000
Tolumonas_auensis	43948	S	22	10	32	0.00001
Succinivibrio_dextrinosolvens	83771	S	15	0	15	0.00000
Solimonas_sp._K1W22B-7	2303331	S	2346	265	2611	0.00062
Flagellatimonas_centrodinii	2806210	S	575	41	616	0.00015
Sinimarinibacterium_sp._NLF-5-8	2698684	S	249	152	401	0.00010
Steroidobacter_denitrificans	465721	S	809	252	1061	0.00025
Sulfurifustis_variabilis	1675686	S	2001	133	2134	0.00051
Sulfuricaulis_limicola	1620215	S	819	66	885	0.00021
Acidiferrobacter_sp._SPIII_3	1281578	S	235	49	284	0.00007
Acidiferrobacter_thiooxydans	163359	S	188	39	227	0.00005
Shewanella_sp._FJAT-53555	2864204	S	23	37	60	0.00001
Shewanella_sp._FJAT-51860	2864212	S	18	3	21	0.00001
Shewanella_sp._FJAT-54031	2864209	S	15	43	58	0.00001
Shewanella_sp._FJAT-53681	2864205	S	13	40	53	0.00001
Shewanella_sp._SNU_WT4	2590015	S	11	3	14	0.00000
Shewanella_sp._FJAT-53749	2864206	S	10	2	12	0.00000
Shewanella_sp._KX20019	2803864	S	10	1	11	0.00000
Shewanella_algae	38313	S	58	67	125	0.00003
Shewanella_cyperi	2814292	S	43	32	75	0.00002
Shewanella_khirikhana	1965282	S	37	7	44	0.00001
Shewanella_litorisediminis	1173586	S	27	8	35	0.00001
Shewanella_baltica	62322	S	26	87	113	0.00003
Shewanella_dokdonensis	712036	S	25	2	27	0.00001
Shewanella_amazonensis	60478	S	22	7	29	0.00001
Shewanella_sediminis	271097	S	22	3	25	0.00001
Shewanella_sedimentimangrovi	2814293	S	19	20	39	0.00001
Shewanella_avicenniae	2814294	S	16	2	18	0.00000
Shewanella_marisflavi	260364	S	16	3	19	0.00000
Shewanella_yunxiaonensis	2829809	S	14	2	16	0.00000
Shewanella_putrefaciens	24	S	14	62	76	0.00002
Shewanella_pealeana	70864	S	14	2	16	0.00000
Shewanella_indica	768528	S	13	26	39	0.00001
Shewanella_denitrificans	192073	S	13	2	15	0.00000
Shewanella_benthica	43661	S	12	3	15	0.00000
Shewanella_oneidensis	70863	S	11	4	15	0.00000
Alteromonas_macleodii	28108	S	36	28	64	0.00002
Alteromonas_sp._RKMC-009	2267264	S	15	7	22	0.00001
Alteromonas_pelagimontana	1858656	S	19	2	21	0.00001
Alteromonas_mediterranea	314275	S	17	8	25	0.00001
Salinimonas_iocasae	2572577	S	25	5	30	0.00001
Salinimonas_lutimaris	914153	S	24	5	29	0.00001
Salinimonas_marina	2785918	S	18	1	19	0.00000
Salinimonas_sediminis	2303538	S	13	2	15	0.00000
Hydrocarboniclastica_marina	2259620	S	105	15	120	0.00003
Paraglaciecola_sp._L1A13	2686359	S	13	1	14	0.00000
Paraglaciecola_psychrophila	326544	S	17	1	18	0.00000
Agarivorans_gilvus	680279	S	14	4	18	0.00000
Saliniradius_amylolyticus	2183582	S	32	3	35	0.00001
Lacimicrobium_alkaliphilum	1526571	S	28	2	30	0.00001
Paraneptunicella_aestuarii	2831148	S	20	1	21	0.00001
Glaciecola_nitratireducens	300231	S	10	0	10	0.00000
Pseudoalteromonas_sp._R3	1709477	S	18	5	23	0.00001
Pseudoalteromonas_rubra	43658	S	29	4	33	0.00001
Pseudoalteromonas_viridis	339617	S	26	8	34	0.00001
Pseudoalteromonas_agarivorans	176102	S	17	56	73	0.00002
Pseudoalteromonas_shioyasakiensis	1190813	S	10	4	14	0.00000
Pseudoalteromonas_xiamenensis	882626	S	10	1	11	0.00000
Pseudoalteromonas_mariniglutinosa	206042	S	10	22	32	0.00001
Ferrimonas_balearica	44012	S	137	20	157	0.00004
Ferrimonas_lipolytica	2724191	S	10	1	11	0.00000
Idiomarina_sp._OT37-5b	2100422	S	28	7	35	0.00001
Idiomarina_piscisalsi	1096243	S	11	9	20	0.00000
Colwellia_sp._Arc7-635	2497879	S	11	3	14	0.00000
Psychromonas_ingrahamii	357794	S	21	2	23	0.00001
Microbulbifer_sp._YPW16	2904242	S	153	14	167	0.00004
Microbulbifer_sp._SH-1	2681547	S	103	16	119	0.00003
Microbulbifer_sp._YPW1	2745199	S	88	16	104	0.00002
Microbulbifer_sp._ALW1	1516059	S	75	13	88	0.00002
Microbulbifer_sp._THAF38	2587856	S	39	13	52	0.00001
Microbulbifer_sp._GL-2	2591606	S	31	5	36	0.00001
Microbulbifer_sp._A4B17	359370	S	22	5	27	0.00001
Microbulbifer_aggregans	1769779	S	102	12	114	0.00003
Microbulbifer_celer	435905	S	92	11	103	0.00002
Microbulbifer_thermotolerans	252514	S	91	5	96	0.00002
Microbulbifer_elongatus	86173	S	76	13	89	0.00002
Microbulbifer_hydrolyticus	48074	S	74	14	88	0.00002
Microbulbifer_agarilyticus	260552	S	60	7	67	0.00002
Microbulbifer_variabilis	266805	S	25	9	34	0.00001
Kineobactrum_salinum	2708301	S	238	9	247	0.00006
Halioglobus_japonicus	930805	S	96	3	99	0.00002
Halioglobus_maricola	2601894	S	75	2	77	0.00002
Congregibacter_litoralis	393662	S	99	38	137	0.00003
Aequoribacter_fuscus	2518989	S	25	3	28	0.00001
Cellvibrio_sp._PSBB006	1987723	S	53	1	54	0.00001
Cellvibrio_sp._KY-YJ-3	454662	S	33	3	36	0.00001
Cellvibrio_sp._KY-GH-1	2303332	S	30	1	31	0.00001
Cellvibrio_sp._PSBB023	1945512	S	22	1	23	0.00001
Cellvibrio_japonicus	155077	S	72	5	77	0.00002
Teredinibacter_turnerae	2426	S	42	1	43	0.00001
Teredinibacter_haidensis	2731755	S	17	0	17	0.00000
Teredinibacter_purpureus	2731756	S	14	0	14	0.00000
Simiduia_agarivorans	447471	S	70	3	73	0.00002
Saccharophagus_degradans	86304	S	14	0	14	0.00000
Agarilytica_rhodophyticola	1737490	S	12	0	12	0.00000
Marinagarivorans_sp._GE09	2721545	S	11	0	11	0.00000
Spongiibacter_taiwanensis	1748242	S	67	2	69	0.00002
Spongiibacter_nanhainus	2794344	S	55	5	60	0.00001
Spongiibacter_sp._IMCC21906	1620392	S	27	6	33	0.00001
Zhongshania_aliphaticivorans	1470434	S	23	1	24	0.00001
Oceanicoccus_sagamiensis	716816	S	16	0	16	0.00000
Vibrio_parahaemolyticus	670	S	32	19	51	0.00001
Vibrio_alginolyticus	663	S	16	75	91	0.00002
Vibrio_campbellii	680	S	12	31	43	0.00001
Vibrio_azureus	512649	S	11	1	12	0.00000
Vibrio_sp._OG9-811	2841925	S	23	5	28	0.00001
Vibrio_sp._B1FLJ16	2751178	S	13	4	17	0.00000
Vibrio_vulnificus	672	S	50	11	61	0.00001
Vibrio_fluvialis	676	S	49	14	63	0.00002
Vibrio_furnissii	29494	S	49	25	74	0.00002
Vibrio_navarrensis	29495	S	27	16	43	0.00001
Vibrio_sinaloensis	379097	S	12	7	19	0.00000
Vibrio_cholerae	666	S	20	33	53	0.00001
Vibrio_cyclitrophicus	47951	S	20	12	32	0.00001
Vibrio_spartinae	1918945	S	19	3	22	0.00001
Vibrio_mimicus	674	S	18	8	26	0.00001
Vibrio_splendidus	29497	S	15	10	25	0.00001
Vibrio_anguillarum	55601	S	13	7	20	0.00000
Vibrio_coralliilyticus	190893	S	13	13	26	0.00001
Vibrio_algicola	2662262	S	12	2	14	0.00000
Vibrio_scophthalmi	45658	S	11	2	13	0.00000
Vibrio_tapetis	52443	S	11	1	12	0.00000
Vibrio_maritimus	990268	S	11	1	12	0.00000
Vibrio_taketomensis	2572923	S	10	1	11	0.00000
Vibrio_mediterranei	689	S	10	1	11	0.00000
Vibrio_panuliri	1381081	S	10	1	11	0.00000
Photobacterium_sp._GJ3	2829502	S	41	5	46	0.00001
Photobacterium_sp._TLY01	2907534	S	29	5	34	0.00001
Photobacterium_damselae	38293	S	53	26	79	0.00002
Photobacterium_gaetbulicola	1295392	S	37	3	40	0.00001
Photobacterium_ganghwense	320778	S	25	6	31	0.00001
Grimontia_hollisae	673	S	34	4	38	0.00001
Salinivibrio_kushneri	1908198	S	15	14	29	0.00001
Thaumasiovibrio_subtropicus	1891207	S	11	1	12	0.00000
Legionella_pneumophila	446	S	117	42	159	0.00004
Legionella_sp._MW5194	2662448	S	16	2	18	0.00000
Legionella_israelensis	454	S	24	1	25	0.00001
Legionella_spiritensis	452	S	21	1	22	0.00001
Legionella_geestiana	45065	S	21	1	22	0.00001
Legionella_antarctica	2708020	S	20	0	20	0.00000
Legionella_oakridgensis	29423	S	18	1	19	0.00000
Legionella_longbeachae	450	S	18	2	20	0.00000
Legionella_sainthelensi	28087	S	15	2	17	0.00000
Legionella_clemsonensis	1867846	S	15	2	17	0.00000
Legionella_cherrii	28084	S	13	0	13	0.00000
Legionella_hackeliae	449	S	13	1	14	0.00000
Legionella_anisa	28082	S	12	2	14	0.00000
Legionella_jordanis	456	S	11	1	12	0.00000
Legionella_fallonii	96230	S	11	0	11	0.00000
Legionella_waltersii	66969	S	10	1	11	0.00000
Fluoribacter_dumoffii	463	S	21	3	24	0.00001
Aquicella_siphonis	254247	S	197	28	225	0.00005
Aquicella_lusitana	254246	S	48	7	55	0.00001
Coxiella_burnetii	777	S	43	9	52	0.00001
Candidatus_Coxiella_mudrowiae	2054173	S	15	1	16	0.00000
Immundisolibacter_cernigliae	1810504	S	770	157	927	0.00022
Candidatus_Endoriftia_persephone	393765	S	261	13	274	0.00007
Sedimenticola_thiotaurini	1543721	S	125	5	130	0.00003
Candidatus_Reidiella_endopervernicosa	2738883	S	93	2	95	0.00002
Thiolapillus_brandeum	1076588	S	79	2	81	0.00002
Pseudohongiella_spirulinae	1249552	S	40	1	41	0.00001
Gallaecimonas_mangrovi	2291597	S	31	2	33	0.00001
Celerinatantimonas_diazotrophica	412034	S	12	0	12	0.00000
Acinetobacter_sp._WCHAc010034	1879049	S	66	33	99	0.00002
Acinetobacter_baumannii	470	S	30	192	222	0.00005
Acinetobacter_johnsonii	40214	S	16	18	34	0.00001
Acinetobacter_indicus	756892	S	16	15	31	0.00001
Acinetobacter_lwoffii	28090	S	14	24	38	0.00001
Acinetobacter_bouvetii	202951	S	14	3	17	0.00000
Acinetobacter_schindleri	108981	S	10	10	20	0.00000
Moraxella_osloensis	34062	S	17	19	36	0.00001
Aquirhabdus_parva	2283318	S	23	1	24	0.00001
Methylophaga_nitratireducenticrescens	754476	S	19	1	20	0.00000
Methylophaga_frappieri	754477	S	19	10	29	0.00001
Methylophaga_sp._TMB456	2881052	S	16	4	20	0.00000
Thiomicrorhabdus_xiamenensis	2739063	S	28	1	29	0.00001
Thiomicrorhabdus_sediminis	2580412	S	10	0	10	0.00000
Thiomicrospira_sp._S5	1803865	S	13	11	24	0.00001
Thiomicrospira_microaerophila	406020	S	12	1	13	0.00000
Thiomicrospira_aerophila	92245	S	11	0	11	0.00000
Thiomicrospira_cyclica	147268	S	10	0	10	0.00000
Hydrogenovibrio_thermophilus	265883	S	22	18	40	0.00001
Piscirickettsia_salmonis	1238	S	20	1	21	0.00001
Thiothrix_litoralis	2891210	S	61	4	65	0.00002
Thiothrix_subterranea	2735563	S	42	9	51	0.00001
Thiothrix_sp._CT3	96472	S	30	8	38	0.00001
Thiothrix_unzii	111769	S	25	10	35	0.00001
Candidatus_Thiothrix_anitrata	2823902	S	19	9	28	0.00001
Beggiatoa_leptomitoformis	288004	S	14	0	14	0.00000
Pasteurella_multocida	747	S	208	516	724	0.00017
Haemophilus_parainfluenzae	729	S	14	18	32	0.00001
Aggregatibacter_actinomycetemcomitans	714	S	19	3	22	0.00001
Aggregatibacter_aphrophilus	732	S	14	7	21	0.00001
Actinobacillus_sp._GY-402	2774188	S	18	15	33	0.00001
Salinisphaera_sp._LB1	2183911	S	478	21	499	0.00012
endosymbiont_of_unidentified_scaly_snail_isolate_Monju	1248727	S	377	34	411	0.00010
Cardiobacterium_sp._Marseille-Q4385	2866573	S	136	24	160	0.00004
Cardiobacterium_hominis	2718	S	120	24	144	0.00003
Suttonella_sp._R2A3	2908648	S	17	1	18	0.00000
Kangiella_profundi	1561924	S	17	2	19	0.00000
Kangiella_koreensis	261964	S	12	1	13	0.00000
Myxococcus_xanthus	34	S	1995	38362	40357	0.00960
Myxococcus_hansupus	1297742	S	1186	52	1238	0.00029
Myxococcus_stipitatus	83455	S	998	43	1041	0.00025
Myxococcus_sp._SCHIC003	2813577	S	850	37	887	0.00021
Corallococcus_coralloides	184914	S	2131	741	2872	0.00068
Corallococcus_sp._EGB	1521117	S	1501	501	2002	0.00048
Corallococcus_macrosporus	35	S	1407	127	1534	0.00037
Pyxidicoccus_sp._SCPEA002	2813578	S	3446	95	3541	0.00084
Anaeromyxobacter_sp._Red232	2918170	S	3881	392	4273	0.00102
Anaeromyxobacter_sp._Fw109-5	404589	S	3070	380	3450	0.00082
Anaeromyxobacter_sp._Red630	2918171	S	2861	352	3213	0.00076
Anaeromyxobacter_sp._K	447217	S	673	1436	2109	0.00050
Anaeromyxobacter_dehalogenans	161493	S	2399	1816	4215	0.00100
Archangium_violaceum	83451	S	4265	825	5090	0.00121
Archangium_gephyra	48	S	2212	516	2728	0.00065
Stigmatella_aurantiaca	41	S	2178	115	2293	0.00055
Cystobacter_fuscus	43	S	1824	469	2293	0.00055
Melittangium_boletus	83453	S	1317	304	1621	0.00039
Vulgatibacter_incomptus	1391653	S	1720	111	1831	0.00044
Sorangium_cellulosum	56	S	18441	2036	20477	0.00487
Polyangium_aurulentum	2567896	S	4909	454	5363	0.00128
Chondromyces_crocatus	52	S	2404	114	2518	0.00060
Pajaroellobacter_abortibovis	1882918	S	30	1	31	0.00001
Sandaracinus_amylolyticus	927083	S	9558	496	10054	0.00239
Labilithrix_luteola	1391654	S	3687	167	3854	0.00092
Haliangium_ochraceum	80816	S	4087	170	4257	0.00101
Geomonas_sp._RF6	2897342	S	702	85	787	0.00019
Geomonas_paludis	2740185	S	478	246	724	0.00017
Geomonas_nitrogeniifigens	2847991	S	468	246	714	0.00017
Geomonas_oryzisoli	2847992	S	395	221	616	0.00015
Geomonas_subterranea	2847989	S	377	179	556	0.00013
Geobacter_sp._FeAm09	2597769	S	355	44	399	0.00010
Geobacter_sp._SVR	2495594	S	291	42	333	0.00008
Geobacter_sp._DSM_9736	1277350	S	176	12	188	0.00004
Geobacter_sulfurreducens	35554	S	460	94	554	0.00013
Geobacter_pickeringii	345632	S	437	102	539	0.00013
Geobacter_metallireducens	28232	S	306	65	371	0.00009
Geobacter_benzoatilyticus	2815309	S	174	34	208	0.00005
Citrifermentans_bremense	60035	S	430	173	603	0.00014
Citrifermentans_bemidjiense	225194	S	370	137	507	0.00012
Geotalea_uraniireducens	351604	S	191	13	204	0.00005
Geotalea_daltonii	1203471	S	90	6	96	0.00002
Geoalkalibacter_subterraneus	483547	S	198	99	297	0.00007
Trichlorobacter_lovleyi	313985	S	121	16	137	0.00003
Desulfuromonas_versatilis	2802975	S	712	128	840	0.00020
Desulfuromonas_sp._DDH964	1823759	S	479	76	555	0.00013
Desulfuromonas_sp._AOP6	1566351	S	172	20	192	0.00005
Desulfuromonas_soudanensis	1603606	S	450	51	501	0.00012
Pelobacter_propionicus	29543	S	301	110	411	0.00010
Syntrophotalea_acetylenica	29542	S	164	27	191	0.00005
Syntrophotalea_carbinolica	19	S	104	7	111	0.00003
Syntrophotalea_acetylenivorans	1842532	S	91	11	102	0.00002
Pseudodesulfovibrio_mercurii	641491	S	328	85	413	0.00010
Pseudodesulfovibrio_indicus	1716143	S	328	76	404	0.00010
Pseudodesulfovibrio_aespoeensis	182210	S	214	114	328	0.00008
Pseudodesulfovibrio_cashew	2678688	S	190	40	230	0.00005
Pseudodesulfovibrio_tunisiensis	463192	S	148	15	163	0.00004
Pseudodesulfovibrio_sp._zrk46	2725288	S	73	13	86	0.00002
Pseudodesulfovibrio_sp._SF6	2810563	S	73	7	80	0.00002
Pseudodesulfovibrio_profundus	57320	S	57	41	98	0.00002
Pseudodesulfovibrio_piezophilus	879567	S	24	3	27	0.00001
Desulfovibrio_sp._IOR2	2583823	S	204	39	243	0.00006
Desulfovibrio_sp._86	2666132	S	52	15	67	0.00002
Desulfovibrio_sp._G11	631220	S	37	33	70	0.00002
Desulfovibrio_vulgaris	881	S	273	7	280	0.00007
Desulfovibrio_sulfodismutans	63561	S	225	59	284	0.00007
Desulfovibrio_piger	901	S	202	42	244	0.00006
Desulfovibrio_desulfuricans	876	S	200	51	251	0.00006
Desulfovibrio_fairfieldensis	44742	S	167	16	183	0.00004
Desulfovibrio_ferrophilus	241368	S	73	6	79	0.00002
Candidatus_Desulfovibrio_trichonymphae	1725232	S	34	3	37	0.00001
Solidesulfovibrio_carbinoliphilus	345370	S	414	52	466	0.00011
Solidesulfovibrio_carbinolicus	296842	S	184	154	338	0.00008
Solidesulfovibrio_magneticus	184917	S	183	115	298	0.00007
Oceanidesulfovibrio_marinus	370038	S	402	25	427	0.00010
Desulfocurvibacter_africanus	873	S	315	23	338	0.00008
Desulfolutivibrio_sulfoxidireducens	2773299	S	283	77	360	0.00009
Megalodesulfovibrio_gigas	879	S	235	11	246	0.00006
Oleidesulfovibrio_alaskensis	58180	S	80	70	150	0.00004
Maridesulfovibrio_salexigens	880	S	34	4	38	0.00001
Maridesulfovibrio_hydrothermalis	191026	S	32	4	36	0.00001
Paradesulfovibrio_bizertensis	376490	S	41	3	44	0.00001
Desulfomicrobium_baculatum	899	S	196	13	209	0.00005
Desulfomicrobium_orale	132132	S	114	17	131	0.00003
Desulfohalobium_retbaense	45663	S	78	4	82	0.00002
Desulfosarcina_alkanivorans	571177	S	252	73	325	0.00008
Desulfosarcina_ovata	83564	S	243	13	256	0.00006
Desulfosarcina_widdelii	947919	S	225	22	247	0.00006
Desulfococcus_multivorans	897	S	206	27	233	0.00006
Desulfoluna_sp._ASN36	2810562	S	139	5	144	0.00003
Desulfatibacillum_aliphaticivorans	218208	S	132	3	135	0.00003
Desulfonema_magnum	45655	S	48	0	48	0.00001
Desulfonema_limicola	45656	S	11	0	11	0.00000
Desulfobacter_postgatei	2293	S	31	6	37	0.00001
Desulfobacter_hydrogenophilus	2291	S	19	3	22	0.00001
Desulforapulum_autotrophicum	2296	S	32	2	34	0.00001
Desulfobacula_toluolica	28223	S	21	1	22	0.00001
Desulfobulbus_propionicus	894	S	225	11	236	0.00006
Desulfobulbus_oralis	1986146	S	166	21	187	0.00004
Desulfobulbus_oligotrophicus	1909699	S	45	21	66	0.00002
Desulfurivibrio_alkaliphilus	427923	S	193	9	202	0.00005
Desulfomarina_profundi	2772557	S	14	1	15	0.00000
Desulfosudis_oleivorans	181663	S	173	9	182	0.00004
Desulfosediminicola_ganghwensis	2569540	S	52	4	56	0.00001
Desulfosediminicola_flagellatus	2569541	S	20	1	21	0.00001
Desulfotalea_psychrophila	84980	S	19	2	21	0.00001
Desulfocapsa_sulfexigens	65555	S	13	0	13	0.00000
Persicimonas_caeni	2292766	S	1187	30	1217	0.00029
Bradymonas_sediminis	1548548	S	393	23	416	0.00010
Bradymonadales_bacterium_V1718	2600177	S	190	7	197	0.00005
Syntrophobacter_fumaroxidans	119484	S	280	61	341	0.00008
Desulfoglaeba_alkanexedens	361111	S	230	9	239	0.00006
Desulfarculus_baarsii	453230	S	457	146	603	0.00014
Syntrophus_aciditrophicus	316277	S	95	5	100	0.00002
Desulfomonile_tiedjei	2358	S	84	0	84	0.00002
Desulfobacca_acetoxidans	60893	S	82	1	83	0.00002
Dissulfurimicrobium_hydrothermale	1750598	S	55	3	58	0.00001
Candidatus_Desulfofervidus_auxilii	1621989	S	19	0	19	0.00000
Hippea_maritima	84405	S	12	0	12	0.00000
Campylobacter_gracilis	824	S	38	6	44	0.00001
Campylobacter_showae	204	S	37	21	58	0.00001
Campylobacter_concisus	199	S	31	8	39	0.00001
Campylobacter_curvus	200	S	29	7	36	0.00001
Campylobacter_rectus	203	S	12	7	19	0.00000
Sulfurimonas_sp._HSL-3221	2894755	S	122	19	141	0.00003
Sulfuricurvum_kujiense	148813	S	12	1	13	0.00000
Helicobacter_pylori	210	S	40	22	62	0.00001
Helicobacter_felis	214	S	10	2	12	0.00000
Wolinella_succinogenes	844	S	10	2	12	0.00000
Nitratifractor_salsuginis	269261	S	65	9	74	0.00002
Sulfurovum_sp._HSL1-3	2893889	S	12	7	19	0.00000
Hydrogenimonas_urashimensis	2740515	S	71	12	83	0.00002
Sulfurospirillum_cavolei	366522	S	11	8	19	0.00000
Caminibacter_mediatlanticus	291048	S	14	14	28	0.00001
Acidithiobacillus_caldus	33059	S	137	30	167	0.00004
Acidithiobacillus_ferrivorans	160808	S	98	35	133	0.00003
Acidithiobacillus_ferrooxidans	920	S	71	101	172	0.00004
Acidithiobacillus_thiooxidans	930	S	28	2	30	0.00001
Acidithiobacillus_ferriphilus	1689834	S	27	10	37	0.00001
Bdellovibrio_bacteriovorus	959	S	113	16	129	0.00003
Bdellovibrio_sp._LBG001	2835041	S	33	4	37	0.00001
Bdellovibrio_sp._NC01	2220073	S	27	3	30	0.00001
Bdellovibrio_sp._ZAP7	2231053	S	15	6	21	0.00001
Bdellovibrio_sp._KM01	2748865	S	13	6	19	0.00000
Pseudobdellovibrio_exovorus	453816	S	21	1	22	0.00001
Hydrogenophilus_thermoluteolus	297	S	166	33	199	0.00005
Mariprofundus_ferrinatatus	1921087	S	67	3	70	0.00002
Mariprofundus_aestuarium	1921086	S	52	3	55	0.00001
Streptomyces_sp._DSM_40868	2721173	S	4021	1607	5628	0.00134
Streptomyces_sp._CdTB01	1725411	S	2830	898	3728	0.00089
Streptomyces_sp._AMCC400023	2056258	S	2803	1203	4006	0.00095
Streptomyces_sp._SAT1	1849967	S	2410	998	3408	0.00081
Streptomyces_sp._SCSIO_64649	2878388	S	2236	471	2707	0.00064
Streptomyces_sp._SN-593	659352	S	2138	586	2724	0.00065
Streptomyces_sp._P3	2135430	S	2026	564	2590	0.00062
Streptomyces_sp._CB01881	2078691	S	2009	457	2466	0.00059
Streptomyces_sp._3214.6	1882757	S	1941	626	2567	0.00061
Streptomyces_sp._ZYC-3	2797636	S	1929	424	2353	0.00056
Streptomyces_sp._Z423-1	2730915	S	1820	586	2406	0.00057
Streptomyces_sp._So13.3	2136173	S	1804	387	2191	0.00052
Streptomyces_sp._MA3_2.13	2867410	S	1705	255	1960	0.00047
Streptomyces_sp._WAC_01438	2203204	S	1690	633	2323	0.00055
Streptomyces_sp._BH-MK-02	2880933	S	1579	381	1960	0.00047
Streptomyces_sp._SCUT-3	2684469	S	1546	704	2250	0.00054
Streptomyces_sp._BJ20	2930049	S	1513	678	2191	0.00052
Streptomyces_sp._ST1015	1848900	S	1498	350	1848	0.00044
Streptomyces_sp._NHF165	2175864	S	1486	296	1782	0.00042
Streptomyces_sp._A2-16	2781734	S	1485	506	1991	0.00047
Streptomyces_sp._NA02950	2742137	S	1475	331	1806	0.00043
Streptomyces_sp._NEAU-sy36	2751189	S	1438	592	2030	0.00048
Streptomyces_sp._LRE541	2931983	S	1410	355	1765	0.00042
Streptomyces_sp._891-h	2720714	S	1364	283	1647	0.00039
Streptomyces_sp._RPA4-2	2721244	S	1355	433	1788	0.00043
Streptomyces_sp._GQFP	2907545	S	1338	255	1593	0.00038
Streptomyces_sp._3025	2923272	S	1336	271	1607	0.00038
Streptomyces_sp._JB150	2714844	S	1290	484	1774	0.00042
Streptomyces_sp._HM190	2695266	S	1288	452	1740	0.00041
Streptomyces_sp._MG28	2865673	S	1282	485	1767	0.00042
Streptomyces_sp._GMY02	1333528	S	1271	254	1525	0.00036
Streptomyces_sp._YIM_121038	2136401	S	1235	400	1635	0.00039
Streptomyces_sp._MST-110588	2833628	S	1225	338	1563	0.00037
Streptomyces_sp._Go_40/10	2825844	S	1213	574	1787	0.00043
Streptomyces_sp._Go-475	2072505	S	1162	578	1740	0.00041
Streptomyces_sp._NA04227	2742136	S	1152	301	1453	0.00035
Streptomyces_sp._W1SF4	2305220	S	1136	448	1584	0.00038
Streptomyces_sp._C8S0	2585716	S	1135	368	1503	0.00036
Streptomyces_sp._MBT27	1488356	S	1102	361	1463	0.00035
Streptomyces_sp._GS7	2692234	S	1085	327	1412	0.00034
Streptomyces_sp._RTd22	1841249	S	1071	442	1513	0.00036
Streptomyces_sp._MG62	2838015	S	1048	424	1472	0.00035
Streptomyces_sp._SYP-A7193	2662065	S	1022	617	1639	0.00039
Streptomyces_sp._HP-A2021	2927875	S	1015	591	1606	0.00038
Streptomyces_sp._BHT-5-2	2866715	S	969	334	1303	0.00031
Streptomyces_sp._Rer75	2750011	S	935	425	1360	0.00032
Streptomyces_sp._SM18	1736046	S	933	284	1217	0.00029
Streptomyces_sp._135	2838850	S	901	319	1220	0.00029
Streptomyces_sp._jing01	2726118	S	900	532	1432	0.00034
Streptomyces_sp._QHH-9511	2684468	S	890	274	1164	0.00028
Streptomyces_sp._HSG2	2797167	S	888	217	1105	0.00026
Streptomyces_sp._CMB-StM0423	2059884	S	874	405	1279	0.00030
Streptomyces_sp._S1D4-11	2721246	S	855	607	1462	0.00035
Streptomyces_sp._CCM_MD2014	1561022	S	847	734	1581	0.00038
Streptomyces_sp._SirexAA-E	862751	S	808	264	1072	0.00026
Streptomyces_sp._Tu_2975	2676871	S	792	277	1069	0.00025
Streptomyces_sp._WAC_01529	2203205	S	772	296	1068	0.00025
Streptomyces_sp._fd1-xmd	1812480	S	728	332	1060	0.00025
Streptomyces_sp._INR7	2607753	S	726	376	1102	0.00026
Streptomyces_sp._S4.7	2705439	S	716	257	973	0.00023
Streptomyces_sp._SUK_48	2582831	S	715	454	1169	0.00028
Streptomyces_sp._TN58	234612	S	676	320	996	0.00024
Streptomyces_sp._CB09001	2083284	S	661	445	1106	0.00026
Streptomyces_sp._HF10	2692233	S	603	429	1032	0.00025
Streptomyces_sp._AgN23	1188315	S	603	542	1145	0.00027
Streptomyces_sp._CNQ-509	444103	S	551	487	1038	0.00025
Streptomyces_sp._WY228	2855836	S	533	298	831	0.00020
Streptomyces_sp._WAC_06738	2203210	S	519	467	986	0.00023
Streptomyces_sp._Mg1	465541	S	516	454	970	0.00023
Streptomyces_sp._ADI95-16	1522758	S	506	418	924	0.00022
Streptomyces_sp._YPW6	2840373	S	483	261	744	0.00018
Streptomyces_sp._769	1262452	S	434	332	766	0.00018
Streptomyces_sp._2323.1	1938841	S	409	257	666	0.00016
Streptomyces_sp._RPA4-5	2721245	S	390	257	647	0.00015
Streptomyces_sp._RLB1-33	2721243	S	389	1132	1521	0.00036
Streptomyces_sp._EAS-AB2608	2779671	S	388	587	975	0.00023
Streptomyces_sp._NA02536	2742133	S	372	997	1369	0.00033
Streptomyces_sp._PBH53	1577075	S	353	495	848	0.00020
Streptomyces_sp._3211	1964449	S	327	394	721	0.00017
Streptomyces_sp._S063	2005885	S	320	226	546	0.00013
Streptomyces_sp._S8	1837283	S	319	282	601	0.00014
Streptomyces_sp._NA03103	2742134	S	309	1896	2205	0.00052
Streptomyces_sp._HNA39	2850561	S	275	320	595	0.00014
Streptomyces_sp._NEAU-S7GS2	2202000	S	275	225	500	0.00012
Streptomyces_sp._11-1-2	1851167	S	269	506	775	0.00018
Streptomyces_sp._XC_2026	2782004	S	262	233	495	0.00012
Streptomyces_sp._WA6-1-16	2879427	S	261	266	527	0.00013
Streptomyces_sp._Sge12	1972846	S	259	383	642	0.00015
Streptomyces_sp._ID38640	1265399	S	258	182	440	0.00010
Streptomyces_sp._MOE7	1961713	S	248	303	551	0.00013
Streptomyces_sp._CLI2509	1984801	S	227	740	967	0.00023
Streptomyces_sp._Tue_6075	1661694	S	218	251	469	0.00011
Streptomyces_sp._V17-9	2831149	S	215	970	1185	0.00028
Streptomyces_sp._A144	2871487	S	205	891	1096	0.00026
Streptomyces_sp._M2	646637	S	205	1047	1252	0.00030
Streptomyces_sp._KPB2	2305221	S	201	1559	1760	0.00042
Streptomyces_sp._CB04723	2748873	S	201	365	566	0.00013
Streptomyces_sp._BSE6.1	2605730	S	195	836	1031	0.00025
Streptomyces_sp._CB00271	2750025	S	193	266	459	0.00011
Streptomyces_sp._CRSS-Y-16	2906474	S	175	945	1120	0.00027
Streptomyces_sp._M56	1495638	S	174	467	641	0.00015
Streptomyces_sp._CFMR_7	1649184	S	164	287	451	0.00011
Streptomyces_sp._WAC00303	2933779	S	156	227	383	0.00009
Streptomyces_sp._SS52	2563602	S	149	680	829	0.00020
Streptomyces_sp._HU2014	2939414	S	145	506	651	0.00015
Streptomyces_sp._endophyte_N2	2153485	S	138	405	543	0.00013
Streptomyces_sp._CB09030	2913412	S	136	462	598	0.00014
Streptomyces_sp._SGAir0924	2109593	S	135	637	772	0.00018
Streptomyces_sp._Tu6071	355249	S	128	373	501	0.00012
Streptomyces_sp._PAMC_26508	1265601	S	124	421	545	0.00013
Streptomyces_sp._VN1	1821625	S	107	459	566	0.00013
Streptomyces_sp._LBUM_1480	2609808	S	105	1065	1170	0.00028
Streptomyces_sp._LBUM_1482	2609809	S	102	2646	2748	0.00065
Streptomyces_sp._WAC00288	2094021	S	98	415	513	0.00012
Streptomyces_sp._S1A1-7	2594459	S	95	861	956	0.00023
Streptomyces_sp._2114.2	1881022	S	81	510	591	0.00014
Streptomyces_sp._S501	2420135	S	79	290	369	0.00009
Streptomyces_sp._WA1-19	2884220	S	67	363	430	0.00010
Streptomyces_sp._GF20	2692235	S	66	376	442	0.00011
Streptomyces_sp._RLB3-17	2594455	S	65	979	1044	0.00025
Streptomyces_sp._R527F	1664033	S	61	354	415	0.00010
Streptomyces_sp._A1-5	2738410	S	59	278	337	0.00008
Streptomyces_sp._604F	1476754	S	50	438	488	0.00012
Streptomyces_sp._CC0208	2306165	S	49	1342	1391	0.00033
Streptomyces_sp._NBU3104	2911367	S	45	299	344	0.00008
Streptomyces_sp._RLB3-6	2594457	S	43	1299	1342	0.00032
Streptomyces_sp._PVA_94-07	1225337	S	41	586	627	0.00015
Streptomyces_sp._CA-256286	2801033	S	40	254	294	0.00007
Streptomyces_sp._FR-008	206662	S	38	314	352	0.00008
Streptomyces_sp._LBUM_1475	2609807	S	34	1034	1068	0.00025
Streptomyces_sp._PLM4	2929798	S	33	276	309	0.00007
Streptomyces_sp._S1D4-20	2594462	S	33	864	897	0.00021
Streptomyces_sp._RLB1-9	2594454	S	31	1645	1676	0.00040
Streptomyces_sp._S1D4-23	2594463	S	30	1547	1577	0.00038
Streptomyces_sp._S1D4-14	2594461	S	27	1698	1725	0.00041
Streptomyces_sp._OUCMDZ-3434	1535304	S	26	264	290	0.00007
Streptomyces_sp._A10(2020)	2782013	S	22	260	282	0.00007
Streptomyces_sp._GBA_94-10	1218177	S	18	222	240	0.00006
Streptomyces_sp._ICC1	2099583	S	15	832	847	0.00020
Streptomyces_venezuelae	54571	S	5933	2103	8036	0.00191
Streptomyces_hygroscopicus	1912	S	2254	3759	6013	0.00143
Streptomyces_rapamycinicus	1226757	S	1321	320	1641	0.00039
Streptomyces_violaceusniger	68280	S	501	331	832	0.00020
Streptomyces_yatensis	155177	S	462	336	798	0.00019
Streptomyces_malaysiensis	92644	S	124	367	491	0.00012
Streptomyces_cadmiisoli	2184053	S	1477	381	1858	0.00044
Streptomyces_aurantiacus	47760	S	1229	302	1531	0.00036
Streptomyces_qaidamensis	1783515	S	980	416	1396	0.00033
Streptomyces_alboniger	132473	S	663	251	914	0.00022
Streptomyces_koyangensis	188770	S	450	454	904	0.00022
Streptomyces_nodosus	40318	S	4016	1050	5066	0.00121
Streptomyces_aquilus	2548456	S	2961	893	3854	0.00092
Streptomyces_chartreusis	1969	S	2720	1182	3902	0.00093
Streptomyces_bingchenggensis	379067	S	2527	507	3034	0.00072
Streptomyces_albus	1888	S	2340	1191	3531	0.00084
Streptomyces_griseus	1911	S	914	820	1734	0.00041
Streptomyces_sp._M54	2759525	S	91	232	323	0.00008
Streptomyces_anulatus	1892	S	642	669	1311	0.00031
Streptomyces_microflavus	1919	S	320	1400	1720	0.00041
Streptomyces_globisporus	1908	S	281	2032	2313	0.00055
Streptomyces_griseorubiginosus	67304	S	2223	744	2967	0.00071
Streptomyces_avermitilis	33903	S	2164	636	2800	0.00067
Streptomyces_lydicus	47763	S	2132	1445	3577	0.00085
Streptomyces_formicae	1616117	S	1999	649	2648	0.00063
Streptomyces_griseochromogenes	68214	S	1821	516	2337	0.00056
Streptomyces_cattleya	29303	S	1796	550	2346	0.00056
Streptomyces_capitiformicae	2014920	S	1792	291	2083	0.00050
Streptomyces_seoulensis	73044	S	1777	703	2480	0.00059
Streptomyces_dengpaensis	2049881	S	1748	496	2244	0.00053
Streptomyces_bathyalis	2710756	S	1744	304	2048	0.00049
Streptomyces_buecherae	2763006	S	1722	458	2180	0.00052
Streptomyces_spectabilis	68270	S	1706	568	2274	0.00054
Streptomyces_nigra	1827580	S	1699	683	2382	0.00057
Streptomyces_armeniacus	83291	S	1657	254	1911	0.00045
Streptomyces_tsukubensis	83656	S	1591	510	2101	0.00050
Streptomyces_niveus	193462	S	1589	729	2318	0.00055
Streptomyces_lincolnensis	1915	S	1573	464	2037	0.00048
Streptomyces_ferrugineus	1413221	S	1530	502	2032	0.00048
Streptomyces_cyaneochromogenes	2496836	S	1491	445	1936	0.00046
Streptomyces_asoensis	249586	S	1482	450	1932	0.00046
Streptomyces_roseirectus	2768066	S	1461	365	1826	0.00043
Streptomyces_collinus	42684	S	1451	915	2366	0.00056
Streptomyces_davaonensis	348043	S	1448	413	1861	0.00044
Streptomyces_actuosus	1885	S	1411	612	2023	0.00048
Streptomyces_xanthii	2768069	S	1409	441	1850	0.00044
Streptomyces_roseochromogenus	285450	S	1381	439	1820	0.00043
Streptomyces_broussonetiae	2686304	S	1379	425	1804	0.00043
Streptomyces_lunaelactis	1535768	S	1357	295	1652	0.00039
Streptomyces_antibioticus	1890	S	1355	494	1849	0.00044
Streptomyces_griseoviridis	45398	S	1345	446	1791	0.00043
Streptomyces_calvus	67282	S	1342	536	1878	0.00045
Streptomyces_incarnatus	665007	S	1342	403	1745	0.00042
Streptomyces_xinghaiensis	1038928	S	1311	416	1727	0.00041
Streptomyces_phaeolivaceus	2653200	S	1237	345	1582	0.00038
Streptomyces_albulus	68570	S	1235	386	1621	0.00039
Streptomyces_rimosus	1927	S	1229	321	1550	0.00037
Streptomyces_fodineus	1904616	S	1226	439	1665	0.00040
Streptomyces_liangshanensis	2717324	S	1223	320	1543	0.00037
Streptomyces_durmitorensis	319947	S	1201	266	1467	0.00035
Streptomyces_olivoreticuli	68246	S	1199	353	1552	0.00037
Streptomyces_vietnamensis	362257	S	1191	409	1600	0.00038
Streptomyces_viridosporus	67581	S	1139	473	1612	0.00038
Streptomyces_genisteinicus	2768068	S	1128	369	1497	0.00036
Streptomyces_chromofuscus	42881	S	1099	432	1531	0.00036
Streptomyces_griseocarneus	51201	S	1086	395	1481	0.00035
Streptomyces_aureoverticillatus	66871	S	1084	301	1385	0.00033
Streptomyces_paludis	2282738	S	1080	244	1324	0.00032
Streptomyces_clavuligerus	1901	S	1077	269	1346	0.00032
Streptomyces_globosus	68209	S	1075	408	1483	0.00035
Streptomyces_glaucescens	1907	S	1071	473	1544	0.00037
Streptomyces_deccanensis	424188	S	1064	443	1507	0.00036
Streptomyces_ambofaciens	1889	S	1064	628	1692	0.00040
Streptomyces_rectiverticillatus	173860	S	1061	354	1415	0.00034
Streptomyces_luteoverticillatus	66425	S	1056	364	1420	0.00034
Streptomyces_parvulus	146923	S	1049	472	1521	0.00036
Streptomyces_alboflavus	67267	S	1045	298	1343	0.00032
Streptomyces_galilaeus	33899	S	1026	352	1378	0.00033
Streptomyces_dangxiongensis	1442032	S	1026	363	1389	0.00033
Streptomyces_pluripotens	1355015	S	1022	240	1262	0.00030
Streptomyces_ficellus	1977088	S	1021	379	1400	0.00033
Streptomyces_exfoliatus	1905	S	1015	358	1373	0.00033
Streptomyces_harbinensis	1176198	S	1010	290	1300	0.00031
Streptomyces_tendae	1932	S	1010	426	1436	0.00034
Streptomyces_prasinus	67345	S	979	328	1307	0.00031
Streptomyces_atratus	1893	S	973	204	1177	0.00028
Streptomyces_lavendulae	1914	S	963	344	1307	0.00031
Streptomyces_cyanogenus	80860	S	942	421	1363	0.00032
Streptomyces_pactum	68249	S	942	386	1328	0.00032
Streptomyces_hundungensis	1077946	S	898	288	1186	0.00028
Streptomyces_fagopyri	2662397	S	897	309	1206	0.00029
Streptomyces_subrutilus	36818	S	890	340	1230	0.00029
Streptomyces_inhibens	2293571	S	874	270	1144	0.00027
Streptomyces_hawaiiensis	67305	S	870	382	1252	0.00030
Streptomyces_vinaceus	1960	S	858	315	1173	0.00028
Streptomyces_peucetius	1950	S	853	241	1094	0.00026
Streptomyces_pristinaespiralis	38300	S	851	318	1169	0.00028
Streptomyces_tirandamycinicus	2174846	S	849	290	1139	0.00027
Streptomyces_mobaraensis	35621	S	827	31758	32585	0.00776
Streptomyces_kanamyceticus	1967	S	813	277	1090	0.00026
Streptomyces_katrae	68223	S	811	314	1125	0.00027
Streptomyces_finlayi	67296	S	784	184	968	0.00023
Streptomyces_coeruleorubidus	116188	S	778	373	1151	0.00027
Streptomyces_nitrosporeus	28894	S	773	226	999	0.00024
Streptomyces_gilvosporeus	553510	S	767	250	1017	0.00024
Streptomyces_spongiicola	1690221	S	759	316	1075	0.00026
Streptomyces_qinzhouensis	2599401	S	748	183	931	0.00022
Streptomyces_tuirus	68278	S	743	378	1121	0.00027
Streptomyces_angustmyceticus	285578	S	737	306	1043	0.00025
Streptomyces_rutgersensis	53451	S	732	364	1096	0.00026
Streptomyces_huasconensis	1854574	S	711	281	992	0.00024
Streptomyces_pratensis	1169025	S	697	174	871	0.00021
Streptomyces_gardneri	66892	S	688	281	969	0.00023
Streptomyces_gobiensis	2875706	S	658	129	787	0.00019
Streptomyces_nojiriensis	66374	S	611	264	875	0.00021
Streptomyces_leeuwenhoekii	1437453	S	539	376	915	0.00022
Streptomyces_cyaneogriseus	68192	S	507	393	900	0.00021
Streptomyces_decoyicus	249567	S	391	217	608	0.00014
Streptomyces_antimycoticus	68175	S	390	395	785	0.00019
Streptomyces_lydicamycinicus	1546107	S	321	192	513	0.00012
Streptomyces_auratus	114687	S	319	211	530	0.00013
Streptomyces_xiamenensis	408015	S	306	261	567	0.00014
Streptomyces_platensis	58346	S	291	215	506	0.00012
Streptomyces_coelicolor	1902	S	101	970	1071	0.00026
Streptomyces_albidoflavus	1886	S	97	1449	1546	0.00037
Streptomyces_sampsonii	42239	S	84	673	757	0.00018
Streptomyces_fungicidicus	68203	S	268	776	1044	0.00025
Streptomyces_alfalfae	1642299	S	208	1166	1374	0.00033
Streptomyces_filamentosus	67294	S	203	255	458	0.00011
Streptomyces_olivaceus	47716	S	200	729	929	0.00022
Streptomyces_californicus	67351	S	188	610	798	0.00019
Streptomyces_cavourensis	67258	S	179	331	510	0.00012
Streptomyces_mirabilis	68239	S	178	1051	1229	0.00029
Streptomyces_fradiae	1906	S	142	2213	2355	0.00056
Streptomyces_griseofuscus	146922	S	127	565	692	0.00016
Streptomyces_autolyticus	75293	S	111	370	481	0.00011
Streptomyces_murinus	33900	S	108	305	413	0.00010
Streptomyces_lividans	1916	S	91	1216	1307	0.00031
Streptomyces_albireticuli	1940	S	90	378	468	0.00011
Streptomyces_scabiei	1930	S	86	749	835	0.00020
Streptomyces_noursei	1971	S	81	315	396	0.00009
Streptomyces_cinereoruber	67260	S	67	349	416	0.00010
Streptomyces_violaceoruber	1935	S	66	289	355	0.00008
Streptomyces_rochei	1928	S	48	357	405	0.00010
Streptomyces_rubrolavendulae	285473	S	35	253	288	0.00007
Kitasatospora_sp._MMS16-BH015	2018025	S	1426	512	1938	0.00046
Kitasatospora_sp._NA04385	2742135	S	1176	673	1849	0.00044
Kitasatospora_setae	2066	S	1268	694	1962	0.00047
Kitasatospora_aureofaciens	1894	S	1064	475	1539	0.00037
Kitasatospora_albolonga	68173	S	330	286	616	0.00015
Streptacidiphilus_sp._P02-A3a	2704468	S	1422	488	1910	0.00045
Streptacidiphilus_sp._PB12-B1b	2705012	S	1288	567	1855	0.00044
Streptacidiphilus_bronchialis	2126346	S	1186	426	1612	0.00038
Yinghuangia_sp._ASG_101	2896848	S	1552	285	1837	0.00044
Micromonospora_inositola	47865	S	15339	7409	22748	0.00541
Micromonospora_sp._WMMC415	2675222	S	5065	1868	6933	0.00165
Micromonospora_sp._WMMA2032	2039870	S	3590	2294	5884	0.00140
Micromonospora_sp._HM134	2583243	S	2637	1138	3775	0.00090
Micromonospora_sp._B006	2201999	S	2236	1670	3906	0.00093
Micromonospora_sp._L5	648999	S	259	2537	2796	0.00067
Micromonospora_terminaliae	1914461	S	12341	6109	18450	0.00439
Micromonospora_viridifaciens	1881	S	6682	2865	9547	0.00227
Micromonospora_purpureochromogenes	47872	S	6158	3194	9352	0.00223
Micromonospora_auratinigra	261654	S	6125	3139	9264	0.00220
Micromonospora_narathiwatensis	299146	S	5942	2706	8648	0.00206
Micromonospora_echinaurantiaca	47857	S	5772	2715	8487	0.00202
Micromonospora_siamensis	299152	S	4795	2244	7039	0.00168
Micromonospora_krabiensis	307121	S	4573	1557	6130	0.00146
Micromonospora_coxensis	356852	S	4265	2315	6580	0.00157
Micromonospora_coriariae	285665	S	4123	1447	5570	0.00133
Micromonospora_echinofusca	47858	S	3952	1781	5733	0.00136
Micromonospora_carbonacea	47853	S	3952	1748	5700	0.00136
Micromonospora_ferruginea	2749844	S	3348	1886	5234	0.00125
Micromonospora_echinospora	1877	S	2688	925	3613	0.00086
Micromonospora_sagamiensis	47875	S	2643	995	3638	0.00087
Micromonospora_zamorensis	709883	S	2504	795	3299	0.00079
Micromonospora_maris	1003110	S	2500	739	3239	0.00077
Micromonospora_endophytica_(Xie_et_al._2001)_Li_et_al._2019	515350	S	2355	682	3037	0.00072
Micromonospora_chokoriensis	356851	S	2330	744	3074	0.00073
Micromonospora_rifamycinica	291594	S	2245	983	3228	0.00077
Micromonospora_craniellae	2294034	S	1666	872	2538	0.00060
Micromonospora_tulbaghiae	479978	S	1542	1564	3106	0.00074
Micromonospora_aurantiaca	47850	S	1364	8079	9443	0.00225
Actinoplanes_sp._L3-i22	2836373	S	3847	2922	6769	0.00161
Actinoplanes_sp._N902-109	649831	S	3733	1188	4921	0.00117
Actinoplanes_sp._OR16	946334	S	2710	1385	4095	0.00097
Actinoplanes_friuliensis	196914	S	3540	617	4157	0.00099
Actinoplanes_ianthinogenes	122358	S	3355	1487	4842	0.00115
Actinoplanes_teichomyceticus	1867	S	2772	1277	4049	0.00096
Actinoplanes_missouriensis	1866	S	2537	914	3451	0.00082
Actinoplanes_derwentensis	113562	S	2284	385	2669	0.00064
Phytohabitans_suffuscus	624315	S	5462	1451	6913	0.00165
Phytohabitans_flavus	1076124	S	4588	935	5523	0.00131
Plantactinospora_sp._KBS50	2024580	S	3173	801	3974	0.00095
Plantactinospora_sp._BC1	2108470	S	680	1984	2664	0.00063
Plantactinospora_sp._BB1	2071627	S	649	1874	2523	0.00060
Dactylosporangium_vinaceum	53362	S	6264	790	7054	0.00168
Actinocatenispora_sera	390989	S	2275	806	3081	0.00073
Actinocatenispora_thailandica	227318	S	2174	730	2904	0.00069
Catellatospora_sp._IY07-71	2728827	S	4774	1173	5947	0.00142
Couchioplanes_caeruleus	56438	S	4600	1190	5790	0.00138
Polymorphospora_rubra	338584	S	3415	775	4190	0.00100
Natronosporangium_hydrolyticum	2811111	S	1846	144	1990	0.00047
Verrucosispora_sp._NA02020	2742132	S	1334	846	2180	0.00052
Salinispora_tropica	168695	S	1239	202	1441	0.00034
Microbacterium_sp._No._7	1714373	S	877	422	1299	0.00031
Microbacterium_sp._10M-3C3	2483401	S	670	261	931	0.00022
Microbacterium_sp._4R-513	2567934	S	662	132	794	0.00019
Microbacterium_sp._SSW1-51	2851650	S	597	181	778	0.00019
Microbacterium_sp._JZ31	1906274	S	587	177	764	0.00018
Microbacterium_sp._YJN-G	2763257	S	501	185	686	0.00016
Microbacterium_sp._XT11	367477	S	488	116	604	0.00014
Microbacterium_sp._ABRD_28	2268461	S	464	69	533	0.00013
Microbacterium_sp._BH-3-3-3	1906742	S	456	118	574	0.00014
Microbacterium_sp._H1-D42	2925844	S	408	75	483	0.00012
Microbacterium_sp._NIBRBAC000506063	2734618	S	406	181	587	0.00014
Microbacterium_sp._cx-55	2875948	S	392	62	454	0.00011
Microbacterium_sp._PM5	2014534	S	377	76	453	0.00011
Microbacterium_sp._A18JL241	2782166	S	376	100	476	0.00011
Microbacterium_sp._Y-01	2048898	S	374	181	555	0.00013
Microbacterium_sp._SSW1-36	2851648	S	367	94	461	0.00011
Microbacterium_sp._LKL04	912630	S	344	89	433	0.00010
Microbacterium_sp._1S1	2606451	S	320	184	504	0.00012
Microbacterium_sp._CBA3102	2603598	S	310	95	405	0.00010
Microbacterium_sp._TPU_3598	1938334	S	295	99	394	0.00009
Microbacterium_sp._Nx66	2766784	S	249	217	466	0.00011
Microbacterium_sp._RG1	2489212	S	163	136	299	0.00007
Microbacterium_sp._CGR1	1696072	S	66	491	557	0.00013
Microbacterium_sp._1.5R	1916917	S	64	462	526	0.00013
Microbacterium_sp._PAMC22086	2861281	S	61	147	208	0.00005
Microbacterium_sp._SGAir0570	2070348	S	51	197	248	0.00006
Microbacterium_sp._str._'China'	2103230	S	42	259	301	0.00007
Microbacterium_sp._PAMC_28756	1795053	S	14	247	261	0.00006
Microbacterium_cremeum	2782169	S	992	222	1214	0.00029
Microbacterium_foliorum	104336	S	967	215	1182	0.00028
Microbacterium_hominis	162426	S	871	2637	3508	0.00083
Microbacterium_oleivorans	273677	S	788	163	951	0.00023
Microbacterium_atlanticum	2782168	S	756	176	932	0.00022
Microbacterium_resistens	156977	S	586	114	700	0.00017
Microbacterium_sediminis	904291	S	580	279	859	0.00020
Microbacterium_lemovicicum	1072463	S	567	136	703	0.00017
Microbacterium_oryzae	743009	S	491	154	645	0.00015
Microbacterium_protaetiae	2509458	S	489	117	606	0.00014
Microbacterium_testaceum	2033	S	486	93	579	0.00014
Microbacterium_lushaniae	2614639	S	471	116	587	0.00014
Microbacterium_wangchenii	2541726	S	455	110	565	0.00013
Microbacterium_pygmaeum	370764	S	454	60	514	0.00012
Microbacterium_esteraromaticum	57043	S	432	102	534	0.00013
Microbacterium_aurum	36805	S	418	140	558	0.00013
Microbacterium_caowuchunii	2614638	S	418	84	502	0.00012
Microbacterium_chocolatum	84292	S	405	97	502	0.00012
Microbacterium_luteum	2782167	S	387	173	560	0.00013
Microbacterium_oxydans	82380	S	381	317	698	0.00017
Microbacterium_hydrocarbonoxydans	273678	S	357	68	425	0.00010
Microbacterium_schleiferi	69362	S	265	98	363	0.00009
Microbacterium_fandaimingii	2708079	S	189	17	206	0.00005
Microbacterium_chengjingii	2769067	S	182	10	192	0.00005
Microbacterium_binotii	462710	S	160	130	290	0.00007
Microbacterium_amylolyticum	936337	S	137	31	168	0.00004
Microbacterium_endophyticum	1526412	S	110	8	118	0.00003
Microbacterium_paraoxydans	199592	S	50	368	418	0.00010
Microbacterium_paludicola	300019	S	49	197	246	0.00006
Agromyces_sp._H17E-10	2932244	S	801	286	1087	0.00026
Agromyces_sp._LHK192	2498704	S	799	253	1052	0.00025
Agromyces_sp._CFWR-12	2929802	S	611	372	983	0.00023
Agromyces_flavus	589382	S	813	281	1094	0.00026
Agromyces_soli	659012	S	806	320	1126	0.00027
Agromyces_aureus	453304	S	710	219	929	0.00022
Agromyces_marinus	1389020	S	639	256	895	0.00021
Agromyces_protaetiae	2509455	S	609	189	798	0.00019
Agromyces_archimandritae	2781962	S	599	189	788	0.00019
Agromyces_badenianii	2080742	S	534	190	724	0.00017
Agromyces_intestinalis	2592652	S	534	307	841	0.00020
Agromyces_laixinhei	2585717	S	447	112	559	0.00013
Leifsonia_sp._21MFCrub1.1	1798223	S	1088	1310	2398	0.00057
Leifsonia_sp._ZF2019	2781978	S	888	268	1156	0.00028
Leifsonia_sp._PS1209	2724914	S	823	246	1069	0.00025
Leifsonia_shinshuensis	150026	S	1255	400	1655	0.00039
Leifsonia_xyli	1575	S	609	93	702	0.00017
Curtobacterium_sp._L6-1	2841594	S	453	157	610	0.00015
Curtobacterium_sp._BH-2-1-1	1905847	S	433	150	583	0.00014
Curtobacterium_sp._TC1	2862880	S	360	180	540	0.00013
Curtobacterium_sp._YC1	2795488	S	348	167	515	0.00012
Curtobacterium_sp._MR_MD2014	1561023	S	321	149	470	0.00011
Curtobacterium_sp._TXMA1	2876939	S	265	201	466	0.00011
Curtobacterium_sp._SGAir0471	2070337	S	242	177	419	0.00010
Curtobacterium_sp._24E2	2804758	S	229	122	351	0.00008
Curtobacterium_sp._C1	2898151	S	91	230	321	0.00008
Curtobacterium_sp._Csp2	2495430	S	68	192	260	0.00006
Curtobacterium_sp._Csp1	2495429	S	37	663	700	0.00017
Curtobacterium_flaccumfaciens	2035	S	705	352	1057	0.00025
Curtobacterium_luteum	33881	S	492	192	684	0.00016
Rathayibacter_sp._VKM_Ac-2759	2609252	S	608	235	843	0.00020
Rathayibacter_sp._VKM_Ac-2760	2609253	S	583	323	906	0.00022
Rathayibacter_sp._VKM_Ac-2804	2609257	S	408	319	727	0.00017
Rathayibacter_sp._VKM_Ac-2801	2609255	S	272	262	534	0.00013
Rathayibacter_sp._VKM_Ac-2762	2609254	S	78	212	290	0.00007
Rathayibacter_sp._VKM_Ac-2805	2609258	S	76	212	288	0.00007
Rathayibacter_festucae	110937	S	624	751	1375	0.00033
Rathayibacter_tanaceti	1671680	S	396	111	507	0.00012
Rathayibacter_rathayi	33887	S	210	61	271	0.00006
Rathayibacter_tritici	33888	S	202	67	269	0.00006
Rathayibacter_iranicus	59737	S	201	29	230	0.00005
Rathayibacter_toxicus	145458	S	96	9	105	0.00002
Leucobacter_sp._NB_10	2873270	S	461	140	601	0.00014
Leucobacter_sp._H25R-14	2932245	S	460	84	544	0.00013
Leucobacter_sp._Psy1	2875729	S	382	52	434	0.00010
Leucobacter_sp._CX169	2813744	S	311	90	401	0.00010
Leucobacter_sp._H21R-36	2932246	S	122	384	506	0.00012
Leucobacter_sp._H21R-40	2932247	S	115	363	478	0.00011
Leucobacter_muris	1935379	S	517	201	718	0.00017
Leucobacter_triazinivorans	1784719	S	502	312	814	0.00019
Leucobacter_luti	340320	S	169	17	186	0.00004
Leucobacter_insecticola	2714934	S	148	13	161	0.00004
Leucobacter_viscericola	2714935	S	129	13	142	0.00003
Leucobacter_denitrificans	683042	S	97	16	113	0.00003
Leucobacter_coleopterorum	2714933	S	73	7	80	0.00002
Agrococcus_sp._SGAir0287	2070347	S	731	267	998	0.00024
Agrococcus_sp._SCSIO52902	2933290	S	707	406	1113	0.00026
Agrococcus_sp._Marseille-Q4369	2810513	S	705	292	997	0.00024
Agrococcus_jejuensis	399736	S	703	268	971	0.00023
Agrococcus_carbonis	684552	S	671	371	1042	0.00025
Clavibacter_michiganensis	28447	S	2664	4363	7027	0.00167
Clavibacter_zhangzhiyongii	2768071	S	369	193	562	0.00013
Clavibacter_sp._A6099	2860285	S	211	142	353	0.00008
Protaetiibacter_sp._SSC-01	2759943	S	701	304	1005	0.00024
Protaetiibacter_intestinalis	2419774	S	639	271	910	0.00022
Protaetiibacter_larvae	2592654	S	520	196	716	0.00017
Salinibacterium_sp._ZJ450	2708338	S	458	80	538	0.00013
Salinibacterium_sp._ZJ70	2708084	S	391	113	504	0.00012
Salinibacterium_sp._dk2585	2603292	S	282	56	338	0.00008
Salinibacterium_sp._UTAS2018	2508880	S	99	9	108	0.00003
Salinibacterium_sp._M195	2583374	S	76	9	85	0.00002
Salinibacterium_hongtaonis	2079791	S	167	21	188	0.00004
Cryobacterium_sp._LW097	1978566	S	375	91	466	0.00011
Cryobacterium_sp._PAMC25264	2861288	S	207	130	337	0.00008
Cryobacterium_soli	2220095	S	282	149	431	0.00010
Cryobacterium_arcticum	670052	S	221	169	390	0.00009
Frondihabitans_sp._PAMC_28766	1795630	S	604	90	694	0.00017
Frondihabitans_sp._762G35	1446794	S	592	142	734	0.00017
Microterricola_viridarii	412690	S	1047	296	1343	0.00032
Microcella_flavibacter	1804990	S	598	330	928	0.00022
Microcella_alkaliphila	279828	S	372	74	446	0.00011
Plantibacter_sp._PA-3-X8	2480625	S	200	193	393	0.00009
Plantibacter_sp._M259	2583822	S	173	162	335	0.00008
Plantibacter_flavus	150123	S	188	163	351	0.00008
Gryllotalpicola_protaetiae	2419771	S	743	165	908	0.00022
Herbiconiux_sp._SALV-R1	2735133	S	719	166	885	0.00021
Cnuibacter_physcomitrellae	1619308	S	701	175	876	0.00021
Mycetocola_zhujimingii	2079792	S	272	36	308	0.00007
Mycetocola_spongiae	2859226	S	200	29	229	0.00005
Mycetocola_sp._JXN-3	2116510	S	198	33	231	0.00006
Humibacter_sp._WJ7-1	2599293	S	648	166	814	0.00019
Subtercola_sp._AK-R2A1-2	2895559	S	381	36	417	0.00010
Subtercola_sp._PAMC28395	2846775	S	221	22	243	0.00006
Frigoribacterium_sp._NBH87	2596916	S	587	199	786	0.00019
Chryseoglobus_indicus	2750620	S	109	269	378	0.00009
Chryseoglobus_sp._28M-23	2772253	S	85	199	284	0.00007
Amnibacterium_sp._L3-i23	2905871	S	532	147	679	0.00016
Diaminobutyricimonas_sp._LJ205	2683590	S	446	96	542	0.00013
Marisediminicola_antarctica	674079	S	444	63	507	0.00012
Gulosibacter_sediminis	1729695	S	413	138	551	0.00013
Agreia_sp._COWG	2773266	S	335	46	381	0.00009
Glaciihabitans_sp._INWT7	2596912	S	330	30	360	0.00009
Aquiluna_borgnonia	2499157	S	37	5	42	0.00001
Candidatus_Aquiluna_sp._UB-MaderosW2red	1855377	S	13	1	14	0.00000
Rhodoluna_limnophila	232537	S	22	3	25	0.00001
Candidatus_Rhodoluna_planktonica	535712	S	16	1	17	0.00000
Pseudoclavibacter_sp._Marseille-Q3772	2866588	S	78	17	95	0.00002
Aurantimicrobium_photophilum	1987356	S	32	12	44	0.00001
Pontimonas_salivibrio	1159327	S	15	0	15	0.00000
Arthrobacter_sp._QXT-31	1357915	S	483	158	641	0.00015
Arthrobacter_sp._QL17	2895818	S	449	122	571	0.00014
Arthrobacter_sp._FW305-BF8	2879617	S	438	142	580	0.00014
Arthrobacter_sp._NicSoilC5	2831000	S	386	245	631	0.00015
Arthrobacter_sp._KBS0702	2578107	S	372	175	547	0.00013
Arthrobacter_sp._PM3	2017685	S	371	72	443	0.00011
Arthrobacter_sp._NicSoilB8	2830998	S	358	111	469	0.00011
Arthrobacter_sp._UKPF54-2	2600159	S	318	159	477	0.00011
Arthrobacter_sp._U41	1849032	S	315	107	422	0.00010
Arthrobacter_sp._ERGS1:01	1704044	S	314	70	384	0.00009
Arthrobacter_sp._NicSoilB4	2830997	S	291	109	400	0.00010
Arthrobacter_sp._24S4-2	2575374	S	290	78	368	0.00009
Arthrobacter_sp._PAMC25564	2565366	S	283	91	374	0.00009
Arthrobacter_sp._Helios	2828862	S	234	44	278	0.00007
Arthrobacter_sp._FB24	290399	S	216	86	302	0.00007
Arthrobacter_sp._FW306-2-2C-D06B	2879618	S	208	47	255	0.00006
Arthrobacter_sp._PGP41	2079227	S	206	90	296	0.00007
Arthrobacter_sp._zg-Y462	2886936	S	199	47	246	0.00006
Arthrobacter_sp._PAMC25284	2861279	S	193	59	252	0.00006
Arthrobacter_sp._PAMC_25486	1494608	S	192	36	228	0.00005
Arthrobacter_sp._zg-Y809	2886940	S	169	73	242	0.00006
Arthrobacter_sp._NtRootA1	2830983	S	147	54	201	0.00005
Arthrobacter_sp._StoSoilB20	2830995	S	131	45	176	0.00004
Arthrobacter_sp._StoSoilB5	2830992	S	129	44	173	0.00004
Arthrobacter_sp._FW306-06-A	2879621	S	80	330	410	0.00010
Arthrobacter_sp._YN	2020486	S	74	37	111	0.00003
Arthrobacter_sp._NicSoilB11	2830999	S	69	324	393	0.00009
Arthrobacter_sp._D5-1	1477518	S	65	52	117	0.00003
Arthrobacter_sp._C1-1	2813727	S	55	8	63	0.00002
Arthrobacter_sp._FW306-05-C	2879620	S	52	320	372	0.00009
Arthrobacter_sp._FW306-07-I	2879622	S	43	283	326	0.00008
Arthrobacter_sp._StoSoilB19	2830994	S	41	221	262	0.00006
Arthrobacter_sp._StoSoilB13	2830993	S	40	86	126	0.00003
Arthrobacter_sp._StoSoilA2	2830990	S	22	46	68	0.00002
Arthrobacter_agilis	37921	S	814	141	955	0.00023
Arthrobacter_crystallopoietes	37928	S	619	129	748	0.00018
Arthrobacter_dokdonellae	2211210	S	337	66	403	0.00010
Arthrobacter_sulfonylureivorans	2486855	S	334	61	395	0.00009
Arthrobacter_woluwensis	156980	S	322	84	406	0.00010
Arthrobacter_jiangjiafuii	2817475	S	246	78	324	0.00008
Arthrobacter_alpinus	656366	S	199	392	591	0.00014
Arthrobacter_sunyaminii	2816859	S	134	53	187	0.00004
Kocuria_rosea	1275	S	831	290	1121	0.00027
Kocuria_turfanensis	388357	S	700	264	964	0.00023
Kocuria_flava	446860	S	671	374	1045	0.00025
Kocuria_palustris	71999	S	433	192	625	0.00015
Kocuria_rhizophila	72000	S	294	451	745	0.00018
Kocuria_varians	1272	S	227	175	402	0.00010
Kocuria_sp._TGY1127_2	2711328	S	89	16	105	0.00003
Kocuria_sp._KD4	2719588	S	44	72	116	0.00003
Kocuria_sp._BT304	1702043	S	30	150	180	0.00004
Kocuria_indica	1049583	S	49	96	145	0.00003
Pseudarthrobacter_sp._BIM_B-2242	2772401	S	262	76	338	0.00008
Pseudarthrobacter_sp._L1SW	2851598	S	226	109	335	0.00008
Pseudarthrobacter_sp._SSS035	2931399	S	157	140	297	0.00007
Pseudarthrobacter_sp._NIBRBAC000502772	2590775	S	138	105	243	0.00006
Pseudarthrobacter_sp._NBSH8	2596911	S	118	49	167	0.00004
Pseudarthrobacter_sp._NIBRBAC000502770	2590785	S	83	248	331	0.00008
Pseudarthrobacter_sp._NIBRBAC000502771	2590774	S	65	220	285	0.00007
Pseudarthrobacter_equi	728066	S	191	83	274	0.00007
Pseudarthrobacter_psychrotolerans	2697569	S	180	80	260	0.00006
Pseudarthrobacter_chlorophenolicus	85085	S	177	74	251	0.00006
Pseudarthrobacter_phenanthrenivorans	361575	S	171	98	269	0.00006
Pseudarthrobacter_sulfonivorans	121292	S	102	110	212	0.00005
Micrococcus_luteus	1270	S	870	1828	2698	0.00064
Micrococcus_sp._KD337-16	2856555	S	395	271	666	0.00016
Micrococcus_sp._KBS0714	1179670	S	11	94	105	0.00003
Micrococcus_yunnanensis	566027	S	11	88	99	0.00002
Sinomonas_atrocyanea	37927	S	855	320	1175	0.00028
Sinomonas_sp._R1AF57	2020377	S	666	179	845	0.00020
Glutamicibacter_creatinolyticus	162496	S	266	70	336	0.00008
Glutamicibacter_protophormiae	37930	S	244	163	407	0.00010
Glutamicibacter_halophytocola	1933880	S	93	18	111	0.00003
Glutamicibacter_nicotianae	37929	S	83	225	308	0.00007
Glutamicibacter_mishrai	1775880	S	75	17	92	0.00002
Glutamicibacter_arilaitensis	256701	S	66	26	92	0.00002
Glutamicibacter_sp._ZJUTW	1155384	S	22	82	104	0.00002
Rothia_kristinae	37923	S	459	305	764	0.00018
Rothia_mucilaginosa	43675	S	123	24	147	0.00004
Rothia_nasimurium	85336	S	86	45	131	0.00003
Rothia_aeria	172042	S	44	19	63	0.00002
Rothia_dentocariosa	2047	S	34	15	49	0.00001
Rothia_terrae	396015	S	27	12	39	0.00001
Rothia_amarae	169480	S	22	11	33	0.00001
Rothia_sp._ZJ932	2810516	S	21	3	24	0.00001
Citricoccus_sp._SGAir0253	2567881	S	694	221	915	0.00022
Paenarthrobacter_ureafaciens	37931	S	188	325	513	0.00012
Paenarthrobacter_aurescens	43663	S	113	82	195	0.00005
Paenarthrobacter_sp._YJN-5	2735316	S	57	130	187	0.00004
Paenarthrobacter_sp._YJN-D	2735317	S	24	51	75	0.00002
Paenarthrobacter_nicotinovorans	29320	S	24	44	68	0.00002
Nesterenkonia_sp._NBAIMH1	2600320	S	230	17	247	0.00006
Paeniglutamicibacter_sp._Y32M11	2853258	S	118	21	139	0.00003
Psychromicrobium_lacuslunae	1618207	S	91	14	105	0.00002
Neomicrococcus_aestuarii	556325	S	72	34	106	0.00003
Auritidibacter_sp._NML130574	2170745	S	50	6	56	0.00001
Renibacterium_salmoninarum	1646	S	44	2	46	0.00001
Cellulomonas_sp._Y8	2591145	S	1332	712	2044	0.00049
Cellulomonas_sp._H30R-01	2704467	S	1051	507	1558	0.00037
Cellulomonas_sp._JZ18	2654191	S	963	510	1473	0.00035
Cellulomonas_sp._C5510	2871170	S	924	462	1386	0.00033
Cellulomonas_sp._zg-ZUI188	2819978	S	887	311	1198	0.00029
Cellulomonas_sp._zg-ZUI222	2816956	S	787	365	1152	0.00027
Cellulomonas_sp._zg-ZUI157	2819979	S	750	321	1071	0.00026
Cellulomonas_sp._EW123	2608402	S	711	502	1213	0.00029
Cellulomonas_sp._PSBB021	2003551	S	682	658	1340	0.00032
Cellulomonas_fimi	1708	S	1065	1191	2256	0.00054
Cellulomonas_iranensis	76862	S	905	520	1425	0.00034
Cellulomonas_shaoxiangyii	2566013	S	835	426	1261	0.00030
Cellulomonas_flavigena	1711	S	832	387	1219	0.00029
Cellulomonas_gilvus	11	S	740	402	1142	0.00027
Cellulomonas_taurus	2729175	S	697	277	974	0.00023
Actinotalea_sp._JY-7876	2758442	S	997	463	1460	0.00035
Oerskovia_sp._KBS0722	1179673	S	692	281	973	0.00023
Pseudactinotalea_sp._HY158	2654547	S	652	117	769	0.00018
Paraoerskovia_marina	545619	S	515	168	683	0.00016
Janibacter_melonis	262209	S	986	406	1392	0.00033
Janibacter_limosus	53458	S	623	200	823	0.00020
Janibacter_indicus	857417	S	359	561	920	0.00022
Janibacter_sp._YB324	2761047	S	204	422	626	0.00015
Phycicoccus_sp._HDW14	2714941	S	1226	479	1705	0.00041
Phycicoccus_endophyticus	1690220	S	1069	367	1436	0.00034
Pedococcus_dokdonensis	443156	S	1297	460	1757	0.00042
Intrasporangium_calvum	53358	S	1168	361	1529	0.00036
Tetrasphaera_sp._HKS02	1813880	S	1123	351	1474	0.00035
Arsenicicoccus_sp._oral_taxon_190	1658671	S	933	437	1370	0.00033
Cellulosimicrobium_cellulans	1710	S	1599	2051	3650	0.00087
Cellulosimicrobium_sp._BI34T	2587808	S	699	396	1095	0.00026
Cellulosimicrobium_sp._JZ28	1906273	S	152	426	578	0.00014
Cellulosimicrobium_sp._TH-20	1980001	S	56	307	363	0.00009
Cellulosimicrobium_sp._72-3	2731680	S	55	292	347	0.00008
Xylanimonas_protaetiae	2509457	S	803	427	1230	0.00029
Xylanimonas_allomyrinae	2509459	S	704	271	975	0.00023
Xylanimonas_cellulosilytica	186189	S	696	303	999	0.00024
Isoptericola_variabilis	139208	S	915	596	1511	0.00036
Isoptericola_dokdonensis	372663	S	783	375	1158	0.00028
Ornithinimicrobium_avium	2283195	S	1023	325	1348	0.00032
Ornithinimicrobium_flavum	1288636	S	834	315	1149	0.00027
Ornithinimicrobium_sp._HY006	2508882	S	680	278	958	0.00023
Ornithinimicrobium_sp._INDO-MA30-4	2908651	S	126	26	152	0.00004
Ornithinimicrobium_ciconiae	2594265	S	569	106	675	0.00016
Ornithinimicrobium_pratense	2593973	S	542	189	731	0.00017
Serinicoccus_hydrothermalis	1758689	S	739	386	1125	0.00027
Serinicoccus_chungangensis	767452	S	695	276	971	0.00023
Serinicoccus_marinus	247333	S	606	335	941	0.00022
Serinicoccus_profundi	1078471	S	526	221	747	0.00018
Brachybacterium_sp._SGAir0954	2571029	S	686	232	918	0.00022
Brachybacterium_sp._CBA3105	2887346	S	664	186	850	0.00020
Brachybacterium_sp._P6-10-X1	1903186	S	573	122	695	0.00017
Brachybacterium_saurashtrense	556288	S	550	191	741	0.00018
Brachybacterium_faecium	43669	S	533	199	732	0.00017
Brachybacterium_ginsengisoli	1331682	S	513	182	695	0.00017
Brachybacterium_vulturis	2017484	S	399	180	579	0.00014
Brachybacterium_avium	2017485	S	310	139	449	0.00011
Dermabacter_vaginalis	1630135	S	160	131	291	0.00007
Dermabacter_jinjuensis	1667168	S	155	158	313	0.00007
Devriesea_agamarum	472569	S	102	7	109	0.00003
Brevibacterium_sp._CS2	2575923	S	639	313	952	0.00023
Brevibacterium_sp._SMBL_HHYL_HB1	2777556	S	247	67	314	0.00007
Brevibacterium_sp._HY170	2898795	S	121	45	166	0.00004
Brevibacterium_sp._'Marine'	2725563	S	119	100	219	0.00005
Brevibacterium_sp._W7.2	2823518	S	69	424	493	0.00012
Brevibacterium_casei	33889	S	597	515	1112	0.00026
Brevibacterium_luteolum	199591	S	335	163	498	0.00012
Brevibacterium_linens	1703	S	275	209	484	0.00012
Brevibacterium_sandarakinum	629680	S	200	45	245	0.00006
Brevibacterium_oceani	358099	S	180	50	230	0.00005
Brevibacterium_aurantiacum	273384	S	179	146	325	0.00008
Brevibacterium_atlanticum	2697563	S	177	46	223	0.00005
Brevibacterium_siliguriense	1136497	S	141	52	193	0.00005
Brevibacterium_limosum	2697565	S	127	58	185	0.00004
Brevibacterium_pigmentatum	1496080	S	75	70	145	0.00003
Georgenia_yuyongxinii	2589797	S	1004	299	1303	0.00031
Georgenia_sp._TF02-10	2917725	S	949	428	1377	0.00033
Georgenia_wutianyii	2585135	S	895	377	1272	0.00030
Georgenia_faecalis	2483799	S	845	286	1131	0.00027
Haloactinobacterium_kanbiaonis	2675754	S	998	177	1175	0.00028
Ruania_sp._LR1S40	2897774	S	532	136	668	0.00016
Ruania_sp._M4N3S171	2897773	S	314	52	366	0.00009
Ruania_zhangjianzhongii	2603206	S	644	78	722	0.00017
Ruania_alkalisoli	2779775	S	381	77	458	0.00011
Dermacoccus_nishinomiyaensis	1274	S	606	313	919	0.00022
Dermacoccus_sp._PAMC28757	2762331	S	404	175	579	0.00014
Luteipulveratus_mongoliensis	571913	S	766	127	893	0.00021
Allobranchiibius_sp._GilTou73	2904523	S	689	181	870	0.00021
Yimella_sp._cx-51	2770551	S	396	94	490	0.00012
Pengzhenrongella_sicca	2819238	S	1174	400	1574	0.00037
Luteimicrobium_xylanilyticum	1133546	S	956	363	1319	0.00031
Beutenbergia_cavernae	84757	S	1141	236	1377	0.00033
Miniimonas_sp._S16	2171623	S	973	635	1608	0.00038
Sanguibacter_keddieii	60920	S	699	258	957	0.00023
Sanguibacter_sp._HDW7	2714931	S	686	266	952	0.00023
Kytococcus_sedentarius	1276	S	674	299	973	0.00023
Gephyromycinifex_aptenodytis	2716227	S	286	42	328	0.00008
Austwickia_chelonae	100225	S	271	26	297	0.00007
Dermatophilus_congolensis	1863	S	72	8	80	0.00002
Demequina_sp._TMPB413	2881056	S	223	21	244	0.00006
Jonesia_denitrificans	43674	S	40	8	48	0.00001
Tropheryma_whipplei	2039	S	11	0	11	0.00000
Mycolicibacterium_litorale	758802	S	1182	327	1509	0.00036
Mycolicibacterium_phocaicum	319706	S	1019	526	1545	0.00037
Mycolicibacterium_sp._YH-1	2908837	S	556	507	1063	0.00025
Mycolicibacterium_smegmatis	1772	S	943	366	1309	0.00031
Mycolicibacterium_hassiacum	46351	S	843	232	1075	0.00026
Mycolicibacterium_fortuitum	1766	S	841	317	1158	0.00028
Mycolicibacterium_madagascariense	212765	S	773	120	893	0.00021
Mycolicibacterium_chubuense	1800	S	763	172	935	0.00022
Mycolicibacterium_phlei	1771	S	755	260	1015	0.00024
Mycolicibacterium_rutilum	370526	S	742	220	962	0.00023
Mycolicibacterium_sediminis	1286180	S	726	134	860	0.00020
Mycolicibacterium_arabiense	1286181	S	715	112	827	0.00020
Mycolicibacterium_pulveris	36813	S	703	119	822	0.00020
Mycolicibacterium_vaccae	1810	S	676	136	812	0.00019
Mycolicibacterium_thermoresistibile	1797	S	672	152	824	0.00020
Mycolicibacterium_chitae	1792	S	672	163	835	0.00020
Mycolicibacterium_psychrotolerans	216929	S	664	151	815	0.00019
Mycolicibacterium_neoaurum	1795	S	662	234	896	0.00021
Mycolicibacterium_mageritense	53462	S	659	112	771	0.00018
Mycolicibacterium_parafortuitum	39692	S	640	130	770	0.00018
Mycolicibacterium_moriokaense	39691	S	638	79	717	0.00017
Mycolicibacterium_duvalii	39688	S	634	126	760	0.00018
Mycolicibacterium_tokaiense	39695	S	633	101	734	0.00017
Mycolicibacterium_monacense	85693	S	577	185	762	0.00018
Mycolicibacterium_poriferae	39694	S	560	118	678	0.00016
Mycolicibacterium_confluentis	28047	S	559	87	646	0.00015
Mycolicibacterium_fallax	1793	S	555	223	778	0.00019
Mycolicibacterium_fluoranthenivorans	258505	S	551	73	624	0.00015
Mycolicibacterium_aurum	1791	S	549	73	622	0.00015
Mycolicibacterium_celeriflavum	1249101	S	538	104	642	0.00015
Mycolicibacterium_baixiangningiae	2761578	S	537	88	625	0.00015
Mycolicibacterium_mucogenicum	56689	S	529	214	743	0.00018
Mycolicibacterium_anyangense	1431246	S	526	87	613	0.00015
Mycolicibacterium_rhodesiae	36814	S	509	83	592	0.00014
Mycolicibacterium_insubricum	444597	S	509	144	653	0.00016
Mycolicibacterium_gilvum	1804	S	505	183	688	0.00016
Mycolicibacterium_gadium	1794	S	505	68	573	0.00014
Mycolicibacterium_aichiense	1799	S	454	78	532	0.00013
Mycolicibacterium_mengxianglii	2736649	S	454	49	503	0.00012
Mycolicibacterium_boenickei	146017	S	434	561	995	0.00024
Mycolicibacterium_austroafricanum	39687	S	424	1595	2019	0.00048
Mycolicibacterium_helvum	1534349	S	368	44	412	0.00010
Mycobacterium_doricum	126673	S	348	80	428	0.00010
Mycolicibacterium_sarraceniae	1534348	S	292	38	330	0.00008
Mycolicibacterium_alvei	67081	S	276	74	350	0.00008
Mycolicibacterium_septicum	98668	S	229	151	380	0.00009
Mycolicibacterium_farcinogenes	1802	S	168	541	709	0.00017
Mycolicibacterium_vanbaalenii	110539	S	82	1283	1365	0.00033
Mycolicibacterium_nivoides	2487344	S	53	240	293	0.00007
Mycobacterium_sp._JS623	212767	S	1398	118	1516	0.00036
Mycobacterium_sp._IDR2000157661	2867005	S	527	96	623	0.00015
Mycobacterium_sp._EPa45	1545728	S	479	80	559	0.00013
Mycobacterium_sp._DL592	2675524	S	441	73	514	0.00012
Mycobacterium_sp._MS1601	1936029	S	431	61	492	0.00012
Mycobacterium_sp._YC-RL4	1682113	S	382	136	518	0.00012
Mycobacterium_sp._WY10	1920667	S	366	1013	1379	0.00033
Mycobacterium_sp._DL440	2675523	S	348	76	424	0.00010
Mycobacterium_sp._TY59	2775496	S	322	54	376	0.00009
Mycobacterium_sp._PYR15	2051552	S	99	795	894	0.00021
Mycobacterium_sp._20KCMC460	2903536	S	26	442	468	0.00011
Mycobacterium_parmense	185642	S	567	105	672	0.00016
Mycobacterium_saskatchewanense	220927	S	546	104	650	0.00015
Mycobacterium_kubicae	120959	S	495	79	574	0.00014
Mycobacterium_simiae	1784	S	442	38	480	0.00011
Mycobacterium_shigaense	722731	S	407	57	464	0.00011
Mycobacterium_heidelbergense	53376	S	386	90	476	0.00011
Mycobacterium_stomatepiae	470076	S	358	68	426	0.00010
Mycobacterium_florentinum	292462	S	350	74	424	0.00010
Mycobacterium_lentiflavum	141349	S	344	77	421	0.00010
Mycobacterium_avium	1764	S	877	937	1814	0.00043
Mycobacterium_intracellulare	1767	S	416	1938	2354	0.00056
Mycobacterium_marseillense	701042	S	398	95	493	0.00012
Mycobacterium_colombiense	339268	S	388	68	456	0.00011
Mycobacterium_mantenii	560555	S	388	48	436	0.00010
Mycobacterium_paraintracellulare	1138383	S	80	547	627	0.00015
Mycobacterium_crocinum	388459	S	1048	563	1611	0.00038
Mycobacterium_rufum	318424	S	900	264	1164	0.00028
Mycobacterium_grossiae	1552759	S	831	249	1080	0.00026
Mycobacterium_dioxanotrophicus	482462	S	626	150	776	0.00018
Mycobacterium_holsaticum	152142	S	578	91	669	0.00016
Mycobacterium_goodii	134601	S	567	199	766	0.00018
Mycobacterium_canettii	78331	S	203	127	330	0.00008
Mycobacterium_tuberculosis	1773	S	110	8029	8139	0.00194
Mycobacterium_paragordonae	1389713	S	538	64	602	0.00014
Mycobacterium_diernhoferi	1801	S	525	105	630	0.00015
Mycobacterium_branderi	43348	S	517	62	579	0.00014
Mycobacterium_conspicuum	44010	S	488	59	547	0.00013
Mycobacterium_frederiksbergense	117567	S	474	143	617	0.00015
Mycobacterium_koreense	1069220	S	456	133	589	0.00014
Mycobacterium_gordonae	1778	S	428	35	463	0.00011
Mycobacterium_cookii	1775	S	399	40	439	0.00010
Mycobacterium_kansasii	1768	S	391	37	428	0.00010
Mycobacterium_paraterrae	577492	S	390	43	433	0.00010
Mycobacterium_shinjukuense	398694	S	368	35	403	0.00010
Mycobacterium_malmoense	1780	S	365	57	422	0.00010
Mycobacterium_paraseoulense	590652	S	364	72	436	0.00010
Mycobacterium_heckeshornense	110505	S	361	28	389	0.00009
Mycobacterium_vicinigordonae	1719132	S	350	19	369	0.00009
Mycobacterium_ostraviense	2738409	S	348	33	381	0.00009
Mycobacterium_noviomagense	459858	S	334	27	361	0.00009
Mycobacterium_lacus	169765	S	320	23	343	0.00008
Mycobacterium_xenopi	1789	S	319	36	355	0.00008
Mycobacterium_basiliense	2094119	S	311	11	322	0.00008
Mycobacterium_virginiense	1795032	S	294	77	371	0.00009
Mycobacterium_riyadhense	486698	S	285	12	297	0.00007
Mycobacterium_seoulense	386911	S	284	65	349	0.00008
Mycobacterium_spongiae	886343	S	271	7	278	0.00007
Mycobacterium_haemophilum	29311	S	175	8	183	0.00004
Mycobacterium_pallens	370524	S	90	810	900	0.00021
Mycobacterium_marinum	1781	S	74	296	370	0.00009
Mycobacterium_leprae	1769	S	61	1	62	0.00001
Mycobacterium_senegalense	1796	S	57	298	355	0.00008
Mycobacterium_lepromatosis	480418	S	54	1	55	0.00001
Mycobacterium_novum	2492438	S	44	576	620	0.00015
Mycobacterium_ulcerans	1809	S	33	155	188	0.00004
Mycobacterium_shottsii	133549	S	29	48	77	0.00002
Mycobacterium_pseudoshottsii	265949	S	11	63	74	0.00002
Mycolicibacter_sp._MYC340	2855503	S	327	89	416	0.00010
Mycolicibacter_sp._MYC098	2872309	S	251	68	319	0.00008
Mycolicibacter_sp._MYC017	2875777	S	201	176	377	0.00009
Mycolicibacter_sp._MYC123	2855502	S	50	235	285	0.00007
Mycolicibacter_sp._MYC101	2872311	S	45	208	253	0.00006
Mycolicibacter_terrae	1788	S	390	130	520	0.00012
Mycolicibacter_hiberniae	29314	S	368	84	452	0.00011
Mycolicibacter_minnesotensis	1118379	S	220	41	261	0.00006
Mycolicibacter_sinensis	875328	S	61	654	715	0.00017
Mycobacteroides_abscessus	36809	S	528	509	1037	0.00025
Mycobacteroides_chelonae	1774	S	301	1275	1576	0.00038
Mycobacteroides_saopaulense	1578165	S	233	23	256	0.00006
Mycobacteroides_salmoniphilum	404941	S	200	16	216	0.00005
Mycobacteroides_immunogenum	83262	S	195	34	229	0.00005
[Mycobacterium]_stephanolepidis	1520670	S	106	12	118	0.00003
Mycolicibacillus_parakoreensis	1069221	S	502	146	648	0.00015
Hoyosella_subflava	639313	S	225	13	238	0.00006
Nocardia_asteroides	1824	S	3667	1381	5048	0.00120
Nocardia_brasiliensis	37326	S	2075	626	2701	0.00064
Nocardia_terpenica	455432	S	1547	305	1852	0.00044
Nocardia_cyriacigeorgica	135487	S	1409	666	2075	0.00049
Nocardia_farcinica	37329	S	1154	785	1939	0.00046
Nocardia_arthritidis	228602	S	941	130	1071	0.00026
Nocardia_wallacei	480035	S	850	267	1117	0.00027
Nocardia_otitidiscaviarum	1823	S	841	183	1024	0.00024
Nocardia_huaxiensis	2755382	S	826	179	1005	0.00024
Nocardia_yamanashiensis	209247	S	760	167	927	0.00022
Nocardia_seriolae	37332	S	752	223	975	0.00023
Nocardia_sp._CS682	1047172	S	747	198	945	0.00023
Nocardia_iowensis	204891	S	746	178	924	0.00022
Nocardia_yunnanensis	2382165	S	737	199	936	0.00022
Nocardia_gipuzkoensis	2749991	S	732	296	1028	0.00024
Nocardia_tengchongensis	2055889	S	718	198	916	0.00022
Nocardia_nova	37330	S	713	110	823	0.00020
Nocardia_mangyaensis	2213200	S	559	164	723	0.00017
Rhodococcus_sp._X156	2499145	S	1070	414	1484	0.00035
Rhodococcus_sp._MTM3W5.2	1805827	S	739	197	936	0.00022
Rhodococcus_sp._SGAir0479	2567884	S	670	218	888	0.00021
Rhodococcus_sp._W8901	2742603	S	609	178	787	0.00019
Rhodococcus_sp._PBTS_1	1653478	S	552	159	711	0.00017
Rhodococcus_sp._ABRD24	2507582	S	396	77	473	0.00011
Rhodococcus_sp._R79	2811421	S	391	261	652	0.00016
Rhodococcus_sp._USK10	2789739	S	328	230	558	0.00013
Rhodococcus_sp._B7740	1564114	S	260	39	299	0.00007
Rhodococcus_sp._P1Y	1302308	S	239	24	263	0.00006
Rhodococcus_sp._WMMA185	679318	S	234	33	267	0.00006
Rhodococcus_sp._WAY2	2663121	S	190	173	363	0.00009
Rhodococcus_sp._USK13	2806442	S	182	134	316	0.00008
Rhodococcus_sp._RDE2	2885078	S	172	177	349	0.00008
Rhodococcus_sp._WB9	2594007	S	119	169	288	0.00007
Rhodococcus_sp._DMU1	2722825	S	82	324	406	0.00010
Rhodococcus_sp._S2-17	1990687	S	74	223	297	0.00007
Rhodococcus_sp._M8	1925550	S	71	231	302	0.00007
Rhodococcus_sp._ZPP	2749906	S	71	205	276	0.00007
Rhodococcus_sp._WB1	1033922	S	33	297	330	0.00008
Rhodococcus_sp._21391	2683591	S	32	156	188	0.00004
Rhodococcus_sp._2G	1570939	S	29	124	153	0.00004
Rhodococcus_sp._AQ5-07	2054902	S	22	80	102	0.00002
Rhodococcus_sp._PSBB049	2812863	S	18	273	291	0.00007
Rhodococcus_sp._P-2	2795031	S	18	23	41	0.00001
Rhodococcus_sp._DMF-1	2907624	S	17	142	159	0.00004
Rhodococcus_sp._008	1723645	S	17	110	127	0.00003
Rhodococcus_sp._p52	935199	S	16	90	106	0.00003
Rhodococcus_sp._LW-XY12	2856851	S	15	140	155	0.00004
Rhodococcus_sp._YL-1	1045808	S	14	64	78	0.00002
Rhodococcus_sp._H-CA8f	1727214	S	11	50	61	0.00001
Rhodococcus_sp._BH4	1807790	S	10	68	78	0.00002
Rhodococcus_opacus	37919	S	1805	1958	3763	0.00090
Rhodococcus_equi	43767	S	937	390	1327	0.00032
Rhodococcus_fascians	1828	S	785	188	973	0.00023
Rhodococcus_rhodochrous	1829	S	592	367	959	0.00023
Rhodococcus_triatomae	300028	S	502	161	663	0.00016
Rhodococcus_koreensis	99653	S	432	138	570	0.00014
Rhodococcus_coprophilus	38310	S	392	76	468	0.00011
Rhodococcus_jostii	132919	S	346	152	498	0.00012
Rhodococcus_pyridinivorans	103816	S	292	1158	1450	0.00035
Rhodococcus_erythropolis	1833	S	121	589	710	0.00017
Rhodococcus_qingshengii	334542	S	108	599	707	0.00017
Rhodococcus_ruber	1830	S	229	780	1009	0.00024
Rhodococcus_globerulus	33008	S	196	24	220	0.00005
Rhodococcus_aetherivorans	191292	S	89	866	955	0.00023
Corynebacterium_sphenisci	191493	S	594	182	776	0.00018
Corynebacterium_cyclohexanicum	322009	S	576	245	821	0.00020
Corynebacterium_frankenforstense	1230998	S	477	144	621	0.00015
Corynebacterium_xerosis	1725	S	403	225	628	0.00015
Corynebacterium_bovis	36808	S	375	86	461	0.00011
Corynebacterium_halotolerans	225326	S	373	86	459	0.00011
Corynebacterium_freneyi	134034	S	339	131	470	0.00011
Corynebacterium_nuruki	1032851	S	338	79	417	0.00010
Corynebacterium_maris	575200	S	287	46	333	0.00008
Corynebacterium_sp._CNCTC7651	2815361	S	124	23	147	0.00004
Corynebacterium_sp._NML98-0116	702967	S	79	27	106	0.00003
Corynebacterium_sp._4H37-19	2684405	S	36	3	39	0.00001
Corynebacterium_sp._1864	2820399	S	20	39	59	0.00001
Corynebacterium_sp._FDAARGOS_1242	2778078	S	14	34	48	0.00001
Corynebacterium_variabile	1727	S	277	163	440	0.00010
Corynebacterium_vitaeruminis	38305	S	272	81	353	0.00008
Corynebacterium_humireducens	1223514	S	261	75	336	0.00008
Corynebacterium_timonense	441500	S	245	59	304	0.00007
Corynebacterium_mycetoides	38302	S	233	110	343	0.00008
Corynebacterium_doosanense	1121358	S	224	108	332	0.00008
Corynebacterium_marinum	349751	S	222	83	305	0.00007
Corynebacterium_yudongzhengii	2080740	S	209	39	248	0.00006
Corynebacterium_liangguodongii	2079535	S	203	45	248	0.00006
Corynebacterium_comes	2675218	S	179	44	223	0.00005
Corynebacterium_jeikeium	38289	S	174	409	583	0.00014
Corynebacterium_atypicum	191610	S	170	51	221	0.00005
Corynebacterium_provencense	1737425	S	168	38	206	0.00005
Corynebacterium_uterequi	1072256	S	157	26	183	0.00004
Corynebacterium_glyciniphilum	1404244	S	148	18	166	0.00004
Corynebacterium_sanguinis	2594913	S	146	98	244	0.00006
Corynebacterium_falsenii	108486	S	142	61	203	0.00005
Corynebacterium_imitans	156978	S	142	86	228	0.00005
Corynebacterium_urealyticum	43771	S	141	138	279	0.00007
Corynebacterium_glaucum	187491	S	136	29	165	0.00004
Corynebacterium_qintianiae	2709392	S	135	36	171	0.00004
Corynebacterium_terpenotabidum	89154	S	129	36	165	0.00004
Corynebacterium_lujinxingii	2763010	S	128	43	171	0.00004
Corynebacterium_ureicelerivorans	401472	S	123	40	163	0.00004
Corynebacterium_uberis	2883169	S	121	14	135	0.00003
Corynebacterium_efficiens	152794	S	109	19	128	0.00003
Corynebacterium_aurimucosum	169292	S	106	48	154	0.00004
Corynebacterium_aquilae	203263	S	103	15	118	0.00003
Corynebacterium_genitalium	38288	S	101	22	123	0.00003
Corynebacterium_coyleae	53374	S	101	25	126	0.00003
Corynebacterium_striatum	43770	S	99	82	181	0.00004
Corynebacterium_glucuronolyticum	39791	S	99	23	122	0.00003
Corynebacterium_incognita	2754725	S	96	22	118	0.00003
Corynebacterium_testudinoris	136857	S	93	19	112	0.00003
Corynebacterium_kroppenstedtii	161879	S	87	8	95	0.00002
Corynebacterium_tuberculostearicum	38304	S	85	51	136	0.00003
Corynebacterium_zhongnanshanii	2768834	S	79	10	89	0.00002
Corynebacterium_endometrii	2488819	S	77	14	91	0.00002
Corynebacterium_riegelii	156976	S	76	19	95	0.00002
Corynebacterium_renale	1724	S	75	8	83	0.00002
Corynebacterium_occultum	2675219	S	67	11	78	0.00002
Corynebacterium_lactis	1231000	S	66	10	76	0.00002
Corynebacterium_flavescens	28028	S	65	18	83	0.00002
Corynebacterium_matruchotii	43768	S	57	4	61	0.00001
Corynebacterium_urogenitale	2487892	S	53	9	62	0.00001
Corynebacterium_cystitidis	35757	S	53	3	56	0.00001
Corynebacterium_lizhenjunii	2709394	S	48	8	56	0.00001
Corynebacterium_epidermidicanis	1050174	S	48	8	56	0.00001
Corynebacterium_simulans	146827	S	47	34	81	0.00002
Corynebacterium_kalinowskii	2675216	S	46	22	68	0.00002
Corynebacterium_phocae	161895	S	45	6	51	0.00001
Corynebacterium_minutissimum	38301	S	43	41	84	0.00002
Corynebacterium_macginleyi	38290	S	43	10	53	0.00001
Corynebacterium_pseudodiphtheriticum	37637	S	40	12	52	0.00001
Corynebacterium_argentoratense	42817	S	40	8	48	0.00001
Corynebacterium_diphtheriae	1717	S	38	51	89	0.00002
Corynebacterium_kefirresidentii	1979527	S	38	25	63	0.00002
Corynebacterium_glutamicum	1718	S	37	476	513	0.00012
Corynebacterium_camporealensis	161896	S	37	9	46	0.00001
Corynebacterium_gerontici	2079234	S	35	7	42	0.00001
Corynebacterium_deserti	1408191	S	34	12	46	0.00001
Corynebacterium_pseudopelargi	2080757	S	34	11	45	0.00001
Corynebacterium_propinquum	43769	S	33	13	46	0.00001
Corynebacterium_pelargi	1471400	S	30	9	39	0.00001
Corynebacterium_ulcerans	65058	S	29	14	43	0.00001
Corynebacterium_accolens	38284	S	28	64	92	0.00002
Corynebacterium_mustelae	571915	S	27	2	29	0.00001
Corynebacterium_amycolatum	43765	S	26	187	213	0.00005
Corynebacterium_singulare	161899	S	26	22	48	0.00001
Corynebacterium_stationis	1705	S	25	6	31	0.00001
Corynebacterium_casei	160386	S	25	31	56	0.00001
Corynebacterium_ammoniagenes	1697	S	24	5	29	0.00001
Corynebacterium_resistens	258224	S	23	13	36	0.00001
Corynebacterium_segmentosum	43990	S	21	48	69	0.00002
Corynebacterium_choanae	1862358	S	20	2	22	0.00001
Corynebacterium_hindlerae	699041	S	19	35	54	0.00001
Corynebacterium_suranareeae	2506452	S	16	4	20	0.00000
Corynebacterium_rouxii	2719119	S	16	9	25	0.00001
Corynebacterium_callunae	1721	S	14	4	18	0.00000
Corynebacterium_pseudotuberculosis	1719	S	13	2	15	0.00000
Gordonia_sp._PP30	2935861	S	667	200	867	0.00021
Gordonia_sp._YC-JH1	2059875	S	415	312	727	0.00017
Gordonia_sp._KTR9	337191	S	383	84	467	0.00011
Gordonia_sp._PDNC005	2811424	S	327	52	379	0.00009
Gordonia_sp._WA4-43	2878678	S	84	299	383	0.00009
Gordonia_sp._JH63	2698900	S	54	178	232	0.00006
Gordonia_sp._135	2676309	S	30	208	238	0.00006
Gordonia_sp._1D	1737359	S	25	390	415	0.00010
Gordonia_polyisoprenivorans	84595	S	930	197	1127	0.00027
Gordonia_terrae	2055	S	614	369	983	0.00023
Gordonia_insulae	2420509	S	564	86	650	0.00015
Gordonia_phthalatica	1136941	S	530	231	761	0.00018
Gordonia_iterans	1004901	S	486	177	663	0.00016
Gordonia_amarae	36821	S	466	100	566	0.00013
Gordonia_jinghuaiqii	2758710	S	456	96	552	0.00013
Gordonia_bronchialis	2054	S	404	102	506	0.00012
Gordonia_rubripertincta	36822	S	394	246	640	0.00015
Gordonia_pseudoamarae	2831662	S	380	77	457	0.00011
Gordonia_otitidis	249058	S	363	65	428	0.00010
Gordonia_zhaorongruii	2597659	S	293	57	350	0.00008
Gordonia_alkanivorans	84096	S	84	323	407	0.00010
Gordonia_amicalis	89053	S	77	579	656	0.00016
Gordonia_hongkongensis	1701090	S	47	153	200	0.00005
Skermania_piniformis	39122	S	548	71	619	0.00015
Tsukamurella_paurometabola	2061	S	959	516	1475	0.00035
Tsukamurella_tyrosinosolvens	57704	S	796	387	1183	0.00028
Tsukamurella_sp._PLM1	2929795	S	544	194	738	0.00018
Tsukamurella_pulmonis	47312	S	511	200	711	0.00017
Dietzia_sp._oral_taxon_368	712270	S	322	628	950	0.00023
Dietzia_psychralcaliphila	139021	S	382	122	504	0.00012
Dietzia_lutea	546160	S	355	232	587	0.00014
Dietzia_timorensis	499555	S	286	172	458	0.00011
Tomitella_gaofuii	2760083	S	561	186	747	0.00018
Tomitella_fengzijianii	2597660	S	538	193	731	0.00017
Segniliparus_rotundus	286802	S	369	23	392	0.00009
Lawsonella_clevelandensis	1528099	S	32	4	36	0.00001
Amycolatopsis_sp._Hca4	2742131	S	4824	1944	6768	0.00161
Amycolatopsis_sp._WQ_127309	2932773	S	2965	928	3893	0.00093
Amycolatopsis_sp._DSM_110486	2865832	S	2341	532	2873	0.00068
Amycolatopsis_sp._FDAARGOS_1241	2778070	S	2249	558	2807	0.00067
Amycolatopsis_sp._CA-230715	2745196	S	1765	314	2079	0.00049
Amycolatopsis_sp._YIM_10	2653857	S	1643	538	2181	0.00052
Amycolatopsis_sp._FU40	2914159	S	1164	565	1729	0.00041
Amycolatopsis_sp._AA4	1896961	S	955	540	1495	0.00036
Amycolatopsis_sp._BJA-103	1911175	S	825	357	1182	0.00028
Amycolatopsis_sp._TNS106	2861750	S	713	449	1162	0.00028
Amycolatopsis_sp._EV170708-02-1	2919322	S	556	574	1130	0.00027
Amycolatopsis_mediterranei	33910	S	4498	3134	7632	0.00182
Amycolatopsis_pretoriensis	218821	S	3038	1079	4117	0.00098
Amycolatopsis_acidiphila	715473	S	2494	620	3114	0.00074
Amycolatopsis_methanolica	1814	S	1620	717	2337	0.00056
Amycolatopsis_albispora	1804986	S	1597	1048	2645	0.00063
Amycolatopsis_thermalba	944492	S	1525	714	2239	0.00053
Amycolatopsis_aidingensis	2842453	S	1461	202	1663	0.00040
Amycolatopsis_keratiniphila	129921	S	822	712	1534	0.00037
Amycolatopsis_japonica	208439	S	452	444	896	0.00021
Amycolatopsis_orientalis	31958	S	1023	374	1397	0.00033
Pseudonocardia_sp._DSM_110487	2865833	S	5782	962	6744	0.00161
Pseudonocardia_sp._CGMCC_4.1532	2761535	S	1826	1117	2943	0.00070
Pseudonocardia_sp._HH130630-07	1690815	S	1447	677	2124	0.00051
Pseudonocardia_sp._AL041005-10	445576	S	1237	642	1879	0.00045
Pseudonocardia_sp._HH130629-09	1641402	S	941	671	1612	0.00038
Pseudonocardia_sp._EC080625-04	1096868	S	27	1589	1616	0.00038
Pseudonocardia_dioxanivorans	240495	S	3138	988	4126	0.00098
Pseudonocardia_broussonetiae	2736640	S	2588	958	3546	0.00084
Pseudonocardia_autotrophica	2074	S	1652	513	2165	0.00052
Pseudonocardia_abyssalis	2792008	S	1515	827	2342	0.00056
Lentzea_guizhouensis	1586287	S	7439	1832	9271	0.00221
Saccharopolyspora_erythraea	1836	S	3217	1335	4552	0.00108
Saccharopolyspora_gregorii	33914	S	1171	277	1448	0.00034
Saccharopolyspora_spinosa	60894	S	681	463	1144	0.00027
Saccharopolyspora_pogona	333966	S	601	746	1347	0.00032
Saccharopolyspora_sp._ASAGF58	2719023	S	346	476	822	0.00020
Saccharothrix_syringae	103733	S	2593	1043	3636	0.00087
Saccharothrix_sp._6-C	2781735	S	2126	835	2961	0.00070
Saccharothrix_espanaensis	103731	S	2002	683	2685	0.00064
Kutzneria_sp._CA-103260	2802641	S	4217	1055	5272	0.00125
Kutzneria_albida	43357	S	2159	579	2738	0.00065
Saccharomonospora_marina	632569	S	1110	300	1410	0.00034
Saccharomonospora_azurea	40988	S	758	263	1021	0.00024
Saccharomonospora_cyanea	40989	S	686	285	971	0.00023
Saccharomonospora_xinjiangensis	75294	S	537	104	641	0.00015
Saccharomonospora_glauca	40990	S	504	210	714	0.00017
Saccharomonospora_viridis	1852	S	475	85	560	0.00013
Kibdelosporangium_phytohabitans	860235	S	2696	382	3078	0.00073
Actinoalloteichus_hoggarensis	1470176	S	919	144	1063	0.00025
Actinoalloteichus_hymeniacidonis	340345	S	662	74	736	0.00018
Actinoalloteichus_sp._GBA129-24	1612551	S	39	478	517	0.00012
Actinoalloteichus_fjordicus	1612552	S	30	444	474	0.00011
Actinosynnema_pretiosum	42197	S	736	1548	2284	0.00054
Actinosynnema_mirum	40567	S	84	849	933	0.00022
Allokutzneria_albata	211114	S	2000	565	2565	0.00061
Alloactinosynnema_sp._L-07	1653480	S	1353	352	1705	0.00041
Prauserella_marina	530584	S	829	86	915	0.00022
Allosaccharopolyspora_coralli	2665642	S	672	168	840	0.00020
Nocardioides_sp._G188	2849501	S	2459	922	3381	0.00080
Nocardioides_sp._JS614	196162	S	2313	809	3122	0.00074
Nocardioides_sp._LMS-CY	2840457	S	2100	818	2918	0.00069
Nocardioides_sp._TF02-7	2917724	S	1738	682	2420	0.00058
Nocardioides_sp._HDW12B	2714939	S	1555	623	2178	0.00052
Nocardioides_sp._S-1144	2582905	S	1493	685	2178	0.00052
Nocardioides_sp._W7	2931390	S	1455	581	2036	0.00048
Nocardioides_sp._zg-579	2663857	S	1429	849	2278	0.00054
Nocardioides_sp._cx-173	2898796	S	1287	522	1809	0.00043
Nocardioides_sp._zg-1228	2763008	S	1286	664	1950	0.00046
Nocardioides_sp._603	2483798	S	1195	651	1846	0.00044
Nocardioides_sp._S5	2017486	S	1172	687	1859	0.00044
Nocardioides_sp._SCSIO_67246	2872154	S	1137	361	1498	0.00036
Nocardioides_sp._InS609-2	2760705	S	1111	306	1417	0.00034
Nocardioides_sp._MC1495	2736757	S	1090	463	1553	0.00037
Nocardioides_sp._CF8	110319	S	1054	511	1565	0.00037
Nocardioides_sp._zg-536	2803858	S	979	506	1485	0.00035
Nocardioides_sp._JQ2195	2592334	S	955	241	1196	0.00028
Nocardioides_sp._ZJ1313	2685869	S	907	1010	1917	0.00046
Nocardioides_sp._WS12	2486272	S	859	181	1040	0.00025
Nocardioides_sp._Kera_G14	2884264	S	854	217	1071	0.00025
Nocardioides_sp._dk884	2662361	S	832	921	1753	0.00042
Nocardioides_mesophilus	433659	S	2169	809	2978	0.00071
Nocardioides_anomalus	2712223	S	1830	676	2506	0.00060
Nocardioides_ungokensis	1643322	S	1817	773	2590	0.00062
Nocardioides_cynanchi	2558918	S	1754	510	2264	0.00054
Nocardioides_humi	449461	S	1637	659	2296	0.00055
Nocardioides_aromaticivorans	200618	S	1405	646	2051	0.00049
Nocardioides_euryhalodurans	2518370	S	1363	508	1871	0.00045
Nocardioides_okcheonensis	2894081	S	1356	749	2105	0.00050
Nocardioides_aquaticus	160826	S	1286	480	1766	0.00042
Nocardioides_dongkuii	2760089	S	1284	767	2051	0.00049
Nocardioides_rotundus	1774216	S	1225	585	1810	0.00043
Nocardioides_dokdonensis	450734	S	1147	638	1785	0.00042
Nocardioides_marinisabuli	419476	S	1132	755	1887	0.00045
Nocardioides_sambongensis	2589074	S	1032	363	1395	0.00033
Nocardioides_panacisoli	627624	S	962	292	1254	0.00030
Nocardioides_seonyuensis	2518371	S	942	306	1248	0.00030
Nocardioides_houyundeii	2045452	S	908	338	1246	0.00030
Nocardioides_piscis	2714938	S	859	386	1245	0.00030
Nocardioides_daphniae	402297	S	700	388	1088	0.00026
Nocardioides_jishulii	2575440	S	630	277	907	0.00022
Nocardioides_baekrokdamisoli	1804624	S	457	70	527	0.00013
Nocardioides_yefusunii	2500546	S	422	151	573	0.00014
Aeromicrobium_sp._Leaf245	1736306	S	759	294	1053	0.00025
Aeromicrobium_sp._zg-629	2663859	S	638	262	900	0.00021
Aeromicrobium_sp._A1-2	2107713	S	568	100	668	0.00016
Aeromicrobium_erythreum	2041	S	902	335	1237	0.00029
Aeromicrobium_choanae	1736691	S	791	295	1086	0.00026
Aeromicrobium_marinum	219314	S	774	211	985	0.00023
Aeromicrobium_yanjiei	2662028	S	758	296	1054	0.00025
Aeromicrobium_chenweiae	2079793	S	734	309	1043	0.00025
Friedmanniella_luteola	546871	S	1498	392	1890	0.00045
Pimelobacter_simplex	2045	S	1487	693	2180	0.00052
Marmoricola_scoriae	642780	S	1437	680	2117	0.00050
Mumia_sp._ZJ1417	2708082	S	960	209	1169	0.00028
Micropruina_glycogenica	75385	S	573	107	680	0.00016
Microlunatus_sagamiharensis	546874	S	1378	402	1780	0.00042
Microlunatus_soli	630515	S	919	107	1026	0.00024
Microlunatus_elymi	2596828	S	839	104	943	0.00022
Microlunatus_phosphovorus	29405	S	802	117	919	0.00022
Microlunatus_sp._Gsoil_973	2672569	S	800	70	870	0.00021
Tessaracoccus_sp._J1M15	2829499	S	523	180	703	0.00017
Tessaracoccus_sp._MC1865	2760310	S	371	110	481	0.00011
Tessaracoccus_defluvii	1285901	S	582	422	1004	0.00024
Tessaracoccus_aquimaris	1332264	S	508	272	780	0.00019
Tessaracoccus_flavescens	399497	S	425	371	796	0.00019
Tessaracoccus_flavus	1610493	S	386	296	682	0.00016
Tessaracoccus_timonensis	2161816	S	259	125	384	0.00009
Brevilactibacter_coleopterorum	2714937	S	875	477	1352	0.00032
Brevilactibacter_sp._MC1595	2819349	S	745	358	1103	0.00026
Acidipropionibacterium_jensenii	1749	S	483	347	830	0.00020
Acidipropionibacterium_acidipropionici	1748	S	467	325	792	0.00019
Acidipropionibacterium_virtanenii	2057246	S	345	78	423	0.00010
Propionibacterium_acidifaciens	556499	S	513	131	644	0.00015
Propionibacterium_freudenreichii	1744	S	413	515	928	0.00022
Propionibacterium_australiense	119981	S	338	66	404	0.00010
Auraticoccus_monumenti	675864	S	1005	231	1236	0.00029
Cutibacterium_avidum	33010	S	266	108	374	0.00009
Cutibacterium_acnes	1747	S	189	109	298	0.00007
Cutibacterium_granulosum	33011	S	169	41	210	0.00005
Cutibacterium_modestum	2559073	S	46	7	53	0.00001
Raineyella_fluvialis	2662261	S	691	113	804	0.00019
Arachnia_propionica	1750	S	432	54	486	0.00012
Arachnia_rubra	1547448	S	215	22	237	0.00006
Vaginimicrobium_propionicum	1871034	S	19	8	27	0.00001
Kribbella_flavida	182640	S	3069	832	3901	0.00093
Kribbella_qitaiheensis	1544730	S	2171	388	2559	0.00061
Actinopolymorpha_singaporensis	117157	S	1873	265	2138	0.00051
Nonomuraea_nitratireducens	2656914	S	8072	2080	10152	0.00242
Nonomuraea_sp._ATCC_55076	1909395	S	4278	1599	5877	0.00140
Nonomuraea_gerenzanensis	93944	S	3899	1524	5423	0.00129
Nonomuraea_coxensis	404386	S	3799	1321	5120	0.00122
Streptosporangium_roseum	2001	S	3380	1135	4515	0.00107
Streptosporangium_sp._'caverna'	2202249	S	3355	889	4244	0.00101
Thermobispora_bispora	2006	S	2451	716	3167	0.00075
Actinomadura_sp._NAK00032	2742128	S	4359	1912	6271	0.00149
Actinomadura_sp._WMMA1423	2591108	S	3289	1212	4501	0.00107
Actinomadura_sp._WMMB_499	1219491	S	3135	919	4054	0.00096
Actinomadura_verrucosospora	46165	S	5892	2221	8113	0.00193
Actinomadura_madurae	1993	S	3937	1470	5407	0.00129
Actinomadura_graeca	2750812	S	3102	885	3987	0.00095
Thermomonospora_amylolytica	1411117	S	2825	1276	4101	0.00098
Thermomonospora_curvata	2020	S	1943	687	2630	0.00063
Nocardiopsis_sp._MT53	2865672	S	1448	421	1869	0.00044
Nocardiopsis_sp._HDS12	2831968	S	403	490	893	0.00021
Nocardiopsis_gilva	280236	S	1172	291	1463	0.00035
Nocardiopsis_dassonvillei	2014	S	728	739	1467	0.00035
Nocardiopsis_alba	53437	S	697	156	853	0.00020
Thermobifida_halotolerans	483545	S	911	350	1261	0.00030
Thermobifida_alba	53522	S	845	394	1239	0.00029
Thermobifida_fusca	2021	S	451	90	541	0.00013
Streptomonospora_litoralis	2498135	S	1311	314	1625	0.00039
Spiractinospora_alimapuensis	2820884	S	771	62	833	0.00020
Blastococcus_sp._PRF04-17	2933797	S	3166	1297	4463	0.00106
Blastococcus_saxobsidens	138336	S	2899	1064	3963	0.00094
Modestobacter_marinus	477641	S	3351	1390	4741	0.00113
Modestobacter_sp._L9-4	2851567	S	1865	851	2716	0.00065
Geodermatophilus_obscurus	1861	S	3679	1489	5168	0.00123
Frankia_inefficax	298654	S	3027	429	3456	0.00082
Frankia_sp._QA3	710111	S	1164	640	1804	0.00043
Frankia_sp._ArI3	1858	S	835	726	1561	0.00037
Candidatus_Frankia_datiscae	2716812	S	1454	235	1689	0.00040
Frankia_casuarinae	106370	S	1056	136	1192	0.00028
Frankia_alni	1859	S	896	805	1701	0.00041
Actinomyces_sp._oral_taxon_414	712122	S	415	96	511	0.00012
Actinomyces_sp._MAS-1	2755559	S	275	61	336	0.00008
Actinomyces_sp._Z16	2079536	S	228	87	315	0.00008
Actinomyces_sp._Chiba101	1851395	S	182	92	274	0.00007
Actinomyces_sp._432	2057798	S	159	38	197	0.00005
Actinomyces_sp._oral_taxon_171	706438	S	97	82	179	0.00004
Actinomyces_sp._oral_taxon_897	2081702	S	55	156	211	0.00005
Actinomyces_sp._oral_taxon_169	712116	S	54	101	155	0.00004
Actinomyces_sp._HMT897	2789424	S	35	97	132	0.00003
Actinomyces_sp._HMT_175	2789425	S	33	140	173	0.00004
Actinomyces_radicidentis	111015	S	422	204	626	0.00015
Actinomyces_howellii	52771	S	347	61	408	0.00010
Actinomyces_slackii	52774	S	272	51	323	0.00008
Actinomyces_respiraculi	2744574	S	253	69	322	0.00008
Actinomyces_procaprae	2560010	S	247	97	344	0.00008
Actinomyces_faecalis	2722820	S	206	33	239	0.00006
Actinomyces_weissii	675090	S	198	44	242	0.00006
Actinomyces_naeslundii	1655	S	157	97	254	0.00006
Actinomyces_viscosus	1656	S	153	69	222	0.00005
Actinomyces_gaoshouyii	1960083	S	151	84	235	0.00006
Actinomyces_qiguomingii	2057800	S	149	22	171	0.00004
Actinomyces_oris	544580	S	136	406	542	0.00013
Actinomyces_wuliandei	2057743	S	132	38	170	0.00004
Actinomyces_marmotae	2737173	S	125	75	200	0.00005
Actinomyces_lilanjuaniae	2321394	S	97	25	122	0.00003
Actinomyces_trachealis	2763540	S	84	17	101	0.00002
Actinomyces_pacaensis	1852377	S	30	4	34	0.00001
Schaalia_sp._19OD2882	2794089	S	163	24	187	0.00004
Schaalia_sp._JY-X169	2758572	S	62	2	64	0.00002
Schaalia_sp._ZJ405	2709403	S	46	4	50	0.00001
Schaalia_odontolytica	1660	S	224	62	286	0.00007
Schaalia_meyeri	52773	S	121	26	147	0.00004
Schaalia_cardiffensis	181487	S	60	10	70	0.00002
Schaalia_turicensis	131111	S	28	31	59	0.00001
Flaviflexus_salsibiostraticola	1282737	S	231	72	303	0.00007
Flaviflexus_sp._dk850	2758573	S	106	43	149	0.00004
Flaviflexus_ciconiae	2496867	S	79	11	90	0.00002
Trueperella_pecoris	2733571	S	170	54	224	0.00005
Trueperella_pyogenes	1661	S	130	79	209	0.00005
Trueperella_bialowiezensis	312285	S	113	6	119	0.00003
Pauljensenia_hongkongensis	178339	S	249	102	351	0.00008
Nanchangia_anserum	2692125	S	192	23	215	0.00005
Actinotignum_schaalii	59505	S	85	6	91	0.00002
Actinobaculum_sp._313	2495645	S	81	5	86	0.00002
Changpingibacter_yushuensis	2758440	S	61	21	82	0.00002
Arcanobacterium_haemolyticum	28264	S	14	11	25	0.00001
Mobiluncus_curtisii	2051	S	32	10	42	0.00001
Boudabousia_tangfeifanii	1912795	S	17	1	18	0.00000
Varibaculum_sp._EMRHCC_39	2811781	S	14	4	18	0.00000
Fannyhessea_vaginae	82135	S	11	3	14	0.00000
Jiangella_sp._DSM_45060	1798224	S	2640	921	3561	0.00085
Jiangella_alkaliphila	419479	S	2436	816	3252	0.00077
Bifidobacterium_pseudolongum	1694	S	298	119	417	0.00010
Bifidobacterium_scardovii	158787	S	279	30	309	0.00007
Bifidobacterium_choerinum	35760	S	267	124	391	0.00009
Bifidobacterium_longum	216816	S	206	459	665	0.00016
Bifidobacterium_pullorum	78448	S	206	88	294	0.00007
Bifidobacterium_bifidum	1681	S	163	124	287	0.00007
Bifidobacterium_subtile	77635	S	134	19	153	0.00004
Bifidobacterium_animalis	28025	S	121	86	207	0.00005
Bifidobacterium_asteroides	1684	S	117	3	120	0.00003
Bifidobacterium_lemurum	1603886	S	112	29	141	0.00003
Bifidobacterium_adolescentis	1680	S	111	26	137	0.00003
Bifidobacterium_eulemuris	1765219	S	101	25	126	0.00003
Bifidobacterium_thermophilum	33905	S	101	24	125	0.00003
Bifidobacterium_breve	1685	S	97	149	246	0.00006
Bifidobacterium_actinocoloniiforme	638619	S	78	3	81	0.00002
Bifidobacterium_angulatum	1683	S	72	20	92	0.00002
Bifidobacterium_dentium	1689	S	68	5	73	0.00002
Bifidobacterium_pseudocatenulatum	28026	S	49	28	77	0.00002
Bifidobacterium_catenulatum	1686	S	44	77	121	0.00003
Bifidobacterium_imperatoris	2020965	S	24	14	38	0.00001
Bifidobacterium_coryneforme	1687	S	18	26	44	0.00001
Parascardovia_denticolens	78258	S	55	9	64	0.00002
Nakamurella_multipartita	53461	S	1491	339	1830	0.00044
Nakamurella_panacisegetis	1090615	S	851	144	995	0.00024
Nakamurella_sp._PAMC28650	2762325	S	758	99	857	0.00020
Nakamurella_antarctica	1902245	S	146	12	158	0.00004
Catenulispora_acidiphila	304895	S	2207	385	2592	0.00062
Jatrophihabitans_sp._GAS493	1907575	S	942	117	1059	0.00025
Jatrophihabitans_telluris	2038343	S	891	103	994	0.00024
Stackebrandtia_nassauensis	283811	S	1248	134	1382	0.00033
Natronoglycomyces_albus	2811108	S	230	9	239	0.00006
Kineococcus_radiotolerans	131568	S	1116	368	1484	0.00035
Epidermidibacterium_keratini	1891644	S	740	437	1177	0.00028
Actinopolyspora_erythraea	414996	S	632	77	709	0.00017
Acidothermus_cellulolyticus	28049	S	554	31	585	0.00014
Candidatus_Planktophila_versatilis	1884905	S	28	5	33	0.00001
Candidatus_Planktophila_lacus	1884913	S	21	2	23	0.00001
Candidatus_Planktophila_sulfonica	1884904	S	15	4	19	0.00000
Candidatus_Nanopelagicus_limnes	1884634	S	26	23	49	0.00001
Conexibacter_sp._SYSU_D00693	2812560	S	10008	2566	12574	0.00299
Conexibacter_sp._DBS9H8	2937801	S	2543	253	2796	0.00067
Conexibacter_sp._S30A1	2937800	S	2433	267	2700	0.00064
Conexibacter_woesei	191495	S	10655	2004	12659	0.00301
Miltoncostaea_marina	2843215	S	3218	840	4058	0.00097
Miltoncostaea_oceani	2843216	S	3082	481	3563	0.00085
Baekduia_soli	496014	S	10330	1863	12193	0.00290
Rubrobacter_xylanophilus	49319	S	3035	424	3459	0.00082
Rubrobacter_tropicus	2653851	S	1966	161	2127	0.00051
Rubrobacter_marinus	2653852	S	1880	184	2064	0.00049
Rubrobacter_radiotolerans	42256	S	734	108	842	0.00020
Rubrobacter_indicoceani	2051957	S	431	38	469	0.00011
Aquihabitans_sp._Kera_3	2884263	S	3940	672	4612	0.00110
Aquihabitans_sp._G128	2849779	S	2769	579	3348	0.00080
Actinomarinicola_tropica	2789776	S	3072	625	3697	0.00088
Iamia_sp._SCSIO_61187	2722752	S	2913	479	3392	0.00081
Ilumatobacter_coccineus	467094	S	1130	72	1202	0.00029
Acidimicrobium_ferrooxidans	53635	S	486	38	524	0.00012
Eggerthella_lenta	84112	S	326	212	538	0.00013
Eggerthella_guodeyinii	2690837	S	279	127	406	0.00010
Eggerthella_sp._YY7918	502558	S	71	31	102	0.00002
Gordonibacter_urolithinfaciens	1335613	S	158	116	274	0.00007
Gordonibacter_pamelaeae	471189	S	152	155	307	0.00007
Arabiibacter_massiliensis	1870985	S	346	73	419	0.00010
Adlercreutzia_equolifaciens	446660	S	142	85	227	0.00005
Adlercreutzia_hattorii	2707299	S	67	94	161	0.00004
Berryella_intestinalis	1531429	S	181	218	399	0.00010
Raoultibacter_timonensis	1907662	S	160	13	173	0.00004
Slackia_heliotrinireducens	84110	S	122	3	125	0.00003
Denitrobacterium_detoxificans	79604	S	64	28	92	0.00002
Cryptobacterium_curtum	84163	S	14	1	15	0.00000
Phoenicibacter_congonensis	1944646	S	11	4	15	0.00000
Olsenella_timonensis	1805478	S	278	82	360	0.00009
Olsenella_uli	133926	S	155	14	169	0.00004
Olsenella_sp._oral_taxon_807	712411	S	99	5	104	0.00002
Parolsenella_massiliensis	1871022	S	155	87	242	0.00006
Parolsenella_catena	2003188	S	138	85	223	0.00005
Parafannyhessea_umbonata	604330	S	190	115	305	0.00007
Thermophilibacter_immobilis	2779519	S	184	69	253	0.00006
Atopobium_sp._oral_taxon_416	712157	S	47	5	52	0.00001
Collinsella_aerofaciens	74426	S	249	128	377	0.00009
Collinsella_stercoris	147206	S	187	29	216	0.00005
Collinsella_sp._zg1085	2844380	S	14	0	14	0.00000
Coriobacterium_glomerans	33871	S	101	3	104	0.00002
Egicoccus_halophilus	1670830	S	1535	261	1796	0.00043
Egibacter_rhizosphaerae	1670831	S	1376	90	1466	0.00035
Euzebya_pacifica	1608957	S	1373	127	1500	0.00036
Thermoactinomyces_vulgaris	2026	S	29511	4918	34429	0.00819
Kroppenstedtia_eburnea	714067	S	2981	235	3216	0.00077
Kroppenstedtia_pulmonis	1380685	S	73	4	77	0.00002
Laceyella_sacchari	37482	S	2014	381	2395	0.00057
Polycladomyces_abyssicola	1125966	S	1289	94	1383	0.00033
Staphylospora_marina	2490858	S	286	37	323	0.00008
Novibacillus_thermophilus	1471761	S	154	19	173	0.00004
Priestia_megaterium	1404	S	5762	7142	12904	0.00307
Priestia_filamentosa	1402861	S	841	115	956	0.00023
Priestia_aryabhattai	412384	S	124	657	781	0.00019
Priestia_flexa	86664	S	77	26	103	0.00002
Priestia_koreensis	284581	S	47	17	64	0.00002
Priestia_sp._J2	2886505	S	15	130	145	0.00003
Bacillus_sp._S3	486398	S	454	144	598	0.00014
Bacillus_sp._Y1	352858	S	182	76	258	0.00006
Bacillus_sp._1NLA3E	666686	S	151	58	209	0.00005
Bacillus_sp._FJAT-18017	1705566	S	98	28	126	0.00003
Bacillus_sp._KH172YL63	2709784	S	55	20	75	0.00002
Bacillus_sp._JY-23	2933872	S	50	21	71	0.00002
Bacillus_sp._FJAT-42376	2014076	S	49	19	68	0.00002
Bacillus_sp._PAMC26568	2760090	S	42	4	46	0.00001
Bacillus_sp._NSP9.1	1071078	S	40	3	43	0.00001
Bacillus_sp._THAF10	2587848	S	38	13	51	0.00001
Bacillus_sp._FJAT-22090	1581038	S	36	10	46	0.00001
Bacillus_sp._OxB-1	98228	S	30	7	37	0.00001
Bacillus_sp._SB49	1071080	S	29	5	34	0.00001
Bacillus_sp._N1-1	2682541	S	14	21	35	0.00001
Bacillus_sp._M4U3P1	2592382	S	12	1	13	0.00000
Bacillus_sp._Cs-700	2589818	S	11	18	29	0.00001
Bacillus_subtilis	1423	S	393	6640	7033	0.00167
Bacillus_velezensis	492670	S	153	3181	3334	0.00079
Bacillus_amyloliquefaciens	1390	S	48	1780	1828	0.00044
Bacillus_siamensis	659243	S	18	64	82	0.00002
Bacillus_paralicheniformis	1648923	S	76	54	130	0.00003
Bacillus_mojavensis	72360	S	18	23	41	0.00001
Bacillus_halotolerans	260554	S	10	28	38	0.00001
Bacillus_atrophaeus	1452	S	24	35	59	0.00001
Bacillus_tequilensis	227866	S	24	24	48	0.00001
Bacillus_vallismortis	72361	S	23	31	54	0.00001
Bacillus_licheniformis	1402	S	19	270	289	0.00007
Bacillus_cereus	1396	S	119	2083	2202	0.00052
Bacillus_pseudomycoides	64104	S	70	32	102	0.00002
Bacillus_thuringiensis	1428	S	65	3407	3472	0.00083
Bacillus_mycoides	1405	S	49	86	135	0.00003
Bacillus_cytotoxicus	580165	S	38	26	64	0.00002
Bacillus_wiedmannii	1890302	S	10	18	28	0.00001
Bacillus_luti	2026191	S	10	11	21	0.00001
Bacillus_smithii	1479	S	193	99	292	0.00007
Bacillus_methanolicus	1471	S	122	59	181	0.00004
Bacillus_glycinifermentans	1664069	S	122	44	166	0.00004
Bacillus_dafuensis	1742359	S	87	34	121	0.00003
Bacillus_infantis	324767	S	84	26	110	0.00003
[Brevibacterium]_frigoritolerans	450367	S	81	31	112	0.00003
Bacillus_gobiensis	1441095	S	63	20	83	0.00002
Bacillus_pumilus	1408	S	58	61	119	0.00003
Bacillus_badius	1455	S	45	18	63	0.00002
Bacillus_safensis	561879	S	43	75	118	0.00003
Bacillus_aquiflavi	2672567	S	41	11	52	0.00001
Bacillus_cabrialesii	2487276	S	37	40	77	0.00002
Bacillus_altitudinis	293387	S	33	154	187	0.00004
Bacillus_fonticola	2728853	S	34	10	44	0.00001
Bacillus_weihaiensis	1547283	S	31	11	42	0.00001
Bacillus_shivajii	1983719	S	28	4	32	0.00001
Bacillus_rugosus	2715209	S	17	19	36	0.00001
Parageobacillus_caldoxylosilyticus	81408	S	2418	763	3181	0.00076
Parageobacillus_sp._KH3-4	2916802	S	202	61	263	0.00006
Parageobacillus_thermoglucosidasius	1426	S	180	112	292	0.00007
Parageobacillus_toebii	153151	S	101	60	161	0.00004
Parageobacillus_genomosp._1	1295642	S	82	18	100	0.00002
Anoxybacillus_sediminis	2613334	S	2360	519	2879	0.00069
Anoxybacillus_caldiproteolyticus	247480	S	59	14	73	0.00002
Anoxybacillus_sp._PDR2	1636720	S	13	47	60	0.00001
Anoxybacillus_flavithermus	33934	S	48	54	102	0.00002
Anoxybacillus_amylolyticus	294699	S	47	12	59	0.00001
Neobacillus_drentensis	220684	S	1122	533	1655	0.00039
Neobacillus_mesonae	1193713	S	327	118	445	0.00011
Geobacillus_subterraneus	129338	S	172	94	266	0.00006
Geobacillus_thermocatenulatus	33938	S	48	34	82	0.00002
Geobacillus_thermoleovorans	33941	S	34	232	266	0.00006
Geobacillus_kaustophilus	1462	S	16	78	94	0.00002
Geobacillus_genomosp._3	1921421	S	99	27	126	0.00003
Geobacillus_thermodenitrificans	33940	S	97	357	454	0.00011
Geobacillus_sp._46C-IIa	1963025	S	46	17	63	0.00002
Geobacillus_sp._Y412MC52	550542	S	10	30	40	0.00001
Geobacillus_stearothermophilus	1422	S	83	78	161	0.00004
Cytobacillus_oceanisediminis	665099	S	515	281	796	0.00019
Cytobacillus_firmus	1399	S	122	62	184	0.00004
Cytobacillus_ciccensis	1670641	S	97	38	135	0.00003
Cytobacillus_gottheilii	859144	S	91	32	123	0.00003
Cytobacillus_sp._CY-G	2901381	S	56	21	77	0.00002
Cytobacillus_kochii	859143	S	31	10	41	0.00001
Metabacillus_sediminilitoris	2567941	S	283	113	396	0.00009
Metabacillus_sp._KUDC1714	2745198	S	138	50	188	0.00004
Metabacillus_sp._cB07	2806989	S	49	20	69	0.00002
Metabacillus_sp._B2-18	2897333	S	19	26	45	0.00001
Metabacillus_dongyingensis	2874282	S	57	21	78	0.00002
Metabacillus_litoralis	152268	S	40	39	79	0.00002
Metabacillus_endolithicus	1535204	S	15	18	33	0.00001
Aeribacillus_pallidus	33936	S	550	225	775	0.00018
Mesobacillus_jeotgali	129985	S	157	80	237	0.00006
Mesobacillus_sp._S13	2880221	S	152	84	236	0.00006
Mesobacillus_foraminis	279826	S	145	42	187	0.00004
Hydrogenibacillus_sp._N12	2866627	S	470	51	521	0.00012
Peribacillus_asahii	228899	S	222	120	342	0.00008
Peribacillus_simplex	1478	S	78	51	129	0.00003
Peribacillus_butanolivorans	421767	S	71	27	98	0.00002
Peribacillus_muralis	264697	S	44	11	55	0.00001
Peribacillus_psychrosaccharolyticus	1407	S	38	14	52	0.00001
Alkalihalobacillus_clausii	79880	S	341	66	407	0.00010
Alkalihalobacillus_miscanthi	2598861	S	36	9	45	0.00001
Alkalihalobacillus_sp._LMS39	2924032	S	22	5	27	0.00001
Alkalihalobacillus_krulwichiae	199441	S	19	6	25	0.00001
Alkalihalobacillus_lehensis	300825	S	11	2	13	0.00000
Lysinibacillus_sp._SGAir0095	2070463	S	57	26	83	0.00002
Lysinibacillus_sp._PLM2	2929796	S	33	15	48	0.00001
Lysinibacillus_sp._CD3-6	2892541	S	17	9	26	0.00001
Lysinibacillus_sp._2017	2169540	S	16	7	23	0.00001
Lysinibacillus_sp._Ag94	2936682	S	15	2	17	0.00000
Lysinibacillus_timonensis	2086577	S	36	19	55	0.00001
Lysinibacillus_sphaericus	1421	S	25	42	67	0.00002
Lysinibacillus_fusiformis	28031	S	14	21	35	0.00001
Lysinibacillus_agricola	2590012	S	14	4	18	0.00000
Lysinibacillus_parviboronicapiens	436516	S	12	4	16	0.00000
Caldibacillus_thermoamylovorans	35841	S	286	98	384	0.00009
Oceanobacillus_kimchii	746691	S	163	19	182	0.00004
Oceanobacillus_iheyensis	182710	S	68	15	83	0.00002
Oceanobacillus_zhaokaii	2052660	S	34	7	41	0.00001
Niallia_sp._Man26	2912824	S	137	33	170	0.00004
Niallia_circulans	1397	S	101	31	132	0.00003
Heyndrickxia_oleronia	38875	S	142	55	197	0.00005
Heyndrickxia_vini	1476025	S	48	15	63	0.00002
Virgibacillus_sp._MSP4-1	2700081	S	19	4	23	0.00001
Virgibacillus_sp._Bac332	2419842	S	16	2	18	0.00000
Virgibacillus_sp._NKC19-16	2831673	S	13	1	14	0.00000
Virgibacillus_sp._SK37	403957	S	10	19	29	0.00001
Virgibacillus_phasianinus	2017483	S	20	3	23	0.00001
Virgibacillus_halodenitrificans	1482	S	17	21	38	0.00001
Virgibacillus_necropolis	163877	S	15	2	17	0.00000
Terribacillus_goriensis	386490	S	103	18	121	0.00003
Terribacillus_aidingensis	586416	S	19	3	22	0.00001
Weizmannia_coagulans	1398	S	121	62	183	0.00004
Rossellomorea_marisflavi	189381	S	71	29	100	0.00002
Rossellomorea_vietnamensis	218284	S	34	14	48	0.00001
Halobacillus_sp._SSTM10-2	2932258	S	19	3	22	0.00001
Halobacillus_sp._SSBR10-3	2932257	S	17	2	19	0.00000
Halobacillus_sp._SSHM10-5	2932259	S	14	2	16	0.00000
Halobacillus_halophilus	1570	S	21	2	23	0.00001
Halobacillus_mangrovi	402384	S	16	2	18	0.00000
Halobacillus_litoralis	45668	S	15	2	17	0.00000
Fictibacillus_arsenicus	255247	S	68	14	82	0.00002
Fictibacillus_phosphorivorans	1221500	S	29	6	35	0.00001
Salicibibacter_cibi	2743001	S	25	4	29	0.00001
Salicibibacter_cibarius	2743000	S	23	7	30	0.00001
Salicibibacter_halophilus	2502791	S	20	7	27	0.00001
Salicibibacter_kimchii	2099786	S	16	1	17	0.00000
Sutcliffiella_horikoshii	79883	S	55	16	71	0.00002
Sutcliffiella_cohnii	33932	S	41	19	60	0.00001
Salisediminibacterium_selenitireducens	85683	S	52	8	60	0.00001
Salisediminibacterium_beveridgei	632773	S	28	4	32	0.00001
Caldalkalibacillus_thermarum	296745	S	74	14	88	0.00002
Gottfriedia_acidiceleris	371036	S	72	23	95	0.00002
Psychrobacillus_sp._INOP01	2829187	S	31	10	41	0.00001
Psychrobacillus_glaciei	2283160	S	25	8	33	0.00001
Gracilibacillus_salitolerans	2663022	S	26	3	29	0.00001
Gracilibacillus_sp._SSWR10-1	2932256	S	14	4	18	0.00000
Lentibacillus_amyloliquefaciens	1472767	S	22	3	25	0.00001
Lentibacillus_sp._CBA3610	2518176	S	17	1	18	0.00000
Halalkalibacterium_halodurans	86665	S	34	23	57	0.00001
Radiobacillus_sp._80	2844358	S	16	3	19	0.00000
Radiobacillus_deserti	2594883	S	14	3	17	0.00000
Lederbergia_lenta	1467	S	31	8	39	0.00001
Pradoshia_sp._D12	2651284	S	30	9	39	0.00001
Pontibacillus_sp._ALD_SL1	2777185	S	16	2	18	0.00000
Pontibacillus_sp._HMF3514	2692425	S	13	2	15	0.00000
Evansella_cellulosilytica	1413	S	25	3	28	0.00001
Anaerobacillus_isosaccharinicus	1532552	S	24	5	29	0.00001
Sediminibacillus_sp._DP4-553-S	2729421	S	24	4	28	0.00001
Salimicrobium_jeotgali	1230341	S	21	3	24	0.00001
Alkalihalophilus_pseudofirmus	79885	S	17	3	20	0.00000
Mangrovibacillus_cuniculi	2593652	S	13	7	20	0.00000
Amphibacillus_xylanus	1449	S	11	2	13	0.00000
Paraliobacillus_zengyii	2213194	S	10	1	11	0.00000
Paenibacillus_sp._32O-W	1695218	S	1489	129	1618	0.00039
Paenibacillus_sp._B01	2660554	S	605	167	772	0.00018
Paenibacillus_sp._RUD330	2023772	S	370	37	407	0.00010
Paenibacillus_sp._H1-7	2282849	S	214	18	232	0.00006
Paenibacillus_sp._JNUCC-32	2777984	S	182	310	492	0.00012
Paenibacillus_sp._Y412MC10	481743	S	177	285	462	0.00011
Paenibacillus_sp._R14(2021)	2859228	S	164	22	186	0.00004
Paenibacillus_sp._YPD9-1	2908839	S	151	18	169	0.00004
Paenibacillus_sp._sptzw28	715179	S	129	11	140	0.00003
Paenibacillus_sp._JZ16	1906272	S	125	26	151	0.00004
Paenibacillus_sp._CAA11	1532905	S	103	18	121	0.00003
Paenibacillus_sp._BIHB4019	1870819	S	97	7	104	0.00002
Paenibacillus_sp._URB8-2	2741301	S	95	20	115	0.00003
Paenibacillus_sp._HWE-109	1306526	S	86	6	92	0.00002
Paenibacillus_sp._PAMC21692	2762320	S	72	53	125	0.00003
Paenibacillus_sp._DCT19	2211212	S	71	11	82	0.00002
Paenibacillus_sp._PK3_47	2072642	S	69	8	77	0.00002
Paenibacillus_sp._FSL_R7-0273	1536772	S	58	8	66	0.00002
Paenibacillus_sp._481	2835869	S	57	5	62	0.00001
Paenibacillus_sp._FSL_H7-0357	1536774	S	56	6	62	0.00001
Paenibacillus_sp._YPG26	2878915	S	50	9	59	0.00001
Paenibacillus_sp._FSL_R7-0331	1536773	S	44	6	50	0.00001
Paenibacillus_sp._JNUCC-31	2777983	S	39	9	48	0.00001
Paenibacillus_sp._FSL_R5-0912	1536771	S	39	16	55	0.00001
Paenibacillus_sp._FSL_P4-0081	1536769	S	37	17	54	0.00001
Paenibacillus_sp._IHB_B_3084	867076	S	35	17	52	0.00001
Paenibacillus_sp._E222	2748863	S	30	9	39	0.00001
Paenibacillus_sp._19GGS1-52	2758563	S	30	2	32	0.00001
Paenibacillus_sp._N3/727	2925845	S	19	19	38	0.00001
Paenibacillus_sp._IHBB_10380	1566358	S	19	3	22	0.00001
Paenibacillus_sp._Cedars	1980674	S	17	85	102	0.00002
Paenibacillus_sp._FSL_R5-0345	1536770	S	12	2	14	0.00000
Paenibacillus_sp._FSL_H7-0737	1536775	S	12	3	15	0.00000
Paenibacillus_sp._M-152	2487928	S	10	132	142	0.00003
Paenibacillus_cellulositrophicus	562959	S	700	65	765	0.00018
Paenibacillus_mucilaginosus	61624	S	615	45	660	0.00016
Paenibacillus_albicereus	2726185	S	490	127	617	0.00015
Paenibacillus_lycopersici	2704462	S	426	49	475	0.00011
Paenibacillus_cellulosilyticus	375489	S	363	43	406	0.00010
Paenibacillus_konkukensis	2020716	S	310	30	340	0.00008
Paenibacillus_ihbetae	1870820	S	271	35	306	0.00007
Paenibacillus_macerans	44252	S	269	22	291	0.00007
Paenibacillus_beijingensis	1126833	S	232	25	257	0.00006
Paenibacillus_rhizovicinus	2704463	S	207	26	233	0.00006
Paenibacillus_dendritiformis	130049	S	185	29	214	0.00005
Paenibacillus_chitinolyticus	79263	S	157	17	174	0.00004
Paenibacillus_naphthalenovorans	162209	S	155	20	175	0.00004
Paenibacillus_stellifer	169760	S	147	24	171	0.00004
Paenibacillus_durus	44251	S	146	50	196	0.00005
Paenibacillus_thiaminolyticus	49283	S	140	21	161	0.00004
Paenibacillus_lautus	1401	S	130	140	270	0.00006
Paenibacillus_polymyxa	1406	S	118	390	508	0.00012
Paenibacillus_protaetiae	2509456	S	118	16	134	0.00003
Paenibacillus_xylanilyticus	248903	S	112	22	134	0.00003
Paenibacillus_donghaensis	414771	S	102	9	111	0.00003
Paenibacillus_sabinae	365617	S	99	22	121	0.00003
Paenibacillus_albus	2495582	S	93	12	105	0.00003
Paenibacillus_azoreducens	116718	S	93	10	103	0.00002
Paenibacillus_agaridevorans	171404	S	82	78	160	0.00004
Paenibacillus_algicola	2565926	S	77	12	89	0.00002
Paenibacillus_yonginensis	1462996	S	72	27	99	0.00002
Paenibacillus_riograndensis	483937	S	33	29	62	0.00001
Paenibacillus_sonchi	373687	S	15	25	40	0.00001
Paenibacillus_sophorae	1333845	S	71	22	93	0.00002
Paenibacillus_physcomitrellae	1619311	S	66	20	86	0.00002
Paenibacillus_tritici	1873425	S	60	8	68	0.00002
Paenibacillus_swuensis	1178515	S	60	8	68	0.00002
Paenibacillus_guangzhouensis	1473112	S	59	5	64	0.00002
Paenibacillus_borealis	160799	S	58	18	76	0.00002
Paenibacillus_lentus	1338368	S	55	5	60	0.00001
Paenibacillus_baekrokdamisoli	1712516	S	54	5	59	0.00001
Paenibacillus_psychroresistens	1778678	S	53	2	55	0.00001
Paenibacillus_tianjinensis	2810347	S	51	8	59	0.00001
Paenibacillus_lutimineralis	2707005	S	50	6	56	0.00001
Paenibacillus_bovis	1616788	S	49	5	54	0.00001
Paenibacillus_graminis	189425	S	40	18	58	0.00001
Paenibacillus_larvae	1464	S	39	4	43	0.00001
Paenibacillus_alvei	44250	S	39	4	43	0.00001
Paenibacillus_jilunlii	682956	S	35	20	55	0.00001
Paenibacillus_barcinonensis	198119	S	34	5	39	0.00001
Paenibacillus_odorifer	189426	S	34	5	39	0.00001
Paenibacillus_kribbensis	172713	S	31	10	41	0.00001
Paenibacillus_pabuli	1472	S	31	10	41	0.00001
Paenibacillus_crassostreae	1763538	S	21	3	24	0.00001
Paenibacillus_uliginis	683737	S	21	19	40	0.00001
Paenibacillus_terrae	159743	S	21	9	30	0.00001
Paenibacillus_brasilensis	128574	S	20	8	28	0.00001
Paenibacillus_xylanexedens	528191	S	16	10	26	0.00001
Paenibacillus_peoriae	59893	S	15	75	90	0.00002
Paenibacillus_antarcticus	253703	S	14	2	16	0.00000
Paenibacillus_glucanolyticus	59843	S	12	61	73	0.00002
Brevibacillus_marinus	2496837	S	1233	186	1419	0.00034
Brevibacillus_choshinensis	54911	S	535	117	652	0.00016
Brevibacillus_composti	2796470	S	271	62	333	0.00008
Brevibacillus_agri	51101	S	253	60	313	0.00007
Brevibacillus_sp._MMS20-4M-10-Y	2895522	S	119	15	134	0.00003
Brevibacillus_sp._HD3.3A	2738979	S	28	116	144	0.00003
Brevibacillus_sp._DP1.3A	2738867	S	18	15	33	0.00001
Brevibacillus_brevis	1393	S	129	65	194	0.00005
Brevibacillus_laterosporus	1465	S	50	45	95	0.00002
Brevibacillus_formosus	54913	S	18	15	33	0.00001
Brevibacillus_parabrevis	54914	S	18	77	95	0.00002
Thermobacillus_composti	377615	S	1708	209	1917	0.00046
Cohnella_candidum	2674991	S	648	78	726	0.00017
Cohnella_sp._LGH	1619153	S	224	66	290	0.00007
Cohnella_sp._MFER-1	2728023	S	127	17	144	0.00003
Cohnella_cholangitidis	2598458	S	112	20	132	0.00003
Cohnella_abietis	2507935	S	36	4	40	0.00001
Saccharibacillus_brassicae	2583377	S	305	33	338	0.00008
Aneurinibacillus_soli	1500254	S	74	142	216	0.00005
Alicyclobacillus_acidocaldarius	405212	S	574	47	621	0.00015
Alicyclobacillus_mengziensis	2931921	S	244	16	260	0.00006
Alicyclobacillus_acidoterrestris	1450	S	69	10	79	0.00002
Alicyclobacillus_sp._SO9	2665646	S	51	3	54	0.00001
Alicyclobacillus_sp._TC	2606450	S	16	2	18	0.00000
Tumebacillus_avium	1903704	S	406	178	584	0.00014
Tumebacillus_algifaecis	1214604	S	152	56	208	0.00005
Kyrpidia_spormannii	2055160	S	152	64	216	0.00005
Kyrpidia_tusciae	33943	S	75	44	119	0.00003
Effusibacillus_dendaii	2743772	S	57	7	64	0.00002
Planococcus_plakortidis	1038856	S	63	40	103	0.00002
Planococcus_sp._MB-3u-03	2058136	S	23	17	40	0.00001
Planococcus_sp._107-1	2908840	S	18	8	26	0.00001
Planococcus_maritimus	192421	S	40	18	58	0.00001
Planococcus_rifietoensis	200991	S	31	25	56	0.00001
Planococcus_glaciei	459472	S	30	9	39	0.00001
Planococcus_lenghuensis	2213202	S	28	6	34	0.00001
Planococcus_antarcticus	161360	S	25	8	33	0.00001
Planococcus_halotolerans	2233542	S	18	5	23	0.00001
Planococcus_massiliensis	1499687	S	16	4	20	0.00000
Planococcus_versutus	1302659	S	11	5	16	0.00000
Planococcus_donghaensis	414778	S	10	6	16	0.00000
Sporosarcina_sp._Marseille-Q4063	2810514	S	19	12	31	0.00001
Sporosarcina_sp._Te-1	2818390	S	16	6	22	0.00001
Sporosarcina_ureae	1571	S	25	13	38	0.00001
Sporosarcina_ureilytica	298596	S	13	17	30	0.00001
Ureibacillus_thermosphaericus	51173	S	33	31	64	0.00002
Ureibacillus_thermophilus	367743	S	27	12	39	0.00001
Solibacillus_silvestris	76853	S	24	8	32	0.00001
Rummeliibacillus_stabekisii	241244	S	24	11	35	0.00001
Paenisporosarcina_antarctica	417367	S	11	3	14	0.00000
Paenisporosarcina_cavernae	2320858	S	11	6	17	0.00000
Kurthia_zopfii	1650	S	10	6	16	0.00000
Jeotgalibacillus_malaysiensis	1508404	S	17	5	22	0.00001
Viridibacillus_sp._JNUCC-6	2779527	S	13	4	17	0.00000
Staphylococcus_aureus	1280	S	35	196	231	0.00006
Staphylococcus_haemolyticus	1283	S	22	24	46	0.00001
Staphylococcus_epidermidis	1282	S	13	182	195	0.00005
Staphylococcus_pseudintermedius	283734	S	10	9	19	0.00000
Macrococcus_brunensis	198483	S	12	8	20	0.00000
Jeotgalicoccus_sp._WY2	2708346	S	14	2	16	0.00000
Jeotgalicoccus_saudimassiliensis	1461582	S	11	0	11	0.00000
Salinicoccus_halodurans	407035	S	10	3	13	0.00000
Exiguobacterium_alkaliphilum	1428684	S	88	28	116	0.00003
Exiguobacterium_sp._N4-1P	2051906	S	16	10	26	0.00001
Exiguobacterium_sp._Helios	2735868	S	15	7	22	0.00001
Exiguobacterium_sp._PFWT01	2829816	S	10	22	32	0.00001
Exiguobacterium_mexicanum	340146	S	57	19	76	0.00002
Exiguobacterium_acetylicum	41170	S	27	46	73	0.00002
Exiguobacterium_antarcticum	132920	S	15	5	20	0.00000
Exiguobacterium_sibiricum	332410	S	12	5	17	0.00000
Listeria_weihenstephanensis	1006155	S	18	4	22	0.00001
Listeria_monocytogenes	1639	S	14	10	24	0.00001
Listeria_innocua	1642	S	11	20	31	0.00001
Sporolactobacillus_terrae	269673	S	44	6	50	0.00001
Limosilactobacillus_pontis	35787	S	45	23	68	0.00002
Limosilactobacillus_fermentum	1613	S	31	42	73	0.00002
Limosilactobacillus_panis	47493	S	16	6	22	0.00001
Limosilactobacillus_reuteri	1598	S	13	10	23	0.00001
Lactobacillus_delbrueckii	1584	S	41	96	137	0.00003
Levilactobacillus_zymae	267363	S	47	19	66	0.00002
Levilactobacillus_brevis	1580	S	16	7	23	0.00001
Levilactobacillus_suantsaii	2292255	S	16	6	22	0.00001
Lacticaseibacillus_casei	1582	S	19	7	26	0.00001
Lacticaseibacillus_rhamnosus	47715	S	18	4	22	0.00001
Lacticaseibacillus_manihotivorans	88233	S	13	4	17	0.00000
Lacticaseibacillus_paracasei	1597	S	10	18	28	0.00001
Schleiferilactobacillus_harbinensis	304207	S	36	4	40	0.00001
Lactiplantibacillus_pentosus	1589	S	11	11	22	0.00001
Loigolactobacillus_coryniformis	1610	S	15	14	29	0.00001
Secundilactobacillus_paracollinoides	240427	S	17	7	24	0.00001
Periweissella_cryptocerci	2506420	S	10	1	11	0.00000
Amylolactobacillus_amylophilus	1603	S	10	11	21	0.00001
Streptococcus_sanguinis	1305	S	14	20	34	0.00001
Streptococcus_oralis	1303	S	13	68	81	0.00002
Streptococcus_suis	1307	S	11	36	47	0.00001
Enterococcus_casseliflavus	37734	S	14	36	50	0.00001
Enterococcus_avium	33945	S	13	8	21	0.00001
Dolosigranulum_pigrum	29394	S	10	3	13	0.00000
Pseudoclostridium_thermosuccinogenes	84032	S	473	109	582	0.00014
Faecalibacterium_prausnitzii	853	S	328	301	629	0.00015
Dysosmobacter_sp._Marseille-Q4140	2830675	S	132	62	194	0.00005
Dysosmobacter_welbionis	2093857	S	113	80	193	0.00005
Flavonifractor_plautii	292800	S	241	60	301	0.00007
Ethanoligenens_harbinense	253239	S	130	6	136	0.00003
Vescimonas_coprocola	2714355	S	65	52	117	0.00003
Vescimonas_fastidiosa	2714353	S	42	58	100	0.00002
Acetivibrio_thermocellus	1515	S	55	38	93	0.00002
Acetivibrio_clariflavus	288965	S	35	23	58	0.00001
Anaerotruncus_colihominis	169435	S	101	51	152	0.00004
Acutalibacter_muris	1796620	S	94	4	98	0.00002
Caproiciproducens_sp._NJN-50	2507162	S	92	10	102	0.00002
Ruthenibacterium_lactatiformans	1550024	S	89	23	112	0.00003
Oscillibacter_sp._NSJ-62	2763056	S	84	27	111	0.00003
Caproicibacter_fermentans	2576756	S	67	3	70	0.00002
Ruminococcus_champanellensis	1161942	S	35	4	39	0.00001
Pusillibacter_faecalis	2714358	S	47	29	76	0.00002
Solibaculum_mannosilyticum	2780922	S	36	30	66	0.00002
Caproicibacterium_lactatifermentans	2666138	S	13	1	14	0.00000
Caproicibacterium_amylolyticum	2766537	S	11	0	11	0.00000
Thermoclostridium_stercorarium	1510	S	20	7	27	0.00001
Ruminiclostridium_herbifermentans	2488810	S	10	2	12	0.00000
Mageeibacillus_indolicus	884684	S	11	14	25	0.00001
Thermaerobacter_sp._FW80	2546351	S	748	140	888	0.00021
Thermaerobacter_sp._PB12/4term	2293838	S	444	99	543	0.00013
Thermaerobacter_marianensis	73919	S	556	127	683	0.00016
Intestinimonas_butyriciproducens	1297617	S	134	50	184	0.00004
Flintibacter_sp._KGMB00164	2610895	S	91	12	103	0.00002
Aminipila_terrae	2697030	S	16	2	18	0.00000
Aminipila_luticellarii	2507160	S	14	2	16	0.00000
Emergencia_timonensis	1776384	S	19	6	25	0.00001
Massilistercora_timonensis	2086584	S	43	42	85	0.00002
Carboxydocella_thermautotrophica	178899	S	37	3	40	0.00001
Symbiobacterium_thermophilum	2734	S	1209	99	1308	0.00031
[Clostridium]_hylemonae	89153	S	36	10	46	0.00001
[Clostridium]_scindens	29347	S	32	12	44	0.00001
Lachnoclostridium_phocaeense	1871021	S	28	22	50	0.00001
Lachnoclostridium_sp._YL32	1834196	S	12	25	37	0.00001
Anaerocolumna_sedimenticola	2696063	S	68	4	72	0.00002
Anaerocolumna_cellulosilytica	433286	S	21	1	22	0.00001
Anaerocolumna_chitinilytica	1727145	S	10	0	10	0.00000
Blautia_sp._NBRC_113351	2877527	S	23	25	48	0.00001
Blautia_producta	33035	S	11	2	13	0.00000
Lachnospiraceae_bacterium_NSJ-38	2763669	S	28	10	38	0.00001
Lachnospiraceae_bacterium_NSJ-29	2763667	S	21	6	27	0.00001
Roseburia_hominis	301301	S	34	40	74	0.00002
Enterocloster_bolteae	208479	S	41	12	53	0.00001
Butyrivibrio_fibrisolvens	831	S	22	6	28	0.00001
Coprococcus_comes	410072	S	10	17	27	0.00001
Anaerostipes_caccae	105841	S	11	2	13	0.00000
Lacrimispora_saccharolytica	84030	S	16	1	17	0.00000
Herbinix_luporum	1679721	S	21	13	34	0.00001
Anaerotignum_propionicum	28446	S	13	1	14	0.00000
Clostridium_sp._BNL1100	755731	S	32	3	35	0.00001
Clostridium_sp._SY8519	1042156	S	23	6	29	0.00001
Clostridium_sp._M62/1	411486	S	19	23	42	0.00001
Clostridium_sp._'deep_sea'	2779445	S	14	0	14	0.00000
Clostridium_botulinum	1491	S	23	33	56	0.00001
Clostridium_perfringens	1502	S	19	7	26	0.00001
Clostridium_beijerinckii	1520	S	18	50	68	0.00002
Clostridium_kluyveri	1534	S	17	1	18	0.00000
Clostridium_tyrobutyricum	1519	S	15	1	16	0.00000
Clostridium_pasteurianum	1501	S	13	2	15	0.00000
Clostridium_formicaceticum	1497	S	12	3	15	0.00000
Hungatella_hathewayi	154046	S	52	2	54	0.00001
Alkaliphilus_oremlandii	461876	S	10	2	12	0.00000
Geosporobacter_ferrireducens	1424294	S	20	4	24	0.00001
Candidatus_Desulforudis_audaxviator	471827	S	203	12	215	0.00005
Desulforamulus_ruminis	1564	S	46	6	52	0.00001
Desulforamulus_ferrireducens	1833852	S	37	23	60	0.00001
Acididesulfobacillus_acetoxydans	1561005	S	60	2	62	0.00001
Candidatus_Formimonas_warabiya	1761012	S	42	2	44	0.00001
Thermanaerosceptrum_fracticalcis	1712410	S	28	3	31	0.00001
Dehalobacterium_formicoaceticum	51515	S	22	3	25	0.00001
Desulfofarcimen_acetoxidans	58138	S	15	1	16	0.00000
Christensenella_sp._Marseille-P3954	2086585	S	184	91	275	0.00007
Christensenella_minuta	626937	S	51	14	65	0.00002
Heliomicrobium_modesticaldum	35701	S	213	88	301	0.00007
Heliorestis_convoluta	356322	S	10	0	10	0.00000
Desulfitobacterium_hafniense	49338	S	36	7	43	0.00001
Desulfitobacterium_dehalogenans	36854	S	16	3	19	0.00000
Desulfosporosinus_youngiae	339862	S	28	9	37	0.00001
Desulfosporosinus_acidiphilus	885581	S	16	3	19	0.00000
Desulfosporosinus_orientis	1563	S	10	2	12	0.00000
Dehalobacter_restrictus	55583	S	15	18	33	0.00001
Syntrophobotulus_glycolicus	51197	S	21	1	22	0.00001
Eubacterium_limosum	1736	S	20	37	57	0.00001
Eubacterium_callanderi	53442	S	13	20	33	0.00001
Acetobacterium_sp._KB-1	2184575	S	31	12	43	0.00001
Acetobacterium_wieringae	52694	S	26	16	42	0.00001
Alkalibacter_sp._ES005	2815577	S	15	0	15	0.00000
Syntrophothermus_lipocalidus	86170	S	45	5	50	0.00001
Candidatus_Contubernalis_alkalaceticum	338645	S	13	0	13	0.00000
Syntrophomonas_wolfei	863	S	12	3	15	0.00000
Clostridioides_difficile	1496	S	11	17	28	0.00001
Peptoclostridium_acidaminophilum	1731	S	15	3	18	0.00000
Desulfoscipio_gibsoniae	102134	S	36	2	38	0.00001
Thermincola_potens	863643	S	25	2	27	0.00001
Desulfotomaculum_nigrificans	1565	S	24	10	34	0.00001
Caloranaerobacter_azorensis	116090	S	13	1	14	0.00000
Moorella_sp._Hama-1	2138101	S	128	37	165	0.00004
Moorella_glycerini	55779	S	81	10	91	0.00002
Moorella_thermoacetica	1525	S	77	19	96	0.00002
Ammonifex_degensii	42838	S	110	4	114	0.00003
Gelria_sp._Kuro-4	2796927	S	247	18	265	0.00006
Thermacetogenium_phaeum	85874	S	157	130	287	0.00007
Carboxydothermus_hydrogenoformans	129958	S	59	6	65	0.00002
Thermanaeromonas_toyohensis	161154	S	19	0	19	0.00000
Thermoanaerobacterium_thermosaccharolyticum	1517	S	21	19	40	0.00001
Mahella_australiensis	252966	S	31	15	46	0.00001
Zhaonella_formicivorans	2528593	S	19	2	21	0.00001
Halothermothrix_orenii	31909	S	16	4	20	0.00000
Iocasia_fonsfrigidae	2682810	S	14	3	17	0.00000
Anoxybacter_fermentans	1323375	S	18	15	33	0.00001
Thermosediminibacter_oceani	291990	S	58	3	61	0.00001
Biomaibacter_acetigenes	2316383	S	28	2	30	0.00001
Natranaerofaba_carboxydovora	2742683	S	12	1	13	0.00000
Koleobacter_methoxysyntrophicus	2751313	S	11	0	11	0.00000
Selenomonas_sp._oral_taxon_126	712528	S	156	37	193	0.00005
Selenomonas_sp._oral_taxon_920	1884263	S	95	19	114	0.00003
Selenomonas_sp._oral_taxon_136	713030	S	33	52	85	0.00002
Selenomonas_sp._oral_taxon_478	712538	S	23	39	62	0.00001
Selenomonas_sputigena	69823	S	249	17	266	0.00006
Selenomonas_timonae	2754044	S	86	34	120	0.00003
Selenomonas_ruminantium	971	S	36	2	38	0.00001
Sporomusa_termitida	2377	S	48	5	53	0.00001
Methylomusa_anaerophila	1930071	S	29	1	30	0.00001
Pelosinus_fermentans	365349	S	11	2	13	0.00000
Megasphaera_stantonii	2144175	S	71	37	108	0.00003
Megasphaera_elsdenii	907	S	61	35	96	0.00002
Megasphaera_massiliensis	1232428	S	39	13	52	0.00001
Acidaminococcus_fermentans	905	S	50	7	57	0.00001
Acidaminococcus_intestini	187327	S	14	0	14	0.00000
Phascolarctobacterium_succinatutens	626940	S	20	43	63	0.00002
Phascolarctobacterium_faecium	33025	S	14	1	15	0.00000
Limnochorda_pilosa	1555112	S	718	27	745	0.00018
Peptoniphilus_ivorii	54006	S	45	8	53	0.00001
Murdochiella_vaginalis	1852373	S	23	17	40	0.00001
Tissierella_sp._JN-28	2507161	S	13	2	15	0.00000
Schnuerera_ultunensis	45497	S	11	3	14	0.00000
Gottschalkia_acidurici	1556	S	17	1	18	0.00000
Ezakiella_coagulans	46507	S	16	36	52	0.00001
Allobaculum_sp._Allo2	2853432	S	26	4	30	0.00001
Allobaculum_mucolyticum	2834459	S	23	4	27	0.00001
Faecalibaculum_rodentium	1702221	S	29	7	36	0.00001
Ndongobacter_massiliensis	1871025	S	27	17	44	0.00001
endosymbiont_'TC1'_of_Trimyema_compressum	243899	S	12	0	12	0.00000
Sphaerobacter_thermophilus	2057	S	5721	257	5978	0.00142
Thermomicrobium_roseum	500	S	461	6	467	0.00011
Roseiflexus_sp._RS-1	357808	S	611	97	708	0.00017
Roseiflexus_castenholzii	120962	S	535	100	635	0.00015
Chloroflexus_aurantiacus	1108	S	199	18	217	0.00005
Chloroflexus_aggregans	152260	S	166	25	191	0.00005
Tepidiforma_bonchosmolovskayae	2601677	S	988	38	1026	0.00024
Candidatus_Promineofilum_breve	1806508	S	903	16	919	0.00022
Anaerolinea_thermophila	167964	S	217	20	237	0.00006
Pelolinea_submarina	913107	S	168	7	175	0.00004
Brevefilum_fermentans	1986204	S	73	2	75	0.00002
Caldilinea_aerophila	133453	S	469	21	490	0.00012
Dehalogenimonas_formicexedens	1839801	S	101	31	132	0.00003
Dehalogenimonas_sp._GP	1536648	S	81	24	105	0.00003
Dehalococcoides_mccartyi	61435	S	31	71	102	0.00002
Ktedonosporobacter_rubrisoli	2509675	S	238	5	243	0.00006
Thermobaculum_terrenum	166501	S	203	25	228	0.00005
Phototrophicus_methaneseepsis	2710758	S	140	1	141	0.00003
Deinococcus_sp._NW-56	2080419	S	388	46	434	0.00010
Deinococcus_sp._TS-293	2737050	S	382	34	416	0.00010
Deinococcus_sp._KNUC1210	2917691	S	255	9	264	0.00006
Deinococcus_sp._AJ005	2652443	S	190	14	204	0.00005
Deinococcus_sp._QL22	2939437	S	130	8	138	0.00003
Deinococcus_maricopensis	309887	S	477	38	515	0.00012
Deinococcus_gobiensis	502394	S	471	54	525	0.00013
Deinococcus_ficus	317577	S	466	37	503	0.00012
Deinococcus_metallilatus	1211322	S	461	44	505	0.00012
Deinococcus_actinosclerus	1768108	S	454	209	663	0.00016
Deinococcus_irradiatisoli	2202254	S	354	28	382	0.00009
Deinococcus_wulumuqiensis	980427	S	296	86	382	0.00009
Deinococcus_peraridilitoris	432329	S	291	13	304	0.00007
Deinococcus_radiopugnans	57497	S	269	27	296	0.00007
Deinococcus_radiodurans	1299	S	245	645	890	0.00021
Deinococcus_geothermalis	68909	S	229	29	258	0.00006
Deinococcus_soli_(ex_Cha_et_al._2016)	1309411	S	207	146	353	0.00008
Deinococcus_deserti	310783	S	166	10	176	0.00004
Deinococcus_proteolyticus	55148	S	157	26	183	0.00004
Deinococcus_psychrotolerans	2489213	S	141	3	144	0.00003
Deinococcus_radiophilus	32062	S	94	14	108	0.00003
Deinococcus_puniceus	1182568	S	67	8	75	0.00002
Thermus_thermophilus	274	S	276	269	545	0.00013
Thermus_aquaticus	271	S	134	18	152	0.00004
Thermus_sp._CCB_US3_UF1	1111069	S	110	15	125	0.00003
Thermus_sp._NEB1569	2918899	S	21	35	56	0.00001
Thermus_oshimai	56957	S	130	23	153	0.00004
Thermus_brockianus	56956	S	87	16	103	0.00002
Thermus_caldilimi	2483360	S	42	9	51	0.00001
Thermus_parvatiensis	456163	S	30	131	161	0.00004
Thermus_scotoductus	37636	S	17	23	40	0.00001
Meiothermus_silvanus	52022	S	234	39	273	0.00007
Meiothermus_taiwanensis	172827	S	199	84	283	0.00007
Meiothermus_ruber	277	S	172	77	249	0.00006
Oceanithermus_profundus	187137	S	702	73	775	0.00018
Marinithermus_hydrothermalis	186192	S	424	74	498	0.00012
Truepera_radiovictrix	332249	S	584	30	614	0.00015
Synechococcus_sp._CBW1004	1353136	S	238	70	308	0.00007
Synechococcus_sp._RSCCF101	2511069	S	189	43	232	0.00006
Synechococcus_sp._CBW1107	2789857	S	154	34	188	0.00004
Synechococcus_sp._CB0101	232348	S	114	29	143	0.00003
Synechococcus_sp._SynAce01	1916956	S	105	12	117	0.00003
Synechococcus_sp._CBW1108	1353147	S	98	15	113	0.00003
Synechococcus_sp._PCC_7336	195250	S	97	3	100	0.00002
Synechococcus_sp._JA-3-3Ab	321327	S	96	30	126	0.00003
Synechococcus_sp._NB0720_10	2907159	S	86	26	112	0.00003
Synechococcus_sp._LA31	2741953	S	82	22	104	0.00002
Synechococcus_sp._LTW-R	2751170	S	76	21	97	0.00002
Synechococcus_sp._RS9909	221352	S	69	32	101	0.00002
Synechococcus_sp._JA-2-3B'a(2-13)	321332	S	63	18	81	0.00002
Synechococcus_sp._HK01-R	2751171	S	57	11	68	0.00002
Synechococcus_sp._A10-1-5-1	2936507	S	51	13	64	0.00002
Synechococcus_sp._PROS-U-1	1400866	S	41	8	49	0.00001
Synechococcus_sp._KORDI-100	1280380	S	40	3	43	0.00001
Synechococcus_sp._A15-127	1050624	S	38	49	87	0.00002
Synechococcus_sp._MEDNS5	1442554	S	38	15	53	0.00001
Synechococcus_sp._Minos11	221341	S	33	2	35	0.00001
Synechococcus_sp._BMK-MC-1	1442551	S	32	16	48	0.00001
Synechococcus_sp._KORDI-52	585425	S	30	11	41	0.00001
Synechococcus_sp._WH_8101	59932	S	29	12	41	0.00001
Synechococcus_sp._BIOS-E4-1	1400864	S	29	3	32	0.00001
Synechococcus_sp._NOUM97013	1442555	S	27	4	31	0.00001
Synechococcus_sp._KORDI-49	585423	S	25	32	57	0.00001
Synechococcus_sp._PCC_6312	195253	S	25	1	26	0.00001
Synechococcus_sp._CC9902	316279	S	22	2	24	0.00001
Synechococcus_sp._PROS-7-1	1442556	S	22	12	34	0.00001
Synechococcus_sp._BIOS-U3-1	1400865	S	20	2	22	0.00001
Synechococcus_sp._CBW1002	1353134	S	19	212	231	0.00006
Synechococcus_sp._ROS8604	1442557	S	19	6	25	0.00001
Synechococcus_sp._PROS-9-1	1968775	S	17	5	22	0.00001
Synechococcus_sp._MIT_S9220	166309	S	17	2	19	0.00000
Synechococcus_sp._A15-44	1050646	S	17	39	56	0.00001
Synechococcus_sp._PCC_7003	374981	S	16	6	22	0.00001
Synechococcus_sp._RS9907	221350	S	14	42	56	0.00001
Synechococcus_sp._A15-62	1050657	S	13	11	24	0.00001
Synechococcus_sp._A15-60	1050655	S	10	93	103	0.00002
Synechococcus_sp._TAK9802	1442558	S	10	31	41	0.00001
Synechococcus_elongatus	32046	S	92	5	97	0.00002
Dactylococcopsis_salina	292566	S	18	8	26	0.00001
Cyanobium_sp._NIES-981	1851505	S	188	63	251	0.00006
Cyanobium_sp._NS01	261284	S	156	58	214	0.00005
Cyanobium_gracile	59930	S	290	63	353	0.00008
Parasynechococcus_marenigrum	2881428	S	61	19	80	0.00002
Prochlorococcus_marinus	1219	S	28	4	32	0.00001
Acaryochloris_marina	155978	S	21	3	24	0.00001
Acaryochloris_sp._'Moss_Beach'	2740837	S	18	11	29	0.00001
Chamaesiphon_minutus	1173032	S	34	2	36	0.00001
Nostoc_sp._UHCC_0870	2914041	S	27	10	37	0.00001
Nostoc_sp._UHCC_0702	2814655	S	26	7	33	0.00001
Nostoc_sp._C052	2576902	S	25	13	38	0.00001
Nostoc_sp._NIES-4103	2005458	S	23	7	30	0.00001
Nostoc_sp._TCL26-01	2576904	S	18	3	21	0.00001
Nostoc_sp._CENA543	1869241	S	17	3	20	0.00000
Nostoc_sp._ATCC_53789	76335	S	13	52	65	0.00002
Nostoc_sp._MS1	2764711	S	13	5	18	0.00000
Nostoc_sp._PCC_7524	28072	S	13	3	16	0.00000
Nostoc_linckia	92942	S	34	14	48	0.00001
Nostoc_edaphicum	264686	S	22	11	33	0.00001
Nostoc_punctiforme	272131	S	20	26	46	0.00001
Nostoc_piscinale	224012	S	16	9	25	0.00001
Nostoc_flagelliforme	1306274	S	15	9	24	0.00001
Nostoc_sphaeroides	446679	S	13	11	24	0.00001
Nostoc_commune	1178	S	10	5	15	0.00000
Anabaena_cylindrica	1165	S	24	11	35	0.00001
Anabaena_sp._WA102	1647413	S	10	46	56	0.00001
Cylindrospermum_stagnale	142864	S	16	5	21	0.00001
Richelia_sinica	1357545	S	10	2	12	0.00000
Calothrix_sp._PCC_7716	2853227	S	45	23	68	0.00002
Calothrix_sp._PCC_7507	99598	S	30	8	38	0.00001
Calothrix_sp._NIES-2100	1954172	S	28	18	46	0.00001
Calothrix_sp._336/3	1337936	S	24	6	30	0.00001
Calothrix_sp._NIES-3974	2005462	S	23	2	25	0.00001
Calothrix_sp._NIES-2098	1954171	S	21	12	33	0.00001
Calothrix_brevissima	938406	S	32	24	56	0.00001
Calothrix_parasitica	1973486	S	30	2	32	0.00001
Scytonema_sp._NIES-4073	2005464	S	67	33	100	0.00002
Scytonema_sp._HK-05	1137095	S	32	10	42	0.00001
Brasilonema_sennae	1397703	S	27	3	30	0.00001
Sphaerospermopsis_kisseleviana	289435	S	26	8	34	0.00001
Sphaerospermopsis_torques-reginae	984207	S	22	6	28	0.00001
Nodularia_sphaerocarpa	137816	S	20	5	25	0.00001
Nodularia_spumigena	70799	S	15	0	15	0.00000
Anabaenopsis_circularis	109266	S	17	23	40	0.00001
Dolichospermum_compactum	136073	S	10	34	44	0.00001
Fischerella_sp._NIES-3754	1752063	S	35	15	50	0.00001
Fischerella_sp._NIES-4106	2005456	S	17	3	20	0.00000
Tolypothrix_sp._PCC_7910	2099387	S	23	9	32	0.00001
Tolypothrix_tenuis	457083	S	10	7	17	0.00000
Rivularia_sp._PCC_7116	373994	S	17	1	18	0.00000
Leptolyngbya_sp._7M	2812896	S	679	49	728	0.00017
Leptolyngbya_sp._BL0902	1115757	S	71	5	76	0.00002
Leptolyngbya_sp._NIES-3755	1752064	S	24	1	25	0.00001
Leptolyngbya_boryana	1184	S	25	0	25	0.00001
Kovacikia_minuta	2931930	S	60	7	67	0.00002
Leptothermofonsia_sichuanensis	2917832	S	45	5	50	0.00001
Leptodesmis_sichuanensis	2906798	S	42	6	48	0.00001
Halomicronema_hongdechloris	1209493	S	48	2	50	0.00001
Thermosynechococcus_sp._NK55a	1394889	S	10	13	23	0.00001
Pseudanabaena_sp._PCC_7367	82654	S	20	0	20	0.00000
Pseudanabaena_sp._ABRG5-3	685565	S	12	0	12	0.00000
Gloeobacter_kilaueensis	1416614	S	291	9	300	0.00007
Gloeobacter_violaceus	33072	S	224	136	360	0.00009
Gloeobacter_morelensis	2907343	S	187	103	290	0.00007
Anthocerotibacter_panamensis	2857077	S	74	3	77	0.00002
Geitlerinema_sp._PCC_7407	1173025	S	159	28	187	0.00004
Allocoleopsis_franciscana	2886352	S	33	4	37	0.00001
Moorena_producens	1155739	S	128	3	131	0.00003
Oscillatoria_acuminata	118323	S	36	2	38	0.00001
Oscillatoria_nigro-viridis	482564	S	24	15	39	0.00001
Oxynema_aestuarii	2874213	S	79	8	87	0.00002
Microcoleus_vaginatus	119532	S	40	19	59	0.00001
[Phormidium]_sp._ETS-05	222819	S	41	3	44	0.00001
Crinalium_epipsammum	241425	S	11	1	12	0.00000
Gloeothece_citriformis	2546356	S	16	1	17	0.00000
Gloeothece_verrucosa	2546359	S	11	0	11	0.00000
Halothece_sp._PCC_7418	65093	S	17	6	23	0.00001
Crocosphaera_subtropica	2546360	S	20	2	22	0.00001
Rippkaea_orientalis	2546366	S	12	1	13	0.00000
Microcystis_aeruginosa	1126	S	36	42	78	0.00002
Gloeocapsa_sp._PCC_7428	1173026	S	24	3	27	0.00001
Cyanobacterium_aponinum	379064	S	10	2	12	0.00000
Chroococcidiopsis_sp._CCMEE_29	155894	S	47	9	56	0.00001
Chroococcidiopsis_sp._CCNUC1	2653189	S	12	19	31	0.00001
Chroococcidiopsis_thermalis	54299	S	11	19	30	0.00001
Pleurocapsa_sp._PCC_7327	118163	S	35	4	39	0.00001
Gloeomargarita_lithophora	1188228	S	19	0	19	0.00000
Fimbriimonas_ginsengisoli	1005039	S	764	4	768	0.00018
Chthonomonas_calidirosea	454171	S	131	1	132	0.00003
Mycoplasmopsis_maculosa	114885	S	12	38	50	0.00001
Alteracholeplasma_palmae	38986	S	13	4	17	0.00000
Gemmatirosa_kalamazoonesis	861299	S	76781	6562	83343	0.01984
Gemmatimonas_groenlandica	2732249	S	6419	784	7203	0.00171
Gemmatimonas_aurantiaca	173480	S	4688	513	5201	0.00124
Gemmatimonas_phototrophica	1379270	S	3892	580	4472	0.00106
Hymenobacter_sp._PAMC_26628	1484118	S	265	70	335	0.00008
Hymenobacter_sp._5317J-9	2932250	S	249	62	311	0.00007
Hymenobacter_sp._PAMC_26554	1484116	S	241	24	265	0.00006
Hymenobacter_sp._BRD128	2675878	S	214	30	244	0.00006
Hymenobacter_sp._APR13	1356852	S	211	91	302	0.00007
Hymenobacter_sp._5116S-3	2932248	S	143	23	166	0.00004
Hymenobacter_sp._BT18	2835648	S	142	19	161	0.00004
Hymenobacter_sp._5116S-27	2932249	S	128	21	149	0.00004
Hymenobacter_sp._DG01	2584940	S	124	35	159	0.00004
Hymenobacter_sp._NBH84	2596915	S	123	19	142	0.00003
Hymenobacter_sp._5413J-13	2932251	S	118	17	135	0.00003
Hymenobacter_sp._5420S-77	2932254	S	114	16	130	0.00003
Hymenobacter_sp._S2-20-2	2761579	S	110	18	128	0.00003
Hymenobacter_sp._DG25B	1385664	S	104	40	144	0.00003
Hymenobacter_sp._BRD67	2675877	S	87	92	179	0.00004
Hymenobacter_sp._DG25A	1385663	S	64	25	89	0.00002
Hymenobacter_sp._HDW8	2714932	S	50	179	229	0.00005
Hymenobacter_sp._5516S-25	2933777	S	32	139	171	0.00004
Hymenobacter_sp._5516J-16	2932253	S	25	115	140	0.00003
Hymenobacter_monticola	1705399	S	273	54	327	0.00008
Hymenobacter_busanensis	2607656	S	246	28	274	0.00007
Hymenobacter_sedentarius	1411621	S	223	35	258	0.00006
Hymenobacter_nivis	1850093	S	212	59	271	0.00006
Hymenobacter_oligotrophus	2319843	S	194	21	215	0.00005
Hymenobacter_jejuensis	2502781	S	155	12	167	0.00004
Hymenobacter_tibetensis	497967	S	123	20	143	0.00003
Hymenobacter_swuensis	1446467	S	112	26	138	0.00003
Hymenobacter_baengnokdamensis	2615203	S	85	101	186	0.00004
Hymenobacter_qilianensis	1385715	S	68	13	81	0.00002
Hymenobacter_radiodurans	2496028	S	32	120	152	0.00004
Pontibacter_russatus	2694929	S	252	25	277	0.00007
Pontibacter_actiniarum	323450	S	133	31	164	0.00004
Pontibacter_akesuensis	388950	S	97	14	111	0.00003
Pontibacter_pudoricolor	2694930	S	41	4	45	0.00001
Pontibacter_sp._SGAir0037	2571030	S	39	6	45	0.00001
Pontibacter_korlensis	400092	S	36	5	41	0.00001
Rufibacter_radiotolerans	1379910	S	79	9	88	0.00002
Rufibacter_sp._DG15C	1379909	S	55	28	83	0.00002
Rufibacter_tibetensis	512763	S	50	8	58	0.00001
Adhaeribacter_swui	2086471	S	50	4	54	0.00001
Adhaeribacter_radiodurans	2745197	S	37	2	39	0.00001
Nibribacter_ruber	2698458	S	56	27	83	0.00002
Spirosoma_sp._CJU-R4	2728024	S	173	13	186	0.00004
Spirosoma_sp._KUDC1026	2745947	S	93	8	101	0.00002
Spirosoma_sp._RHs26	2898794	S	69	5	74	0.00002
Spirosoma_sp._KCTC_42546	2520506	S	68	10	78	0.00002
Spirosoma_sp._KCTC_72228	2710596	S	40	5	45	0.00001
Spirosoma_rigui	564064	S	121	8	129	0.00003
Spirosoma_taeanense	2735870	S	101	8	109	0.00003
Spirosoma_montaniterrae	1178516	S	86	5	91	0.00002
Spirosoma_pollinicola	2057025	S	75	8	83	0.00002
Spirosoma_radiotolerans	1379870	S	68	4	72	0.00002
Spirosoma_endbachense	2666025	S	67	31	98	0.00002
Spirosoma_aerolatum	1211326	S	57	2	59	0.00001
Spirosoma_aureum	2692134	S	25	14	39	0.00001
Rhodocytophaga_rosea	2704465	S	40	1	41	0.00001
Aquirufa_sp._9H-EGSE	2696560	S	13	4	17	0.00000
Aquirufa_nivalisilvae	2516557	S	12	3	15	0.00000
Cytophaga_hutchinsonii	985	S	27	2	29	0.00001
Dyadobacter_fermentans	94254	S	171	14	185	0.00004
Dyadobacter_sp._LJ419	2906456	S	43	3	46	0.00001
Dyadobacter_sp._NIV53	2861765	S	30	1	31	0.00001
Dyadobacter_sandarakinus	2747268	S	73	6	79	0.00002
Fibrella_aestuarina	651143	S	171	16	187	0.00004
Fibrella_sp._ES10-3-2-2	1834519	S	82	7	89	0.00002
Runella_slithyformis	106	S	83	7	90	0.00002
Runella_rosea	2259595	S	33	3	36	0.00001
Runella_sp._SP2	2268026	S	28	1	29	0.00001
Larkinella_sp._IE-0392	2907205	S	58	3	61	0.00001
Leadbetterella_byssophila	316068	S	12	6	18	0.00000
Arcticibacterium_luteifluviistationis	1784714	S	10	0	10	0.00000
Chryseolinea_soli	2321403	S	495	18	513	0.00012
Fulvivirga_sp._SS9-22	2904245	S	24	1	25	0.00001
Fulvivirga_sp._SW1-E11	2904247	S	22	7	29	0.00001
Fulvivirga_sp._W9P-11	2904246	S	18	4	22	0.00001
Fulvivirga_lutea	2810512	S	18	1	19	0.00000
Echinicola_soli	2591634	S	25	2	27	0.00001
Echinicola_vietnamensis	390884	S	19	10	29	0.00001
Echinicola_strongylocentroti	1795355	S	19	3	22	0.00001
Echinicola_rosea	1807691	S	17	8	25	0.00001
Echinicola_sp._SCS_3-6	2859768	S	11	4	15	0.00000
Algoriphagus_sp._Y33	2772483	S	18	1	19	0.00000
Algoriphagus_sanaruensis	1727163	S	23	2	25	0.00001
Aquiflexum_balticum	280473	S	22	4	26	0.00001
Cyclobacterium_amurskyense	320787	S	10	0	10	0.00000
Mongoliitalea_daihaiensis	2782006	S	12	1	13	0.00000
Marivirga_tractuosa	1006	S	16	5	21	0.00001
Mangrovivirga_cuniculi	2715131	S	11	0	11	0.00000
Niastella_koreensis	354356	S	1405	127	1532	0.00036
Chitinophaga_sp._XS-30	2604421	S	180	55	235	0.00006
Chitinophaga_sp._KRA15-503	2829818	S	109	49	158	0.00004
Chitinophaga_filiformis	104663	S	250	31	281	0.00007
Chitinophaga_oryzae	2725414	S	154	18	172	0.00004
Chitinophaga_pinensis	79329	S	102	16	118	0.00003
Chitinophaga_agri	2703787	S	98	19	117	0.00003
Chitinophaga_alhagiae	2203219	S	85	1	86	0.00002
Chitinophaga_caeni	2029983	S	62	9	71	0.00002
Flavisolibacter_ginsenosidimutans	661481	S	417	23	440	0.00010
Flavisolibacter_tropicus	1492898	S	239	32	271	0.00006
Panacibacter_ginsenosidivorans	1813871	S	450	18	468	0.00011
Paraflavitalea_soli	2315862	S	432	28	460	0.00011
Niabella_soli	446683	S	127	14	141	0.00003
Niabella_ginsenosidivorans	1176587	S	115	11	126	0.00003
Pseudocnuella_soli	2502779	S	234	25	259	0.00006
Arachidicoccus_sp._BS20	1850526	S	91	33	124	0.00003
Arachidicoccus_sp._B3-10	2545455	S	32	2	34	0.00001
Arachidicoccus_sp._5GH13-10	2875539	S	30	4	34	0.00001
Arachidicoccus_soli	2341117	S	37	3	40	0.00001
Arachidicoccus_ginsenosidivorans	496057	S	35	5	40	0.00001
Pseudobacter_ginsenosidimutans	661488	S	231	17	248	0.00006
Ferruginibacter_sp._KIS38-8	2875540	S	136	12	148	0.00004
Ferruginibacter_lapsinanis	563172	S	81	7	88	0.00002
Flavihumibacter_sp._IMCC34838	2838156	S	123	9	132	0.00003
Flavihumibacter_sp._IMCC34837	2838157	S	96	5	101	0.00002
Lacibacter_sp._S13-6-6	2760713	S	204	8	212	0.00005
Filimonas_lacunae	477680	S	105	11	116	0.00003
Phnomibacter_ginsenosidimutans	2676868	S	100	10	110	0.00003
Flavobacterium_sp._HJ-32-4	1160795	S	57	5	62	0.00001
Flavobacterium_sp._F-29	2893883	S	32	10	42	0.00001
Flavobacterium_sp._MDT1-60	1979344	S	29	8	37	0.00001
Flavobacterium_sp._CJ74	2294119	S	22	2	24	0.00001
Flavobacterium_sp._IGB_4-14	1871076	S	20	2	22	0.00001
Flavobacterium_sp._Sr18	935222	S	19	4	23	0.00001
Flavobacterium_sp._140616W15	2478552	S	19	6	25	0.00001
Flavobacterium_sp._KBS0721	1179672	S	16	7	23	0.00001
Flavobacterium_sp._M31R6	2739062	S	15	3	18	0.00000
Flavobacterium_sp._SLB02	2665645	S	15	4	19	0.00000
Flavobacterium_sp._CLA17	2724135	S	13	3	16	0.00000
Flavobacterium_sp._F-340	2893886	S	13	5	18	0.00000
Flavobacterium_sp._I3-2	2748319	S	13	29	42	0.00001
Flavobacterium_sp._B183	907046	S	12	3	15	0.00000
Flavobacterium_sp._F-70	2893884	S	12	3	15	0.00000
Flavobacterium_sp._MMS21-Er5	2937442	S	11	7	18	0.00000
Flavobacterium_sp._GENT5	1751095	S	11	3	14	0.00000
Flavobacterium_sp._KSM-R2A30	2897181	S	10	5	15	0.00000
Flavobacterium_sp._F-323	2893885	S	10	3	13	0.00000
Flavobacterium_sp._CHNK8	2871165	S	10	14	24	0.00001
Flavobacterium_commune	1306519	S	124	29	153	0.00004
Flavobacterium_album	2175091	S	37	3	40	0.00001
Flavobacterium_magnum	2162713	S	32	5	37	0.00001
Flavobacterium_johnsoniae	986	S	27	20	47	0.00001
Flavobacterium_gilvum	1492737	S	27	5	32	0.00001
Flavobacterium_anhuiense	459526	S	23	13	36	0.00001
Flavobacterium_nackdongense	2547394	S	21	2	23	0.00001
Flavobacterium_crocinum	2183896	S	17	7	24	0.00001
Flavobacterium_pallidum	2172098	S	17	2	19	0.00000
Flavobacterium_inviolabile	2748320	S	14	3	17	0.00000
Flavobacterium_alkalisoli	2602769	S	14	1	15	0.00000
Flavobacterium_sangjuense	2518177	S	14	2	16	0.00000
Flavobacterium_enshiense	1341165	S	14	2	16	0.00000
Flavobacterium_endoglycinae	2816357	S	13	4	17	0.00000
Flavobacterium_crassostreae	1763534	S	12	4	16	0.00000
Flavobacterium_haoranii	683124	S	12	7	19	0.00000
Flavobacterium_jumunjinense	998845	S	11	2	13	0.00000
Flavobacterium_fluviale	2249356	S	10	5	15	0.00000
Capnocytophaga_gingivalis	1017	S	21	10	31	0.00001
Capnocytophaga_haemolytica	45243	S	15	4	19	0.00000
Capnocytophaga_canimorsus	28188	S	10	17	27	0.00001
Muricauda_sp._SCSIO_65647	2908843	S	19	0	19	0.00000
Muricauda_aquimarina	254955	S	20	18	38	0.00001
Muricauda_oceani	2698672	S	15	14	29	0.00001
Muricauda_ruestringensis	111501	S	14	1	15	0.00000
Gramella_fulva	2126553	S	20	2	22	0.00001
Gramella_sp._GC03-9	2920386	S	11	5	16	0.00000
Gramella_flava	1486245	S	15	7	22	0.00001
Robiginitalea_biformata	252307	S	75	5	80	0.00002
Winogradskyella_forsetii	2686077	S	15	9	24	0.00001
Nonlabens_spongiae	331648	S	22	18	40	0.00001
Antarcticibacterium_flavum	2058175	S	16	6	22	0.00001
Antarcticibacterium_sp._1MA-6-2	2908210	S	14	3	17	0.00000
Formosa_sp._Hel3_A1_48	1336795	S	10	4	14	0.00000
Sinomicrobium_sp._HD2P242	2900738	S	32	1	33	0.00001
Maribacter_sp._HTCC2170	313603	S	10	6	16	0.00000
Aequorivita_sp._H23M31	2494375	S	10	14	24	0.00001
Myroides_odoratus	256	S	11	5	16	0.00000
Flagellimonas_sp._CMM7	2654676	S	11	1	12	0.00000
Kordia_antarctica	1218801	S	10	2	12	0.00000
Zobellia_galactanivorans	63186	S	17	1	18	0.00000
Zunongwangia_sp._SCSIO_43204	2779359	S	11	14	25	0.00001
Euzebyella_marina	1761453	S	15	16	31	0.00001
Arenibacter_algicola	616991	S	15	9	24	0.00001
Zhouia_spongiae	2202721	S	14	6	20	0.00000
Constantimarinum_furrinae	2562285	S	14	2	16	0.00000
Galbibacter_sp._BG1	1170699	S	14	2	16	0.00000
Amniculibacterium_sp._G2-70	2767188	S	13	25	38	0.00001
Aggregatimonas_sangjinii	2583587	S	13	1	14	0.00000
Flavobacteriaceae_bacterium_10Alg115	2584122	S	13	1	14	0.00000
Wenyingzhuangia_fucanilytica	1790137	S	11	3	14	0.00000
Pukyongia_salina	2094025	S	10	1	11	0.00000
Aegicerativicinus_sediminis	2893202	S	10	0	10	0.00000
Costertonia_aggregata	343403	S	10	4	14	0.00000
Chryseobacterium_sp._Y16C	2920939	S	20	26	46	0.00001
Chryseobacterium_sp._6424	2039166	S	19	8	27	0.00001
Chryseobacterium_sp.	1871047	S	14	7	21	0.00001
Chryseobacterium_sp._IHB_B_17019	1721091	S	13	4	17	0.00000
Chryseobacterium_sp._MEBOG07	2879939	S	13	7	20	0.00000
Chryseobacterium_sp._SC2-2	2929800	S	12	9	21	0.00001
Chryseobacterium_sp._ZHDP1	2838877	S	12	16	28	0.00001
Chryseobacterium_sp._cx-624	2758037	S	10	2	12	0.00000
Chryseobacterium_taklimakanense	536441	S	28	22	50	0.00001
Chryseobacterium_indologenes	253	S	24	21	45	0.00001
Chryseobacterium_camelliae	1265445	S	20	17	37	0.00001
Chryseobacterium_piperi	558152	S	15	3	18	0.00000
Chryseobacterium_arthrosphaerae	651561	S	15	14	29	0.00001
Chryseobacterium_indoltheticum	254	S	14	7	21	0.00001
Chryseobacterium_gleum	250	S	13	32	45	0.00001
Chryseobacterium_daecheongense	192389	S	13	4	17	0.00000
Chryseobacterium_shandongense	1493872	S	12	13	25	0.00001
Chryseobacterium_gallinarum	1324352	S	11	6	17	0.00000
Chryseobacterium_lactis	1241981	S	10	15	25	0.00001
Kaistella_sp._97-N-M2	2908645	S	15	4	19	0.00000
Kaistella_antarctica	266748	S	10	2	12	0.00000
Kaistella_daneshvariae	2487074	S	10	2	12	0.00000
Elizabethkingia_anophelis	1117645	S	28	36	64	0.00002
Elizabethkingia_meningoseptica	238	S	10	1	11	0.00000
Cruoricaptor_ignavus	1118202	S	37	6	43	0.00001
Ornithobacterium_rhinotracheale	28251	S	20	19	39	0.00001
Fluviicola_taffensis	191579	S	85	6	91	0.00002
Owenweeksia_hongkongensis	253245	S	18	0	18	0.00000
Croceimicrobium_hydrocarbonivorans	2761580	S	14	2	16	0.00000
Blattabacterium_cuenoti	1653831	S	23	7	30	0.00001
Rhodocaloribacter_litoris	2558931	S	1449	147	1596	0.00038
Rhodothermus_marinus	29549	S	1244	68	1312	0.00031
Salinibacter_ruber	146919	S	788	12	800	0.00019
Alistipes_communis	2585118	S	180	141	321	0.00008
Alistipes_onderdonkii	328813	S	177	216	393	0.00009
Alistipes_finegoldii	214856	S	168	148	316	0.00008
Alistipes_dispar	2585119	S	159	17	176	0.00004
Alistipes_senegalensis	1288121	S	144	28	172	0.00004
Alistipes_megaguti	2364787	S	134	13	147	0.00004
Alistipes_shahii	328814	S	106	56	162	0.00004
Alistipes_indistinctus	626932	S	100	21	121	0.00003
Alistipes_sp._dk3624	2662363	S	85	18	103	0.00002
Prevotella_sp._Rep29	2691580	S	22	2	24	0.00001
Prevotella_sp._E13-17	2913616	S	22	5	27	0.00001
Prevotella_sp._E2-28	2913620	S	15	6	21	0.00001
Prevotella_sp._oral_taxon_475	712471	S	14	1	15	0.00000
Prevotella_sp._E15-22	2937774	S	12	6	18	0.00000
Prevotella_sp._E9-3	2913621	S	11	4	15	0.00000
Prevotella_dentalis	52227	S	79	17	96	0.00002
Prevotella_denticola	28129	S	36	14	50	0.00001
Prevotella_multiformis	282402	S	25	14	39	0.00001
Prevotella_ruminicola	839	S	20	0	20	0.00000
Prevotella_melaninogenica	28132	S	16	6	22	0.00001
Prevotella_intermedia	28131	S	15	8	23	0.00001
Prevotella_copri	165179	S	14	6	20	0.00000
Prevotella_enoeca	76123	S	14	3	17	0.00000
Prevotella_buccalis	28127	S	13	15	28	0.00001
Prevotella_bryantii	77095	S	10	0	10	0.00000
Paraprevotella_xylaniphila	454155	S	13	11	24	0.00001
Pseudoprevotella_muciniphila	2133944	S	12	0	12	0.00000
Bacteroides_sp._CBA7301	2715212	S	16	3	19	0.00000
Bacteroides_sp._M10	2763022	S	11	22	33	0.00001
Bacteroides_thetaiotaomicron	818	S	25	16	41	0.00001
Bacteroides_zoogleoformans	28119	S	25	6	31	0.00001
Bacteroides_fragilis	817	S	23	53	76	0.00002
Bacteroides_eggerthii	28111	S	22	23	45	0.00001
Bacteroides_cellulosilyticus	246787	S	14	5	19	0.00000
Bacteroides_stercoris	46506	S	14	14	28	0.00001
Bacteroides_helcogenes	290053	S	12	0	12	0.00000
Bacteroides_uniformis	820	S	12	31	43	0.00001
Bacteroides_xylanisolvens	371601	S	11	26	37	0.00001
Bacteroides_faecis	674529	S	11	9	20	0.00000
Phocaeicola_salanitronis	376805	S	21	9	30	0.00001
Phocaeicola_coprophilus	387090	S	18	9	27	0.00001
Phocaeicola_dorei	357276	S	16	26	42	0.00001
Tannerella_serpentiformis	712710	S	99	4	103	0.00002
Tannerella_forsythia	28112	S	29	4	33	0.00001
Parabacteroides_goldsteinii	328812	S	39	9	48	0.00001
Parabacteroides_merdae	46503	S	25	27	52	0.00001
Parabacteroides_distasonis	823	S	16	40	56	0.00001
Parabacteroides_johnsonii	387661	S	16	13	29	0.00001
Porphyromonas_sp._oral_taxon_275	712435	S	114	11	125	0.00003
Porphyromonas_asaccharolytica	28123	S	24	2	26	0.00001
Porphyromonas_gingivalis	837	S	21	3	24	0.00001
Sodaliphilus_pleomorphus	2606626	S	76	39	115	0.00003
Duncaniella_dubosii	2518971	S	17	4	21	0.00001
Muribaculum_intestinale	1796646	S	19	3	22	0.00001
Muribaculum_gordoncarteri	2530390	S	16	3	19	0.00000
Proteiniphilum_sp._JNU-WLY501	2829812	S	13	1	14	0.00000
Proteiniphilum_saccharofermentans	1642647	S	11	2	13	0.00000
Petrimonas_mucosa	1642646	S	22	2	24	0.00001
Barnesiella_viscericola	397865	S	45	61	106	0.00003
Odoribacter_splanchnicus	28118	S	15	22	37	0.00001
Paludibacter_propionicigenes	185300	S	19	0	19	0.00000
Tenuifilum_thalassicum	2590900	S	11	0	11	0.00000
Draconibacterium_orientale	1168034	S	23	1	24	0.00001
Draconibacterium_halophilum	2706887	S	10	0	10	0.00000
Maribellus_comscasis	2681766	S	11	0	11	0.00000
Alkalitalea_saponilacus	889453	S	12	0	12	0.00000
Mucilaginibacter_sp._14171R-50	2703789	S	54	3	57	0.00001
Mucilaginibacter_sp._SMC90	2929803	S	50	2	52	0.00001
Mucilaginibacter_sp._21P	2778902	S	38	2	40	0.00001
Mucilaginibacter_sp._F39-2	2728022	S	35	2	37	0.00001
Mucilaginibacter_ginsenosidivorans	398053	S	82	2	84	0.00002
Mucilaginibacter_gotjawali	1550579	S	78	2	80	0.00002
Mucilaginibacter_ginsenosidivorax	862126	S	77	3	80	0.00002
Mucilaginibacter_daejeonensis	398049	S	72	4	76	0.00002
Mucilaginibacter_mali	2740462	S	69	2	71	0.00002
Mucilaginibacter_gossypii	551996	S	61	38	99	0.00002
Mucilaginibacter_celer	2305508	S	61	2	63	0.00002
Mucilaginibacter_mallensis	652787	S	58	1	59	0.00001
Mucilaginibacter_xinganensis	1234841	S	56	2	58	0.00001
Mucilaginibacter_rubeus	2027860	S	52	108	160	0.00004
Mucilaginibacter_ginkgonis	2682091	S	47	2	49	0.00001
Mucilaginibacter_paludis	423351	S	45	2	47	0.00001
Pedobacter_sp._HDW13	2714940	S	31	3	34	0.00001
Pedobacter_sp._SW-16	2766984	S	20	3	23	0.00001
Pedobacter_sp._PACM_27299	1727164	S	19	2	21	0.00001
Pedobacter_sp._KBS0701	2578106	S	19	5	24	0.00001
Pedobacter_sp._Q8-18	2895286	S	19	1	20	0.00000
Pedobacter_sp._G11	2482728	S	15	1	16	0.00000
Pedobacter_sp._D749	2856523	S	15	4	19	0.00000
Pedobacter_heparinus	984	S	42	3	45	0.00001
Pedobacter_endophyticus	2789740	S	37	3	40	0.00001
Pedobacter_roseus	336820	S	33	8	41	0.00001
Pedobacter_suwonensis	332999	S	23	4	27	0.00001
Pedobacter_cryoconitis	188932	S	22	2	24	0.00001
Pedobacter_ginsengisoli	363852	S	22	2	24	0.00001
Pedobacter_schmidteae	2201271	S	22	1	23	0.00001
Pedobacter_aquae	2605747	S	17	1	18	0.00000
Pedobacter_steynii	430522	S	16	1	17	0.00000
Sphingobacterium_sp._DR205	2713573	S	86	9	95	0.00002
Sphingobacterium_sp._ML3W	1538644	S	12	4	16	0.00000
Sphingobacterium_sp._dk4302	2662364	S	12	1	13	0.00000
Sphingobacterium_sp._SRCM116780	2907623	S	11	2	13	0.00000
Sphingobacterium_thalpophilum	259	S	44	56	100	0.00002
Sphingobacterium_spiritivorum	258	S	36	28	64	0.00002
Sphingobacterium_multivorum	28454	S	28	69	97	0.00002
Sphingobacterium_lactis	797291	S	25	24	49	0.00001
Sphingobacterium_psychroaquaticum	561061	S	13	2	15	0.00000
Sphingobacterium_mizutaii	1010	S	12	1	13	0.00000
Olivibacter_sp._LS-1	2592345	S	259	11	270	0.00006
Olivibacter_sp._SDN3	2764720	S	23	3	26	0.00001
Anseongella_ginsenosidimutans	496056	S	73	3	76	0.00002
Solitalea_sp._S2-8	2911172	S	34	4	38	0.00001
Solitalea_canadensis	995	S	21	1	22	0.00001
Pseudopedobacter_saltans	151895	S	17	15	32	0.00001
Haliscomenobacter_hydrossis	2350	S	81	1	82	0.00002
Saprospira_grandis	1008	S	16	0	16	0.00000
Candidatus_Sulfidibacterium_hydrothermale	2875962	S	32	1	33	0.00001
Chlorobaculum_limnaeum	274537	S	265	48	313	0.00007
Chlorobaculum_tepidum	1097	S	135	42	177	0.00004
Chlorobaculum_parvum	274539	S	130	28	158	0.00004
Pelodictyon_luteolum	1100	S	118	20	138	0.00003
Pelodictyon_phaeoclathratiforme	34090	S	24	1	25	0.00001
Chlorobium_limicola	1092	S	45	2	47	0.00001
Chlorobium_phaeobacteroides	1096	S	19	2	21	0.00001
Chlorobium_phaeovibrioides	1094	S	13	2	15	0.00000
Prosthecochloris_sp._GSB1	281093	S	90	5	95	0.00002
Prosthecochloris_sp._HL-130-GSB	1974213	S	35	5	40	0.00001
Prosthecochloris_sp._CIB_2401	1868325	S	29	6	35	0.00001
Prosthecochloris_aestuarii	1102	S	32	2	34	0.00001
Chloroherpeton_thalassium	100716	S	46	0	46	0.00001
Candidatus_Cyclonatronum_proteinivorum	1457365	S	89	8	97	0.00002
Melioribacter_roseus	1134405	S	27	2	29	0.00001
Ignavibacterium_album	591197	S	19	2	21	0.00001
Candidatus_Cloacimonas_acidaminovorans	456827	S	56	1	57	0.00001
Fibrobacter_succinogenes	833	S	26	0	26	0.00001
Gemmata_obscuriglobus	114	S	4540	692	5232	0.00125
Gemmata_massiliana	1210884	S	1901	740	2641	0.00063
Gemmata_sp._SH-PL17	1630693	S	1790	785	2575	0.00061
Urbifossiella_limnaea	2528023	S	7127	580	7707	0.00183
Frigoriglobus_tundricola	2774151	S	5349	767	6116	0.00146
Limnoglobus_roseus	2598579	S	3133	134	3267	0.00078
Tuwongella_immobilis	692036	S	292	11	303	0.00007
Telmatocola_sphagniphila	1123043	S	234	2	236	0.00006
Aquisphaera_giovannonii	406548	S	3953	634	4587	0.00109
Tautonia_plasticadhaerens	2527974	S	3360	279	3639	0.00087
Paludisphaera_borealis	1387353	S	2575	527	3102	0.00074
Singulisphaera_acidiphila	466153	S	2490	341	2831	0.00067
Isosphaera_pallida	128	S	376	25	401	0.00010
Planctomyces_sp._SH-PL62	1636152	S	2353	776	3129	0.00074
Planctomyces_sp._SH-PL14	1632864	S	1441	87	1528	0.00036
Caulifigura_coniformis	2527983	S	2482	161	2643	0.00063
Gimesia_panareensis	2527978	S	310	35	345	0.00008
Gimesia_chilikensis	2605989	S	171	96	267	0.00006
Gimesia_maris	122	S	129	19	148	0.00004
Gimesia_fumaroli	2527976	S	73	14	87	0.00002
Gimesia_benthica	2608982	S	65	85	150	0.00004
Gimesia_alba	2527973	S	64	10	74	0.00002
Gimesia_algae	2527971	S	60	14	74	0.00002
Gimesia_aquarii	2527964	S	53	3	56	0.00001
Maioricimonas_rarisocia	2528026	S	937	117	1054	0.00025
Alienimonas_californiensis	2527989	S	927	67	994	0.00024
Symmachiella_dynata	2527995	S	318	18	336	0.00008
Planctopirus_ephydatiae	2528019	S	80	31	111	0.00003
Planctopirus_limnophila	120	S	69	25	94	0.00002
Fuerstiella_marisgermanici	1891926	S	189	3	192	0.00005
Rubinisphaera_brasiliensis	119	S	182	18	200	0.00005
Calycomorphotria_hydatis	2528027	S	179	6	185	0.00004
Crateriforma_conspicua	2527996	S	153	28	181	0.00004
Thalassoglobus_polymorphus	2527994	S	65	3	68	0.00002
Polystyrenella_longa	2528007	S	50	4	54	0.00001
Lacipirellula_parvula	2650471	S	870	103	973	0.00023
Lacipirellula_limnantheis	2528024	S	858	117	975	0.00023
Pirellulimonas_nuda	2528009	S	999	102	1101	0.00026
Botrimarina_mediterranea	2528022	S	914	80	994	0.00024
Aeoliella_mucimassa	2527972	S	340	26	366	0.00009
Adhaeretor_mobilis	1930276	S	174	15	189	0.00005
Bythopirellula_goksoeyrii	1400387	S	110	7	117	0.00003
Stieleria_neptunia	2527979	S	352	35	387	0.00009
Stieleria_maiorica	2795974	S	323	58	381	0.00009
Rosistilla_oblonga	2527990	S	237	108	345	0.00008
Rosistilla_carotiformis	2528017	S	124	49	173	0.00004
Rosistilla_ulvae	1930277	S	119	67	186	0.00004
Lignipirellula_cremea	2528010	S	645	66	711	0.00017
Anatilimnocola_aggregata	2528021	S	548	53	601	0.00014
Bremerella_volcania	2527984	S	453	30	483	0.00012
Pirellula_staleyi	125	S	290	10	300	0.00007
Pirellula_sp._SH-Sr6A	1632865	S	117	3	120	0.00003
Roseimaritima_ulvae	980254	S	262	19	281	0.00007
Roseimaritima_multifibrata	1930274	S	87	10	97	0.00002
Rubripirellula_lacrimiformis	1930273	S	164	28	192	0.00005
Mariniblastus_fucicola	980251	S	133	2	135	0.00003
Aureliella_helgolandensis	2527968	S	123	8	131	0.00003
Rhodopirellula_baltica	265606	S	119	7	126	0.00003
Thermogutta_terrifontis	1331910	S	136	3	139	0.00003
Humisphaera_borealis	2807512	S	1502	36	1538	0.00037
Phycisphaera_mikurensis	547188	S	866	68	934	0.00022
Mucisphaera_calidilacus	2527982	S	382	20	402	0.00010
Poriferisphaera_corsica	2528020	S	53	0	53	0.00001
Anaerohalosphaera_lusitana	1936003	S	87	3	90	0.00002
Limihaloglobus_sulfuriphilus	1851148	S	42	2	44	0.00001
Sedimentisphaera_cyanobacteriorum	1940790	S	13	14	27	0.00001
Sedimentisphaera_salicampi	1941349	S	13	2	15	0.00000
Candidatus_Kuenenia_stuttgartiensis	174633	S	26	0	26	0.00001
Candidatus_Uabimicrobium_amorphum	2596890	S	19	0	19	0.00000
Opitutus_terrae	107709	S	2820	155	2975	0.00071
Opitutus_sp._GAS368	1882749	S	1757	305	2062	0.00049
Lacunisphaera_limnophila	1838286	S	1379	219	1598	0.00038
Oleiharenicola_sp._KSB-15	2862869	S	1142	68	1210	0.00029
Nibricoccus_aquaticus	2576891	S	935	47	982	0.00023
Ereboglobus_luteus	1796921	S	726	38	764	0.00018
Ruficoccus_sp._ZRK36	2866311	S	218	33	251	0.00006
Coraliomargarita_akajimensis	395922	S	52	1	53	0.00001
Verrucomicrobium_sp._GAS474	1882831	S	734	80	814	0.00019
Verrucomicrobium_spinosum	2736	S	357	24	381	0.00009
Luteolibacter_ambystomatis	2824561	S	383	30	413	0.00010
Luteolibacter_luteus	2728835	S	381	21	402	0.00010
Roseimicrobium_sp._ORNL1	2711231	S	505	20	525	0.00013
Sulfuriroseicoccus_oceanibius	2707525	S	118	14	132	0.00003
Akkermansia_muciniphila	239935	S	239	30	269	0.00006
Akkermansia_glycaniphila	1679444	S	97	7	104	0.00002
Methylacidimicrobium_sp._AP8	2730359	S	190	28	218	0.00005
Methylacidimicrobium_sp._B4	2796139	S	171	34	205	0.00005
Methylacidiphilum_kamchatkense	431057	S	12	16	28	0.00001
Candidatus_Xiphinematobacter_sp._Idaho_Grape	1704307	S	28	2	30	0.00001
Kiritimatiella_glycovorans	1307763	S	228	265	493	0.00012
Tichowtungia_aerotolerans	2697043	S	97	3	100	0.00002
Candidatus_Protochlamydia_naegleriophila	389348	S	10	17	27	0.00001
Neochlamydia_sp._S13	1353976	S	19	5	24	0.00001
Parachlamydia_acanthamoebae	83552	S	16	6	22	0.00001
Waddlia_chondrophila	71667	S	17	5	22	0.00001
Simkania_negevensis	83561	S	16	2	18	0.00000
Candidatus_Velamenicoccus_archaeovorus	1930593	S	66	0	66	0.00002
Luteitalea_sp._TBR-22	2802971	S	8059	1468	9527	0.00227
Luteitalea_pratensis	1855912	S	6233	731	6964	0.00166
Granulicella_sp._WH15	2602070	S	1011	175	1186	0.00028
Granulicella_sp._5B5	1617967	S	816	128	944	0.00022
Granulicella_mallensis	940614	S	675	74	749	0.00018
Granulicella_tundricola	940615	S	556	67	623	0.00015
Edaphobacter_sp._12200R-103	2703788	S	2033	303	2336	0.00056
Edaphobacter_sp._4G125	2763071	S	484	61	545	0.00013
Terriglobus_roseus	392734	S	895	171	1066	0.00025
Terriglobus_albidus	1592106	S	730	63	793	0.00019
Terriglobus_saanensis	870903	S	448	52	500	0.00012
Acidobacterium_capsulatum	33075	S	841	103	944	0.00022
Acidobacterium_sp._4Y35	2763107	S	806	56	862	0.00021
Candidatus_Koribacter_versatilis	658062	S	1479	47	1526	0.00036
Acidisarcina_polymorpha	2211140	S	577	38	615	0.00015
Paludibaculum_fermentans	1473598	S	2008	50	2058	0.00049
Chloracidobacterium_aggregatum	2851959	S	303	166	469	0.00011
Chloracidobacterium_validum	2821543	S	195	3	198	0.00005
Chloracidobacterium_sp._D	2821536	S	27	129	156	0.00004
Chloracidobacterium_thermophilum	458033	S	19	83	102	0.00002
Sulfidibacter_corallicola	2818388	S	571	12	583	0.00014
Nitrospira_moscoviensis	42253	S	1603	132	1735	0.00041
Nitrospira_japonica	1325564	S	842	94	936	0.00022
Nitrospira_sp._KM1	1936990	S	510	44	554	0.00013
Candidatus_Nitrospira_inopinata	1715989	S	457	37	494	0.00012
Leptospirillum_ferrooxidans	180	S	17	39	56	0.00001
Dissulfurispira_thermophila	2715679	S	31	0	31	0.00001
Thermodesulfovibrio_yellowstonii	28262	S	16	0	16	0.00000
Treponema_brennaborense	81028	S	36	14	50	0.00001
Treponema_primitia	88058	S	33	3	36	0.00001
Treponema_azotonutricium	150829	S	32	2	34	0.00001
Treponema_sp._Marseille-Q4132	2766701	S	13	12	25	0.00001
Treponema_succinifaciens	167	S	15	12	27	0.00001
Treponema_socranskii	53419	S	15	13	28	0.00001
Treponema_medium	58231	S	12	30	42	0.00001
Treponema_parvum	138851	S	11	1	12	0.00000
Spirochaeta_thermophila	154	S	156	5	161	0.00004
Spirochaeta_africana	46355	S	58	5	63	0.00002
Sediminispirochaeta_smaragdinae	55206	S	21	1	22	0.00001
Salinispira_pacifica	1307761	S	19	1	20	0.00000
Sphaerochaeta_associata	1129264	S	26	3	29	0.00001
Sphaerochaeta_coccoides	273376	S	21	1	22	0.00001
Sphaerochaeta_globosa	1131703	S	17	2	19	0.00000
Sphaerochaeta_pleomorpha	1131707	S	14	2	16	0.00000
Breznakiella_homolactica	2798577	S	36	7	43	0.00001
Leptospira_kmetyi	408139	S	26	3	29	0.00001
Leptospira_santarosai	28183	S	25	14	39	0.00001
Leptospira_weilii	28184	S	12	10	22	0.00001
Leptospira_kobayashii	1917830	S	12	0	12	0.00000
Leptospira_tipperaryensis	2564040	S	11	1	12	0.00000
Turneriella_parva	29510	S	77	0	77	0.00002
Pyramidobacter_piscolens	638849	S	182	10	192	0.00005
Fretibacterium_fastidiosum	651822	S	145	2	147	0.00004
Aminomonas_paucivorans	81412	S	141	14	155	0.00004
Cloacibacillus_porcorum	1197717	S	126	25	151	0.00004
Thermanaerovibrio_acidaminovorans	81462	S	56	22	78	0.00002
Thermanaerovibrio_velox	108007	S	24	6	30	0.00001
Jonquetella_anthropi	428712	S	68	10	78	0.00002
Aminobacterium_colombiense	81468	S	24	1	25	0.00001
Acetomicrobium_mobile	97477	S	20	0	20	0.00000
Thermovirga_lienii	336261	S	14	11	25	0.00001
Candidatus_Nanosynbacter_featherlites	2572088	S	38	21	59	0.00001
Candidatus_Nanosynbacter_lyticus	2093824	S	19	68	87	0.00002
Nanosynbacter_sp._HMT-352	2899133	S	12	45	57	0.00001
Candidatus_Saccharimonas_aalborgensis	1332188	S	76	1	77	0.00002
Candidatus_Bipolaricaulis_anaerobius	2026885	S	172	7	179	0.00004
Candidatus_Chazhemtobacterium_aquaticus	2715735	S	16	0	16	0.00000
Candidatus_Babela_massiliensis	673862	S	13	0	13	0.00000
Candidatus_Absconditicoccus_praedator	2735562	S	12	0	12	0.00000
Thermotoga_caldifontis	1508419	S	26	55	81	0.00002
Pseudothermotoga_hypogea	57487	S	11	8	19	0.00000
Mesotoga_infera	1236046	S	16	2	18	0.00000
Thermocrinis_minervae	381751	S	13	9	22	0.00001
Thermosulfidibacter_takaii	412593	S	30	0	30	0.00001
Persephonella_marina	309805	S	13	1	14	0.00000
Sulfurihydrogenibium_azorense	309806	S	12	2	14	0.00000
Thermovibrio_ammonificans	228745	S	25	2	27	0.00001
Thermosulfurimonas_marina	2047767	S	49	8	57	0.00001
Thermosulfuriphilus_ammonigenes	1936021	S	24	1	25	0.00001
Thermodesulfatator_indicus	171695	S	23	4	27	0.00001
Caldithrix_abyssi	187145	S	96	0	96	0.00002
Geovibrio_thiophilus	139438	S	19	4	23	0.00001
Flexistipes_sinusarabici	2352	S	17	2	19	0.00000
Deferribacter_desulfuricans	197162	S	11	2	13	0.00000
Denitrovibrio_acetiphilus	118000	S	11	1	12	0.00000
Desulfurispirillum_indicum	936456	S	70	33	103	0.00002
Elusimicrobium_minutum	423605	S	31	0	31	0.00001
Coprothermobacter_proteolyticus	35786	S	26	5	31	0.00001
Caldisericum_exile	693075	S	20	0	20	0.00000
Atribacter_laminatus	2847778	S	10	0	10	0.00000
Fusarium_oxysporum	5507	S	1222	287	1509	0.00036
Fusarium_acuminatum	5515	S	966	34	1000	0.00024
Fusarium_avenaceum	40199	S	16	0	16	0.00000
Fusarium_sambucinum	5128	S	83	19	102	0.00002
Fusarium_longipes	694270	S	24	0	24	0.00001
Fusarium_poae	36050	S	23	4	27	0.00001
Fusarium_sporotrichioides	5514	S	17	0	17	0.00000
Fusarium_pseudograminearum	101028	S	14	2	16	0.00000
Fusarium_venenatum	56646	S	12	12	24	0.00001
Fusarium_nygamai	42673	S	24	3	27	0.00001
Fusarium_fujikuroi	5127	S	19	1	20	0.00000
Fusarium_thapsinum	120644	S	17	1	18	0.00000
Fusarium_pseudonygamai	47755	S	13	1	14	0.00000
Fusarium_graminum	86546	S	30	1	31	0.00001
Fusarium_heterosporum	42747	S	28	1	29	0.00001
Fusarium_decemcellulare	57161	S	55	0	55	0.00001
Fusarium_scirpi	2211609	S	25	6	31	0.00001
Fusarium_equiseti	61235	S	19	5	24	0.00001
Fusarium_dimerum	57145	S	47	0	47	0.00001
Fusarium_chlamydosporum	86545	S	19	6	25	0.00001
Fusarium_nelsonii	77846	S	17	5	22	0.00001
Fusarium_lateritium	5523	S	34	0	34	0.00001
Fusarium_musae	1042133	S	10	8	18	0.00000
Trichoderma_erinaceum	202914	S	132	12	144	0.00003
Trichoderma_pleuroti	500994	S	84	5	89	0.00002
Trichoderma_reesei	51453	S	68	3	71	0.00002
Trichoderma_citrinoviride	58853	S	66	4	70	0.00002
Trichoderma_afroharzianum	1567482	S	60	7	67	0.00002
Trichoderma_harzianum	5544	S	47	6	53	0.00001
Trichoderma_atroviride	63577	S	37	5	42	0.00001
Trichoderma_koningiopsis	337941	S	36	3	39	0.00001
Trichoderma_gamsii	398673	S	34	2	36	0.00001
Trichoderma_virens	29875	S	32	211	243	0.00006
Trichoderma_hamatum	49224	S	31	1	32	0.00001
Trichoderma_asperellum	101201	S	27	1	28	0.00001
Trichoderma_viride	5547	S	21	182	203	0.00005
Beauveria_pseudobassiana	931006	S	250	40	290	0.00007
Beauveria_felina	37994	S	139	4	143	0.00003
Beauveria_brongniartii	118266	S	33	9	42	0.00001
Beauveria_bassiana	176275	S	30	47	77	0.00002
Beauveria_rudraprayagi	1481906	S	25	37	62	0.00001
Cordyceps_fumosorosea	114497	S	202	8	210	0.00005
Metarhizium_guizhouense	169041	S	138	60	198	0.00005
Metarhizium_album	92629	S	100	2	102	0.00002
Metarhizium_rileyi	1649241	S	67	4	71	0.00002
Metarhizium_acridum	92637	S	44	21	65	0.00002
Metarhizium_humberi	2596975	S	30	15	45	0.00001
Metarhizium_majus	1650735	S	26	9	35	0.00001
Metarhizium_brunneum	500148	S	19	12	31	0.00001
Metarhizium_anisopliae	5530	S	14	15	29	0.00001
Ustilaginoidea_virens	1159556	S	149	4	153	0.00004
Pochonia_chlamydosporia	280754	S	47	2	49	0.00001
Purpureocillium_lilacinum	33203	S	260	9	269	0.00006
Drechmeria_coniospora	98403	S	157	4	161	0.00004
Clonostachys_rosea	29856	S	75	3	78	0.00002
Colletotrichum_higginsianum	80884	S	228	37	265	0.00006
Thermothielavioides_terrestris	2587410	S	403	31	434	0.00010
Thermothelomyces_thermophilus	78579	S	346	18	364	0.00009
Neurospora_crassa	5141	S	183	11	194	0.00005
Pyricularia_oryzae	318829	S	82	23	105	0.00003
Pyricularia_pennisetigena	1578925	S	81	13	94	0.00002
Pyricularia_grisea	148305	S	71	11	82	0.00002
Neopestalotiopsis_rosae	1562205	S	45	36	81	0.00002
Neopestalotiopsis_clavispora	289240	S	29	25	54	0.00001
Botrytis_cinerea	40559	S	33	0	33	0.00001
Aspergillus_luchuensis	1069201	S	5036	164	5200	0.00124
Aspergillus_oryzae	5062	S	112	168	280	0.00007
Aspergillus_flavus	5059	S	93	153	246	0.00006
Aspergillus_chevalieri	182096	S	347	18	365	0.00009
Aspergillus_puulaauensis	1220207	S	52	1	53	0.00001
Aspergillus_fumigatus	746128	S	42	0	42	0.00001
Penicillium_citrinum	5077	S	32	1	33	0.00001
Penicillium_expansum	27334	S	32	9	41	0.00001
Penicillium_chrysogenum	5076	S	27	3	30	0.00001
Penicillium_digitatum	36651	S	25	3	28	0.00001
Penicillium_aurantiogriseum	36655	S	24	5	29	0.00001
Penicillium_italicum	40296	S	16	4	20	0.00000
Paecilomyces_niveus	5093	S	24	0	24	0.00001
Paecilomyces_variotii	264951	S	21	0	21	0.00001
Talaromyces_rugulosus	121627	S	39	1	40	0.00001
Paraphaeosphaeria_minitans	565426	S	103	23	126	0.00003
Ampelomyces_quisqualis	50730	S	54	4	58	0.00001
Zymoseptoria_tritici	1047171	S	53	0	53	0.00001
Cercospora_beticola	122368	S	43	0	43	0.00001
Eremothecium_gossypii	33169	S	28	23	51	0.00001
Saccharomyces_eubayanus	1080349	S	10	0	10	0.00000
Tetrapisispora_phaffii	113608	S	11	0	11	0.00000
Lachancea_thermotolerans	381046	S	16	1	17	0.00000
Kazachstania_naganishii	588726	S	12	0	12	0.00000
Kluyveromyces_marxianus	4911	S	10	4	14	0.00000
Ogataea_parapolymorpha	1005962	S	17	0	17	0.00000
Yarrowia_lipolytica	4952	S	29	0	29	0.00001
Candida_dubliniensis	42374	S	13	1	14	0.00000
Sugiyamaella_lignohabitans	796027	S	10	0	10	0.00000
Pseudozyma_flocculosa	84751	S	356	3	359	0.00009
Ustilago_maydis	5270	S	108	2	110	0.00003
Sporisorium_graminicola	280036	S	84	12	96	0.00002
Malassezia_restricta	76775	S	35	6	41	0.00001
Phlebiopsis_gigantea	82310	S	102	0	102	0.00002
Rhizoctonia_solani	456999	S	32	1	33	0.00001
Marasmius_oreades	181124	S	16	0	16	0.00000
Cryptococcus_neoformans	5207	S	12	0	12	0.00000
Cryptococcus_gattii_VGI	37769	S	11	5	16	0.00000
Phytophthora_cinnamomi	4785	S	233	37	270	0.00006
Phytophthora_fragariae	53985	S	183	25	208	0.00005
Phytophthora_cryptogea	4786	S	115	9	124	0.00003
Phytophthora_infestans	4787	S	94	145	239	0.00006
Phytophthora_boehmeriae	109152	S	61	7	68	0.00002
Phytophthora_cactorum	29920	S	51	7	58	0.00001
Phytophthora_parasitica	4792	S	28	3	31	0.00001
Pythium_aphanidermatum	65070	S	130	3	133	0.00003
