name	taxonomy_id	taxonomy_lvl	kraken_assigned_reads	added_reads	new_est_reads	fraction_total_reads
Streptomyces_sp._WAC_01438	2203204	S	15911	5881	21792	0.00094
Streptomyces_sp._AMCC400023	2056258	S	15076	6535	21611	0.00094
Streptomyces_sp._SCSIO_64649	2878388	S	13243	2705	15948	0.00069
Streptomyces_sp._CB01881	2078691	S	12702	2771	15473	0.00067
Streptomyces_sp._SN-593	659352	S	11592	3079	14671	0.00063
Streptomyces_sp._So13.3	2136173	S	10999	2294	13293	0.00058
Streptomyces_sp._ZYC-3	2797636	S	10748	2337	13085	0.00057
Streptomyces_sp._CdTB01	1725411	S	10366	3245	13611	0.00059
Streptomyces_sp._MA3_2.13	2867410	S	10250	1489	11739	0.00051
Streptomyces_sp._NHF165	2175864	S	9822	1908	11730	0.00051
Streptomyces_sp._SCUT-3	2684469	S	9424	4155	13579	0.00059
Streptomyces_sp._ST1015	1848900	S	9154	2104	11258	0.00049
Streptomyces_sp._BH-MK-02	2880933	S	8911	2110	11021	0.00048
Streptomyces_sp._BJ20	2930049	S	8891	3927	12818	0.00055
Streptomyces_sp._NA02950	2742137	S	8718	1916	10634	0.00046
Streptomyces_sp._Z423-1	2730915	S	8584	2734	11318	0.00049
Streptomyces_sp._3025	2923272	S	8155	1614	9769	0.00042
Streptomyces_sp._P3	2135430	S	8152	2241	10393	0.00045
Streptomyces_sp._891-h	2720714	S	8064	1635	9699	0.00042
Streptomyces_sp._LRE541	2931983	S	8043	2002	10045	0.00043
Streptomyces_sp._SYP-A7193	2662065	S	7969	4902	12871	0.00056
Streptomyces_sp._MG28	2865673	S	7836	2979	10815	0.00047
Streptomyces_sp._SirexAA-E	862751	S	7622	2463	10085	0.00044
Streptomyces_sp._CMB-StM0423	2059884	S	7594	3690	11284	0.00049
Streptomyces_sp._3214.6	1882757	S	7476	2387	9863	0.00043
Streptomyces_sp._GQFP	2907545	S	7390	1391	8781	0.00038
Streptomyces_sp._HM190	2695266	S	7373	2553	9926	0.00043
Streptomyces_sp._MST-110588	2833628	S	7307	1967	9274	0.00040
Streptomyces_sp._A2-16	2781734	S	7302	2473	9775	0.00042
Streptomyces_sp._C8S0	2585716	S	7246	2293	9539	0.00041
Streptomyces_sp._SM18	1736046	S	7198	2160	9358	0.00040
Streptomyces_sp._YIM_121038	2136401	S	7144	2291	9435	0.00041
Streptomyces_sp._MG62	2838015	S	7043	2835	9878	0.00043
Streptomyces_sp._W1SF4	2305220	S	7018	2722	9740	0.00042
Streptomyces_sp._NA04227	2742136	S	6815	1736	8551	0.00037
Streptomyces_sp._QHH-9511	2684468	S	6808	2059	8867	0.00038
Streptomyces_sp._Tu_2975	2676871	S	6803	2343	9146	0.00040
Streptomyces_sp._GMY02	1333528	S	6744	1317	8061	0.00035
Streptomyces_sp._JB150	2714844	S	6731	2499	9230	0.00040
Streptomyces_sp._Go-475	2072505	S	6627	3284	9911	0.00043
Streptomyces_sp._SAT1	1849967	S	6609	2687	9296	0.00040
Streptomyces_sp._DSM_40868	2721173	S	6605	2611	9216	0.00040
Streptomyces_sp._MBT27	1488356	S	6602	2114	8716	0.00038
Streptomyces_sp._NEAU-sy36	2751189	S	6417	2610	9027	0.00039
Streptomyces_sp._GS7	2692234	S	6097	1807	7904	0.00034
Streptomyces_sp._RTd22	1841249	S	5997	2585	8582	0.00037
Streptomyces_sp._RPA4-2	2721244	S	5925	1884	7809	0.00034
Streptomyces_sp._BHT-5-2	2866715	S	5918	2016	7934	0.00034
Streptomyces_sp._CB09001	2083284	S	5793	3939	9732	0.00042
Streptomyces_sp._fd1-xmd	1812480	S	5668	2606	8274	0.00036
Streptomyces_sp._HP-A2021	2927875	S	5614	3274	8888	0.00038
Streptomyces_sp._135	2838850	S	5534	1948	7482	0.00032
Streptomyces_sp._Rer75	2750011	S	5506	2614	8120	0.00035
Streptomyces_sp._INR7	2607753	S	5396	2844	8240	0.00036
Streptomyces_sp._Go_40/10	2825844	S	5368	2535	7903	0.00034
Streptomyces_sp._TN58	234612	S	5351	2560	7911	0.00034
Streptomyces_sp._HSG2	2797167	S	5239	1247	6486	0.00028
Streptomyces_sp._WAC_01529	2203205	S	4870	1852	6722	0.00029
Streptomyces_sp._CCM_MD2014	1561022	S	4817	4341	9158	0.00040
Streptomyces_sp._S4.7	2705439	S	4547	1617	6164	0.00027
Streptomyces_sp._WAC_06738	2203210	S	4318	4203	8521	0.00037
Streptomyces_sp._jing01	2726118	S	4101	2420	6521	0.00028
Streptomyces_sp._CNQ-509	444103	S	4057	3875	7932	0.00034
Streptomyces_sp._WY228	2855836	S	3831	2131	5962	0.00026
Streptomyces_sp._S1D4-11	2721246	S	3658	2692	6350	0.00027
Streptomyces_sp._YPW6	2840373	S	3470	1866	5336	0.00023
Streptomyces_sp._SUK_48	2582831	S	3309	2123	5432	0.00024
Streptomyces_sp._ADI95-16	1522758	S	3161	2774	5935	0.00026
Streptomyces_sp._Mg1	465541	S	2926	2732	5658	0.00024
Streptomyces_sp._AgN23	1188315	S	2731	2483	5214	0.00023
Streptomyces_sp._NA02536	2742133	S	2726	7380	10106	0.00044
Streptomyces_sp._HF10	2692233	S	2665	1918	4583	0.00020
Streptomyces_sp._769	1262452	S	2658	2057	4715	0.00020
Streptomyces_sp._S063	2005885	S	2492	1769	4261	0.00018
Streptomyces_sp._S8	1837283	S	2433	2150	4583	0.00020
Streptomyces_sp._RPA4-5	2721245	S	2375	1578	3953	0.00017
Streptomyces_sp._2323.1	1938841	S	2298	1450	3748	0.00016
Streptomyces_sp._3211	1964449	S	2248	2903	5151	0.00022
Streptomyces_sp._A144	2871487	S	2017	9539	11556	0.00050
Streptomyces_sp._EAS-AB2608	2779671	S	1992	3221	5213	0.00023
Streptomyces_sp._SGAir0924	2109593	S	1867	9598	11465	0.00050
Streptomyces_sp._NEAU-S7GS2	2202000	S	1861	1560	3421	0.00015
Streptomyces_sp._Sge12	1972846	S	1850	2938	4788	0.00021
Streptomyces_sp._ID38640	1265399	S	1832	1336	3168	0.00014
Streptomyces_sp._XC_2026	2782004	S	1756	1576	3332	0.00014
Streptomyces_sp._SS52	2563602	S	1751	8691	10442	0.00045
Streptomyces_sp._WA6-1-16	2879427	S	1700	1759	3459	0.00015
Streptomyces_sp._RLB1-33	2721243	S	1656	4959	6615	0.00029
Streptomyces_sp._PAMC_26508	1265601	S	1656	6201	7857	0.00034
Streptomyces_sp._PBH53	1577075	S	1651	2499	4150	0.00018
Streptomyces_sp._MOE7	1961713	S	1528	1880	3408	0.00015
Streptomyces_sp._HNA39	2850561	S	1511	1763	3274	0.00014
Streptomyces_sp._CB00271	2750025	S	1476	2053	3529	0.00015
Streptomyces_sp._Tue_6075	1661694	S	1442	1684	3126	0.00014
Streptomyces_sp._11-1-2	1851167	S	1399	2681	4080	0.00018
Streptomyces_sp._WAC00303	2933779	S	1278	1880	3158	0.00014
Streptomyces_sp._CFMR_7	1649184	S	1251	2203	3454	0.00015
Streptomyces_sp._S501	2420135	S	1218	4929	6147	0.00027
Streptomyces_sp._CB04723	2748873	S	936	1708	2644	0.00011
Streptomyces_sp._V17-9	2831149	S	923	4521	5444	0.00024
Streptomyces_sp._CB09030	2913412	S	901	3103	4004	0.00017
Streptomyces_sp._M56	1495638	S	900	2460	3360	0.00015
Streptomyces_sp._CLI2509	1984801	S	866	3105	3971	0.00017
Streptomyces_sp._Tu6071	355249	S	837	2679	3516	0.00015
Streptomyces_sp._BSE6.1	2605730	S	794	3731	4525	0.00020
Streptomyces_sp._NA03103	2742134	S	785	5252	6037	0.00026
Streptomyces_sp._M2	646637	S	767	4313	5080	0.00022
Streptomyces_sp._HU2014	2939414	S	694	2451	3145	0.00014
Streptomyces_sp._WAC00288	2094021	S	689	2954	3643	0.00016
Streptomyces_sp._VN1	1821625	S	685	2984	3669	0.00016
Streptomyces_sp._endophyte_N2	2153485	S	671	1995	2666	0.00012
Streptomyces_sp._CRSS-Y-16	2906474	S	650	3868	4518	0.00020
Streptomyces_sp._2114.2	1881022	S	537	3431	3968	0.00017
Streptomyces_sp._A1-5	2738410	S	524	2520	3044	0.00013
Streptomyces_sp._WA1-19	2884220	S	522	2865	3387	0.00015
Streptomyces_sp._R527F	1664033	S	504	2960	3464	0.00015
Streptomyces_sp._KPB2	2305221	S	504	4266	4770	0.00021
Streptomyces_sp._LBUM_1480	2609808	S	496	5158	5654	0.00024
Streptomyces_sp._S1A1-7	2594459	S	452	4525	4977	0.00022
Streptomyces_sp._GF20	2692235	S	446	2583	3029	0.00013
Streptomyces_sp._NBU3104	2911367	S	392	2653	3045	0.00013
Streptomyces_sp._CA-256286	2801033	S	337	2163	2500	0.00011
Streptomyces_sp._FR-008	206662	S	324	2729	3053	0.00013
Streptomyces_sp._604F	1476754	S	315	2953	3268	0.00014
Streptomyces_sp._LBUM_1482	2609809	S	245	6578	6823	0.00030
Streptomyces_sp._RLB3-6	2594457	S	244	8177	8421	0.00036
Streptomyces_sp._RLB3-17	2594455	S	241	4020	4261	0.00018
Streptomyces_sp._GBA_94-10	1218177	S	240	3181	3421	0.00015
Streptomyces_sp._OUCMDZ-3434	1535304	S	227	2469	2696	0.00012
Streptomyces_sp._CC0208	2306165	S	187	5216	5403	0.00023
Streptomyces_sp._PLM4	2929798	S	187	1592	1779	0.00008
Streptomyces_sp._S1D4-20	2594462	S	168	4876	5044	0.00022
Streptomyces_sp._PVA_94-07	1225337	S	161	2466	2627	0.00011
Streptomyces_sp._LBUM_1475	2609807	S	148	4661	4809	0.00021
Streptomyces_sp._A10(2020)	2782013	S	145	1744	1889	0.00008
Streptomyces_sp._S1D4-14	2594461	S	101	7041	7142	0.00031
Streptomyces_sp._RLB1-9	2594454	S	85	5002	5087	0.00022
Streptomyces_sp._S1D4-23	2594463	S	84	4801	4885	0.00021
Streptomyces_sp._ICC4	2099584	S	57	4098	4155	0.00018
Streptomyces_sp._ICC1	2099583	S	43	2671	2714	0.00012
Streptomyces_sp._SM17	565560	S	28	1188	1216	0.00005
Streptomyces_sp._HNM0561	2903099	S	12	2469	2481	0.00011
Streptomyces_sp._KY75	2772433	S	10	3666	3676	0.00016
Streptomyces_venezuelae	54571	S	38763	15618	54381	0.00235
Streptomyces_qaidamensis	1783515	S	10064	4221	14285	0.00062
Streptomyces_cadmiisoli	2184053	S	8254	2078	10332	0.00045
Streptomyces_aurantiacus	47760	S	6671	1607	8278	0.00036
Streptomyces_alboniger	132473	S	4119	1537	5656	0.00024
Streptomyces_koyangensis	188770	S	3187	3203	6390	0.00028
Streptomyces_pristinaespiralis	38300	S	28226	11660	39886	0.00173
Streptomyces_hygroscopicus	1912	S	10936	16527	27463	0.00119
Streptomyces_rapamycinicus	1226757	S	6569	1583	8152	0.00035
Streptomyces_violaceusniger	68280	S	2839	1888	4727	0.00020
Streptomyces_yatensis	155177	S	2709	1982	4691	0.00020
Streptomyces_malaysiensis	92644	S	763	2298	3061	0.00013
Streptomyces_calvus	67282	S	18731	7358	26089	0.00113
Streptomyces_chartreusis	1969	S	17809	7506	25315	0.00110
Streptomyces_griseus	1911	S	6223	5484	11707	0.00051
Streptomyces_sp._M54	2759525	S	585	1500	2085	0.00009
Streptomyces_anulatus	1892	S	4949	5153	10102	0.00044
Streptomyces_microflavus	1919	S	2402	10595	12997	0.00056
Streptomyces_globisporus	1908	S	2020	14718	16738	0.00072
Streptomyces_pactum	68249	S	15952	6441	22393	0.00097
Streptomyces_pratensis	1169025	S	14344	3516	17860	0.00077
Streptomyces_albus	1888	S	14155	7141	21296	0.00092
Streptomyces_armeniacus	83291	S	12783	1898	14681	0.00064
Streptomyces_formicae	1616117	S	12694	4054	16748	0.00072
Streptomyces_lydicus	47763	S	12652	8569	21221	0.00092
Streptomyces_bathyalis	2710756	S	12484	2109	14593	0.00063
Streptomyces_peucetius	1950	S	12269	3382	15651	0.00068
Streptomyces_galilaeus	33899	S	12261	4123	16384	0.00071
Streptomyces_ambofaciens	1889	S	11886	7127	19013	0.00082
Streptomyces_viridosporus	67581	S	11504	4691	16195	0.00070
Streptomyces_cyaneochromogenes	2496836	S	11150	3276	14426	0.00062
Streptomyces_buecherae	2763006	S	10823	2791	13614	0.00059
Streptomyces_bingchenggensis	379067	S	10686	2082	12768	0.00055
Streptomyces_tsukubensis	83656	S	10607	2485	13092	0.00057
Streptomyces_griseorubiginosus	67304	S	10547	3475	14022	0.00061
Streptomyces_lincolnensis	1915	S	10506	3043	13549	0.00059
Streptomyces_durmitorensis	319947	S	10449	2265	12714	0.00055
Streptomyces_capitiformicae	2014920	S	10423	1670	12093	0.00052
Streptomyces_cattleya	29303	S	10288	3048	13336	0.00058
Streptomyces_lunaelactis	1535768	S	10229	2166	12395	0.00054
Streptomyces_spectabilis	68270	S	10189	3337	13526	0.00059
Streptomyces_deccanensis	424188	S	10156	4203	14359	0.00062
Streptomyces_niveus	193462	S	9891	4466	14357	0.00062
Streptomyces_seoulensis	73044	S	8992	3471	12463	0.00054
Streptomyces_aquilus	2548456	S	8907	2638	11545	0.00050
Streptomyces_ferrugineus	1413221	S	8886	2867	11753	0.00051
Streptomyces_prasinus	67345	S	8339	2735	11074	0.00048
Streptomyces_xanthii	2768069	S	8324	2538	10862	0.00047
Streptomyces_roseirectus	2768066	S	8236	2015	10251	0.00044
Streptomyces_genisteinicus	2768068	S	8169	2602	10771	0.00047
Streptomyces_tendae	1932	S	7918	3279	11197	0.00048
Streptomyces_davaonensis	348043	S	7908	2215	10123	0.00044
Streptomyces_xinghaiensis	1038928	S	7897	2431	10328	0.00045
Streptomyces_parvulus	146923	S	7649	3382	11031	0.00048
Streptomyces_vietnamensis	362257	S	7634	2573	10207	0.00044
Streptomyces_rimosus	1927	S	7616	17568	25184	0.00109
Streptomyces_nigra	1827580	S	7414	2918	10332	0.00045
Streptomyces_asoensis	249586	S	7343	2189	9532	0.00041
Streptomyces_clavuligerus	1901	S	7271	1764	9035	0.00039
Streptomyces_albulus	68570	S	7229	2215	9444	0.00041
Streptomyces_griseoviridis	45398	S	7147	2317	9464	0.00041
Streptomyces_olivoreticuli	68246	S	7136	2043	9179	0.00040
Streptomyces_dengpaensis	2049881	S	7114	1976	9090	0.00039
Streptomyces_alboflavus	67267	S	7070	1975	9045	0.00039
Streptomyces_actuosus	1885	S	7063	3001	10064	0.00044
Streptomyces_phaeolivaceus	2653200	S	7035	1941	8976	0.00039
Streptomyces_griseocarneus	51201	S	7027	2487	9514	0.00041
Streptomyces_liangshanensis	2717324	S	6897	1757	8654	0.00037
Streptomyces_rectiverticillatus	173860	S	6893	2237	9130	0.00040
Streptomyces_paludis	2282738	S	6865	1512	8377	0.00036
Streptomyces_harbinensis	1176198	S	6843	1911	8754	0.00038
Streptomyces_globosus	68209	S	6735	2488	9223	0.00040
Streptomyces_luteoverticillatus	66425	S	6713	2250	8963	0.00039
Streptomyces_ficellus	1977088	S	6704	2422	9126	0.00039
Streptomyces_aureoverticillatus	66871	S	6678	1817	8495	0.00037
Streptomyces_avermitilis	33903	S	6664	1920	8584	0.00037
Streptomyces_exfoliatus	1905	S	6577	2268	8845	0.00038
Streptomyces_griseochromogenes	68214	S	6495	1807	8302	0.00036
Streptomyces_antibioticus	1890	S	6473	2311	8784	0.00038
Streptomyces_atratus	1893	S	6461	1321	7782	0.00034
Streptomyces_nodosus	40318	S	6178	1575	7753	0.00034
Streptomyces_lavendulae	1914	S	6146	2152	8298	0.00036
Streptomyces_nitrosporeus	28894	S	6054	1724	7778	0.00034
Streptomyces_collinus	42684	S	6033	4128	10161	0.00044
Streptomyces_vinaceus	1960	S	6003	2160	8163	0.00035
Streptomyces_hawaiiensis	67305	S	5972	2601	8573	0.00037
Streptomyces_broussonetiae	2686304	S	5895	1783	7678	0.00033
Streptomyces_glaucescens	1907	S	5870	2540	8410	0.00036
Streptomyces_subrutilus	36818	S	5860	2186	8046	0.00035
Streptomyces_chromofuscus	42881	S	5790	2234	8024	0.00035
Streptomyces_coeruleorubidus	116188	S	5750	2742	8492	0.00037
Streptomyces_katrae	68223	S	5698	2155	7853	0.00034
Streptomyces_finlayi	67296	S	5538	1269	6807	0.00029
Streptomyces_roseochromogenus	285450	S	5425	1698	7123	0.00031
Streptomyces_hundungensis	1077946	S	5361	1678	7039	0.00030
Streptomyces_dangxiongensis	1442032	S	5340	1854	7194	0.00031
Streptomyces_incarnatus	665007	S	5209	1547	6756	0.00029
Streptomyces_gardneri	66892	S	5142	2082	7224	0.00031
Streptomyces_inhibens	2293571	S	5135	1561	6696	0.00029
Streptomyces_tirandamycinicus	2174846	S	5116	1713	6829	0.00030
Streptomyces_fodineus	1904616	S	5088	1797	6885	0.00030
Streptomyces_rutgersensis	53451	S	5043	2460	7503	0.00032
Streptomyces_tuirus	68278	S	5030	2531	7561	0.00033
Streptomyces_kanamyceticus	1967	S	4896	1652	6548	0.00028
Streptomyces_qinzhouensis	2599401	S	4810	1152	5962	0.00026
Streptomyces_gilvosporeus	553510	S	4790	1527	6317	0.00027
Streptomyces_spongiicola	1690221	S	4745	1935	6680	0.00029
Streptomyces_mobaraensis	35621	S	4687	182514	187201	0.00810
Streptomyces_nojiriensis	66374	S	4636	1988	6624	0.00029
Streptomyces_gobiensis	2875706	S	4618	878	5496	0.00024
Streptomyces_angustmyceticus	285578	S	4423	1805	6228	0.00027
Streptomyces_pluripotens	1355015	S	4375	1006	5381	0.00023
Streptomyces_huasconensis	1854574	S	4373	1708	6081	0.00026
Streptomyces_cyanogenus	80860	S	4285	1891	6176	0.00027
Streptomyces_fagopyri	2662397	S	4042	1377	5419	0.00023
Streptomyces_leeuwenhoekii	1437453	S	3774	2622	6396	0.00028
Streptomyces_cyaneogriseus	68192	S	3401	2626	6027	0.00026
Streptomyces_fungicidicus	68203	S	2589	7557	10146	0.00044
Streptomyces_decoyicus	249567	S	2511	1394	3905	0.00017
Streptomyces_lydicamycinicus	1546107	S	2241	1340	3581	0.00015
Streptomyces_auratus	114687	S	2068	1370	3438	0.00015
Streptomyces_antimycoticus	68175	S	2044	2092	4136	0.00018
Streptomyces_xiamenensis	408015	S	1956	1679	3635	0.00016
Streptomyces_platensis	58346	S	1808	1344	3152	0.00014
Streptomyces_coelicolor	1902	S	610	4842	5452	0.00024
Streptomyces_albidoflavus	1886	S	580	8740	9320	0.00040
Streptomyces_sampsonii	42239	S	288	2328	2616	0.00011
Streptomyces_olivaceus	47716	S	1491	5496	6987	0.00030
Streptomyces_alfalfae	1642299	S	1372	7806	9178	0.00040
Streptomyces_filamentosus	67294	S	1233	1551	2784	0.00012
Streptomyces_californicus	67351	S	1206	3946	5152	0.00022
Streptomyces_cavourensis	67258	S	1164	2142	3306	0.00014
Streptomyces_mirabilis	68239	S	1024	6154	7178	0.00031
Streptomyces_autolyticus	75293	S	858	2908	3766	0.00016
Streptomyces_fradiae	1906	S	747	11610	12357	0.00053
Streptomyces_griseofuscus	146922	S	710	3202	3912	0.00017
Streptomyces_noursei	1971	S	682	2698	3380	0.00015
Streptomyces_murinus	33900	S	677	1933	2610	0.00011
Streptomyces_albireticuli	1940	S	536	2280	2816	0.00012
Streptomyces_scabiei	1930	S	524	4650	5174	0.00022
Streptomyces_violaceoruber	1935	S	465	2060	2525	0.00011
Streptomyces_lividans	1916	S	460	4316	4776	0.00021
Streptomyces_cinereoruber	67260	S	411	2166	2577	0.00011
Streptomyces_rubrolavendulae	285473	S	326	2387	2713	0.00012
Streptomyces_rochei	1928	S	228	1722	1950	0.00008
Streptomyces_sviceus	285530	S	21	1846	1867	0.00008
Streptomyces_violascens	67381	S	16	1581	1597	0.00007
Kitasatospora_sp._MMS16-BH015	2018025	S	8991	3099	12090	0.00052
Kitasatospora_sp._NA04385	2742135	S	7373	4229	11602	0.00050
Kitasatospora_setae	2066	S	7620	4222	11842	0.00051
Kitasatospora_aureofaciens	1894	S	6449	2779	9228	0.00040
Kitasatospora_albolonga	68173	S	2425	1966	4391	0.00019
Streptacidiphilus_sp._P02-A3a	2704468	S	8596	2899	11495	0.00050
Streptacidiphilus_sp._PB12-B1b	2705012	S	7607	3290	10897	0.00047
Streptacidiphilus_bronchialis	2126346	S	7222	2513	9735	0.00042
Yinghuangia_sp._ASG_101	2896848	S	11035	1948	12983	0.00056
Microbacterium_sp._4R-513	2567934	S	6615	1166	7781	0.00034
Microbacterium_sp._No._7	1714373	S	5776	2481	8257	0.00036
Microbacterium_sp._10M-3C3	2483401	S	4909	1366	6275	0.00027
Microbacterium_sp._JZ31	1906274	S	4603	1241	5844	0.00025
Microbacterium_sp._YJN-G	2763257	S	3834	1184	5018	0.00022
Microbacterium_sp._ABRD_28	2268461	S	3822	502	4324	0.00019
Microbacterium_sp._SSW1-51	2851650	S	3605	852	4457	0.00019
Microbacterium_sp._BH-3-3-3	1906742	S	3511	810	4321	0.00019
Microbacterium_sp._H1-D42	2925844	S	3217	511	3728	0.00016
Microbacterium_sp._A18JL241	2782166	S	3205	716	3921	0.00017
Microbacterium_sp._NIBRBAC000506063	2734618	S	3113	1227	4340	0.00019
Microbacterium_sp._XT11	367477	S	3106	630	3736	0.00016
Microbacterium_sp._LKL04	912630	S	3060	704	3764	0.00016
Microbacterium_sp._SSW1-36	2851648	S	3006	621	3627	0.00016
Microbacterium_sp._cx-55	2875948	S	2944	420	3364	0.00015
Microbacterium_sp._PM5	2014534	S	2864	515	3379	0.00015
Microbacterium_sp._Y-01	2048898	S	2798	1036	3834	0.00017
Microbacterium_sp._CBA3102	2603598	S	2385	543	2928	0.00013
Microbacterium_sp._1S1	2606451	S	2167	838	3005	0.00013
Microbacterium_sp._TPU_3598	1938334	S	2127	516	2643	0.00011
Microbacterium_sp._Nx66	2766784	S	1754	1046	2800	0.00012
Microbacterium_sp._RG1	2489212	S	1177	880	2057	0.00009
Microbacterium_sp._CGR1	1696072	S	628	1771	2399	0.00010
Microbacterium_sp._1.5R	1916917	S	566	1533	2099	0.00009
Microbacterium_sp._PAMC22086	2861281	S	494	998	1492	0.00006
Microbacterium_sp._SGAir0570	2070348	S	435	1508	1943	0.00008
Microbacterium_sp._str._'China'	2103230	S	266	1298	1564	0.00007
Microbacterium_sp._PAMC_28756	1795053	S	115	1755	1870	0.00008
Microbacterium_sp._KUDC0406	2909588	S	71	4374	4445	0.00019
Microbacterium_sp._Se5.02b	2864103	S	29	1801	1830	0.00008
Microbacterium_sp._KUDC0405	2909587	S	26	1595	1621	0.00007
Microbacterium_sp._PAMC21962	2861280	S	22	885	907	0.00004
Microbacterium_sp._Se63.02b	2709304	S	17	1103	1120	0.00005
Microbacterium_cremeum	2782169	S	14057	2906	16963	0.00073
Microbacterium_atlanticum	2782168	S	12408	2682	15090	0.00065
Microbacterium_hominis	162426	S	7184	19618	26802	0.00116
Microbacterium_foliorum	104336	S	7021	1435	8456	0.00037
Microbacterium_oleivorans	273677	S	5938	1132	7070	0.00031
Microbacterium_resistens	156977	S	4662	846	5508	0.00024
Microbacterium_lemovicicum	1072463	S	4634	1030	5664	0.00025
Microbacterium_pygmaeum	370764	S	4309	529	4838	0.00021
Microbacterium_sediminis	904291	S	4212	1880	6092	0.00026
Microbacterium_oryzae	743009	S	3899	1139	5038	0.00022
Microbacterium_testaceum	2033	S	3637	646	4283	0.00019
Microbacterium_lushaniae	2614639	S	3565	811	4376	0.00019
Microbacterium_wangchenii	2541726	S	3547	792	4339	0.00019
Microbacterium_aurum	36805	S	3516	1091	4607	0.00020
Microbacterium_caowuchunii	2614638	S	3485	653	4138	0.00018
Microbacterium_chocolatum	84292	S	3427	762	4189	0.00018
Microbacterium_luteum	2782167	S	3276	1350	4626	0.00020
Microbacterium_esteraromaticum	57043	S	3056	668	3724	0.00016
Microbacterium_protaetiae	2509458	S	3012	660	3672	0.00016
Microbacterium_oxydans	82380	S	2891	2183	5074	0.00022
Microbacterium_hydrocarbonoxydans	273678	S	2467	435	2902	0.00013
Microbacterium_schleiferi	69362	S	2241	781	3022	0.00013
Microbacterium_fandaimingii	2708079	S	1416	120	1536	0.00007
Microbacterium_binotii	462710	S	1163	858	2021	0.00009
Microbacterium_chengjingii	2769067	S	1111	58	1169	0.00005
Microbacterium_amylolyticum	936337	S	1073	227	1300	0.00006
Microbacterium_endophyticum	1526412	S	840	58	898	0.00004
Microbacterium_paraoxydans	199592	S	464	3085	3549	0.00015
Microbacterium_paludicola	300019	S	346	1255	1601	0.00007
Agromyces_flavus	589382	S	46258	15273	61531	0.00266
Agromyces_sp._H17E-10	2932244	S	12000	4179	16179	0.00070
Agromyces_sp._LHK192	2498704	S	10111	3106	13217	0.00057
Agromyces_sp._CFWR-12	2929802	S	6649	4342	10991	0.00048
Agromyces_aureus	453304	S	10840	3186	14026	0.00061
Agromyces_marinus	1389020	S	9728	3711	13439	0.00058
Agromyces_badenianii	2080742	S	9198	3157	12355	0.00053
Agromyces_soli	659012	S	8932	3370	12302	0.00053
Agromyces_laixinhei	2585717	S	7279	1756	9035	0.00039
Agromyces_protaetiae	2509455	S	7147	2126	9273	0.00040
Agromyces_intestinalis	2592652	S	6229	3839	10068	0.00044
Agromyces_archimandritae	2781962	S	5669	1691	7360	0.00032
Curtobacterium_sp._L6-1	2841594	S	3190	1059	4249	0.00018
Curtobacterium_sp._BH-2-1-1	1905847	S	2933	992	3925	0.00017
Curtobacterium_sp._MR_MD2014	1561023	S	2539	1182	3721	0.00016
Curtobacterium_sp._YC1	2795488	S	2458	1161	3619	0.00016
Curtobacterium_sp._TC1	2862880	S	2050	1059	3109	0.00013
Curtobacterium_sp._24E2	2804758	S	1869	1024	2893	0.00013
Curtobacterium_sp._SGAir0471	2070337	S	1669	1319	2988	0.00013
Curtobacterium_sp._TXMA1	2876939	S	1566	1280	2846	0.00012
Curtobacterium_sp._C1	2898151	S	595	1751	2346	0.00010
Curtobacterium_sp._Csp2	2495430	S	524	1744	2268	0.00010
Curtobacterium_sp._Csp1	2495429	S	70	1516	1586	0.00007
Curtobacterium_sp._csp3	2588937	S	14	1897	1911	0.00008
Curtobacterium_flaccumfaciens	2035	S	4944	2397	7341	0.00032
Curtobacterium_luteum	33881	S	2916	1090	4006	0.00017
Rathayibacter_sp._VKM_Ac-2759	2609252	S	4220	1522	5742	0.00025
Rathayibacter_sp._VKM_Ac-2760	2609253	S	3731	1954	5685	0.00025
Rathayibacter_sp._VKM_Ac-2804	2609257	S	2825	2096	4921	0.00021
Rathayibacter_sp._VKM_Ac-2801	2609255	S	1593	1495	3088	0.00013
Rathayibacter_sp._VKM_Ac-2762	2609254	S	727	1970	2697	0.00012
Rathayibacter_sp._VKM_Ac-2805	2609258	S	699	1953	2652	0.00011
Rathayibacter_festucae	110937	S	4301	4587	8888	0.00038
Rathayibacter_tanaceti	1671680	S	2581	679	3260	0.00014
Rathayibacter_iranicus	59737	S	1752	242	1994	0.00009
Rathayibacter_rathayi	33887	S	1613	448	2061	0.00009
Rathayibacter_tritici	33888	S	1603	503	2106	0.00009
Rathayibacter_toxicus	145458	S	648	57	705	0.00003
Agrococcus_sp._SCSIO52902	2933290	S	8742	4519	13261	0.00057
Agrococcus_sp._Marseille-Q4369	2810513	S	5599	2066	7665	0.00033
Agrococcus_sp._SGAir0287	2070347	S	4664	1482	6146	0.00027
Agrococcus_carbonis	684552	S	5907	2873	8780	0.00038
Agrococcus_jejuensis	399736	S	5068	1683	6751	0.00029
Leucobacter_sp._Psy1	2875729	S	3690	471	4161	0.00018
Leucobacter_sp._H25R-14	2932245	S	3090	533	3623	0.00016
Leucobacter_sp._NB_10	2873270	S	3056	884	3940	0.00017
Leucobacter_sp._CX169	2813744	S	1925	519	2444	0.00011
Leucobacter_sp._H21R-36	2932246	S	923	2529	3452	0.00015
Leucobacter_sp._H21R-40	2932247	S	733	2011	2744	0.00012
Leucobacter_muris	1935379	S	3159	1186	4345	0.00019
Leucobacter_triazinivorans	1784719	S	3047	1802	4849	0.00021
Leucobacter_luti	340320	S	1116	109	1225	0.00005
Leucobacter_viscericola	2714935	S	937	97	1034	0.00004
Leucobacter_insecticola	2714934	S	795	70	865	0.00004
Leucobacter_denitrificans	683042	S	661	105	766	0.00003
Leucobacter_coleopterorum	2714933	S	562	59	621	0.00003
Leifsonia_sp._ZF2019	2781978	S	4516	1361	5877	0.00025
Leifsonia_sp._PS1209	2724914	S	4087	1218	5305	0.00023
Leifsonia_sp._21MFCrub1.1	1798223	S	3741	5185	8926	0.00039
Leifsonia_shinshuensis	150026	S	6007	1840	7847	0.00034
Leifsonia_xyli	1575	S	3419	507	3926	0.00017
Clavibacter_michiganensis	28447	S	17983	22099	40082	0.00173
Clavibacter_zhangzhiyongii	2768071	S	2329	1190	3519	0.00015
Clavibacter_sp._A6099	2860285	S	1404	971	2375	0.00010
Protaetiibacter_sp._SSC-01	2759943	S	4798	1916	6714	0.00029
Protaetiibacter_intestinalis	2419774	S	4344	1708	6052	0.00026
Protaetiibacter_larvae	2592654	S	3401	1186	4587	0.00020
Salinibacterium_sp._ZJ450	2708338	S	3948	643	4591	0.00020
Salinibacterium_sp._ZJ70	2708084	S	2789	741	3530	0.00015
Salinibacterium_sp._dk2585	2603292	S	2401	422	2823	0.00012
Salinibacterium_sp._UTAS2018	2508880	S	737	72	809	0.00004
Salinibacterium_sp._M195	2583374	S	587	68	655	0.00003
Salinibacterium_hongtaonis	2079791	S	1112	124	1236	0.00005
Cryobacterium_sp._LW097	1978566	S	2821	640	3461	0.00015
Cryobacterium_sp._PAMC25264	2861288	S	1404	876	2280	0.00010
Cryobacterium_soli	2220095	S	2168	1154	3322	0.00014
Cryobacterium_arcticum	670052	S	1701	1315	3016	0.00013
Frondihabitans_sp._PAMC_28766	1795630	S	4117	601	4718	0.00020
Frondihabitans_sp._762G35	1446794	S	3686	858	4544	0.00020
Microterricola_viridarii	412690	S	7897	2056	9953	0.00043
Plantibacter_sp._PA-3-X8	2480625	S	1391	1404	2795	0.00012
Plantibacter_sp._M259	2583822	S	1225	1197	2422	0.00010
Plantibacter_flavus	150123	S	1488	1304	2792	0.00012
Microcella_flavibacter	1804990	S	3840	1951	5791	0.00025
Microcella_alkaliphila	279828	S	2535	464	2999	0.00013
Cnuibacter_physcomitrellae	1619308	S	5148	1182	6330	0.00027
Mycetocola_zhujimingii	2079792	S	1818	226	2044	0.00009
Mycetocola_sp._JXN-3	2116510	S	1763	272	2035	0.00009
Mycetocola_spongiae	2859226	S	1243	170	1413	0.00006
Herbiconiux_sp._SALV-R1	2735133	S	4824	1024	5848	0.00025
Frigoribacterium_sp._NBH87	2596916	S	4668	1454	6122	0.00026
Subtercola_sp._AK-R2A1-2	2895559	S	2792	276	3068	0.00013
Subtercola_sp._PAMC28395	2846775	S	1716	182	1898	0.00008
Gryllotalpicola_protaetiae	2419771	S	4304	884	5188	0.00022
Diaminobutyricimonas_sp._LJ205	2683590	S	3728	742	4470	0.00019
Chryseoglobus_sp._28M-23	2772253	S	707	1584	2291	0.00010
Chryseoglobus_indicus	2750620	S	637	1500	2137	0.00009
Humibacter_sp._WJ7-1	2599293	S	3656	857	4513	0.00020
Amnibacterium_sp._L3-i23	2905871	S	3617	922	4539	0.00020
Marisediminicola_antarctica	674079	S	3112	408	3520	0.00015
Gulosibacter_sediminis	1729695	S	2823	882	3705	0.00016
Glaciihabitans_sp._INWT7	2596912	S	2373	199	2572	0.00011
Agreia_sp._COWG	2773266	S	2341	298	2639	0.00011
Aquiluna_borgnonia	2499157	S	320	30	350	0.00002
Candidatus_Aquiluna_sp._UB-MaderosW2red	1855377	S	125	7	132	0.00001
Rhodoluna_limnophila	232537	S	183	12	195	0.00001
Rhodoluna_lacicola	529884	S	142	9	151	0.00001
Candidatus_Rhodoluna_planktonica	535712	S	113	6	119	0.00001
Pseudoclavibacter_sp._Marseille-Q3772	2866588	S	558	114	672	0.00003
Aurantimicrobium_photophilum	1987356	S	200	20	220	0.00001
Aurantimicrobium_sp._MWH-Uga1	2079575	S	99	40	139	0.00001
Aurantimicrobium_minutum	708131	S	93	38	131	0.00001
Pontimonas_salivibrio	1159327	S	252	12	264	0.00001
Arthrobacter_sp._QXT-31	1357915	S	66190	19258	85448	0.00370
Arthrobacter_sp._FW305-BF8	2879617	S	14732	4201	18933	0.00082
Arthrobacter_sp._PGP41	2079227	S	9395	3209	12604	0.00055
Arthrobacter_sp._NicSoilC5	2831000	S	6404	3283	9687	0.00042
Arthrobacter_sp._24S4-2	2575374	S	5513	1289	6802	0.00029
Arthrobacter_sp._PM3	2017685	S	5264	862	6126	0.00027
Arthrobacter_sp._FB24	290399	S	4873	1556	6429	0.00028
Arthrobacter_sp._NicSoilB8	2830998	S	4872	1328	6200	0.00027
Arthrobacter_sp._U41	1849032	S	4234	1253	5487	0.00024
Arthrobacter_sp._PAMC25564	2565366	S	4232	1209	5441	0.00024
Arthrobacter_sp._QL17	2895818	S	4203	1026	5229	0.00023
Arthrobacter_sp._NicSoilB4	2830997	S	4137	1364	5501	0.00024
Arthrobacter_sp._UKPF54-2	2600159	S	3737	1663	5400	0.00023
Arthrobacter_sp._KBS0702	2578107	S	3678	1545	5223	0.00023
Arthrobacter_sp._PAMC25284	2861279	S	3116	851	3967	0.00017
Arthrobacter_sp._FW306-2-2C-D06B	2879618	S	3112	633	3745	0.00016
Arthrobacter_sp._ERGS1:01	1704044	S	3112	629	3741	0.00016
Arthrobacter_sp._Helios	2828862	S	2434	421	2855	0.00012
Arthrobacter_sp._NtRootA1	2830983	S	2292	719	3011	0.00013
Arthrobacter_sp._StoSoilB20	2830995	S	2124	600	2724	0.00012
Arthrobacter_sp._StoSoilB5	2830992	S	2091	616	2707	0.00012
Arthrobacter_sp._zg-Y462	2886936	S	1724	370	2094	0.00009
Arthrobacter_sp._PAMC_25486	1494608	S	1558	267	1825	0.00008
Arthrobacter_sp._zg-Y809	2886940	S	1555	541	2096	0.00009
Arthrobacter_sp._D5-1	1477518	S	1482	1000	2482	0.00011
Arthrobacter_sp._YN	2020486	S	1435	612	2047	0.00009
Arthrobacter_sp._FW306-06-A	2879621	S	1124	4136	5260	0.00023
Arthrobacter_sp._NicSoilB11	2830999	S	1039	4322	5361	0.00023
Arthrobacter_sp._C1-1	2813727	S	779	114	893	0.00004
Arthrobacter_sp._StoSoilB19	2830994	S	766	3652	4418	0.00019
Arthrobacter_sp._FW306-07-I	2879622	S	754	4430	5184	0.00022
Arthrobacter_sp._StoSoilB13	2830993	S	738	1442	2180	0.00009
Arthrobacter_sp._StoSoilA2	2830990	S	704	1333	2037	0.00009
Arthrobacter_sp._FW306-05-C	2879620	S	588	3250	3838	0.00017
Arthrobacter_sp._AQ5-05	2184581	S	85	1290	1375	0.00006
Arthrobacter_crystallopoietes	37928	S	38296	7280	45576	0.00197
Arthrobacter_agilis	37921	S	6233	952	7185	0.00031
Arthrobacter_sulfonylureivorans	2486855	S	3862	646	4508	0.00020
Arthrobacter_woluwensis	156980	S	2857	683	3540	0.00015
Arthrobacter_dokdonellae	2211210	S	2762	487	3249	0.00014
Arthrobacter_jiangjiafuii	2817475	S	2215	614	2829	0.00012
Arthrobacter_alpinus	656366	S	1915	2537	4452	0.00019
Arthrobacter_sunyaminii	2816859	S	1511	486	1997	0.00009
Pseudarthrobacter_sp._L1SW	2851598	S	8265	3208	11473	0.00050
Pseudarthrobacter_sp._BIM_B-2242	2772401	S	5010	1254	6264	0.00027
Pseudarthrobacter_sp._NIBRBAC000502772	2590775	S	2575	1969	4544	0.00020
Pseudarthrobacter_sp._NBSH8	2596911	S	2398	933	3331	0.00014
Pseudarthrobacter_sp._SSS035	2931399	S	1940	1815	3755	0.00016
Pseudarthrobacter_sp._NIBRBAC000502771	2590774	S	1150	3757	4907	0.00021
Pseudarthrobacter_sp._NIBRBAC000502770	2590785	S	1037	3004	4041	0.00017
Pseudarthrobacter_phenanthrenivorans	361575	S	9332	4417	13749	0.00059
Pseudarthrobacter_chlorophenolicus	85085	S	5293	1968	7261	0.00031
Pseudarthrobacter_equi	728066	S	5003	1976	6979	0.00030
Pseudarthrobacter_psychrotolerans	2697569	S	2841	1176	4017	0.00017
Pseudarthrobacter_sulfonivorans	121292	S	2062	2340	4402	0.00019
Kocuria_rosea	1275	S	15395	5035	20430	0.00088
Kocuria_turfanensis	388357	S	10568	3761	14329	0.00062
Kocuria_flava	446860	S	9336	4783	14119	0.00061
Kocuria_palustris	71999	S	3099	1278	4377	0.00019
Kocuria_rhizophila	72000	S	2474	3727	6201	0.00027
Kocuria_varians	1272	S	1996	1457	3453	0.00015
Kocuria_sp._TGY1127_2	2711328	S	821	142	963	0.00004
Kocuria_sp._KD4	2719588	S	486	800	1286	0.00006
Kocuria_sp._BT304	1702043	S	228	1136	1364	0.00006
Kocuria_indica	1049583	S	380	740	1120	0.00005
Micrococcus_luteus	1270	S	6058	10176	16234	0.00070
Micrococcus_sp._KD337-16	2856555	S	2591	1658	4249	0.00018
Micrococcus_sp._KBS0714	1179670	S	95	827	922	0.00004
Micrococcus_yunnanensis	566027	S	68	556	624	0.00003
Sinomonas_atrocyanea	37927	S	6146	2151	8297	0.00036
Sinomonas_sp._R1AF57	2020377	S	4887	1214	6101	0.00026
Paenarthrobacter_ureafaciens	37931	S	2605	4316	6921	0.00030
Paenarthrobacter_aurescens	43663	S	2120	1347	3467	0.00015
Paenarthrobacter_sp._YJN-5	2735316	S	597	1353	1950	0.00008
Paenarthrobacter_sp._YJN-D	2735317	S	380	775	1155	0.00005
Paenarthrobacter_nicotinovorans	29320	S	359	636	995	0.00004
Glutamicibacter_creatinolyticus	162496	S	1981	494	2475	0.00011
Glutamicibacter_protophormiae	37930	S	1701	1095	2796	0.00012
Glutamicibacter_halophytocola	1933880	S	1050	204	1254	0.00005
Glutamicibacter_mishrai	1775880	S	721	169	890	0.00004
Glutamicibacter_arilaitensis	256701	S	686	267	953	0.00004
Glutamicibacter_nicotianae	37929	S	553	1702	2255	0.00010
Glutamicibacter_sp._ZJUTW	1155384	S	132	585	717	0.00003
Rothia_kristinae	37923	S	3245	1964	5209	0.00023
Rothia_mucilaginosa	43675	S	887	180	1067	0.00005
Rothia_nasimurium	85336	S	472	238	710	0.00003
Rothia_aeria	172042	S	459	184	643	0.00003
Rothia_dentocariosa	2047	S	239	96	335	0.00001
Rothia_terrae	396015	S	210	94	304	0.00001
Rothia_amarae	169480	S	165	78	243	0.00001
Rothia_sp._ZJ932	2810516	S	122	19	141	0.00001
Citricoccus_sp._SGAir0253	2567881	S	5094	1458	6552	0.00028
Nesterenkonia_sp._NBAIMH1	2600320	S	1791	124	1915	0.00008
Paeniglutamicibacter_sp._Y32M11	2853258	S	1095	181	1276	0.00006
Psychromicrobium_lacuslunae	1618207	S	723	105	828	0.00004
Neomicrococcus_aestuarii	556325	S	558	257	815	0.00004
Auritidibacter_sp._NML130574	2170745	S	535	60	595	0.00003
Renibacterium_salmoninarum	1646	S	381	24	405	0.00002
Intrasporangium_calvum	53358	S	43229	12799	56028	0.00242
Phycicoccus_sp._HDW14	2714941	S	14416	5622	20038	0.00087
Phycicoccus_endophyticus	1690220	S	10777	3736	14513	0.00063
Janibacter_melonis	262209	S	8380	3271	11651	0.00050
Janibacter_limosus	53458	S	5843	1779	7622	0.00033
Janibacter_indicus	857417	S	2901	4534	7435	0.00032
Janibacter_sp._YB324	2761047	S	1716	3590	5306	0.00023
Pedococcus_dokdonensis	443156	S	11307	3843	15150	0.00066
Tetrasphaera_sp._HKS02	1813880	S	9406	2818	12224	0.00053
Arsenicicoccus_sp._oral_taxon_190	1658671	S	7378	3236	10614	0.00046
Cellulomonas_sp._Y8	2591145	S	8612	4331	12943	0.00056
Cellulomonas_sp._H30R-01	2704467	S	7854	3597	11451	0.00050
Cellulomonas_sp._C5510	2871170	S	6673	3130	9803	0.00042
Cellulomonas_sp._zg-ZUI188	2819978	S	6528	2144	8672	0.00038
Cellulomonas_sp._JZ18	2654191	S	6505	3263	9768	0.00042
Cellulomonas_sp._zg-ZUI157	2819979	S	5761	2364	8125	0.00035
Cellulomonas_sp._zg-ZUI222	2816956	S	5680	2528	8208	0.00036
Cellulomonas_sp._EW123	2608402	S	4675	3306	7981	0.00035
Cellulomonas_sp._PSBB021	2003551	S	4347	4093	8440	0.00037
Cellulomonas_fimi	1708	S	7174	6523	13697	0.00059
Cellulomonas_shaoxiangyii	2566013	S	6177	2986	9163	0.00040
Cellulomonas_iranensis	76862	S	5609	3049	8658	0.00037
Cellulomonas_flavigena	1711	S	5472	2426	7898	0.00034
Cellulomonas_gilvus	11	S	5045	2555	7600	0.00033
Cellulomonas_taurus	2729175	S	4819	1793	6612	0.00029
Actinotalea_sp._JY-7876	2758442	S	7490	3133	10623	0.00046
Oerskovia_sp._KBS0722	1179673	S	5146	1889	7035	0.00030
Pseudactinotalea_sp._HY158	2654547	S	4734	787	5521	0.00024
Paraoerskovia_marina	545619	S	3745	1120	4865	0.00021
Cellulosimicrobium_cellulans	1710	S	13870	15296	29166	0.00126
Cellulosimicrobium_sp._BI34T	2587808	S	5632	2851	8483	0.00037
Cellulosimicrobium_sp._JZ28	1906273	S	1028	2458	3486	0.00015
Cellulosimicrobium_sp._72-3	2731680	S	645	2923	3568	0.00015
Cellulosimicrobium_sp._TH-20	1980001	S	483	2257	2740	0.00012
Xylanimonas_protaetiae	2509457	S	5855	3012	8867	0.00038
Xylanimonas_cellulosilytica	186189	S	5061	2098	7159	0.00031
Xylanimonas_allomyrinae	2509459	S	4916	1807	6723	0.00029
Isoptericola_variabilis	139208	S	7652	4579	12231	0.00053
Isoptericola_dokdonensis	372663	S	6441	2856	9297	0.00040
Ornithinimicrobium_avium	2283195	S	8510	2580	11090	0.00048
Ornithinimicrobium_flavum	1288636	S	6938	2553	9491	0.00041
Ornithinimicrobium_sp._HY006	2508882	S	5723	2189	7912	0.00034
Ornithinimicrobium_sp._INDO-MA30-4	2908651	S	1027	208	1235	0.00005
Ornithinimicrobium_ciconiae	2594265	S	5066	894	5960	0.00026
Ornithinimicrobium_pratense	2593973	S	3989	1298	5287	0.00023
Serinicoccus_chungangensis	767452	S	6097	2361	8458	0.00037
Serinicoccus_hydrothermalis	1758689	S	5188	2654	7842	0.00034
Serinicoccus_profundi	1078471	S	4993	2042	7035	0.00030
Serinicoccus_marinus	247333	S	4413	2365	6778	0.00029
Brevibacterium_sp._CS2	2575923	S	4054	1857	5911	0.00026
Brevibacterium_sp._SMBL_HHYL_HB1	2777556	S	1820	467	2287	0.00010
Brevibacterium_sp._HY170	2898795	S	936	327	1263	0.00005
Brevibacterium_sp._'Marine'	2725563	S	687	535	1222	0.00005
Brevibacterium_sp._W7.2	2823518	S	596	3410	4006	0.00017
Brevibacterium_casei	33889	S	4376	3512	7888	0.00034
Brevibacterium_luteolum	199591	S	2371	1084	3455	0.00015
Brevibacterium_linens	1703	S	2250	1588	3838	0.00017
Brevibacterium_atlanticum	2697563	S	1552	377	1929	0.00008
Brevibacterium_aurantiacum	273384	S	1470	1127	2597	0.00011
Brevibacterium_oceani	358099	S	1307	338	1645	0.00007
Brevibacterium_sandarakinum	629680	S	1281	273	1554	0.00007
Brevibacterium_limosum	2697565	S	1092	468	1560	0.00007
Brevibacterium_siliguriense	1136497	S	817	280	1097	0.00005
Brevibacterium_pigmentatum	1496080	S	695	606	1301	0.00006
Brachybacterium_sp._CBA3105	2887346	S	4275	1102	5377	0.00023
Brachybacterium_sp._SGAir0954	2571029	S	4065	1255	5320	0.00023
Brachybacterium_sp._P6-10-X1	1903186	S	3968	770	4738	0.00021
Brachybacterium_saurashtrense	556288	S	3622	1136	4758	0.00021
Brachybacterium_ginsengisoli	1331682	S	3610	1160	4770	0.00021
Brachybacterium_faecium	43669	S	3287	1105	4392	0.00019
Brachybacterium_vulturis	2017484	S	2723	1096	3819	0.00017
Brachybacterium_avium	2017485	S	2414	966	3380	0.00015
Dermabacter_vaginalis	1630135	S	962	753	1715	0.00007
Dermabacter_jinjuensis	1667168	S	951	928	1879	0.00008
Devriesea_agamarum	472569	S	584	36	620	0.00003
Georgenia_sp._TF02-10	2917725	S	8672	3665	12337	0.00053
Georgenia_yuyongxinii	2589797	S	8579	2429	11008	0.00048
Georgenia_wutianyii	2585135	S	6492	2593	9085	0.00039
Georgenia_faecalis	2483799	S	6459	2066	8525	0.00037
Dermacoccus_nishinomiyaensis	1274	S	4336	2096	6432	0.00028
Dermacoccus_sp._PAMC28757	2762331	S	3151	1274	4425	0.00019
Luteipulveratus_mongoliensis	571913	S	6474	1052	7526	0.00033
Allobranchiibius_sp._GilTou73	2904523	S	5140	1314	6454	0.00028
Yimella_sp._cx-51	2770551	S	3224	747	3971	0.00017
Haloactinobacterium_kanbiaonis	2675754	S	7854	1297	9151	0.00040
Ruania_sp._LR1S40	2897774	S	4188	998	5186	0.00022
Ruania_sp._M4N3S171	2897773	S	2521	390	2911	0.00013
Ruania_zhangjianzhongii	2603206	S	4538	519	5057	0.00022
Ruania_alkalisoli	2779775	S	2985	556	3541	0.00015
Pengzhenrongella_sicca	2819238	S	8294	2608	10902	0.00047
Luteimicrobium_xylanilyticum	1133546	S	6099	2130	8229	0.00036
Beutenbergia_cavernae	84757	S	8440	1611	10051	0.00043
Miniimonas_sp._S16	2171623	S	5632	3340	8972	0.00039
Sanguibacter_keddieii	60920	S	5032	1693	6725	0.00029
Sanguibacter_sp._HDW7	2714931	S	4208	1487	5695	0.00025
Gephyromycinifex_aptenodytis	2716227	S	2498	327	2825	0.00012
Austwickia_chelonae	100225	S	2129	186	2315	0.00010
Dermatophilus_congolensis	1863	S	531	54	585	0.00003
Kytococcus_sedentarius	1276	S	4667	1920	6587	0.00029
Demequina_sp._TMPB413	2881056	S	1728	155	1883	0.00008
Jonesia_denitrificans	43674	S	358	71	429	0.00002
Tropheryma_whipplei	2039	S	123	0	123	0.00001
Mycolicibacterium_litorale	758802	S	8607	2416	11023	0.00048
Mycolicibacterium_smegmatis	1772	S	6892	3702	10594	0.00046
Mycolicibacterium_neoaurum	1795	S	6838	1771	8609	0.00037
Mycolicibacterium_sp._YH-1	2908837	S	4757	2455	7212	0.00031
Mycolicibacterium_madagascariense	212765	S	5646	880	6526	0.00028
Mycolicibacterium_rutilum	370526	S	5571	1689	7260	0.00031
Mycolicibacterium_phlei	1771	S	5319	1839	7158	0.00031
Mycolicibacterium_sediminis	1286180	S	5290	980	6270	0.00027
Mycolicibacterium_arabiense	1286181	S	5283	832	6115	0.00026
Mycolicibacterium_hassiacum	46351	S	5274	1445	6719	0.00029
Mycolicibacterium_mageritense	53462	S	5208	908	6116	0.00026
Mycolicibacterium_vaccae	1810	S	4981	1007	5988	0.00026
Mycolicibacterium_gadium	1794	S	4962	679	5641	0.00024
Mycolicibacterium_chubuense	1800	S	4828	1120	5948	0.00026
Mycolicibacterium_moriokaense	39691	S	4739	593	5332	0.00023
Mycolicibacterium_chitae	1792	S	4717	1150	5867	0.00025
Mycolicibacterium_thermoresistibile	1797	S	4677	1065	5742	0.00025
Mycolicibacterium_parafortuitum	39692	S	4658	949	5607	0.00024
Mycolicibacterium_fortuitum	1766	S	4649	1726	6375	0.00028
Mycolicibacterium_psychrotolerans	216929	S	4601	1067	5668	0.00025
Mycolicibacterium_rhodesiae	36814	S	4444	742	5186	0.00022
Mycolicibacterium_pulveris	36813	S	4410	757	5167	0.00022
Mycolicibacterium_tokaiense	39695	S	4360	708	5068	0.00022
Mycolicibacterium_monacense	85693	S	4342	1420	5762	0.00025
Mycolicibacterium_fallax	1793	S	4319	1776	6095	0.00026
Mycolicibacterium_fluoranthenivorans	258505	S	4318	577	4895	0.00021
Mycolicibacterium_duvalii	39688	S	4317	864	5181	0.00022
Mycolicibacterium_poriferae	39694	S	4294	922	5216	0.00023
Mycolicibacterium_celeriflavum	1249101	S	4174	839	5013	0.00022
Mycolicibacterium_confluentis	28047	S	4044	631	4675	0.00020
Mycolicibacterium_baixiangningiae	2761578	S	3990	653	4643	0.00020
Mycolicibacterium_phocaicum	319706	S	3970	2020	5990	0.00026
Mycolicibacterium_aurum	1791	S	3878	518	4396	0.00019
Mycolicibacterium_gilvum	1804	S	3838	1445	5283	0.00023
Mycolicibacterium_boenickei	146017	S	3771	4675	8446	0.00037
Mycolicibacterium_insubricum	444597	S	3537	1029	4566	0.00020
Mycolicibacterium_mengxianglii	2736649	S	3364	369	3733	0.00016
Mycolicibacterium_aichiense	1799	S	3338	592	3930	0.00017
Mycolicibacterium_anyangense	1431246	S	3291	553	3844	0.00017
Mycobacterium_doricum	126673	S	3034	696	3730	0.00016
Mycolicibacterium_austroafricanum	39687	S	3016	10720	13736	0.00059
Mycolicibacterium_helvum	1534349	S	2868	348	3216	0.00014
Mycolicibacterium_alvei	67081	S	2686	749	3435	0.00015
Mycolicibacterium_mucogenicum	56689	S	2419	952	3371	0.00015
Mycolicibacterium_septicum	98668	S	2295	1481	3776	0.00016
Mycolicibacterium_sarraceniae	1534348	S	2237	293	2530	0.00011
Mycolicibacterium_farcinogenes	1802	S	1125	4024	5149	0.00022
Mycolicibacterium_vanbaalenii	110539	S	786	11006	11792	0.00051
Mycolicibacterium_nivoides	2487344	S	540	2317	2857	0.00012
Mycobacterium_sp._JS623	212767	S	5536	478	6014	0.00026
Mycobacterium_sp._YC-RL4	1682113	S	4576	1720	6296	0.00027
Mycobacterium_sp._IDR2000157661	2867005	S	4210	800	5010	0.00022
Mycobacterium_sp._MS1601	1936029	S	3309	486	3795	0.00016
Mycobacterium_sp._DL592	2675524	S	3023	513	3536	0.00015
Mycobacterium_sp._EPa45	1545728	S	2923	515	3438	0.00015
Mycobacterium_sp._DL440	2675523	S	2482	585	3067	0.00013
Mycobacterium_sp._TY59	2775496	S	1891	335	2226	0.00010
Mycobacterium_sp._WY10	1920667	S	381	1182	1563	0.00007
Mycobacterium_sp._PYR15	2051552	S	174	1571	1745	0.00008
Mycobacterium_sp._20KCMC460	2903536	S	148	2800	2948	0.00013
Mycobacterium_sp._MOTT36Y	1168287	S	57	776	833	0.00004
Mycobacterium_sp._IWGMT90018-18076	2871094	S	31	1056	1087	0.00005
Mycobacterium_saskatchewanense	220927	S	3956	779	4735	0.00020
Mycobacterium_parmense	185642	S	3667	714	4381	0.00019
Mycobacterium_kubicae	120959	S	3267	564	3831	0.00017
Mycobacterium_shigaense	722731	S	2733	399	3132	0.00014
Mycobacterium_simiae	1784	S	2602	231	2833	0.00012
Mycobacterium_heidelbergense	53376	S	2557	627	3184	0.00014
Mycobacterium_florentinum	292462	S	2488	549	3037	0.00013
Mycobacterium_lentiflavum	141349	S	2344	551	2895	0.00013
Mycobacterium_stomatepiae	470076	S	2290	452	2742	0.00012
Mycobacterium_avium	1764	S	5912	4628	10540	0.00046
Mycobacterium_intracellulare	1767	S	2724	22258	24982	0.00108
Mycobacterium_colombiense	339268	S	2474	443	2917	0.00013
Mycobacterium_mantenii	560555	S	2298	294	2592	0.00011
Mycobacterium_marseillense	701042	S	2126	519	2645	0.00011
Mycobacterium_paraintracellulare	1138383	S	624	4296	4920	0.00021
Mycobacterium_diernhoferi	1801	S	6770	1399	8169	0.00035
Mycobacterium_frederiksbergense	117567	S	5823	1878	7701	0.00033
Mycobacterium_grossiae	1552759	S	5796	1795	7591	0.00033
Mycobacterium_rufum	318424	S	5242	1610	6852	0.00030
Mycobacterium_dioxanotrophicus	482462	S	4423	1126	5549	0.00024
Mycobacterium_holsaticum	152142	S	4048	659	4707	0.00020
Mycobacterium_canettii	78331	S	1361	1298	2659	0.00012
Mycobacterium_tuberculosis	1773	S	813	17301	18114	0.00078
Mycobacterium_goodii	134601	S	3905	1478	5383	0.00023
Mycobacterium_branderi	43348	S	3583	450	4033	0.00017
Mycobacterium_conspicuum	44010	S	3212	405	3617	0.00016
Mycobacterium_paragordonae	1389713	S	3206	402	3608	0.00016
Mycobacterium_koreense	1069220	S	3016	924	3940	0.00017
Mycobacterium_gordonae	1778	S	2935	255	3190	0.00014
Mycobacterium_cookii	1775	S	2790	287	3077	0.00013
Mycobacterium_heckeshornense	110505	S	2723	218	2941	0.00013
Mycobacterium_paraterrae	577492	S	2633	301	2934	0.00013
Mycobacterium_shinjukuense	398694	S	2512	251	2763	0.00012
Mycobacterium_lacus	169765	S	2438	185	2623	0.00011
Mycobacterium_riyadhense	486698	S	2434	106	2540	0.00011
Mycobacterium_noviomagense	459858	S	2423	198	2621	0.00011
Mycobacterium_kansasii	1768	S	2380	244	2624	0.00011
Mycobacterium_ostraviense	2738409	S	2322	243	2565	0.00011
Mycobacterium_vicinigordonae	1719132	S	2322	128	2450	0.00011
Mycobacterium_paraseoulense	590652	S	2270	479	2749	0.00012
Mycobacterium_xenopi	1789	S	2204	266	2470	0.00011
Mycobacterium_malmoense	1780	S	2092	343	2435	0.00011
Mycobacterium_seoulense	386911	S	2052	504	2556	0.00011
Mycobacterium_virginiense	1795032	S	1927	539	2466	0.00011
Mycobacterium_spongiae	886343	S	1761	50	1811	0.00008
Mycobacterium_basiliense	2094119	S	1743	64	1807	0.00008
Mycobacterium_crocinum	388459	S	1329	784	2113	0.00009
Mycobacterium_haemophilum	29311	S	1089	55	1144	0.00005
Mycobacterium_marinum	1781	S	551	2325	2876	0.00012
Mycobacterium_senegalense	1796	S	501	2927	3428	0.00015
Mycobacterium_ulcerans	1809	S	300	1670	1970	0.00009
Mycobacterium_novum	2492438	S	295	4312	4607	0.00020
Mycobacterium_leprae	1769	S	277	7	284	0.00001
Mycobacterium_lepromatosis	480418	S	247	6	253	0.00001
Mycobacterium_shottsii	133549	S	134	254	388	0.00002
Mycobacterium_pallens	370524	S	118	1195	1313	0.00006
Mycobacterium_pseudoshottsii	265949	S	67	441	508	0.00002
Mycolicibacter_sp._MYC340	2855503	S	1919	516	2435	0.00011
Mycolicibacter_sp._MYC098	2872309	S	1876	503	2379	0.00010
Mycolicibacter_sp._MYC017	2875777	S	1183	1009	2192	0.00009
Mycolicibacter_sp._MYC101	2872311	S	360	1574	1934	0.00008
Mycolicibacter_sp._MYC123	2855502	S	350	1574	1924	0.00008
Mycolicibacter_terrae	1788	S	2538	848	3386	0.00015
Mycolicibacter_hiberniae	29314	S	2480	561	3041	0.00013
Mycolicibacter_minnesotensis	1118379	S	1624	300	1924	0.00008
Mycolicibacter_sinensis	875328	S	376	4488	4864	0.00021
Mycobacteroides_abscessus	36809	S	3793	3000	6793	0.00029
Mycobacteroides_chelonae	1774	S	3019	2102	5121	0.00022
Mycobacteroides_saopaulense	1578165	S	1674	237	1911	0.00008
Mycobacteroides_immunogenum	83262	S	1568	344	1912	0.00008
Mycobacteroides_salmoniphilum	404941	S	1365	150	1515	0.00007
[Mycobacterium]_stephanolepidis	1520670	S	752	223	975	0.00004
Mycolicibacillus_parakoreensis	1069221	S	3364	1031	4395	0.00019
Hoyosella_subflava	639313	S	1662	98	1760	0.00008
Rhodococcus_sp._X156	2499145	S	7203	2726	9929	0.00043
Rhodococcus_sp._MTM3W5.2	1805827	S	5899	1552	7451	0.00032
Rhodococcus_sp._SGAir0479	2567884	S	4488	1435	5923	0.00026
Rhodococcus_sp._W8901	2742603	S	4398	1262	5660	0.00024
Rhodococcus_sp._PBTS_1	1653478	S	3930	1123	5053	0.00022
Rhodococcus_sp._WAY2	2663121	S	3636	2606	6242	0.00027
Rhodococcus_sp._USK13	2806442	S	3260	1881	5141	0.00022
Rhodococcus_sp._R79	2811421	S	2873	1612	4485	0.00019
Rhodococcus_sp._ABRD24	2507582	S	2735	524	3259	0.00014
Rhodococcus_sp._USK10	2789739	S	2192	1296	3488	0.00015
Rhodococcus_sp._P1Y	1302308	S	1994	199	2193	0.00009
Rhodococcus_sp._B7740	1564114	S	1906	284	2190	0.00009
Rhodococcus_sp._WMMA185	679318	S	1699	237	1936	0.00008
Rhodococcus_sp._RDE2	2885078	S	1065	1039	2104	0.00009
Rhodococcus_sp._WB9	2594007	S	1019	1358	2377	0.00010
Rhodococcus_sp._ZPP	2749906	S	965	2108	3073	0.00013
Rhodococcus_sp._S2-17	1990687	S	832	1900	2732	0.00012
Rhodococcus_sp._DMU1	2722825	S	745	2751	3496	0.00015
Rhodococcus_sp._M8	1925550	S	602	1839	2441	0.00011
Rhodococcus_sp._21391	2683591	S	289	1309	1598	0.00007
Rhodococcus_sp._WB1	1033922	S	262	2213	2475	0.00011
Rhodococcus_sp._P-2	2795031	S	231	275	506	0.00002
Rhodococcus_sp._2G	1570939	S	219	884	1103	0.00005
Rhodococcus_sp._YL-1	1045808	S	157	664	821	0.00004
Rhodococcus_sp._DMF-1	2907624	S	150	1181	1331	0.00006
Rhodococcus_sp._p52	935199	S	148	790	938	0.00004
Rhodococcus_sp._008	1723645	S	122	731	853	0.00004
Rhodococcus_sp._LW-XY12	2856851	S	116	1039	1155	0.00005
Rhodococcus_sp._PSBB049	2812863	S	105	1501	1606	0.00007
Rhodococcus_sp._NJ-530	2490853	S	96	533	629	0.00003
Rhodococcus_sp._AQ5-07	2054902	S	91	307	398	0.00002
Rhodococcus_sp._H-CA8f	1727214	S	74	313	387	0.00002
Rhodococcus_sp._BH4	1807790	S	61	386	447	0.00002
Rhodococcus_sp._C1	644410	S	31	355	386	0.00002
Rhodococcus_opacus	37919	S	14641	14844	29485	0.00128
Rhodococcus_equi	43767	S	6750	2582	9332	0.00040
Rhodococcus_fascians	1828	S	5396	1275	6671	0.00029
Rhodococcus_rhodochrous	1829	S	4286	2560	6846	0.00030
Rhodococcus_koreensis	99653	S	3694	1125	4819	0.00021
Rhodococcus_triatomae	300028	S	3567	1143	4710	0.00020
Rhodococcus_coprophilus	38310	S	3029	581	3610	0.00016
Rhodococcus_jostii	132919	S	2734	1147	3881	0.00017
Rhodococcus_qingshengii	334542	S	1176	6258	7434	0.00032
Rhodococcus_erythropolis	1833	S	865	3823	4688	0.00020
Rhodococcus_ruber	1830	S	2230	7210	9440	0.00041
Rhodococcus_pyridinivorans	103816	S	2093	7999	10092	0.00044
Rhodococcus_globerulus	33008	S	1628	198	1826	0.00008
Rhodococcus_aetherivorans	191292	S	714	6550	7264	0.00031
Nocardia_asteroides	1824	S	27566	10038	37604	0.00163
Nocardia_brasiliensis	37326	S	13660	3946	17606	0.00076
Nocardia_cyriacigeorgica	135487	S	10416	4783	15199	0.00066
Nocardia_terpenica	455432	S	9467	1823	11290	0.00049
Nocardia_gipuzkoensis	2749991	S	7909	3033	10942	0.00047
Nocardia_farcinica	37329	S	7839	5160	12999	0.00056
Nocardia_wallacei	480035	S	6122	1844	7966	0.00034
Nocardia_huaxiensis	2755382	S	5695	1195	6890	0.00030
Nocardia_arthritidis	228602	S	5557	752	6309	0.00027
Nocardia_otitidiscaviarum	1823	S	5038	1071	6109	0.00026
Nocardia_tengchongensis	2055889	S	4886	1299	6185	0.00027
Nocardia_iowensis	204891	S	4879	1119	5998	0.00026
Nocardia_mangyaensis	2213200	S	4762	1354	6116	0.00026
Nocardia_yamanashiensis	209247	S	4756	1011	5767	0.00025
Nocardia_yunnanensis	2382165	S	4697	1215	5912	0.00026
Nocardia_sp._CS682	1047172	S	4693	1197	5890	0.00025
Nocardia_nova	37330	S	4638	707	5345	0.00023
Nocardia_seriolae	37332	S	4589	1308	5897	0.00026
Corynebacterium_cyclohexanicum	322009	S	4202	1722	5924	0.00026
Corynebacterium_sphenisci	191493	S	3400	1024	4424	0.00019
Corynebacterium_frankenforstense	1230998	S	3105	923	4028	0.00017
Corynebacterium_bovis	36808	S	2917	655	3572	0.00015
Corynebacterium_xerosis	1725	S	2834	1553	4387	0.00019
Corynebacterium_halotolerans	225326	S	2334	531	2865	0.00012
Corynebacterium_nuruki	1032851	S	2285	530	2815	0.00012
Corynebacterium_freneyi	134034	S	1934	740	2674	0.00012
Corynebacterium_vitaeruminis	38305	S	1864	544	2408	0.00010
Corynebacterium_sp._CNCTC7651	2815361	S	820	154	974	0.00004
Corynebacterium_sp._NML98-0116	702967	S	492	171	663	0.00003
Corynebacterium_sp._4H37-19	2684405	S	140	14	154	0.00001
Corynebacterium_sp._1864	2820399	S	140	275	415	0.00002
Corynebacterium_sp._FDAARGOS_1242	2778078	S	116	282	398	0.00002
Corynebacterium_sp._sy039	2599641	S	32	3	35	0.00000
Corynebacterium_humireducens	1223514	S	1720	491	2211	0.00010
Corynebacterium_variabile	1727	S	1707	979	2686	0.00012
Corynebacterium_maris	575200	S	1646	260	1906	0.00008
Corynebacterium_marinum	349751	S	1596	591	2187	0.00009
Corynebacterium_doosanense	1121358	S	1505	704	2209	0.00010
Corynebacterium_timonense	441500	S	1391	327	1718	0.00007
Corynebacterium_mycetoides	38302	S	1337	622	1959	0.00008
Corynebacterium_yudongzhengii	2080740	S	1329	244	1573	0.00007
Corynebacterium_liangguodongii	2079535	S	1298	283	1581	0.00007
Corynebacterium_atypicum	191610	S	1258	369	1627	0.00007
Corynebacterium_uterequi	1072256	S	1235	205	1440	0.00006
Corynebacterium_jeikeium	38289	S	1202	2844	4046	0.00018
Corynebacterium_terpenotabidum	89154	S	1201	331	1532	0.00007
Corynebacterium_comes	2675218	S	1198	291	1489	0.00006
Corynebacterium_glyciniphilum	1404244	S	1143	139	1282	0.00006
Corynebacterium_provencense	1737425	S	1104	245	1349	0.00006
Corynebacterium_sanguinis	2594913	S	1031	681	1712	0.00007
Corynebacterium_uberis	2883169	S	931	111	1042	0.00005
Corynebacterium_urealyticum	43771	S	902	861	1763	0.00008
Corynebacterium_falsenii	108486	S	901	378	1279	0.00006
Corynebacterium_casei	160386	S	890	1075	1965	0.00009
Corynebacterium_imitans	156978	S	884	523	1407	0.00006
Corynebacterium_lujinxingii	2763010	S	866	288	1154	0.00005
Corynebacterium_genitalium	38288	S	831	180	1011	0.00004
Corynebacterium_stationis	1705	S	800	198	998	0.00004
Corynebacterium_ureicelerivorans	401472	S	796	257	1053	0.00005
Corynebacterium_testudinoris	136857	S	776	155	931	0.00004
Corynebacterium_efficiens	152794	S	766	138	904	0.00004
Corynebacterium_glucuronolyticum	39791	S	754	172	926	0.00004
Corynebacterium_glaucum	187491	S	739	155	894	0.00004
Corynebacterium_qintianiae	2709392	S	721	194	915	0.00004
Corynebacterium_coyleae	53374	S	670	164	834	0.00004
Corynebacterium_kroppenstedtii	161879	S	652	64	716	0.00003
Corynebacterium_striatum	43770	S	646	528	1174	0.00005
Corynebacterium_lactis	1231000	S	637	99	736	0.00003
Corynebacterium_occultum	2675219	S	636	109	745	0.00003
Corynebacterium_matruchotii	43768	S	606	43	649	0.00003
Corynebacterium_incognita	2754725	S	605	136	741	0.00003
Corynebacterium_aurimucosum	169292	S	594	268	862	0.00004
Corynebacterium_tuberculostearicum	38304	S	549	324	873	0.00004
Corynebacterium_riegelii	156976	S	533	134	667	0.00003
Corynebacterium_zhongnanshanii	2768834	S	525	71	596	0.00003
Corynebacterium_endometrii	2488819	S	525	98	623	0.00003
Corynebacterium_aquilae	203263	S	509	76	585	0.00003
Corynebacterium_renale	1724	S	495	57	552	0.00002
Corynebacterium_camporealensis	161896	S	448	111	559	0.00002
Corynebacterium_simulans	146827	S	387	284	671	0.00003
Corynebacterium_flavescens	28028	S	366	102	468	0.00002
Corynebacterium_cystitidis	35757	S	360	22	382	0.00002
Corynebacterium_urogenitale	2487892	S	358	64	422	0.00002
Corynebacterium_singulare	161899	S	355	294	649	0.00003
Corynebacterium_epidermidicanis	1050174	S	340	57	397	0.00002
Corynebacterium_lizhenjunii	2709394	S	321	53	374	0.00002
Corynebacterium_kalinowskii	2675216	S	319	151	470	0.00002
Corynebacterium_minutissimum	38301	S	292	282	574	0.00002
Corynebacterium_gerontici	2079234	S	290	57	347	0.00002
Corynebacterium_argentoratense	42817	S	282	60	342	0.00001
Corynebacterium_macginleyi	38290	S	264	62	326	0.00001
Corynebacterium_phocae	161895	S	264	35	299	0.00001
Corynebacterium_diphtheriae	1717	S	247	372	619	0.00003
Corynebacterium_propinquum	43769	S	244	101	345	0.00001
Corynebacterium_choanae	1862358	S	213	21	234	0.00001
Corynebacterium_kefirresidentii	1979527	S	211	138	349	0.00002
Corynebacterium_pelargi	1471400	S	193	63	256	0.00001
Corynebacterium_pseudopelargi	2080757	S	188	64	252	0.00001
Corynebacterium_ulcerans	65058	S	174	78	252	0.00001
Corynebacterium_resistens	258224	S	170	96	266	0.00001
Corynebacterium_glutamicum	1718	S	169	2818	2987	0.00013
Corynebacterium_deserti	1408191	S	167	59	226	0.00001
Corynebacterium_ammoniagenes	1697	S	166	35	201	0.00001
Corynebacterium_pseudodiphtheriticum	37637	S	162	51	213	0.00001
Corynebacterium_mustelae	571915	S	140	10	150	0.00001
Corynebacterium_accolens	38284	S	139	321	460	0.00002
Corynebacterium_amycolatum	43765	S	132	951	1083	0.00005
Corynebacterium_hindlerae	699041	S	129	240	369	0.00002
Corynebacterium_segmentosum	43990	S	116	268	384	0.00002
Corynebacterium_anserum	2684406	S	107	12	119	0.00001
Corynebacterium_silvaticum	2320431	S	104	43	147	0.00001
Corynebacterium_suranareeae	2506452	S	101	29	130	0.00001
Corynebacterium_rouxii	2719119	S	93	53	146	0.00001
Corynebacterium_pseudotuberculosis	1719	S	92	20	112	0.00000
Corynebacterium_callunae	1721	S	91	30	121	0.00001
Corynebacterium_crudilactis	1652495	S	77	85	162	0.00001
Corynebacterium_kutscheri	35755	S	38	5	43	0.00000
Gordonia_sp._PP30	2935861	S	4022	1203	5225	0.00023
Gordonia_sp._YC-JH1	2059875	S	2706	2084	4790	0.00021
Gordonia_sp._KTR9	337191	S	2663	580	3243	0.00014
Gordonia_sp._PDNC005	2811424	S	2249	359	2608	0.00011
Gordonia_sp._WA4-43	2878678	S	487	1720	2207	0.00010
Gordonia_sp._JH63	2698900	S	354	1166	1520	0.00007
Gordonia_sp._135	2676309	S	194	1305	1499	0.00006
Gordonia_sp._1D	1737359	S	89	1342	1431	0.00006
Gordonia_polyisoprenivorans	84595	S	6345	1387	7732	0.00033
Gordonia_terrae	2055	S	4988	2948	7936	0.00034
Gordonia_insulae	2420509	S	3742	570	4312	0.00019
Gordonia_bronchialis	2054	S	3448	877	4325	0.00019
Gordonia_amarae	36821	S	3226	700	3926	0.00017
Gordonia_phthalatica	1136941	S	3196	1378	4574	0.00020
Gordonia_iterans	1004901	S	3175	1172	4347	0.00019
Gordonia_jinghuaiqii	2758710	S	2891	610	3501	0.00015
Gordonia_rubripertincta	36822	S	2827	1749	4576	0.00020
Gordonia_pseudoamarae	2831662	S	2820	576	3396	0.00015
Gordonia_otitidis	249058	S	2335	416	2751	0.00012
Gordonia_zhaorongruii	2597659	S	1929	375	2304	0.00010
Gordonia_alkanivorans	84096	S	730	2722	3452	0.00015
Gordonia_amicalis	89053	S	537	3908	4445	0.00019
Gordonia_hongkongensis	1701090	S	380	1197	1577	0.00007
Gordonia_ajococcus	1292359	S	18	906	924	0.00004
Skermania_piniformis	39122	S	3618	503	4121	0.00018
Tsukamurella_paurometabola	2061	S	6633	3378	10011	0.00043
Tsukamurella_tyrosinosolvens	57704	S	6171	2848	9019	0.00039
Tsukamurella_sp._PLM1	2929795	S	3667	1263	4930	0.00021
Tsukamurella_pulmonis	47312	S	3604	1365	4969	0.00022
Dietzia_sp._oral_taxon_368	712270	S	2261	1632	3893	0.00017
Dietzia_sp._DQ12-45-1b	912801	S	13	2914	2927	0.00013
Dietzia_lutea	546160	S	2542	1531	4073	0.00018
Dietzia_psychralcaliphila	139021	S	2514	774	3288	0.00014
Dietzia_timorensis	499555	S	1875	1163	3038	0.00013
Tomitella_gaofuii	2760083	S	3939	1332	5271	0.00023
Tomitella_fengzijianii	2597660	S	3372	1230	4602	0.00020
Segniliparus_rotundus	286802	S	1841	115	1956	0.00008
Lawsonella_clevelandensis	1528099	S	385	48	433	0.00002
Nocardioides_sp._zg-1228	2763008	S	25347	12932	38279	0.00166
Nocardioides_sp._G188	2849501	S	23524	8559	32083	0.00139
Nocardioides_sp._S5	2017486	S	23047	13426	36473	0.00158
Nocardioides_sp._JS614	196162	S	19340	6694	26034	0.00113
Nocardioides_sp._LMS-CY	2840457	S	19141	7341	26482	0.00115
Nocardioides_sp._HDW12B	2714939	S	17059	6636	23695	0.00103
Nocardioides_sp._TF02-7	2917724	S	16251	6233	22484	0.00097
Nocardioides_sp._SCSIO_67246	2872154	S	15972	4958	20930	0.00091
Nocardioides_sp._W7	2931390	S	15123	5968	21091	0.00091
Nocardioides_sp._cx-173	2898796	S	14045	5627	19672	0.00085
Nocardioides_sp._CF8	110319	S	13671	6555	20226	0.00088
Nocardioides_sp._S-1144	2582905	S	13467	6071	19538	0.00085
Nocardioides_sp._zg-579	2663857	S	12891	7586	20477	0.00089
Nocardioides_sp._InS609-2	2760705	S	12558	3393	15951	0.00069
Nocardioides_sp._603	2483798	S	11172	6031	17203	0.00074
Nocardioides_sp._MC1495	2736757	S	11138	4632	15770	0.00068
Nocardioides_sp._JQ2195	2592334	S	9506	2341	11847	0.00051
Nocardioides_sp._zg-536	2803858	S	8783	4464	13247	0.00057
Nocardioides_sp._WS12	2486272	S	7514	1554	9068	0.00039
Nocardioides_sp._ZJ1313	2685869	S	7299	8712	16011	0.00069
Nocardioides_sp._dk884	2662361	S	7239	8581	15820	0.00068
Nocardioides_sp._Kera_G14	2884264	S	6580	1625	8205	0.00036
Nocardioides_mesophilus	433659	S	22405	8041	30446	0.00132
Nocardioides_okcheonensis	2894081	S	20020	10715	30735	0.00133
Nocardioides_euryhalodurans	2518370	S	18645	6719	25364	0.00110
Nocardioides_ungokensis	1643322	S	16673	6857	23530	0.00102
Nocardioides_anomalus	2712223	S	15961	5698	21659	0.00094
Nocardioides_cynanchi	2558918	S	13208	3701	16909	0.00073
Nocardioides_humi	449461	S	13032	5080	18112	0.00078
Nocardioides_dongkuii	2760089	S	12190	7053	19243	0.00083
Nocardioides_rotundus	1774216	S	11892	5455	17347	0.00075
Nocardioides_seonyuensis	2518371	S	11732	3690	15422	0.00067
Nocardioides_aromaticivorans	200618	S	11525	5133	16658	0.00072
Nocardioides_aquaticus	160826	S	10973	3960	14933	0.00065
Nocardioides_marinisabuli	419476	S	10812	6992	17804	0.00077
Nocardioides_dokdonensis	450734	S	9713	5249	14962	0.00065
Nocardioides_piscis	2714938	S	9453	4134	13587	0.00059
Nocardioides_sambongensis	2589074	S	9306	3160	12466	0.00054
Nocardioides_houyundeii	2045452	S	8953	3220	12173	0.00053
Nocardioides_panacisoli	627624	S	8217	2406	10623	0.00046
Nocardioides_daphniae	402297	S	6402	3433	9835	0.00043
Nocardioides_jishulii	2575440	S	5577	2379	7956	0.00034
Nocardioides_yefusunii	2500546	S	3894	1343	5237	0.00023
Nocardioides_baekrokdamisoli	1804624	S	3600	536	4136	0.00018
Aeromicrobium_sp._Leaf245	1736306	S	6159	2241	8400	0.00036
Aeromicrobium_sp._zg-629	2663859	S	4859	1879	6738	0.00029
Aeromicrobium_sp._A1-2	2107713	S	4384	730	5114	0.00022
Aeromicrobium_choanae	1736691	S	6585	2343	8928	0.00039
Aeromicrobium_erythreum	2041	S	6454	2289	8743	0.00038
Aeromicrobium_chenweiae	2079793	S	5888	2354	8242	0.00036
Aeromicrobium_marinum	219314	S	5778	1507	7285	0.00032
Aeromicrobium_yanjiei	2662028	S	5348	1979	7327	0.00032
Friedmanniella_luteola	546871	S	21043	5206	26249	0.00114
Marmoricola_scoriae	642780	S	10644	4845	15489	0.00067
Pimelobacter_simplex	2045	S	10485	4721	15206	0.00066
Mumia_sp._ZJ1417	2708082	S	7786	1628	9414	0.00041
Micropruina_glycogenica	75385	S	5464	970	6434	0.00028
Microlunatus_sagamiharensis	546874	S	14731	4350	19081	0.00083
Microlunatus_phosphovorus	29405	S	12407	1888	14295	0.00062
Microlunatus_soli	630515	S	8758	1241	9999	0.00043
Microlunatus_elymi	2596828	S	8204	1362	9566	0.00041
Microlunatus_sp._Gsoil_973	2672569	S	7210	840	8050	0.00035
Tessaracoccus_sp._J1M15	2829499	S	3966	1338	5304	0.00023
Tessaracoccus_sp._MC1865	2760310	S	3189	923	4112	0.00018
Tessaracoccus_defluvii	1285901	S	4478	3166	7644	0.00033
Tessaracoccus_aquimaris	1332264	S	3670	1996	5666	0.00025
Tessaracoccus_flavescens	399497	S	3247	2778	6025	0.00026
Tessaracoccus_flavus	1610493	S	3158	2360	5518	0.00024
Tessaracoccus_timonensis	2161816	S	1895	889	2784	0.00012
Brevilactibacter_coleopterorum	2714937	S	6344	3496	9840	0.00043
Brevilactibacter_sp._MC1595	2819349	S	5742	2729	8471	0.00037
Acidipropionibacterium_jensenii	1749	S	3857	3018	6875	0.00030
Acidipropionibacterium_acidipropionici	1748	S	3693	2633	6326	0.00027
Acidipropionibacterium_virtanenii	2057246	S	2667	621	3288	0.00014
Auraticoccus_monumenti	675864	S	10091	2241	12332	0.00053
Propionibacterium_acidifaciens	556499	S	3615	878	4493	0.00019
Propionibacterium_freudenreichii	1744	S	2940	3143	6083	0.00026
Propionibacterium_australiense	119981	S	2773	509	3282	0.00014
Cutibacterium_avidum	33010	S	2378	891	3269	0.00014
Cutibacterium_granulosum	33011	S	1336	333	1669	0.00007
Cutibacterium_acnes	1747	S	945	566	1511	0.00007
Cutibacterium_modestum	2559073	S	563	101	664	0.00003
Raineyella_fluvialis	2662261	S	5160	829	5989	0.00026
Arachnia_propionica	1750	S	2977	407	3384	0.00015
Arachnia_rubra	1547448	S	1697	219	1916	0.00008
Vaginimicrobium_propionicum	1871034	S	183	78	261	0.00001
Kribbella_flavida	182640	S	25665	6750	32415	0.00140
Kribbella_qitaiheensis	1544730	S	18726	3280	22006	0.00095
Actinopolymorpha_singaporensis	117157	S	12862	1731	14593	0.00063
Micromonospora_sp._WMMC415	2675222	S	18199	7357	25556	0.00111
Micromonospora_sp._HM134	2583243	S	10088	4853	14941	0.00065
Micromonospora_sp._WMMA2032	2039870	S	9796	6899	16695	0.00072
Micromonospora_sp._B006	2201999	S	7821	6538	14359	0.00062
Micromonospora_sp._L5	648999	S	752	8676	9428	0.00041
Micromonospora_purpureochromogenes	47872	S	19419	11097	30516	0.00132
Micromonospora_echinaurantiaca	47857	S	18711	9764	28475	0.00123
Micromonospora_echinofusca	47858	S	17368	8541	25909	0.00112
Micromonospora_inositola	47865	S	16195	8629	24824	0.00107
Micromonospora_krabiensis	307121	S	15819	5879	21698	0.00094
Micromonospora_carbonacea	47853	S	15343	7373	22716	0.00098
Micromonospora_terminaliae	1914461	S	14562	7940	22502	0.00097
Micromonospora_echinospora	1877	S	13212	5000	18212	0.00079
Micromonospora_viridifaciens	1881	S	12647	5977	18624	0.00081
Micromonospora_coriariae	285665	S	12591	4862	17453	0.00076
Micromonospora_coxensis	356852	S	12344	7388	19732	0.00085
Micromonospora_siamensis	299152	S	11860	6116	17976	0.00078
Micromonospora_sagamiensis	47875	S	11111	4609	15720	0.00068
Micromonospora_auratinigra	261654	S	11064	6283	17347	0.00075
Micromonospora_ferruginea	2749844	S	10571	6601	17172	0.00074
Micromonospora_maris	1003110	S	10406	3429	13835	0.00060
Micromonospora_chokoriensis	356851	S	10142	3559	13701	0.00059
Micromonospora_narathiwatensis	299146	S	10012	5073	15085	0.00065
Micromonospora_zamorensis	709883	S	9874	3435	13309	0.00058
Micromonospora_endophytica_(Xie_et_al._2001)_Li_et_al._2019	515350	S	9750	3204	12954	0.00056
Micromonospora_rifamycinica	291594	S	8984	4361	13345	0.00058
Micromonospora_craniellae	2294034	S	7823	5242	13065	0.00057
Micromonospora_tulbaghiae	479978	S	5593	6527	12120	0.00052
Micromonospora_aurantiaca	47850	S	4012	28907	32919	0.00142
Actinoplanes_sp._N902-109	649831	S	28665	6817	35482	0.00154
Actinoplanes_sp._L3-i22	2836373	S	25663	6815	32478	0.00141
Actinoplanes_sp._OR16	946334	S	21577	6230	27807	0.00120
Actinoplanes_sp._SE50/110	134676	S	21	27390	27411	0.00119
Actinoplanes_friuliensis	196914	S	41177	7260	48437	0.00210
Actinoplanes_ianthinogenes	122358	S	21418	8774	30192	0.00131
Actinoplanes_missouriensis	1866	S	20481	6855	27336	0.00118
Actinoplanes_teichomyceticus	1867	S	19675	8540	28215	0.00122
Actinoplanes_derwentensis	113562	S	17367	2805	20172	0.00087
Phytohabitans_suffuscus	624315	S	28964	8093	37057	0.00160
Phytohabitans_flavus	1076124	S	24331	5204	29535	0.00128
Plantactinospora_sp._KBS50	2024580	S	15546	4315	19861	0.00086
Plantactinospora_sp._BC1	2108470	S	3548	10704	14252	0.00062
Plantactinospora_sp._BB1	2071627	S	3519	10501	14020	0.00061
Couchioplanes_caeruleus	56438	S	33034	9430	42464	0.00184
Catellatospora_sp._IY07-71	2728827	S	31669	7958	39627	0.00171
Dactylosporangium_vinaceum	53362	S	28943	3688	32631	0.00141
Actinocatenispora_thailandica	227318	S	12396	3685	16081	0.00070
Actinocatenispora_sera	390989	S	12001	3765	15766	0.00068
Polymorphospora_rubra	338584	S	20018	4965	24983	0.00108
Natronosporangium_hydrolyticum	2811111	S	11002	855	11857	0.00051
Verrucosispora_sp._NA02020	2742132	S	7051	5909	12960	0.00056
Salinispora_tropica	168695	S	5931	1101	7032	0.00030
Pseudonocardia_sp._DSM_110487	2865833	S	71480	11597	83077	0.00359
Pseudonocardia_sp._CGMCC_4.1532	2761535	S	21649	14644	36293	0.00157
Pseudonocardia_sp._HH130630-07	1690815	S	16063	5173	21236	0.00092
Pseudonocardia_sp._AL041005-10	445576	S	12069	4849	16918	0.00073
Pseudonocardia_sp._HH130629-09	1641402	S	9907	4450	14357	0.00062
Pseudonocardia_sp._EC080625-04	1096868	S	486	11108	11594	0.00050
Pseudonocardia_sp._EC080619-01	1096856	S	60	12584	12644	0.00055
Pseudonocardia_sp._EC080610-09	1688404	S	46	3282	3328	0.00014
Pseudonocardia_broussonetiae	2736640	S	32160	12474	44634	0.00193
Pseudonocardia_dioxanivorans	240495	S	31257	9687	40944	0.00177
Pseudonocardia_abyssalis	2792008	S	17096	10429	27525	0.00119
Pseudonocardia_autotrophica	2074	S	16652	5261	21913	0.00095
Amycolatopsis_sp._DSM_110486	2865832	S	15667	3449	19116	0.00083
Amycolatopsis_sp._WQ_127309	2932773	S	13938	4302	18240	0.00079
Amycolatopsis_sp._FDAARGOS_1241	2778070	S	12948	3106	16054	0.00069
Amycolatopsis_sp._Hca4	2742131	S	11945	4813	16758	0.00073
Amycolatopsis_sp._YIM_10	2653857	S	10856	3558	14414	0.00062
Amycolatopsis_sp._CA-230715	2745196	S	10794	1874	12668	0.00055
Amycolatopsis_sp._TNS106	2861750	S	7549	4797	12346	0.00053
Amycolatopsis_sp._FU40	2914159	S	6636	3043	9679	0.00042
Amycolatopsis_sp._AA4	1896961	S	6216	3324	9540	0.00041
Amycolatopsis_sp._BJA-103	1911175	S	5820	2534	8354	0.00036
Amycolatopsis_sp._EV170708-02-1	2919322	S	4283	4571	8854	0.00038
Amycolatopsis_acidiphila	715473	S	13931	3400	17331	0.00075
Amycolatopsis_mediterranei	33910	S	12199	10546	22745	0.00098
Amycolatopsis_pretoriensis	218821	S	11597	4156	15753	0.00068
Amycolatopsis_keratiniphila	129921	S	6491	5853	12344	0.00053
Amycolatopsis_japonica	208439	S	3589	3657	7246	0.00031
Amycolatopsis_thermalba	944492	S	10460	4908	15368	0.00066
Amycolatopsis_methanolica	1814	S	10241	4554	14795	0.00064
Amycolatopsis_albispora	1804986	S	10229	6693	16922	0.00073
Amycolatopsis_aidingensis	2842453	S	9360	1272	10632	0.00046
Amycolatopsis_orientalis	31958	S	6652	2503	9155	0.00040
Saccharothrix_sp._6-C	2781735	S	24455	9357	33812	0.00146
Saccharothrix_syringae	103733	S	19050	7460	26510	0.00115
Saccharothrix_espanaensis	103731	S	14771	4920	19691	0.00085
Saccharopolyspora_erythraea	1836	S	22114	7396	29510	0.00128
Saccharopolyspora_gregorii	33914	S	13208	3061	16269	0.00070
Saccharopolyspora_spinosa	60894	S	5581	3312	8893	0.00038
Saccharopolyspora_pogona	333966	S	4927	5116	10043	0.00043
Saccharopolyspora_sp._ASAGF58	2719023	S	4126	4747	8873	0.00038
Lentzea_guizhouensis	1586287	S	50033	12074	62107	0.00269
Saccharomonospora_marina	632569	S	7365	1995	9360	0.00041
Saccharomonospora_azurea	40988	S	5296	1875	7171	0.00031
Saccharomonospora_cyanea	40989	S	4955	2121	7076	0.00031
Saccharomonospora_xinjiangensis	75294	S	4014	782	4796	0.00021
Saccharomonospora_viridis	1852	S	3579	642	4221	0.00018
Saccharomonospora_glauca	40990	S	3398	1448	4846	0.00021
Kutzneria_sp._CA-103260	2802641	S	16744	4160	20904	0.00090
Kutzneria_albida	43357	S	12867	3425	16292	0.00070
Actinoalloteichus_hoggarensis	1470176	S	6013	938	6951	0.00030
Actinoalloteichus_hymeniacidonis	340345	S	4459	491	4950	0.00021
Actinoalloteichus_sp._GBA129-24	1612551	S	290	3937	4227	0.00018
Actinoalloteichus_fjordicus	1612552	S	191	3132	3323	0.00014
Actinosynnema_pretiosum	42197	S	5391	11615	17006	0.00074
Actinosynnema_mirum	40567	S	441	4600	5041	0.00022
Kibdelosporangium_phytohabitans	860235	S	12801	1776	14577	0.00063
Allokutzneria_albata	211114	S	11703	3226	14929	0.00065
Alloactinosynnema_sp._L-07	1653480	S	10609	2702	13311	0.00058
Prauserella_marina	530584	S	5772	596	6368	0.00028
Allosaccharopolyspora_coralli	2665642	S	5200	1283	6483	0.00028
Nonomuraea_nitratireducens	2656914	S	28626	7330	35956	0.00156
Nonomuraea_sp._ATCC_55076	1909395	S	24362	9184	33546	0.00145
Nonomuraea_gerenzanensis	93944	S	23413	9241	32654	0.00141
Nonomuraea_coxensis	404386	S	23041	7959	31000	0.00134
Streptosporangium_roseum	2001	S	21322	6940	28262	0.00122
Streptosporangium_sp._'caverna'	2202249	S	18000	4608	22608	0.00098
Thermobispora_bispora	2006	S	11320	3007	14327	0.00062
Actinomadura_sp._WMMB_499	1219491	S	35567	10065	45632	0.00197
Actinomadura_sp._NAK00032	2742128	S	16043	6777	22820	0.00099
Actinomadura_sp._WMMA1423	2591108	S	14775	5249	20024	0.00087
Actinomadura_madurae	1993	S	20331	7397	27728	0.00120
Actinomadura_verrucosospora	46165	S	17174	6289	23463	0.00102
Actinomadura_graeca	2750812	S	13548	3758	17306	0.00075
Thermomonospora_amylolytica	1411117	S	14609	6348	20957	0.00091
Thermomonospora_curvata	2020	S	10136	3447	13583	0.00059
Nocardiopsis_dassonvillei	2014	S	15117	10658	25775	0.00112
Nocardiopsis_sp._MT53	2865672	S	9276	2513	11789	0.00051
Nocardiopsis_sp._HDS12	2831968	S	3301	2497	5798	0.00025
Nocardiopsis_gilva	280236	S	6930	1631	8561	0.00037
Nocardiopsis_alba	53437	S	4922	1017	5939	0.00026
Thermobifida_halotolerans	483545	S	5509	2072	7581	0.00033
Thermobifida_alba	53522	S	5504	2528	8032	0.00035
Thermobifida_fusca	2021	S	2955	585	3540	0.00015
Streptomonospora_litoralis	2498135	S	7882	1794	9676	0.00042
Spiractinospora_alimapuensis	2820884	S	5137	397	5534	0.00024
Blastococcus_sp._PRF04-17	2933797	S	44876	17195	62071	0.00269
Blastococcus_saxobsidens	138336	S	34632	11823	46455	0.00201
Geodermatophilus_obscurus	1861	S	68124	25305	93429	0.00404
Modestobacter_marinus	477641	S	32000	12367	44367	0.00192
Modestobacter_sp._L9-4	2851567	S	18044	7721	25765	0.00111
Frankia_inefficax	298654	S	18847	2554	21401	0.00093
Frankia_sp._QA3	710111	S	7672	3530	11202	0.00048
Frankia_sp._ArI3	1858	S	5529	3995	9524	0.00041
Candidatus_Frankia_datiscae	2716812	S	8740	1326	10066	0.00044
Frankia_casuarinae	106370	S	7698	931	8629	0.00037
Frankia_alni	1859	S	6405	4831	11236	0.00049
Actinomyces_sp._oral_taxon_414	712122	S	2603	591	3194	0.00014
Actinomyces_sp._MAS-1	2755559	S	2181	476	2657	0.00011
Actinomyces_sp._Z16	2079536	S	1528	590	2118	0.00009
Actinomyces_sp._432	2057798	S	1314	316	1630	0.00007
Actinomyces_sp._Chiba101	1851395	S	1135	579	1714	0.00007
Actinomyces_sp._oral_taxon_171	706438	S	748	635	1383	0.00006
Actinomyces_sp._oral_taxon_169	712116	S	435	834	1269	0.00005
Actinomyces_sp._HMT897	2789424	S	328	902	1230	0.00005
Actinomyces_sp._oral_taxon_897	2081702	S	306	859	1165	0.00005
Actinomyces_sp._HMT_175	2789425	S	194	846	1040	0.00005
Actinomyces_sp._zg-332	2708340	S	16	3	19	0.00000
Actinomyces_radicidentis	111015	S	3072	1440	4512	0.00020
Actinomyces_howellii	52771	S	2816	491	3307	0.00014
Actinomyces_slackii	52774	S	1968	369	2337	0.00010
Actinomyces_respiraculi	2744574	S	1911	521	2432	0.00011
Actinomyces_weissii	675090	S	1703	373	2076	0.00009
Actinomyces_procaprae	2560010	S	1640	658	2298	0.00010
Actinomyces_faecalis	2722820	S	1357	218	1575	0.00007
Actinomyces_qiguomingii	2057800	S	1220	184	1404	0.00006
Actinomyces_viscosus	1656	S	1183	543	1726	0.00007
Actinomyces_naeslundii	1655	S	1043	644	1687	0.00007
Actinomyces_wuliandei	2057743	S	1023	302	1325	0.00006
Actinomyces_oris	544580	S	912	2790	3702	0.00016
Actinomyces_lilanjuaniae	2321394	S	816	220	1036	0.00004
Actinomyces_gaoshouyii	1960083	S	811	456	1267	0.00005
Actinomyces_marmotae	2737173	S	763	463	1226	0.00005
Actinomyces_trachealis	2763540	S	544	115	659	0.00003
Actinomyces_pacaensis	1852377	S	200	27	227	0.00001
Schaalia_sp._19OD2882	2794089	S	1160	167	1327	0.00006
Schaalia_sp._JY-X169	2758572	S	441	18	459	0.00002
Schaalia_sp._ZJ405	2709403	S	325	31	356	0.00002
Schaalia_odontolytica	1660	S	1623	417	2040	0.00009
Schaalia_meyeri	52773	S	878	171	1049	0.00005
Schaalia_cardiffensis	181487	S	546	88	634	0.00003
Schaalia_turicensis	131111	S	182	198	380	0.00002
Flaviflexus_salsibiostraticola	1282737	S	1577	483	2060	0.00009
Flaviflexus_sp._dk850	2758573	S	797	320	1117	0.00005
Flaviflexus_ciconiae	2496867	S	792	116	908	0.00004
Trueperella_pecoris	2733571	S	1101	355	1456	0.00006
Trueperella_pyogenes	1661	S	810	507	1317	0.00006
Trueperella_bialowiezensis	312285	S	602	35	637	0.00003
Pauljensenia_hongkongensis	178339	S	1490	593	2083	0.00009
Nanchangia_anserum	2692125	S	1321	159	1480	0.00006
Actinobaculum_sp._313	2495645	S	551	33	584	0.00003
Actinotignum_schaalii	59505	S	500	37	537	0.00002
Arcanobacterium_haemolyticum	28264	S	161	83	244	0.00001
Arcanobacterium_phocisimile	1302235	S	84	29	113	0.00000
Arcanobacterium_phocae	131112	S	66	24	90	0.00000
Arcanobacterium_sp._2701	2722751	S	54	16	70	0.00000
Changpingibacter_yushuensis	2758440	S	360	120	480	0.00002
Mobiluncus_curtisii	2051	S	243	77	320	0.00001
Varibaculum_sp._EMRHCC_39	2811781	S	116	38	154	0.00001
Boudabousia_tangfeifanii	1912795	S	99	8	107	0.00000
Fannyhessea_vaginae	82135	S	55	17	72	0.00000
Jiangella_sp._DSM_45060	1798224	S	22629	7716	30345	0.00131
Jiangella_alkaliphila	419479	S	21055	6895	27950	0.00121
Nakamurella_multipartita	53461	S	12814	2787	15601	0.00068
Nakamurella_panacisegetis	1090615	S	5801	930	6731	0.00029
Nakamurella_sp._PAMC28650	2762325	S	5161	635	5796	0.00025
Nakamurella_antarctica	1902245	S	900	75	975	0.00004
Bifidobacterium_choerinum	35760	S	1810	801	2611	0.00011
Bifidobacterium_pseudolongum	1694	S	1727	594	2321	0.00010
Bifidobacterium_scardovii	158787	S	1569	144	1713	0.00007
Bifidobacterium_longum	216816	S	1531	2069	3600	0.00016
Bifidobacterium_bifidum	1681	S	1268	350	1618	0.00007
Bifidobacterium_pullorum	78448	S	1154	453	1607	0.00007
Bifidobacterium_animalis	28025	S	941	816	1757	0.00008
Bifidobacterium_asteroides	1684	S	764	484	1248	0.00005
Bifidobacterium_adolescentis	1680	S	751	135	886	0.00004
Bifidobacterium_subtile	77635	S	750	110	860	0.00004
Bifidobacterium_breve	1685	S	653	3099	3752	0.00016
Bifidobacterium_lemurum	1603886	S	601	103	704	0.00003
Bifidobacterium_thermophilum	33905	S	598	137	735	0.00003
Bifidobacterium_eulemuris	1765219	S	573	92	665	0.00003
Bifidobacterium_actinocoloniiforme	638619	S	511	18	529	0.00002
Bifidobacterium_dentium	1689	S	387	24	411	0.00002
Bifidobacterium_angulatum	1683	S	376	89	465	0.00002
Bifidobacterium_pseudocatenulatum	28026	S	288	136	424	0.00002
Bifidobacterium_catenulatum	1686	S	288	298	586	0.00003
Bifidobacterium_saguini	762210	S	127	39	166	0.00001
Bifidobacterium_imperatoris	2020965	S	111	39	150	0.00001
Bifidobacterium_coryneforme	1687	S	65	52	117	0.00001
Bifidobacterium_indicum	1691	S	44	35	79	0.00000
Parascardovia_denticolens	78258	S	455	78	533	0.00002
Gardnerella_vaginalis	2702	S	26	56	82	0.00000
Scardovia_inopinata	78259	S	57	21	78	0.00000
Catenulispora_acidiphila	304895	S	12498	2098	14596	0.00063
Jatrophihabitans_sp._GAS493	1907575	S	5546	586	6132	0.00027
Jatrophihabitans_telluris	2038343	S	5276	531	5807	0.00025
Stackebrandtia_nassauensis	283811	S	7916	832	8748	0.00038
Natronoglycomyces_albus	2811108	S	1245	48	1293	0.00006
Kineococcus_radiotolerans	131568	S	8266	2621	10887	0.00047
Epidermidibacterium_keratini	1891644	S	4461	2526	6987	0.00030
Actinopolyspora_erythraea	414996	S	4286	502	4788	0.00021
Acidothermus_cellulolyticus	28049	S	3457	191	3648	0.00016
Candidatus_Planktophila_lacus	1884913	S	168	21	189	0.00001
Candidatus_Planktophila_versatilis	1884905	S	121	23	144	0.00001
Candidatus_Planktophila_sulfonica	1884904	S	117	33	150	0.00001
Candidatus_Planktophila_dulcis	1884914	S	85	42	127	0.00001
Candidatus_Planktophila_vernalis	1884907	S	57	9	66	0.00000
Candidatus_Planktophila_limnetica	573600	S	27	3	30	0.00000
Candidatus_Nanopelagicus_hibericus	1884915	S	32	20	52	0.00000
Candidatus_Nanopelagicus_limnes	1884634	S	12	16	28	0.00000
Candidatus_Nanopelagicus_abundans	1884916	S	11	5	16	0.00000
Rubrobacter_tropicus	2653851	S	79070	6330	85400	0.00370
Rubrobacter_xylanophilus	49319	S	70121	9597	79718	0.00345
Rubrobacter_marinus	2653852	S	45983	4409	50392	0.00218
Rubrobacter_radiotolerans	42256	S	17052	2461	19513	0.00084
Rubrobacter_indicoceani	2051957	S	9328	805	10133	0.00044
Baekduia_soli	496014	S	42248	7507	49755	0.00215
Conexibacter_sp._SYSU_D00693	2812560	S	51332	13220	64552	0.00279
Conexibacter_sp._DBS9H8	2937801	S	14622	1494	16116	0.00070
Conexibacter_sp._S30A1	2937800	S	14596	1643	16239	0.00070
Conexibacter_woesei	191495	S	69674	13213	82887	0.00359
Miltoncostaea_marina	2843215	S	24798	6452	31250	0.00135
Miltoncostaea_oceani	2843216	S	23729	3685	27414	0.00119
Aquihabitans_sp._G128	2849779	S	35242	7485	42727	0.00185
Aquihabitans_sp._Kera_3	2884263	S	29839	5097	34936	0.00151
Iamia_sp._SCSIO_61187	2722752	S	40524	6780	47304	0.00205
Actinomarinicola_tropica	2789776	S	33660	6957	40617	0.00176
Ilumatobacter_coccineus	467094	S	12807	826	13633	0.00059
Acidimicrobium_ferrooxidans	53635	S	3499	283	3782	0.00016
Euzebya_pacifica	1608957	S	10755	1007	11762	0.00051
Egicoccus_halophilus	1670830	S	10714	1811	12525	0.00054
Egibacter_rhizosphaerae	1670831	S	9559	631	10190	0.00044
Eggerthella_lenta	84112	S	1707	1242	2949	0.00013
Eggerthella_guodeyinii	2690837	S	1548	757	2305	0.00010
Eggerthella_sp._YY7918	502558	S	330	154	484	0.00002
Gordonibacter_urolithinfaciens	1335613	S	938	738	1676	0.00007
Gordonibacter_pamelaeae	471189	S	830	920	1750	0.00008
Adlercreutzia_equolifaciens	446660	S	819	512	1331	0.00006
Adlercreutzia_hattorii	2707299	S	430	541	971	0.00004
Arabiibacter_massiliensis	1870985	S	1794	407	2201	0.00010
Raoultibacter_timonensis	1907662	S	1016	88	1104	0.00005
Berryella_intestinalis	1531429	S	964	1140	2104	0.00009
Slackia_heliotrinireducens	84110	S	801	26	827	0.00004
Denitrobacterium_detoxificans	79604	S	522	230	752	0.00003
Phoenicibacter_congonensis	1944646	S	136	61	197	0.00001
Cryptobacterium_curtum	84163	S	82	9	91	0.00000
Olsenella_timonensis	1805478	S	1805	586	2391	0.00010
Olsenella_uli	133926	S	932	106	1038	0.00004
Olsenella_sp._oral_taxon_807	712411	S	628	40	668	0.00003
Parolsenella_massiliensis	1871022	S	941	539	1480	0.00006
Parolsenella_catena	2003188	S	762	471	1233	0.00005
Parafannyhessea_umbonata	604330	S	1164	734	1898	0.00008
Thermophilibacter_immobilis	2779519	S	1135	457	1592	0.00007
Atopobium_sp._oral_taxon_416	712157	S	264	30	294	0.00001
Lancefieldella_parvula	1382	S	35	3	38	0.00000
Collinsella_aerofaciens	74426	S	1504	798	2302	0.00010
Collinsella_stercoris	147206	S	1115	184	1299	0.00006
Collinsella_sp._zg1085	2844380	S	53	2	55	0.00000
Coriobacterium_glomerans	33871	S	728	26	754	0.00003
Priestia_megaterium	1404	S	59208	60900	120108	0.00520
Priestia_filamentosa	1402861	S	41627	5544	47171	0.00204
Priestia_aryabhattai	412384	S	1197	5048	6245	0.00027
Priestia_flexa	86664	S	340	111	451	0.00002
Priestia_koreensis	284581	S	116	42	158	0.00001
Priestia_sp._J2	2886505	S	85	556	641	0.00003
Metabacillus_sp._KUDC1714	2745198	S	25442	9061	34503	0.00149
Metabacillus_sp._cB07	2806989	S	168	68	236	0.00001
Metabacillus_sp._B2-18	2897333	S	156	193	349	0.00002
Metabacillus_dongyingensis	2874282	S	12013	4445	16458	0.00071
Metabacillus_sediminilitoris	2567941	S	4749	1845	6594	0.00029
Metabacillus_litoralis	152268	S	227	205	432	0.00002
Metabacillus_endolithicus	1535204	S	124	132	256	0.00001
[Brevibacterium]_frigoritolerans	450367	S	15705	5590	21295	0.00092
Bacillus_sp._Y1	352858	S	2215	890	3105	0.00013
Bacillus_sp._S3	486398	S	898	271	1169	0.00005
Bacillus_sp._FJAT-22090	1581038	S	700	189	889	0.00004
Bacillus_sp._1NLA3E	666686	S	583	214	797	0.00003
Bacillus_sp._FJAT-18017	1705566	S	412	114	526	0.00002
Bacillus_sp._PAMC26568	2760090	S	317	32	349	0.00002
Bacillus_sp._OxB-1	98228	S	193	47	240	0.00001
Bacillus_sp._NSP9.1	1071078	S	186	15	201	0.00001
Bacillus_sp._KH172YL63	2709784	S	173	63	236	0.00001
Bacillus_sp._FJAT-42376	2014076	S	165	64	229	0.00001
Bacillus_sp._JY-23	2933872	S	145	59	204	0.00001
Bacillus_sp._SB49	1071080	S	135	24	159	0.00001
Bacillus_sp._THAF10	2587848	S	107	37	144	0.00001
Bacillus_sp._M4U3P1	2592382	S	93	12	105	0.00000
Bacillus_sp._N1-1	2682541	S	65	44	109	0.00000
Bacillus_sp._Cs-700	2589818	S	52	37	89	0.00000
Bacillus_sp._PAMC26543	2762329	S	37	277	314	0.00001
Bacillus_sp._NP247	2846779	S	26	40	66	0.00000
Bacillus_sp._WP8	756828	S	23	33	56	0.00000
Bacillus_sp._H8-1	2930532	S	19	266	285	0.00001
Bacillus_sp._BD59S	2499213	S	19	31	50	0.00000
Bacillus_sp._PGP15	2933563	S	18	90	108	0.00000
Bacillus_sp._N5-665	2925318	S	14	30	44	0.00000
Bacillus_sp._N3536	2666127	S	13	14	27	0.00000
Bacillus_sp._COPE52	2233998	S	13	15	28	0.00000
Bacillus_sp._MBGLi79	2070759	S	13	90	103	0.00000
Bacillus_sp._SYJ	2529386	S	13	45	58	0.00000
Bacillus_sp._ZJS3	2928154	S	12	31	43	0.00000
Bacillus_sp._N447-1	2789208	S	10	109	119	0.00001
Bacillus_mojavensis	72360	S	966	1338	2304	0.00010
Bacillus_halotolerans	260554	S	300	898	1198	0.00005
Bacillus_velezensis	492670	S	264	6844	7108	0.00031
Bacillus_amyloliquefaciens	1390	S	113	3779	3892	0.00017
Bacillus_siamensis	659243	S	28	92	120	0.00001
Bacillus_paralicheniformis	1648923	S	454	318	772	0.00003
Bacillus_subtilis	1423	S	284	18007	18291	0.00079
Bacillus_atrophaeus	1452	S	156	290	446	0.00002
Bacillus_vallismortis	72361	S	71	93	164	0.00001
Bacillus_tequilensis	227866	S	65	63	128	0.00001
Bacillus_licheniformis	1402	S	48	489	537	0.00002
Bacillus_inaquosorum	483913	S	21	216	237	0.00001
Bacillus_spizizenii	96241	S	16	62	78	0.00000
Bacillus_pseudomycoides	64104	S	888	416	1304	0.00006
Bacillus_cereus	1396	S	493	11653	12146	0.00053
Bacillus_thuringiensis	1428	S	396	15196	15592	0.00067
Bacillus_mycoides	1405	S	352	581	933	0.00004
Bacillus_cytotoxicus	580165	S	113	78	191	0.00001
Bacillus_toyonensis	155322	S	87	724	811	0.00004
Bacillus_wiedmannii	1890302	S	74	126	200	0.00001
Bacillus_luti	2026191	S	48	52	100	0.00000
Bacillus_nitratireducens	2026193	S	32	58	90	0.00000
Bacillus_anthracis	1392	S	30	9738	9768	0.00042
Bacillus_sp._ABP14	1892404	S	15	94	109	0.00000
Bacillus_albus	2026189	S	17	82	99	0.00000
Bacillus_paranthracis	2026186	S	15	395	410	0.00002
Bacillus_safensis	561879	S	1290	2343	3633	0.00016
Bacillus_pumilus	1408	S	428	452	880	0.00004
Bacillus_dafuensis	1742359	S	343	130	473	0.00002
Bacillus_glycinifermentans	1664069	S	314	110	424	0.00002
Bacillus_methanolicus	1471	S	300	157	457	0.00002
Bacillus_gobiensis	1441095	S	261	82	343	0.00001
Bacillus_weihaiensis	1547283	S	247	89	336	0.00001
Bacillus_infantis	324767	S	232	69	301	0.00001
Bacillus_altitudinis	293387	S	207	909	1116	0.00005
Bacillus_badius	1455	S	197	78	275	0.00001
Bacillus_aquiflavi	2672567	S	194	54	248	0.00001
Bacillus_fonticola	2728853	S	96	28	124	0.00001
Bacillus_cabrialesii	2487276	S	76	79	155	0.00001
Bacillus_smithii	1479	S	75	37	112	0.00000
Bacillus_shivajii	1983719	S	64	9	73	0.00000
Bacillus_rugosus	2715209	S	44	48	92	0.00000
Bacillus_xiamenensis	1178537	S	11	38	49	0.00000
Bacillus_haynesii	1925021	S	11	38	49	0.00000
Peribacillus_simplex	1478	S	3655	2469	6124	0.00026
Peribacillus_asahii	228899	S	649	337	986	0.00004
Peribacillus_butanolivorans	421767	S	477	156	633	0.00003
Peribacillus_muralis	264697	S	194	47	241	0.00001
Peribacillus_psychrosaccharolyticus	1407	S	158	57	215	0.00001
Terribacillus_goriensis	386490	S	3668	615	4283	0.00019
Terribacillus_aidingensis	586416	S	156	27	183	0.00001
Geobacillus_subterraneus	129338	S	650	478	1128	0.00005
Geobacillus_genomosp._3	1921421	S	349	114	463	0.00002
Geobacillus_stearothermophilus	1422	S	326	475	801	0.00003
Geobacillus_sp._46C-IIa	1963025	S	159	81	240	0.00001
Geobacillus_sp._JS12	1813182	S	44	158	202	0.00001
Geobacillus_sp._Y412MC52	550542	S	31	118	149	0.00001
Geobacillus_sp._C56-T3	691437	S	20	92	112	0.00000
Geobacillus_thermocatenulatus	33938	S	154	172	326	0.00001
Geobacillus_thermoleovorans	33941	S	36	430	466	0.00002
Geobacillus_kaustophilus	1462	S	17	177	194	0.00001
Geobacillus_thermodenitrificans	33940	S	24	198	222	0.00001
Geobacillus_zalihae	213419	S	20	152	172	0.00001
Cytobacillus_oceanisediminis	665099	S	1343	743	2086	0.00009
Cytobacillus_firmus	1399	S	812	418	1230	0.00005
Cytobacillus_ciccensis	1670641	S	586	226	812	0.00004
Cytobacillus_gottheilii	859144	S	212	74	286	0.00001
Cytobacillus_sp._CY-G	2901381	S	184	69	253	0.00001
Cytobacillus_kochii	859143	S	142	46	188	0.00001
Hydrogenibacillus_sp._N12	2866627	S	2695	304	2999	0.00013
Mesobacillus_jeotgali	129985	S	920	385	1305	0.00006
Mesobacillus_foraminis	279826	S	785	222	1007	0.00004
Mesobacillus_sp._S13	2880221	S	531	245	776	0.00003
Anoxybacillus_sediminis	2613334	S	1124	242	1366	0.00006
Anoxybacillus_sp._PDR2	1636720	S	23	113	136	0.00001
Anoxybacillus_flavithermus	33934	S	122	81	203	0.00001
Anoxybacillus_amylolyticus	294699	S	111	23	134	0.00001
Anoxybacillus_caldiproteolyticus	247480	S	107	23	130	0.00001
Anoxybacillus_kamchatkensis	196180	S	18	64	82	0.00000
Anoxybacillus_gonensis	198467	S	14	53	67	0.00000
Neobacillus_drentensis	220684	S	908	427	1335	0.00006
Neobacillus_mesonae	1193713	S	480	176	656	0.00003
Lysinibacillus_sp._SGAir0095	2070463	S	284	116	400	0.00002
Lysinibacillus_sp._PLM2	2929796	S	92	36	128	0.00001
Lysinibacillus_sp._2017	2169540	S	66	29	95	0.00000
Lysinibacillus_sp._CD3-6	2892541	S	59	22	81	0.00000
Lysinibacillus_sp._Ag94	2936682	S	59	5	64	0.00000
Lysinibacillus_sp._YS11	2072025	S	29	62	91	0.00000
Lysinibacillus_sp._ACHW1.5	2913506	S	14	26	40	0.00000
Lysinibacillus_fusiformis	28031	S	132	113	245	0.00001
Lysinibacillus_timonensis	2086577	S	102	52	154	0.00001
Lysinibacillus_agricola	2590012	S	77	21	98	0.00000
Lysinibacillus_sphaericus	1421	S	73	73	146	0.00001
Lysinibacillus_parviboronicapiens	436516	S	68	23	91	0.00000
Lysinibacillus_capsici	2115968	S	14	21	35	0.00000
Alkalihalobacillus_clausii	79880	S	743	143	886	0.00004
Alkalihalobacillus_krulwichiae	199441	S	128	39	167	0.00001
Alkalihalobacillus_sp._LMS39	2924032	S	86	19	105	0.00000
Alkalihalobacillus_miscanthi	2598861	S	69	23	92	0.00000
Alkalihalobacillus_lehensis	300825	S	48	15	63	0.00000
Virgibacillus_sp._NKC19-16	2831673	S	76	6	82	0.00000
Virgibacillus_sp._MSP4-1	2700081	S	70	15	85	0.00000
Virgibacillus_sp._Bac332	2419842	S	57	7	64	0.00000
Virgibacillus_sp._SK37	403957	S	39	11	50	0.00000
Virgibacillus_sp._Bac330	2419841	S	30	7	37	0.00000
Virgibacillus_sp._6R	1911587	S	16	66	82	0.00000
Virgibacillus_necropolis	163877	S	188	26	214	0.00001
Virgibacillus_phasianinus	2017483	S	120	16	136	0.00001
Virgibacillus_halodenitrificans	1482	S	84	24	108	0.00000
Virgibacillus_pantothenticus	1473	S	29	113	142	0.00001
Virgibacillus_dokdonensis	302167	S	19	4	23	0.00000
Parageobacillus_toebii	153151	S	175	144	319	0.00001
Parageobacillus_genomosp._1	1295642	S	148	56	204	0.00001
Parageobacillus_caldoxylosilyticus	81408	S	142	62	204	0.00001
Parageobacillus_thermoglucosidasius	1426	S	132	66	198	0.00001
Parageobacillus_sp._KH3-4	2916802	S	92	41	133	0.00001
Rossellomorea_marisflavi	189381	S	531	218	749	0.00003
Rossellomorea_vietnamensis	218284	S	150	62	212	0.00001
Fictibacillus_arsenicus	255247	S	522	96	618	0.00003
Fictibacillus_phosphorivorans	1221500	S	145	25	170	0.00001
Niallia_circulans	1397	S	347	104	451	0.00002
Niallia_sp._Man26	2912824	S	273	65	338	0.00001
Halobacillus_sp._SSBR10-3	2932257	S	105	16	121	0.00001
Halobacillus_sp._SSTM10-2	2932258	S	88	21	109	0.00000
Halobacillus_sp._SSHM10-5	2932259	S	78	22	100	0.00000
Halobacillus_litoralis	45668	S	97	19	116	0.00001
Halobacillus_halophilus	1570	S	90	15	105	0.00000
Halobacillus_mangrovi	402384	S	84	15	99	0.00000
Salicibibacter_cibarius	2743000	S	126	27	153	0.00001
Salicibibacter_halophilus	2502791	S	115	28	143	0.00001
Salicibibacter_kimchii	2099786	S	105	9	114	0.00000
Salicibibacter_cibi	2743001	S	60	8	68	0.00000
Weizmannia_coagulans	1398	S	416	189	605	0.00003
Salisediminibacterium_selenitireducens	85683	S	228	34	262	0.00001
Salisediminibacterium_beveridgei	632773	S	128	19	147	0.00001
Sutcliffiella_horikoshii	79883	S	197	56	253	0.00001
Sutcliffiella_cohnii	33932	S	125	57	182	0.00001
Heyndrickxia_oleronia	38875	S	163	60	223	0.00001
Heyndrickxia_vini	1476025	S	152	45	197	0.00001
Psychrobacillus_sp._INOP01	2829187	S	167	55	222	0.00001
Psychrobacillus_sp._AK_1817	2303505	S	28	30	58	0.00000
Psychrobacillus_glaciei	2283160	S	103	36	139	0.00001
Oceanobacillus_zhaokaii	2052660	S	154	31	185	0.00001
Oceanobacillus_kimchii	746691	S	86	19	105	0.00000
Oceanobacillus_iheyensis	182710	S	29	10	39	0.00000
Gracilibacillus_sp._SSPM10-3	2932255	S	70	15	85	0.00000
Gracilibacillus_sp._SSWR10-1	2932256	S	64	14	78	0.00000
Gracilibacillus_salitolerans	2663022	S	108	12	120	0.00001
Lentibacillus_sp._CBA3610	2518176	S	107	8	115	0.00000
Lentibacillus_amyloliquefaciens	1472767	S	96	11	107	0.00000
Caldalkalibacillus_thermarum	296745	S	189	36	225	0.00001
Pontibacillus_sp._HMF3514	2692425	S	96	15	111	0.00000
Pontibacillus_sp._ALD_SL1	2777185	S	72	9	81	0.00000
Lederbergia_lenta	1467	S	162	43	205	0.00001
Pradoshia_sp._D12	2651284	S	158	50	208	0.00001
Caldibacillus_thermoamylovorans	35841	S	155	51	206	0.00001
Salimicrobium_jeotgali	1230341	S	155	24	179	0.00001
Anaerobacillus_isosaccharinicus	1532552	S	149	35	184	0.00001
Radiobacillus_sp._80	2844358	S	88	20	108	0.00000
Radiobacillus_deserti	2594883	S	52	11	63	0.00000
Gottfriedia_acidiceleris	371036	S	130	40	170	0.00001
Halalkalibacterium_halodurans	86665	S	125	90	215	0.00001
Aeribacillus_pallidus	33936	S	100	39	139	0.00001
Alkalihalophilus_pseudofirmus	79885	S	94	16	110	0.00000
Sediminibacillus_sp._DP4-553-S	2729421	S	94	16	110	0.00000
Mangrovibacillus_cuniculi	2593652	S	84	47	131	0.00001
Evansella_cellulosilytica	1413	S	81	12	93	0.00000
Amphibacillus_xylanus	1449	S	72	13	85	0.00000
Paraliobacillus_zengyii	2213194	S	64	11	75	0.00000
Paenibacillus_sp._B01	2660554	S	2881	771	3652	0.00016
Paenibacillus_sp._JZ16	1906272	S	2381	463	2844	0.00012
Paenibacillus_sp._RUD330	2023772	S	1657	166	1823	0.00008
Paenibacillus_sp._32O-W	1695218	S	1462	131	1593	0.00007
Paenibacillus_sp._sptzw28	715179	S	909	78	987	0.00004
Paenibacillus_sp._R14(2021)	2859228	S	799	105	904	0.00004
Paenibacillus_sp._H1-7	2282849	S	709	59	768	0.00003
Paenibacillus_sp._BIHB4019	1870819	S	585	44	629	0.00003
Paenibacillus_sp._HWE-109	1306526	S	481	38	519	0.00002
Paenibacillus_sp._FSL_H7-0357	1536774	S	447	52	499	0.00002
Paenibacillus_sp._PAMC21692	2762320	S	432	273	705	0.00003
Paenibacillus_sp._YPD9-1	2908839	S	430	52	482	0.00002
Paenibacillus_sp._FSL_R7-0273	1536772	S	423	61	484	0.00002
Paenibacillus_sp._URB8-2	2741301	S	411	81	492	0.00002
Paenibacillus_sp._Y412MC10	481743	S	359	538	897	0.00004
Paenibacillus_sp._PK3_47	2072642	S	358	46	404	0.00002
Paenibacillus_sp._IHB_B_3084	867076	S	303	133	436	0.00002
Paenibacillus_sp._FSL_R7-0331	1536773	S	295	44	339	0.00001
Paenibacillus_sp._DCT19	2211212	S	263	40	303	0.00001
Paenibacillus_sp._JNUCC-31	2777983	S	261	60	321	0.00001
Paenibacillus_sp._CAA11	1532905	S	236	43	279	0.00001
Paenibacillus_sp._E222	2748863	S	220	62	282	0.00001
Paenibacillus_sp._JNUCC-32	2777984	S	207	326	533	0.00002
Paenibacillus_sp._YPG26	2878915	S	192	36	228	0.00001
Paenibacillus_sp._19GGS1-52	2758563	S	182	16	198	0.00001
Paenibacillus_sp._481	2835869	S	153	14	167	0.00001
Paenibacillus_sp._FSL_R5-0912	1536771	S	151	60	211	0.00001
Paenibacillus_sp._FSL_P4-0081	1536769	S	149	64	213	0.00001
Paenibacillus_sp._FSL_R5-0345	1536770	S	85	20	105	0.00000
Paenibacillus_sp._IHBB_10380	1566358	S	78	13	91	0.00000
Paenibacillus_sp._N3/727	2925845	S	72	65	137	0.00001
Paenibacillus_sp._Cedars	1980674	S	58	246	304	0.00001
Paenibacillus_sp._FSL_H7-0737	1536775	S	56	14	70	0.00000
Paenibacillus_sp._37	2607911	S	47	456	503	0.00002
Paenibacillus_sp._DR312	2871175	S	35	463	498	0.00002
Paenibacillus_sp._M-152	2487928	S	31	349	380	0.00002
Paenibacillus_sp._lzh-N1	2069255	S	18	218	236	0.00001
Paenibacillus_sp._S02	2823904	S	17	99	116	0.00001
Paenibacillus_mucilaginosus	61624	S	3336	250	3586	0.00016
Paenibacillus_albicereus	2726185	S	2336	569	2905	0.00013
Paenibacillus_lycopersici	2704462	S	1947	223	2170	0.00009
Paenibacillus_xylanilyticus	248903	S	1427	270	1697	0.00007
Paenibacillus_rhizovicinus	2704463	S	1037	129	1166	0.00005
Paenibacillus_konkukensis	2020716	S	971	97	1068	0.00005
Paenibacillus_cellulositrophicus	562959	S	944	86	1030	0.00004
Paenibacillus_dendritiformis	130049	S	940	135	1075	0.00005
Paenibacillus_beijingensis	1126833	S	932	102	1034	0.00004
Paenibacillus_macerans	44252	S	908	77	985	0.00004
Paenibacillus_durus	44251	S	671	201	872	0.00004
Paenibacillus_chitinolyticus	79263	S	658	74	732	0.00003
Paenibacillus_stellifer	169760	S	641	104	745	0.00003
Paenibacillus_ihbetae	1870820	S	624	79	703	0.00003
Paenibacillus_thiaminolyticus	49283	S	623	87	710	0.00003
Paenibacillus_polymyxa	1406	S	599	1736	2335	0.00010
Paenibacillus_cellulosilyticus	375489	S	518	62	580	0.00003
Paenibacillus_agaridevorans	171404	S	510	465	975	0.00004
Paenibacillus_protaetiae	2509456	S	508	72	580	0.00003
Paenibacillus_donghaensis	414771	S	496	46	542	0.00002
Paenibacillus_sabinae	365617	S	477	99	576	0.00002
Paenibacillus_naphthalenovorans	162209	S	436	57	493	0.00002
Paenibacillus_albus	2495582	S	425	55	480	0.00002
Paenibacillus_tritici	1873425	S	395	50	445	0.00002
Paenibacillus_xylanexedens	528191	S	379	207	586	0.00003
Paenibacillus_riograndensis	483937	S	136	108	244	0.00001
Paenibacillus_sonchi	373687	S	117	185	302	0.00001
Paenibacillus_lautus	1401	S	352	322	674	0.00003
Paenibacillus_azoreducens	116718	S	351	38	389	0.00002
Paenibacillus_sophorae	1333845	S	346	98	444	0.00002
Paenibacillus_jilunlii	682956	S	308	160	468	0.00002
Paenibacillus_tianjinensis	2810347	S	302	45	347	0.00002
Paenibacillus_algicola	2565926	S	285	44	329	0.00001
Paenibacillus_yonginensis	1462996	S	284	102	386	0.00002
Paenibacillus_swuensis	1178515	S	283	39	322	0.00001
Paenibacillus_physcomitrellae	1619311	S	274	76	350	0.00002
Paenibacillus_guangzhouensis	1473112	S	268	24	292	0.00001
Paenibacillus_borealis	160799	S	256	69	325	0.00001
Paenibacillus_baekrokdamisoli	1712516	S	236	23	259	0.00001
Paenibacillus_graminis	189425	S	232	94	326	0.00001
Paenibacillus_peoriae	59893	S	230	981	1211	0.00005
Paenibacillus_bovis	1616788	S	220	27	247	0.00001
Paenibacillus_barcinonensis	198119	S	214	33	247	0.00001
Paenibacillus_lutimineralis	2707005	S	202	25	227	0.00001
Paenibacillus_lentus	1338368	S	191	18	209	0.00001
Paenibacillus_alvei	44250	S	178	21	199	0.00001
Paenibacillus_pabuli	1472	S	171	50	221	0.00001
Paenibacillus_terrae	159743	S	170	64	234	0.00001
Paenibacillus_kribbensis	172713	S	166	50	216	0.00001
Paenibacillus_psychroresistens	1778678	S	166	9	175	0.00001
Paenibacillus_odorifer	189426	S	143	22	165	0.00001
Paenibacillus_larvae	1464	S	130	20	150	0.00001
Paenibacillus_crassostreae	1763538	S	128	18	146	0.00001
Paenibacillus_brasilensis	128574	S	113	41	154	0.00001
Paenibacillus_uliginis	683737	S	96	75	171	0.00001
Paenibacillus_antarcticus	253703	S	73	10	83	0.00000
Paenibacillus_glucanolyticus	59843	S	54	235	289	0.00001
Brevibacillus_marinus	2496837	S	1154	173	1327	0.00006
Brevibacillus_agri	51101	S	764	178	942	0.00004
Brevibacillus_composti	2796470	S	619	142	761	0.00003
Brevibacillus_sp._MMS20-4M-10-Y	2895522	S	399	50	449	0.00002
Brevibacillus_sp._HD3.3A	2738979	S	51	212	263	0.00001
Brevibacillus_sp._DP1.3A	2738867	S	46	40	86	0.00000
Brevibacillus_brevis	1393	S	495	256	751	0.00003
Brevibacillus_choshinensis	54911	S	422	90	512	0.00002
Brevibacillus_laterosporus	1465	S	145	177	322	0.00001
Brevibacillus_formosus	54913	S	70	58	128	0.00001
Brevibacillus_parabrevis	54914	S	57	245	302	0.00001
Cohnella_sp._LGH	1619153	S	944	318	1262	0.00005
Cohnella_sp._MFER-1	2728023	S	465	59	524	0.00002
Cohnella_candidum	2674991	S	1278	153	1431	0.00006
Cohnella_cholangitidis	2598458	S	500	82	582	0.00003
Cohnella_abietis	2507935	S	151	16	167	0.00001
Thermobacillus_composti	377615	S	2538	339	2877	0.00012
Saccharibacillus_brassicae	2583377	S	1501	171	1672	0.00007
Aneurinibacillus_soli	1500254	S	169	236	405	0.00002
Alicyclobacillus_acidocaldarius	405212	S	3139	259	3398	0.00015
Alicyclobacillus_acidoterrestris	1450	S	336	55	391	0.00002
Alicyclobacillus_mengziensis	2931921	S	317	22	339	0.00001
Alicyclobacillus_sp._SO9	2665646	S	202	14	216	0.00001
Alicyclobacillus_sp._TC	2606450	S	62	7	69	0.00000
Tumebacillus_avium	1903704	S	1668	719	2387	0.00010
Tumebacillus_algifaecis	1214604	S	715	259	974	0.00004
Kyrpidia_spormannii	2055160	S	449	203	652	0.00003
Kyrpidia_tusciae	33943	S	325	207	532	0.00002
Effusibacillus_dendaii	2743772	S	179	23	202	0.00001
Planococcus_glaciei	459472	S	314	96	410	0.00002
Planococcus_sp._MB-3u-03	2058136	S	144	98	242	0.00001
Planococcus_sp._107-1	2908840	S	117	52	169	0.00001
Planococcus_sp._PAMC_21323	1526927	S	34	16	50	0.00000
Planococcus_plakortidis	1038856	S	234	140	374	0.00002
Planococcus_maritimus	192421	S	179	79	258	0.00001
Planococcus_lenghuensis	2213202	S	172	37	209	0.00001
Planococcus_halotolerans	2233542	S	131	41	172	0.00001
Planococcus_massiliensis	1499687	S	126	29	155	0.00001
Planococcus_rifietoensis	200991	S	125	93	218	0.00001
Planococcus_antarcticus	161360	S	68	21	89	0.00000
Planococcus_halocryophilus	1215089	S	42	22	64	0.00000
Planococcus_donghaensis	414778	S	40	23	63	0.00000
Planococcus_versutus	1302659	S	32	15	47	0.00000
Planococcus_kocurii	1374	S	13	46	59	0.00000
Planococcus_faecalis	1598147	S	11	39	50	0.00000
Sporosarcina_sp._Te-1	2818390	S	94	21	115	0.00000
Sporosarcina_sp._Marseille-Q4063	2810514	S	79	13	92	0.00000
Sporosarcina_sp._resist	2762563	S	46	93	139	0.00001
Sporosarcina_sp._PTS2304	2283194	S	39	10	49	0.00000
Sporosarcina_sp._P37	1930546	S	13	37	50	0.00000
Sporosarcina_sp._P33	1930764	S	11	34	45	0.00000
Sporosarcina_ureae	1571	S	160	42	202	0.00001
Sporosarcina_pasteurii	1474	S	42	11	53	0.00000
Sporosarcina_ureilytica	298596	S	41	12	53	0.00000
Sporosarcina_psychrophila	1476	S	19	46	65	0.00000
Solibacillus_silvestris	76853	S	398	144	542	0.00002
Solibacillus_sp._R5-41	2048654	S	79	32	111	0.00000
Ureibacillus_thermosphaericus	51173	S	58	51	109	0.00000
Ureibacillus_thermophilus	367743	S	51	20	71	0.00000
Paenisporosarcina_antarctica	417367	S	74	22	96	0.00000
Paenisporosarcina_cavernae	2320858	S	38	21	59	0.00000
Jeotgalibacillus_malaysiensis	1508404	S	95	31	126	0.00001
Kurthia_zopfii	1650	S	34	16	50	0.00000
Kurthia_sp._11kri321	1750719	S	27	15	42	0.00000
Rummeliibacillus_stabekisii	241244	S	61	29	90	0.00000
Viridibacillus_sp._JNUCC-6	2779527	S	54	18	72	0.00000
Staphylospora_marina	2490858	S	783	120	903	0.00004
Kroppenstedtia_eburnea	714067	S	615	53	668	0.00003
Kroppenstedtia_pulmonis	1380685	S	117	8	125	0.00001
Novibacillus_thermophilus	1471761	S	688	86	774	0.00003
Polycladomyces_abyssicola	1125966	S	332	29	361	0.00002
Thermoactinomyces_vulgaris	2026	S	311	58	369	0.00002
Laceyella_sacchari	37482	S	287	63	350	0.00002
Exiguobacterium_alkaliphilum	1428684	S	405	123	528	0.00002
Exiguobacterium_mexicanum	340146	S	359	113	472	0.00002
Exiguobacterium_sp._N4-1P	2051906	S	75	49	124	0.00001
Exiguobacterium_sp._Helios	2735868	S	64	28	92	0.00000
Exiguobacterium_sp._AT1b	360911	S	57	65	122	0.00001
Exiguobacterium_sp._PFWT01	2829816	S	32	37	69	0.00000
Exiguobacterium_sp._MH3	1399115	S	29	39	68	0.00000
Exiguobacterium_acetylicum	41170	S	123	197	320	0.00001
Exiguobacterium_sibiricum	332410	S	95	44	139	0.00001
Exiguobacterium_antarcticum	132920	S	77	27	104	0.00000
Gemella_haemolysans	1379	S	14	9	23	0.00000
Staphylococcus_aureus	1280	S	112	9644	9756	0.00042
Staphylococcus_pseudintermedius	283734	S	43	41	84	0.00000
Staphylococcus_epidermidis	1282	S	48	196	244	0.00001
Staphylococcus_capitis	29388	S	45	50	95	0.00000
Staphylococcus_sp._17KM0847	2583989	S	16	7	23	0.00000
Staphylococcus_sp._CCM_9025	2892440	S	13	5	18	0.00000
Staphylococcus_haemolyticus	1283	S	31	51	82	0.00000
Staphylococcus_pettenkoferi	170573	S	31	7	38	0.00000
Staphylococcus_lugdunensis	28035	S	31	14	45	0.00000
Staphylococcus_xylosus	1288	S	30	13	43	0.00000
Staphylococcus_pseudoxylosus	2282419	S	30	15	45	0.00000
Staphylococcus_simulans	1286	S	27	10	37	0.00000
Staphylococcus_gallinarum	1293	S	22	1	23	0.00000
Staphylococcus_chromogenes	46126	S	22	10	32	0.00000
Staphylococcus_simiae	308354	S	21	11	32	0.00000
Staphylococcus_saprophyticus	29385	S	20	9	29	0.00000
Staphylococcus_felis	46127	S	18	7	25	0.00000
Staphylococcus_carnosus	1281	S	18	6	24	0.00000
Staphylococcus_saccharolyticus	33028	S	18	7	25	0.00000
Staphylococcus_hyicus	1284	S	18	8	26	0.00000
Staphylococcus_hominis	1290	S	18	13	31	0.00000
Staphylococcus_schleiferi	1295	S	18	25	43	0.00000
Staphylococcus_arlettae	29378	S	17	11	28	0.00000
Staphylococcus_succinus	61015	S	16	5	21	0.00000
Staphylococcus_muscae	1294	S	15	6	21	0.00000
Staphylococcus_edaphicus	1955013	S	15	4	19	0.00000
Staphylococcus_cohnii	29382	S	14	9	23	0.00000
Staphylococcus_agnetis	985762	S	14	5	19	0.00000
Staphylococcus_nepalensis	214473	S	13	4	17	0.00000
Staphylococcus_pasteuri	45972	S	12	9	21	0.00000
Staphylococcus_warneri	1292	S	12	15	27	0.00000
Staphylococcus_equorum	246432	S	12	15	27	0.00000
Staphylococcus_piscifermentans	70258	S	10	3	13	0.00000
Staphylococcus_lloydii	2781774	S	10	4	14	0.00000
Staphylococcus_lutrae	155085	S	10	4	14	0.00000
Staphylococcus_auricularis	29379	S	10	3	13	0.00000
Staphylococcus_condimenti	70255	S	10	3	13	0.00000
Macrococcus_brunensis	198483	S	32	9	41	0.00000
Macrococcus_armenti	2875764	S	25	11	36	0.00000
Macrococcus_caseolyticus	69966	S	22	43	65	0.00000
Macrococcus_canis	1855823	S	21	8	29	0.00000
Mammaliicoccus_sciuri	1296	S	62	38	100	0.00000
Mammaliicoccus_vitulinus	71237	S	25	11	36	0.00000
Mammaliicoccus_lentus	42858	S	21	14	35	0.00000
Mammaliicoccus_stepanovicii	643214	S	16	5	21	0.00000
Jeotgalicoccus_saudimassiliensis	1461582	S	49	5	54	0.00000
Jeotgalicoccus_sp._WY2	2708346	S	35	6	41	0.00000
Jeotgalicoccus_sp._ATCC_8456	946435	S	13	2	15	0.00000
Salinicoccus_halodurans	407035	S	81	24	105	0.00000
Nosocomiicoccus_ampullae	489910	S	41	6	47	0.00000
Abyssicoccus_albus	1817405	S	16	4	20	0.00000
Listeria_monocytogenes	1639	S	122	2556	2678	0.00012
Listeria_innocua	1642	S	52	43	95	0.00000
Listeria_grayi	1641	S	35	10	45	0.00000
Listeria_weihenstephanensis	1006155	S	34	7	41	0.00000
Listeria_seeligeri	1640	S	33	14	47	0.00000
Listeria_sp._PSOL-1	1844999	S	30	8	38	0.00000
Listeria_ivanovii	1638	S	27	6	33	0.00000
Listeria_welshimeri	1643	S	13	7	20	0.00000
Brochothrix_thermosphacta	2756	S	47	15	62	0.00000
Sporolactobacillus_terrae	269673	S	169	23	192	0.00001
Limosilactobacillus_fermentum	1613	S	242	179	421	0.00002
Limosilactobacillus_pontis	35787	S	189	98	287	0.00001
Limosilactobacillus_mucosae	97478	S	87	34	121	0.00001
Limosilactobacillus_panis	47493	S	74	28	102	0.00000
Limosilactobacillus_reuteri	1598	S	45	67	112	0.00000
Limosilactobacillus_gastricus	227942	S	12	4	16	0.00000
Lactobacillus_delbrueckii	1584	S	231	507	738	0.00003
Lactobacillus_sp._3B(2020)	2695882	S	21	6	27	0.00000
Lactobacillus_sp._CBA3606	2099789	S	10	7	17	0.00000
Lactobacillus_amylovorus	1604	S	23	46	69	0.00000
Lactobacillus_johnsonii	33959	S	23	17	40	0.00000
Lactobacillus_panisapium	2012495	S	23	3	26	0.00000
Lactobacillus_amylolyticus	83683	S	19	9	28	0.00000
Lactobacillus_crispatus	47770	S	16	8	24	0.00000
Lactobacillus_kefiranofaciens	267818	S	16	9	25	0.00000
Lactobacillus_helveticus	1587	S	14	19	33	0.00000
Lactobacillus_gasseri	1596	S	12	18	30	0.00000
Lactobacillus_acidophilus	1579	S	12	4	16	0.00000
Lactobacillus_acetotolerans	1600	S	12	2	14	0.00000
Levilactobacillus_zymae	267363	S	229	66	295	0.00001
Levilactobacillus_brevis	1580	S	144	45	189	0.00001
Levilactobacillus_suantsaii	2292255	S	86	29	115	0.00001
Levilactobacillus_koreensis	637971	S	59	8	67	0.00000
Lacticaseibacillus_rhamnosus	47715	S	83	49	132	0.00001
Lacticaseibacillus_casei	1582	S	70	32	102	0.00000
Lacticaseibacillus_manihotivorans	88233	S	56	15	71	0.00000
Lacticaseibacillus_paracasei	1597	S	39	122	161	0.00001
Lacticaseibacillus_zeae	57037	S	37	22	59	0.00000
Lacticaseibacillus_chiayiensis	2100821	S	34	6	40	0.00000
Lactiplantibacillus_pentosus	1589	S	99	24	123	0.00001
Lactiplantibacillus_plantarum	1590	S	85	95	180	0.00001
Lactiplantibacillus_paraplantarum	60520	S	33	7	40	0.00000
Schleiferilactobacillus_harbinensis	304207	S	231	24	255	0.00001
Weissella_confusa	1583	S	43	30	73	0.00000
Weissella_cibaria	137591	S	33	22	55	0.00000
Weissella_soli	155866	S	24	6	30	0.00000
Weissella_viridescens	1629	S	13	5	18	0.00000
Weissella_diestrammenae	1162633	S	13	3	16	0.00000
Weissella_koreensis	165096	S	12	7	19	0.00000
Weissella_coleopterorum	2714949	S	11	4	15	0.00000
Ligilactobacillus_ruminis	1623	S	46	15	61	0.00000
Ligilactobacillus_animalis	1605	S	32	36	68	0.00000
Ligilactobacillus_salivarius	1624	S	27	19	46	0.00000
Ligilactobacillus_agilis	1601	S	24	14	38	0.00000
Ligilactobacillus_acidipiscis	89059	S	18	6	24	0.00000
Ligilactobacillus_murinus	1622	S	14	14	28	0.00000
Leuconostoc_mesenteroides	1245	S	20	25	45	0.00000
Leuconostoc_lactis	1246	S	16	32	48	0.00000
Leuconostoc_gelidum	1244	S	14	3	17	0.00000
Lentilactobacillus_buchneri	1581	S	39	12	51	0.00000
Lentilactobacillus_parabuchneri	152331	S	26	7	33	0.00000
Lentilactobacillus_hilgardii	1588	S	19	4	23	0.00000
Lentilactobacillus_kefiri	33962	S	17	5	22	0.00000
Lentilactobacillus_curieae	1138822	S	10	2	12	0.00000
Pediococcus_acidilactici	1254	S	44	20	64	0.00000
Pediococcus_inopinatus	114090	S	36	19	55	0.00000
Pediococcus_pentosaceus	1255	S	12	5	17	0.00000
Pediococcus_damnosus	51663	S	10	4	14	0.00000
Oenococcus_kitaharae	336988	S	45	3	48	0.00000
Oenococcus_sicerae	2203724	S	24	0	24	0.00000
Oenococcus_sp._UCMA_16435	2259623	S	15	4	19	0.00000
Oenococcus_oeni	1247	S	11	2	13	0.00000
Secundilactobacillus_paracollinoides	240427	S	78	26	104	0.00000
Secundilactobacillus_malefermentans	176292	S	15	5	20	0.00000
Companilactobacillus_allii	1847728	S	10	13	23	0.00000
Loigolactobacillus_coryniformis	1610	S	36	26	62	0.00000
Loigolactobacillus_bifermentans	1607	S	21	5	26	0.00000
Loigolactobacillus_backii	375175	S	18	7	25	0.00000
Latilactobacillus_sakei	1599	S	18	9	27	0.00000
Latilactobacillus_curvatus	28038	S	18	12	30	0.00000
Latilactobacillus_fuchuensis	164393	S	17	0	17	0.00000
Liquorilactobacillus_mali	1618	S	20	9	29	0.00000
Liquorilactobacillus_hordei	468911	S	16	9	25	0.00000
Paucilactobacillus_oligofermentans	293371	S	13	3	16	0.00000
Paucilactobacillus_nenjiangensis	1296540	S	11	6	17	0.00000
Furfurilactobacillus_rossiae	231049	S	33	5	38	0.00000
Periweissella_cryptocerci	2506420	S	27	3	30	0.00000
Amylolactobacillus_amylophilus	1603	S	24	20	44	0.00000
Apilactobacillus_kunkeei	148814	S	11	4	15	0.00000
Acetilactobacillus_jinshanensis	1720083	S	17	0	17	0.00000
Lapidilactobacillus_dextrinicus	51664	S	12	3	15	0.00000
Bombilactobacillus_bombi	1303590	S	10	1	11	0.00000
Streptococcus_sanguinis	1305	S	110	43	153	0.00001
Streptococcus_sp._HKU75	2781599	S	27	5	32	0.00000
Streptococcus_sp._zg-86	2664091	S	11	4	15	0.00000
Streptococcus_sp._A12	1759399	S	10	13	23	0.00000
Streptococcus_suis	1307	S	79	70	149	0.00001
Streptococcus_oralis	1303	S	49	57	106	0.00000
Streptococcus_equi	1336	S	34	9	43	0.00000
Streptococcus_gordonii	1302	S	33	14	47	0.00000
Streptococcus_pyogenes	1314	S	27	152	179	0.00001
Streptococcus_sobrinus	1310	S	25	4	29	0.00000
Streptococcus_mitis	28037	S	25	30	55	0.00000
Streptococcus_cristatus	45634	S	24	34	58	0.00000
Streptococcus_chenjunshii	2173853	S	21	2	23	0.00000
Streptococcus_ferus	1345	S	21	4	25	0.00000
Streptococcus_salivarius	1304	S	20	36	56	0.00000
Streptococcus_intermedius	1338	S	10	37	47	0.00000
Streptococcus_pantholopis	1811193	S	17	2	19	0.00000
Streptococcus_pneumoniae	1313	S	17	175	192	0.00001
Streptococcus_thermophilus	1308	S	17	393	410	0.00002
Streptococcus_infantis	68892	S	17	8	25	0.00000
Streptococcus_merionis	400065	S	16	2	18	0.00000
Streptococcus_porcinus	1340	S	15	8	23	0.00000
Streptococcus_mutans	1309	S	15	11	26	0.00000
Streptococcus_ratti	1341	S	15	2	17	0.00000
Streptococcus_parasuis	1501662	S	13	32	45	0.00000
Streptococcus_halichoeri	254785	S	13	18	31	0.00000
Streptococcus_uberis	1349	S	12	6	18	0.00000
Streptococcus_respiraculi	2021971	S	12	3	15	0.00000
Streptococcus_pluranimalium	82348	S	11	5	16	0.00000
Streptococcus_canis	1329	S	11	9	20	0.00000
Lactococcus_garvieae	1363	S	34	128	162	0.00001
Lactococcus_raffinolactis	1366	S	22	10	32	0.00000
Lactococcus_lactis	1358	S	20	40	60	0.00000
Lactococcus_cremoris	1359	S	19	15	34	0.00000
Floricoccus_penangensis	1859475	S	12	3	15	0.00000
Enterococcus_casseliflavus	37734	S	56	135	191	0.00001
Enterococcus_gilvus	160453	S	41	18	59	0.00000
Enterococcus_faecalis	1351	S	39	40	79	0.00000
Enterococcus_raffinosus	71452	S	38	23	61	0.00000
Enterococcus_avium	33945	S	37	21	58	0.00000
Enterococcus_mundtii	53346	S	33	14	47	0.00000
Enterococcus_cecorum	44008	S	25	19	44	0.00000
Enterococcus_durans	53345	S	21	21	42	0.00000
Enterococcus_thailandicus	417368	S	20	10	30	0.00000
Enterococcus_faecium	1352	S	19	137	156	0.00001
Enterococcus_hirae	1354	S	18	14	32	0.00000
Enterococcus_wangshanyuanii	2005703	S	18	2	20	0.00000
Enterococcus_rotai	118060	S	16	0	16	0.00000
Vagococcus_lutrae	81947	S	26	49	75	0.00000
Vagococcus_fluvialis	2738	S	23	19	42	0.00000
Vagococcus_penaei	633807	S	14	4	18	0.00000
Vagococcus_hydrophili	2714947	S	12	4	16	0.00000
Vagococcus_zengguangii	2571750	S	11	5	16	0.00000
Vagococcus_sp._CY52-2	2925838	S	10	11	21	0.00000
Vagococcus_coleopterorum	2714946	S	10	3	13	0.00000
Tetragenococcus_halophilus	51669	S	25	19	44	0.00000
Tetragenococcus_koreensis	290335	S	11	7	18	0.00000
Aerococcus_sanguinicola	119206	S	57	13	70	0.00000
Aerococcus_urinae	1376	S	39	13	52	0.00000
Aerococcus_christensenii	87541	S	19	28	47	0.00000
Aerococcus_urinaeequi	51665	S	16	102	118	0.00001
Aerococcus_urinaehominis	128944	S	15	3	18	0.00000
Suicoccus_acidiformans	2036206	S	37	23	60	0.00000
Abiotrophia_defectiva	46125	S	30	8	38	0.00000
Ignavigranum_ruoffiae	89093	S	23	3	26	0.00000
Carnobacterium_sp._17-4	208596	S	14	26	40	0.00000
Carnobacterium_maltaromaticum	2751	S	31	13	44	0.00000
Carnobacterium_divergens	2748	S	24	5	29	0.00000
Carnobacterium_inhibens	147709	S	11	6	17	0.00000
Carnobacterium_viridans	174587	S	10	5	15	0.00000
Jeotgalibaca_dankookensis	708126	S	28	7	35	0.00000
Jeotgalibaca_porci	1868793	S	22	14	36	0.00000
Jeotgalibaca_ciconiae	2496265	S	18	8	26	0.00000
Jeotgalibaca_arthritidis	1868794	S	14	32	46	0.00000
Jeotgalibaca_sp._MA1X17-3	2908211	S	11	2	13	0.00000
Dolosigranulum_pigrum	29394	S	58	17	75	0.00000
Granulicatella_adiacens	46124	S	13	6	19	0.00000
Granulicatella_elegans	137732	S	12	30	42	0.00000
Marinilactibacillus_sp._15R	1911586	S	16	6	22	0.00000
Thermaerobacter_sp._FW80	2546351	S	3790	759	4549	0.00020
Thermaerobacter_sp._PB12/4term	2293838	S	2873	695	3568	0.00015
Thermaerobacter_marianensis	73919	S	3552	864	4416	0.00019
Intestinimonas_butyriciproducens	1297617	S	716	259	975	0.00004
Flintibacter_sp._KGMB00164	2610895	S	457	54	511	0.00002
Emergencia_timonensis	1776384	S	194	65	259	0.00001
Aminipila_luticellarii	2507160	S	67	6	73	0.00000
Aminipila_butyrica	433296	S	60	5	65	0.00000
Aminipila_terrae	2697030	S	30	2	32	0.00000
Mogibacterium_pumilum	86332	S	13	12	25	0.00000
Massilistercora_timonensis	2086584	S	219	208	427	0.00002
Carboxydocella_thermautotrophica	178899	S	159	15	174	0.00001
Fenollaria_massiliensis	938288	S	14	15	29	0.00000
Faecalibacterium_prausnitzii	853	S	2052	1926	3978	0.00017
Dysosmobacter_sp._Marseille-Q4140	2830675	S	996	425	1421	0.00006
Dysosmobacter_welbionis	2093857	S	689	465	1154	0.00005
Flavonifractor_plautii	292800	S	1476	355	1831	0.00008
Vescimonas_coprocola	2714355	S	433	352	785	0.00003
Vescimonas_fastidiosa	2714353	S	312	444	756	0.00003
Ethanoligenens_harbinense	253239	S	707	35	742	0.00003
Ruthenibacterium_lactatiformans	1550024	S	694	186	880	0.00004
Oscillibacter_sp._NSJ-62	2763056	S	663	203	866	0.00004
Caproiciproducens_sp._NJN-50	2507162	S	510	59	569	0.00002
Anaerotruncus_colihominis	169435	S	493	246	739	0.00003
Acutalibacter_muris	1796620	S	437	21	458	0.00002
Caproicibacter_fermentans	2576756	S	311	17	328	0.00001
Pusillibacter_faecalis	2714358	S	288	182	470	0.00002
Ruminococcus_champanellensis	1161942	S	146	11	157	0.00001
Ruminococcus_albus	1264	S	51	1	52	0.00000
Ruminococcus_bicirculans	1160721	S	28	6	34	0.00000
Ruminococcus_bovis	2564099	S	19	2	21	0.00000
Caproicibacterium_amylolyticum	2766537	S	121	7	128	0.00001
Caproicibacterium_lactatifermentans	2666138	S	106	10	116	0.00001
Solibaculum_mannosilyticum	2780922	S	181	158	339	0.00001
Acetivibrio_clariflavus	288965	S	44	25	69	0.00000
Acetivibrio_thermocellus	1515	S	40	495	535	0.00002
Acetivibrio_saccincola	1677857	S	26	14	40	0.00000
Pseudoclostridium_thermosuccinogenes	84032	S	90	20	110	0.00000
Ruminiclostridium_herbifermentans	2488810	S	49	10	59	0.00000
Ruminiclostridium_cellulolyticum	1521	S	41	8	49	0.00000
Thermoclostridium_stercorarium	1510	S	50	6	56	0.00000
Mageeibacillus_indolicus	884684	S	35	46	81	0.00000
Monoglobus_pectinilyticus	1981510	S	34	16	50	0.00000
Fastidiosipila_sanguinis	236753	S	21	11	32	0.00000
Symbiobacterium_thermophilum	2734	S	4427	361	4788	0.00021
Clostridium_sp._C5S11	704125	S	122	14	136	0.00001
Clostridium_sp._SY8519	1042156	S	120	32	152	0.00001
Clostridium_sp._M62/1	411486	S	115	136	251	0.00001
Clostridium_sp._DL-VIII	641107	S	83	13	96	0.00000
Clostridium_sp._BNL1100	755731	S	55	5	60	0.00000
Clostridium_sp._AWRP	2212991	S	50	18	68	0.00000
Clostridium_sp._JN-9	2507159	S	49	7	56	0.00000
Clostridium_sp._'deep_sea'	2779445	S	33	0	33	0.00000
Clostridium_sp._BJN0001	2930219	S	29	6	35	0.00000
Clostridium_sp._JN-1	2483110	S	23	3	26	0.00000
Clostridium_sp._MD294	97138	S	16	1	17	0.00000
Clostridium_sp._C1	1155388	S	14	12	26	0.00000
Clostridium_sp._001	1970093	S	12	6	18	0.00000
Clostridium_botulinum	1491	S	158	105	263	0.00001
Clostridium_beijerinckii	1520	S	141	192	333	0.00001
Clostridium_perfringens	1502	S	136	40	176	0.00001
Clostridium_saccharoperbutylacetonicum	36745	S	119	24	143	0.00001
Clostridium_pasteurianum	1501	S	78	12	90	0.00000
Clostridium_kluyveri	1534	S	67	4	71	0.00000
Clostridium_carboxidivorans	217159	S	64	14	78	0.00000
Clostridium_intestinale	36845	S	62	7	69	0.00000
Clostridium_saccharobutylicum	169679	S	56	10	66	0.00000
Clostridium_argentinense	29341	S	56	7	63	0.00000
Clostridium_baratii	1561	S	55	15	70	0.00000
Clostridium_thermarum	1716543	S	52	28	80	0.00000
Clostridium_cellulovorans	1493	S	46	6	52	0.00000
Clostridium_sporogenes	1509	S	46	211	257	0.00001
Clostridium_butyricum	1492	S	44	7	51	0.00000
Clostridium_estertheticum	238834	S	43	7	50	0.00000
Clostridium_manihotivorum	2320868	S	43	4	47	0.00000
Clostridium_aceticum	84022	S	36	3	39	0.00000
Clostridium_fermenticellae	2068654	S	35	3	38	0.00000
Clostridium_cadaveris	1529	S	33	7	40	0.00000
Clostridium_gasigenes	94869	S	32	5	37	0.00000
Clostridium_bornimense	1216932	S	31	9	40	0.00000
Clostridium_chauvoei	46867	S	30	7	37	0.00000
Clostridium_drakei	332101	S	30	18	48	0.00000
Clostridium_tetani	1513	S	29	9	38	0.00000
Clostridium_formicaceticum	1497	S	27	4	31	0.00000
Clostridium_acetobutylicum	1488	S	27	1	28	0.00000
Clostridium_tyrobutyricum	1519	S	26	2	28	0.00000
Clostridium_scatologenes	1548	S	24	18	42	0.00000
Clostridium_isatidis	182773	S	24	10	34	0.00000
Clostridium_cochlearium	1494	S	22	6	28	0.00000
Clostridium_novyi	1542	S	17	85	102	0.00000
Clostridium_taeniosporum	394958	S	17	2	19	0.00000
Clostridium_septicum	1504	S	15	3	18	0.00000
Clostridium_diolis	223919	S	10	98	108	0.00000
Hungatella_hathewayi	154046	S	251	9	260	0.00001
Alkaliphilus_oremlandii	461876	S	85	21	106	0.00000
Alkaliphilus_sp._B6464	2731219	S	73	18	91	0.00000
Alkaliphilus_metalliredigens	208226	S	35	6	41	0.00000
Crassaminicella_profunda	1286698	S	28	5	33	0.00000
Crassaminicella_thermophila	2599308	S	28	8	36	0.00000
Crassaminicella_sp._143-21	2855394	S	20	8	28	0.00000
Caloramator_sp._E03	2576307	S	64	6	70	0.00000
Geosporobacter_ferrireducens	1424294	S	42	6	48	0.00000
Paraclostridium_bifermentans	1490	S	32	9	41	0.00000
Serpentinicella_alkaliphila	1734049	S	30	4	34	0.00000
Sarcina_sp._JB2	2726954	S	27	12	39	0.00000
Hathewaya_histolytica	1498	S	23	7	30	0.00000
[Clostridium]_hylemonae	89153	S	198	50	248	0.00001
Lachnoclostridium_phocaeense	1871021	S	180	144	324	0.00001
[Clostridium]_scindens	29347	S	140	54	194	0.00001
Lachnoclostridium_sp._YL32	1834196	S	41	57	98	0.00000
Lachnoclostridium_phytofermentans	66219	S	26	1	27	0.00000
Blautia_producta	33035	S	118	25	143	0.00001
Blautia_sp._NBRC_113351	2877527	S	77	82	159	0.00001
Blautia_sp._SC05B48	2479767	S	14	39	53	0.00000
Blautia_pseudococcoides	1796616	S	62	9	71	0.00000
Blautia_liquoris	2779518	S	42	3	45	0.00000
Blautia_argi	1912897	S	29	24	53	0.00000
Blautia_obeum	40520	S	27	24	51	0.00000
Blautia_hansenii	1322	S	17	11	28	0.00000
Blautia_massiliensis	1737424	S	12	26	38	0.00000
Anaerocolumna_cellulosilytica	433286	S	240	12	252	0.00001
Anaerocolumna_sedimenticola	2696063	S	85	5	90	0.00000
Anaerocolumna_chitinilytica	1727145	S	61	2	63	0.00000
Lachnospiraceae_bacterium_NSJ-38	2763669	S	148	53	201	0.00001
Lachnospiraceae_bacterium_NSJ-29	2763667	S	136	38	174	0.00001
Lachnospiraceae_bacterium_sunii_NSJ-8	2763672	S	72	51	123	0.00001
Lachnospiraceae_bacterium_NSJ-4	2763670	S	28	26	54	0.00000
Roseburia_hominis	301301	S	146	145	291	0.00001
Roseburia_intestinalis	166486	S	44	57	101	0.00000
Roseburia_sp._NSJ-69	2763062	S	24	9	33	0.00000
Enterocloster_bolteae	208479	S	179	51	230	0.00001
Enterocloster_clostridioformis	1531	S	23	58	81	0.00000
Lacrimispora_sphenoides	29370	S	111	14	125	0.00001
Lacrimispora_saccharolytica	84030	S	68	13	81	0.00000
Coprococcus_comes	410072	S	87	87	174	0.00001
Coprococcus_eutactus	33043	S	36	34	70	0.00000
Coprococcus_catus	116085	S	32	16	48	0.00000
Coprococcus_sp._ART55/1	751585	S	19	15	34	0.00000
Anaerostipes_caccae	105841	S	69	13	82	0.00000
Anaerostipes_rhamnosivorans	1229621	S	63	23	86	0.00000
Anaerostipes_hadrus	649756	S	18	16	34	0.00000
Butyrivibrio_fibrisolvens	831	S	67	17	84	0.00000
Butyrivibrio_hungatei	185008	S	26	5	31	0.00000
Butyrivibrio_proteoclasticus	43305	S	16	3	19	0.00000
Herbinix_luporum	1679721	S	77	48	125	0.00001
Anaerotignum_propionicum	28446	S	75	7	82	0.00000
[Ruminococcus]_gnavus	33038	S	52	44	96	0.00000
[Ruminococcus]_torques	33039	S	19	14	33	0.00000
Sellimonas_intestinalis	1653434	S	67	35	102	0.00000
Novisyntrophococcus_fermenticellae	2068655	S	59	7	66	0.00000
Anaerobutyricum_hallii	39488	S	44	14	58	0.00000
Dorea_longicatena	88431	S	35	31	66	0.00000
Faecalicatena_sp._Marseille-Q4148	2823316	S	30	13	43	0.00000
Pseudobutyrivibrio_xylanivorans	185007	S	28	1	29	0.00000
Cellulosilyticum_lentocellum	29360	S	11	11	22	0.00000
[Clostridium]_colinum	36835	S	21	2	23	0.00000
Lachnospira_eligens	39485	S	14	2	16	0.00000
Lachnoanaerobaculum_umeaense	617123	S	13	3	16	0.00000
Candidatus_Desulforudis_audaxviator	471827	S	1168	63	1231	0.00005
Desulforamulus_ruminis	1564	S	215	38	253	0.00001
Desulforamulus_ferrireducens	1833852	S	172	107	279	0.00001
Desulforamulus_reducens	59610	S	54	13	67	0.00000
Acididesulfobacillus_acetoxydans	1561005	S	282	10	292	0.00001
Candidatus_Formimonas_warabiya	1761012	S	234	23	257	0.00001
Desulfofarcimen_acetoxidans	58138	S	114	14	128	0.00001
Thermanaerosceptrum_fracticalcis	1712410	S	94	14	108	0.00000
Dehalobacterium_formicoaceticum	51515	S	63	14	77	0.00000
Christensenella_sp._Marseille-P3954	2086585	S	1021	492	1513	0.00007
Christensenella_minuta	626937	S	283	73	356	0.00002
Heliomicrobium_modesticaldum	35701	S	1155	463	1618	0.00007
Heliorestis_convoluta	356322	S	91	5	96	0.00000
Eubacterium_limosum	1736	S	149	185	334	0.00001
Eubacterium_sp._c-25	2841037	S	40	19	59	0.00000
Eubacterium_sp._MSJ-33	2841528	S	28	16	44	0.00000
Eubacterium_sp._NSJ-61	2764325	S	13	18	31	0.00000
Eubacterium_callanderi	53442	S	71	71	142	0.00001
Eubacterium_maltosivorans	2041044	S	44	224	268	0.00001
Acetobacterium_sp._KB-1	2184575	S	205	65	270	0.00001
Acetobacterium_wieringae	52694	S	74	40	114	0.00000
Acetobacterium_woodii	33952	S	33	7	40	0.00000
Alkalibacter_sp._ES005	2815577	S	111	6	117	0.00001
Desulfitobacterium_hafniense	49338	S	176	27	203	0.00001
Desulfitobacterium_dehalogenans	36854	S	74	13	87	0.00000
Desulfitobacterium_metallireducens	142877	S	67	13	80	0.00000
Desulfitobacterium_dichloroeliminans	233055	S	41	34	75	0.00000
Desulfosporosinus_youngiae	339862	S	107	28	135	0.00001
Desulfosporosinus_meridiei	79209	S	80	25	105	0.00000
Desulfosporosinus_orientis	1563	S	76	14	90	0.00000
Desulfosporosinus_acidiphilus	885581	S	65	11	76	0.00000
Dehalobacter_restrictus	55583	S	48	81	129	0.00001
Syntrophobotulus_glycolicus	51197	S	104	6	110	0.00000
Peptoclostridium_acidaminophilum	1731	S	107	16	123	0.00001
Clostridioides_difficile	1496	S	61	1723	1784	0.00008
Romboutsia_ilealis	1115758	S	26	10	36	0.00000
Romboutsia_hominis	1507512	S	25	7	32	0.00000
Romboutsia_sp._CE17	2724150	S	25	8	33	0.00000
Terrisporobacter_sp._MCA3	2813371	S	48	6	54	0.00000
Paeniclostridium_sordellii	1505	S	38	7	45	0.00000
Acetoanaerobium_sticklandii	1511	S	35	3	38	0.00000
Filifactor_alocis	143361	S	30	38	68	0.00000
Tepidibacter_sp._8C15b	2925782	S	23	4	27	0.00000
Peptacetobacter_hiranonis	89152	S	21	4	25	0.00000
Syntrophothermus_lipocalidus	86170	S	207	17	224	0.00001
Syntrophomonas_wolfei	863	S	69	12	81	0.00000
Candidatus_Contubernalis_alkalaceticum	338645	S	60	2	62	0.00000
Candidatus_Syntrophocurvum_alkaliphilum	2293317	S	24	5	29	0.00000
Desulfoscipio_gibsoniae	102134	S	236	18	254	0.00001
Thermincola_potens	863643	S	128	10	138	0.00001
Desulfotomaculum_nigrificans	1565	S	116	44	160	0.00001
Vallitalea_pronyensis	1348613	S	33	3	36	0.00000
Vallitalea_guaymasensis	1185412	S	24	3	27	0.00000
Petrocella_atlantisensis	2173034	S	35	5	40	0.00000
Caloranaerobacter_azorensis	116090	S	91	12	103	0.00000
Alkalicella_caledoniensis	2731377	S	51	6	57	0.00000
Moorella_sp._Hama-1	2138101	S	572	100	672	0.00003
Moorella_thermoacetica	1525	S	492	72	564	0.00002
Moorella_glycerini	55779	S	422	34	456	0.00002
Ammonifex_degensii	42838	S	643	22	665	0.00003
Gelria_sp._Kuro-4	2796927	S	1483	103	1586	0.00007
Thermacetogenium_phaeum	85874	S	579	452	1031	0.00004
Carboxydothermus_hydrogenoformans	129958	S	213	17	230	0.00001
Thermoanaerobacter_mathranii	583357	S	47	82	129	0.00001
Thermoanaerobacter_kivui	2325	S	25	16	41	0.00000
Thermoanaerobacter_italicus	108150	S	11	20	31	0.00000
Thermanaeromonas_toyohensis	161154	S	152	4	156	0.00001
Caldanaerobacter_subterraneus	911092	S	86	81	167	0.00001
Caldicellulosiruptor_changbaiensis	1222016	S	28	67	95	0.00000
Caldicellulosiruptor_acetigenus	301953	S	17	20	37	0.00000
Caldicellulosiruptor_diazotrophicus	2806205	S	10	10	20	0.00000
Thermoanaerobacterium_thermosaccharolyticum	1517	S	45	83	128	0.00001
Thermoanaerobacterium_sp._RBIITD	1550240	S	13	7	20	0.00000
Mahella_australiensis	252966	S	145	67	212	0.00001
Zhaonella_formicivorans	2528593	S	114	15	129	0.00001
Thermodesulfobium_acidiphilum	1794699	S	37	59	96	0.00000
Thermosediminibacter_oceani	291990	S	325	26	351	0.00002
Biomaibacter_acetigenes	2316383	S	131	8	139	0.00001
Tepidanaerobacter_acetatoxydans	499229	S	59	2	61	0.00000
Iocasia_fonsfrigidae	2682810	S	146	11	157	0.00001
Halothermothrix_orenii	31909	S	81	10	91	0.00000
Halanaerobium_praevalens	2331	S	23	15	38	0.00000
Halanaerobium_hydrogeniformans	656519	S	16	8	24	0.00000
Anoxybacter_fermentans	1323375	S	109	22	131	0.00001
Halobacteroides_halobius	42422	S	63	11	74	0.00000
Acetohalobium_arabaticum	28187	S	23	2	25	0.00000
Koleobacter_methoxysyntrophicus	2751313	S	164	12	176	0.00001
Natranaerofaba_carboxydovora	2742683	S	81	3	84	0.00000
Natranaerobius_thermophilus	375929	S	59	8	67	0.00000
Selenomonas_sp._oral_taxon_126	712528	S	699	184	883	0.00004
Selenomonas_sp._oral_taxon_920	1884263	S	469	104	573	0.00002
Selenomonas_sp._oral_taxon_136	713030	S	214	275	489	0.00002
Selenomonas_sp._oral_taxon_478	712538	S	190	258	448	0.00002
Selenomonas_sputigena	69823	S	1235	96	1331	0.00006
Selenomonas_timonae	2754044	S	486	223	709	0.00003
Selenomonas_ruminantium	971	S	175	14	189	0.00001
Megamonas_funiformis	437897	S	27	58	85	0.00000
Megamonas_hypermegale	158847	S	19	69	88	0.00000
Pectinatus_frisingensis	865	S	41	2	43	0.00000
Pelosinus_fermentans	365349	S	168	17	185	0.00001
Pelosinus_sp._UFO1	484770	S	121	20	141	0.00001
Sporomusa_termitida	2377	S	250	27	277	0.00001
Methylomusa_anaerophila	1930071	S	163	9	172	0.00001
Megasphaera_elsdenii	907	S	436	147	583	0.00003
Megasphaera_stantonii	2144175	S	393	201	594	0.00003
Megasphaera_massiliensis	1232428	S	211	68	279	0.00001
Dialister_pneumosintes	39950	S	17	2	19	0.00000
Dialister_massiliensis	2161821	S	10	150	160	0.00001
Veillonella_rodentium	248315	S	32	9	41	0.00000
Veillonella_atypica	39777	S	12	5	17	0.00000
Veillonella_parvula	29466	S	10	5	15	0.00000
Veillonella_dispar	39778	S	10	27	37	0.00000
Acidaminococcus_fermentans	905	S	328	41	369	0.00002
Acidaminococcus_intestini	187327	S	82	4	86	0.00000
Phascolarctobacterium_faecium	33025	S	76	6	82	0.00000
Phascolarctobacterium_sp._Marseille-Q4147	2823317	S	48	31	79	0.00000
Phascolarctobacterium_succinatutens	626940	S	37	78	115	0.00000
Limnochorda_pilosa	1555112	S	4778	184	4962	0.00021
Peptoniphilus_ivorii	54006	S	206	44	250	0.00001
Peptoniphilus_harei	54005	S	32	31	63	0.00000
Murdochiella_vaginalis	1852373	S	94	78	172	0.00001
Anaerococcus_mediterraneensis	1870984	S	29	55	84	0.00000
Anaerococcus_prevotii	33034	S	10	12	22	0.00000
Finegoldia_magna	1260	S	37	27	64	0.00000
Parvimonas_micra	33033	S	22	36	58	0.00000
Miniphocaeibacter_halophilus	2931922	S	15	1	16	0.00000
Helcococcus_kunzii	40091	S	14	5	19	0.00000
Schnuerera_ultunensis	45497	S	102	11	113	0.00000
Keratinibaculum_paraultunense	1278232	S	50	16	66	0.00000
Tissierella_sp._JN-28	2507161	S	49	9	58	0.00000
Gudongella_oleilytica	1582259	S	32	5	37	0.00000
Gottschalkia_acidurici	1556	S	133	13	146	0.00001
Ezakiella_coagulans	46507	S	88	204	292	0.00001
Ezakiella_massiliensis	1852374	S	30	14	44	0.00000
Sedimentibacter_sp._zth1	2816908	S	32	3	35	0.00000
Allobaculum_sp._Allo2	2853432	S	98	18	116	0.00001
Allobaculum_mucolyticum	2834459	S	74	16	90	0.00000
Faecalibaculum_rodentium	1702221	S	177	44	221	0.00001
[Clostridium]_innocuum	1522	S	71	53	124	0.00001
Erysipelatoclostridium_ramosum	1547	S	17	8	25	0.00000
Erysipelothrix_sp._HDW6B	2714929	S	11	11	22	0.00000
Erysipelothrix_larvae	1514105	S	19	9	28	0.00000
Bulleidia_sp._zg-1006	2806552	S	27	9	36	0.00000
Intestinibaculum_porci	2487118	S	20	8	28	0.00000
Longicatena_caecimuris	1796635	S	19	31	50	0.00000
Faecalibacillus_intestinalis	1982626	S	16	18	34	0.00000
Faecalitalea_cylindroides	39483	S	13	23	36	0.00000
Amedibacterium_intestinale	2583452	S	10	17	27	0.00000
Turicibacter_sp._H121	1712675	S	34	30	64	0.00000
Turicibacter_sp._TJ11	2806443	S	11	8	19	0.00000
Turicibacter_sanguinis	154288	S	21	5	26	0.00000
Ndongobacter_massiliensis	1871025	S	164	117	281	0.00001
endosymbiont_'TC1'_of_Trimyema_compressum	243899	S	63	3	66	0.00000
Deinococcus_sp._NW-56	2080419	S	2090	305	2395	0.00010
Deinococcus_sp._TS-293	2737050	S	1891	201	2092	0.00009
Deinococcus_sp._KNUC1210	2917691	S	1512	62	1574	0.00007
Deinococcus_sp._AJ005	2652443	S	1094	95	1189	0.00005
Deinococcus_sp._QL22	2939437	S	813	73	886	0.00004
Deinococcus_ficus	317577	S	2821	277	3098	0.00013
Deinococcus_gobiensis	502394	S	2666	371	3037	0.00013
Deinococcus_maricopensis	309887	S	2619	236	2855	0.00012
Deinococcus_metallilatus	1211322	S	2472	299	2771	0.00012
Deinococcus_actinosclerus	1768108	S	2369	1605	3974	0.00017
Deinococcus_irradiatisoli	2202254	S	1926	181	2107	0.00009
Deinococcus_wulumuqiensis	980427	S	1692	693	2385	0.00010
Deinococcus_peraridilitoris	432329	S	1665	83	1748	0.00008
Deinococcus_radiopugnans	57497	S	1418	185	1603	0.00007
Deinococcus_geothermalis	68909	S	1284	214	1498	0.00006
Deinococcus_radiodurans	1299	S	1267	685	1952	0.00008
Deinococcus_soli_(ex_Cha_et_al._2016)	1309411	S	1137	1210	2347	0.00010
Deinococcus_psychrotolerans	2489213	S	970	28	998	0.00004
Deinococcus_deserti	310783	S	931	69	1000	0.00004
Deinococcus_proteolyticus	55148	S	930	224	1154	0.00005
Deinococcus_radiophilus	32062	S	532	120	652	0.00003
Deinococcus_puniceus	1182568	S	422	72	494	0.00002
Thermus_thermophilus	274	S	1633	1949	3582	0.00015
Thermus_sp._CCB_US3_UF1	1111069	S	794	117	911	0.00004
Thermus_sp._NEB1569	2918899	S	140	247	387	0.00002
Thermus_oshimai	56957	S	745	140	885	0.00004
Thermus_aquaticus	271	S	704	101	805	0.00003
Thermus_brockianus	56956	S	622	120	742	0.00003
Thermus_caldilimi	2483360	S	278	68	346	0.00002
Thermus_scotoductus	37636	S	137	202	339	0.00001
Thermus_parvatiensis	456163	S	111	518	629	0.00003
Meiothermus_silvanus	52022	S	1317	210	1527	0.00007
Meiothermus_taiwanensis	172827	S	1086	388	1474	0.00006
Meiothermus_ruber	277	S	1037	392	1429	0.00006
Oceanithermus_profundus	187137	S	3896	414	4310	0.00019
Marinithermus_hydrothermalis	186192	S	2442	448	2890	0.00013
Truepera_radiovictrix	332249	S	3379	183	3562	0.00015
Synechococcus_sp._CBW1004	1353136	S	1412	344	1756	0.00008
Synechococcus_sp._RSCCF101	2511069	S	1223	263	1486	0.00006
Synechococcus_sp._CBW1107	2789857	S	1201	219	1420	0.00006
Synechococcus_sp._CBW1108	1353147	S	801	105	906	0.00004
Synechococcus_sp._JA-3-3Ab	321327	S	732	165	897	0.00004
Synechococcus_sp._CB0101	232348	S	728	151	879	0.00004
Synechococcus_sp._SynAce01	1916956	S	727	75	802	0.00003
Synechococcus_sp._LTW-R	2751170	S	526	122	648	0.00003
Synechococcus_sp._NB0720_10	2907159	S	517	128	645	0.00003
Synechococcus_sp._RS9909	221352	S	489	166	655	0.00003
Synechococcus_sp._JA-2-3B'a(2-13)	321332	S	456	93	549	0.00002
Synechococcus_sp._LA31	2741953	S	430	91	521	0.00002
Synechococcus_sp._PCC_7336	195250	S	389	13	402	0.00002
Synechococcus_sp._A10-1-5-1	2936507	S	345	74	419	0.00002
Synechococcus_sp._Minos11	221341	S	323	22	345	0.00001
Synechococcus_sp._HK01-R	2751171	S	321	51	372	0.00002
Synechococcus_sp._WH_8101	59932	S	276	87	363	0.00002
Synechococcus_sp._PROS-U-1	1400866	S	252	42	294	0.00001
Synechococcus_sp._KORDI-100	1280380	S	247	16	263	0.00001
Synechococcus_sp._NOUM97013	1442555	S	227	34	261	0.00001
Synechococcus_sp._BMK-MC-1	1442551	S	224	82	306	0.00001
Synechococcus_sp._KORDI-52	585425	S	183	53	236	0.00001
Synechococcus_sp._BIOS-E4-1	1400864	S	180	18	198	0.00001
Synechococcus_sp._MEDNS5	1442554	S	166	50	216	0.00001
Synechococcus_sp._A15-127	1050624	S	156	137	293	0.00001
Synechococcus_sp._PCC_6312	195253	S	147	6	153	0.00001
Synechococcus_sp._KORDI-49	585423	S	144	127	271	0.00001
Synechococcus_sp._PROS-7-1	1442556	S	139	55	194	0.00001
Synechococcus_sp._CBW1006	1353138	S	132	853	985	0.00004
Synechococcus_sp._BIOS-U3-1	1400865	S	128	13	141	0.00001
Synechococcus_sp._A15-62	1050657	S	127	79	206	0.00001
Synechococcus_sp._A15-44	1050646	S	116	179	295	0.00001
Synechococcus_sp._CBW1002	1353134	S	114	838	952	0.00004
Synechococcus_sp._MIT_S9220	166309	S	113	16	129	0.00001
Synechococcus_sp._CC9902	316279	S	106	10	116	0.00001
Synechococcus_sp._NIES-970	1827144	S	103	18	121	0.00001
Synechococcus_sp._PCC_7003	374981	S	102	28	130	0.00001
Synechococcus_sp._WH_8109	166314	S	102	68	170	0.00001
Synechococcus_sp._ROS8604	1442557	S	91	21	112	0.00000
Synechococcus_sp._RS9907	221350	S	89	180	269	0.00001
Synechococcus_sp._TAK9802	1442558	S	74	156	230	0.00001
Synechococcus_sp._WH_8020	32052	S	73	12	85	0.00000
Synechococcus_sp._RS9902	221345	S	61	108	169	0.00001
Synechococcus_sp._M16.1	1442553	S	52	134	186	0.00001
Synechococcus_sp._PCC_7502	1173263	S	52	2	54	0.00000
Synechococcus_sp._PROS-9-1	1968775	S	44	10	54	0.00000
Synechococcus_sp._A15-60	1050655	S	42	256	298	0.00001
Synechococcus_sp._CC9311	64471	S	40	8	48	0.00000
Synechococcus_sp._SYN20	1050714	S	31	40	71	0.00000
Synechococcus_sp._MVIR-18-1	1386941	S	30	45	75	0.00000
Synechococcus_sp._A18-25c	1866938	S	20	126	146	0.00001
Synechococcus_sp._PCC_11901	2579791	S	18	74	92	0.00000
Synechococcus_sp._PCC_8807	195248	S	15	75	90	0.00000
Synechococcus_sp._PCC_7002	32049	S	15	57	72	0.00000
Synechococcus_sp._PCC_7117	195498	S	13	54	67	0.00000
Synechococcus_sp._PCC_73109	374982	S	13	51	64	0.00000
Synechococcus_elongatus	32046	S	644	33	677	0.00003
Dactylococcopsis_salina	292566	S	95	36	131	0.00001
Cyanobium_sp._NIES-981	1851505	S	1255	372	1627	0.00007
Cyanobium_sp._NS01	261284	S	1143	379	1522	0.00007
Cyanobium_gracile	59930	S	1832	350	2182	0.00009
Parasynechococcus_marenigrum	2881428	S	281	82	363	0.00002
Prochlorococcus_marinus	1219	S	239	24	263	0.00001
Acaryochloris_marina	155978	S	168	31	199	0.00001
Acaryochloris_sp._'Moss_Beach'	2740837	S	107	75	182	0.00001
Chamaesiphon_minutus	1173032	S	275	15	290	0.00001
Synechocystis_sp._PCC_6714	1147	S	56	19	75	0.00000
Synechocystis_sp._CACIAM_05	1933929	S	18	122	140	0.00001
Nostoc_sp._NIES-4103	2005458	S	158	23	181	0.00001
Nostoc_sp._UHCC_0702	2814655	S	150	20	170	0.00001
Nostoc_sp._C052	2576902	S	122	29	151	0.00001
Nostoc_sp._CENA543	1869241	S	116	12	128	0.00001
Nostoc_sp._TCL26-01	2576904	S	99	8	107	0.00000
Nostoc_sp._MS1	2764711	S	94	15	109	0.00000
Nostoc_sp._'Lobaria_pulmonaria_(5183)_cyanobiont'	1618022	S	93	20	113	0.00000
Nostoc_sp._UHCC_0870	2914041	S	83	11	94	0.00000
Nostoc_sp._ATCC_53789	76335	S	78	130	208	0.00001
Nostoc_sp._PCC_7524	28072	S	75	9	84	0.00000
Nostoc_sp._'Peltigera_membranacea_cyanobiont'_N6	1261031	S	70	20	90	0.00000
Nostoc_sp._C057	2576903	S	60	98	158	0.00001
Nostoc_sp._PCC_7107	317936	S	54	27	81	0.00000
Nostoc_sp._NIES-2111	1973475	S	37	85	122	0.00001
Nostoc_sp._TCL240-02	2572090	S	33	19	52	0.00000
Nostoc_sp._NIES-3756	1751286	S	17	50	67	0.00000
Nostoc_linckia	92942	S	189	42	231	0.00001
Nostoc_punctiforme	272131	S	134	89	223	0.00001
Nostoc_edaphicum	264686	S	125	32	157	0.00001
Nostoc_flagelliforme	1306274	S	111	37	148	0.00001
Nostoc_sphaeroides	446679	S	110	54	164	0.00001
Nostoc_piscinale	224012	S	109	21	130	0.00001
Nostoc_commune	1178	S	71	21	92	0.00000
Anabaena_sp._WA102	1647413	S	65	138	203	0.00001
Anabaena_sp._90	46234	S	33	314	347	0.00002
Anabaena_sp._YBS01	2490939	S	12	533	545	0.00002
Anabaena_cylindrica	1165	S	104	18	122	0.00001
Cylindrospermum_stagnale	142864	S	131	13	144	0.00001
Trichormus_azollae	1164	S	61	6	67	0.00000
Richelia_sinica	1357545	S	40	4	44	0.00000
Calothrix_sp._PCC_7716	2853227	S	174	142	316	0.00001
Calothrix_sp._NIES-3974	2005462	S	173	15	188	0.00001
Calothrix_sp._NIES-2100	1954172	S	162	124	286	0.00001
Calothrix_sp._PCC_7507	99598	S	161	40	201	0.00001
Calothrix_sp._NIES-2098	1954171	S	106	76	182	0.00001
Calothrix_sp._PCC_6303	1170562	S	81	28	109	0.00000
Calothrix_sp._336/3	1337936	S	61	21	82	0.00000
Calothrix_brevissima	938406	S	164	78	242	0.00001
Calothrix_parasitica	1973486	S	142	8	150	0.00001
Scytonema_sp._NIES-4073	2005464	S	643	222	865	0.00004
Scytonema_sp._HK-05	1137095	S	260	70	330	0.00001
Brasilonema_sennae	1397703	S	133	12	145	0.00001
Sphaerospermopsis_torques-reginae	984207	S	110	42	152	0.00001
Sphaerospermopsis_kisseleviana	289435	S	103	42	145	0.00001
Nodularia_spumigena	70799	S	101	12	113	0.00000
Nodularia_sphaerocarpa	137816	S	78	18	96	0.00000
Dolichospermum_compactum	136073	S	65	98	163	0.00001
Dolichospermum_sp._UHCC_0315A	1914871	S	25	211	236	0.00001
Dolichospermum_flos-aquae	1166	S	18	181	199	0.00001
Anabaenopsis_circularis	109266	S	54	37	91	0.00000
Anabaenopsis_elenkinii	156213	S	40	6	46	0.00000
Fischerella_sp._NIES-3754	1752063	S	134	30	164	0.00001
Fischerella_sp._NIES-4106	2005456	S	111	13	124	0.00001
Tolypothrix_sp._PCC_7910	2099387	S	127	36	163	0.00001
Tolypothrix_tenuis	457083	S	93	40	133	0.00001
Rivularia_sp._PCC_7116	373994	S	55	3	58	0.00000
Leptolyngbya_sp._7M	2812896	S	3114	208	3322	0.00014
Leptolyngbya_sp._BL0902	1115757	S	549	33	582	0.00003
Leptolyngbya_sp._NIES-3755	1752064	S	140	13	153	0.00001
Leptolyngbya_sp._PCC_7376	111781	S	47	4	51	0.00000
Leptolyngbya_boryana	1184	S	137	0	137	0.00001
Kovacikia_minuta	2931930	S	496	45	541	0.00002
Leptothermofonsia_sichuanensis	2917832	S	261	21	282	0.00001
Leptodesmis_sichuanensis	2906798	S	251	24	275	0.00001
Thermoleptolyngbya_sp._PKUAC-SCTB121	2811482	S	51	603	654	0.00003
Thermoleptolyngbya_sichuanensis	2885951	S	14	182	196	0.00001
Thermosynechococcus_sp._NK55a	1394889	S	95	46	141	0.00001
Thermosynechococcus_sp._TA-1	2813673	S	51	52	103	0.00000
Thermosynechococcus_sp._CL-1	2583530	S	32	34	66	0.00000
Thermosynechococcus_vestitus	146786	S	149	58	207	0.00001
Halomicronema_hongdechloris	1209493	S	453	18	471	0.00002
Pseudanabaena_sp._PCC_7367	82654	S	167	7	174	0.00001
Pseudanabaena_sp._ABRG5-3	685565	S	73	5	78	0.00000
Gloeobacter_kilaueensis	1416614	S	1875	49	1924	0.00008
Gloeobacter_morelensis	2907343	S	1426	580	2006	0.00009
Gloeobacter_violaceus	33072	S	1391	622	2013	0.00009
Anthocerotibacter_panamensis	2857077	S	452	11	463	0.00002
Geitlerinema_sp._PCC_7407	1173025	S	1024	148	1172	0.00005
Allocoleopsis_franciscana	2886352	S	177	19	196	0.00001
Moorena_producens	1155739	S	666	16	682	0.00003
Oscillatoria_nigro-viridis	482564	S	223	108	331	0.00001
Oscillatoria_acuminata	118323	S	159	10	169	0.00001
Oxynema_aestuarii	2874213	S	428	37	465	0.00002
Microcoleus_vaginatus	119532	S	200	64	264	0.00001
Planktothrix_agardhii	1160	S	19	29	48	0.00000
Planktothrix_rubescens	59512	S	17	19	36	0.00000
[Phormidium]_sp._ETS-05	222819	S	263	15	278	0.00001
Crinalium_epipsammum	241425	S	81	10	91	0.00000
Microcystis_aeruginosa	1126	S	280	250	530	0.00002
Microcystis_sp._MC19	1967666	S	37	18	55	0.00000
Gloeothece_citriformis	2546356	S	76	6	82	0.00000
Gloeothece_verrucosa	2546359	S	61	5	66	0.00000
Halothece_sp._PCC_7418	65093	S	100	32	132	0.00001
Euhalothece_natronophila	577489	S	19	2	21	0.00000
Crocosphaera_subtropica	2546360	S	80	6	86	0.00000
Rippkaea_orientalis	2546366	S	75	8	83	0.00000
Candidatus_Atelocyanobacterium_thalassa	713887	S	16	2	18	0.00000
Geminocystis_herdmanii	669359	S	61	18	79	0.00000
Geminocystis_sp._NIES-3709	1617448	S	34	9	43	0.00000
Geminocystis_sp._NIES-3708	1615909	S	19	5	24	0.00000
Gloeocapsa_sp._PCC_7428	1173026	S	102	10	112	0.00000
Chondrocystis_sp._NIES-4102	2005460	S	55	8	63	0.00000
Cyanobacterium_aponinum	379064	S	46	13	59	0.00000
Chroococcidiopsis_sp._CCMEE_29	155894	S	306	52	358	0.00002
Chroococcidiopsis_sp._CCNUC1	2653189	S	63	96	159	0.00001
Chroococcidiopsis_thermalis	54299	S	83	139	222	0.00001
Pleurocapsa_sp._PCC_7327	118163	S	163	18	181	0.00001
Stanieria_sp._NIES-3757	1807358	S	31	7	38	0.00000
Stanieria_cyanosphaera	102116	S	29	8	37	0.00000
Gloeomargarita_lithophora	1188228	S	148	5	153	0.00001
Thermostichus_lividus	33070	S	119	16	135	0.00001
cyanobacterium_endosymbiont_of_Epithemia_turgida	718217	S	25	3	28	0.00000
cyanobacterium_endosymbiont_of_Rhopalodia_gibberula	1763363	S	17	2	19	0.00000
Sphaerobacter_thermophilus	2057	S	12476	822	13298	0.00058
Thermomicrobium_roseum	500	S	2713	62	2775	0.00012
Roseiflexus_castenholzii	120962	S	2703	487	3190	0.00014
Roseiflexus_sp._RS-1	357808	S	2661	477	3138	0.00014
Chloroflexus_aurantiacus	1108	S	1056	116	1172	0.00005
Chloroflexus_aggregans	152260	S	933	154	1087	0.00005
Tepidiforma_bonchosmolovskayae	2601677	S	6829	291	7120	0.00031
Candidatus_Promineofilum_breve	1806508	S	6572	132	6704	0.00029
Caldilinea_aerophila	133453	S	3209	236	3445	0.00015
Anaerolinea_thermophila	167964	S	1304	120	1424	0.00006
Pelolinea_submarina	913107	S	1022	43	1065	0.00005
Brevefilum_fermentans	1986204	S	421	13	434	0.00002
Dehalogenimonas_formicexedens	1839801	S	619	187	806	0.00003
Dehalogenimonas_sp._GP	1536648	S	482	144	626	0.00003
Dehalococcoides_mccartyi	61435	S	148	391	539	0.00002
Ktedonosporobacter_rubrisoli	2509675	S	1278	44	1322	0.00006
Thermobaculum_terrenum	166501	S	1203	169	1372	0.00006
Phototrophicus_methaneseepsis	2710758	S	906	11	917	0.00004
Fimbriimonas_ginsengisoli	1005039	S	3089	17	3106	0.00013
Chthonomonas_calidirosea	454171	S	758	6	764	0.00003
Mycoplasma_sp._SG1	2810348	S	39	1	40	0.00000
Mycoplasma_sp._(ex_Biomphalaria_glabrata)	1749074	S	37	15	52	0.00000
Mycoplasma_genitalium	2097	S	21	0	21	0.00000
Mycoplasma_phocoenae	754517	S	12	52	64	0.00000
Mycoplasmopsis_agalactiae	2110	S	11	40	51	0.00000
Mycoplasmopsis_synoviae	2109	S	10	140	150	0.00001
Mesomycoplasma_dispar	86660	S	10	10	20	0.00000
Candidatus_Hepatoplasma_crinochetorum	295596	S	10	4	14	0.00000
Candidatus_Phytoplasma_luffae	35773	S	10	28	38	0.00000
Alteracholeplasma_palmae	38986	S	54	13	67	0.00000
Acholeplasma_laidlawii	2148	S	13	6	19	0.00000
Paracholeplasma_brassicae	61635	S	18	8	26	0.00000
Mariniplasma_anaerobium	2735436	S	15	2	17	0.00000
Haploplasma_axanthum	29552	S	14	8	22	0.00000
Malacoplasma_iowae	2116	S	25	8	33	0.00000
Candidatus_Izimaplasma_sp._HR1	1541959	S	33	2	35	0.00000
Bradyrhizobium_sp._170	2782641	S	27032	6723	33755	0.00146
Bradyrhizobium_sp._200	2782665	S	25977	5615	31592	0.00137
Bradyrhizobium_sp._CCBAU_051011	858422	S	23005	4281	27286	0.00118
Bradyrhizobium_sp._CCBAU_51753	1325100	S	10833	2279	13112	0.00057
Bradyrhizobium_sp._A19	2898149	S	8669	1456	10125	0.00044
Bradyrhizobium_sp._BTAi1	288000	S	8431	1485	9916	0.00043
Bradyrhizobium_sp._ORS_278	114615	S	8280	1824	10104	0.00044
Bradyrhizobium_sp._ORS_285	115808	S	8207	1784	9991	0.00043
Bradyrhizobium_sp._SK17	2057741	S	7294	2339	9633	0.00042
Bradyrhizobium_sp._186	2782654	S	6527	1708	8235	0.00036
Bradyrhizobium_sp._CCBAU_53421	1325120	S	5951	1817	7768	0.00034
Bradyrhizobium_sp._CCGE-LA001	1223566	S	5752	2106	7858	0.00034
Bradyrhizobium_sp._1(2017)	1404888	S	5078	1545	6623	0.00029
Bradyrhizobium_sp._CCBAU_53338	1325111	S	4941	1991	6932	0.00030
Bradyrhizobium_sp._195	2782662	S	4905	1716	6621	0.00029
Bradyrhizobium_sp._CCBAU_53340	1325112	S	4862	1859	6721	0.00029
Bradyrhizobium_sp._S2-11-2	2840472	S	4571	3403	7974	0.00035
Bradyrhizobium_sp._CCBAU_53351	1325114	S	4524	2250	6774	0.00029
Bradyrhizobium_sp._6(2017)	1197460	S	4347	2103	6450	0.00028
Bradyrhizobium_sp._S2-20-1	2840469	S	3782	2999	6781	0.00029
Bradyrhizobium_sp._S2-11-4	2840473	S	3641	3176	6817	0.00029
Bradyrhizobium_sp._41S5	1404443	S	3459	2316	5775	0.00025
Bradyrhizobium_sp._191	2782659	S	3429	3299	6728	0.00029
Bradyrhizobium_sp._I71	2590772	S	3204	2741	5945	0.00026
Bradyrhizobium_sp._CCBAU_51765	1325102	S	3026	2704	5730	0.00025
Bradyrhizobium_sp._C-145	574727	S	2055	2030	4085	0.00018
Bradyrhizobium_sp.	376	S	1530	5023	6553	0.00028
Bradyrhizobium_sp._144S4	2823807	S	1338	3278	4616	0.00020
Bradyrhizobium_sp._40	2782674	S	1222	2703	3925	0.00017
Bradyrhizobium_sp._323S2	1404649	S	1146	2867	4013	0.00017
Bradyrhizobium_sp._4	2782678	S	1144	2837	3981	0.00017
Bradyrhizobium_sp._192	2782660	S	1029	2474	3503	0.00015
Bradyrhizobium_sp._LCT2	2493093	S	765	2134	2899	0.00013
Bradyrhizobium_sp._187	2782655	S	464	2230	2694	0.00012
Bradyrhizobium_sp._SG09	2599805	S	456	3232	3688	0.00016
Bradyrhizobium_sp._TM102	2599819	S	376	2544	2920	0.00013
Bradyrhizobium_sp._CW1	2782686	S	338	5073	5411	0.00023
Bradyrhizobium_sp._172	2782643	S	276	3256	3532	0.00015
Bradyrhizobium_sp._38S5	2819348	S	267	3159	3426	0.00015
Bradyrhizobium_sp._1S5	2816456	S	228	2482	2710	0.00012
Bradyrhizobium_sp._131	2782609	S	212	3358	3570	0.00015
Bradyrhizobium_sp._155	2782629	S	164	2864	3028	0.00013
Bradyrhizobium_sp._CCBAU_21365	1325083	S	25	1215	1240	0.00005
Bradyrhizobium_erythrophlei	1437360	S	27555	2175	29730	0.00129
Bradyrhizobium_paxllaeri	190148	S	22979	4189	27168	0.00118
Bradyrhizobium_diazoefficiens	1355477	S	20443	37815	58258	0.00252
Bradyrhizobium_icense	1274631	S	19369	2663	22032	0.00095
Bradyrhizobium_lablabi	722472	S	9341	10662	20003	0.00087
Bradyrhizobium_japonicum	375	S	8131	11698	19829	0.00086
Bradyrhizobium_canariense	255045	S	8042	12659	20701	0.00090
Bradyrhizobium_genosp._L	83637	S	7862	1542	9404	0.00041
Bradyrhizobium_oligotrophicum	44255	S	7441	1265	8706	0.00038
Bradyrhizobium_arachidis	858423	S	5886	1663	7549	0.00033
Bradyrhizobium_quebecense	2748629	S	4964	2780	7744	0.00034
Bradyrhizobium_vignae	1549949	S	4909	1134	6043	0.00026
Bradyrhizobium_genosp._B	83627	S	4858	1016	5874	0.00025
Bradyrhizobium_guangdongense	1325090	S	4834	1779	6613	0.00029
Bradyrhizobium_cosmicum	1404864	S	4703	1506	6209	0.00027
Bradyrhizobium_guangzhouense	1325095	S	4373	1645	6018	0.00026
Bradyrhizobium_septentrionale	1404411	S	4255	2570	6825	0.00030
Bradyrhizobium_guangxiense	1325115	S	4093	1761	5854	0.00025
Bradyrhizobium_daqingense	993502	S	3933	2106	6039	0.00026
Bradyrhizobium_amphicarpaeae	1404768	S	2950	1209	4159	0.00018
Bradyrhizobium_betae	244734	S	2805	1538	4343	0.00019
Bradyrhizobium_symbiodeficiens	1404367	S	2722	4070	6792	0.00029
Bradyrhizobium_zhanjiangense	1325107	S	1920	1914	3834	0.00017
Bradyrhizobium_elkanii	29448	S	1396	5307	6703	0.00029
Bradyrhizobium_ottawaense	931866	S	1140	7045	8185	0.00035
Rhodopseudomonas_palustris	1076	S	27682	8933	36615	0.00158
Rhodopseudomonas_sp._SK50-23	340268	S	3988	794	4782	0.00021
Rhodopseudomonas_boonkerdii	475937	S	3921	1000	4921	0.00021
Nitrobacter_winogradskyi	913	S	12689	1988	14677	0.00064
Nitrobacter_hamburgensis	912	S	11180	1740	12920	0.00056
Tardiphaga_sp._37S4	1404741	S	2077	1534	3611	0.00016
Tardiphaga_sp._vice154	2592814	S	156	2120	2276	0.00010
Tardiphaga_sp._vice278	2592815	S	110	2348	2458	0.00011
Tardiphaga_sp._vice304	2592817	S	92	1531	1623	0.00007
Tardiphaga_sp._vice352	2592816	S	32	851	883	0.00004
Tardiphaga_robiniae	943830	S	2284	1506	3790	0.00016
Afipia_carboxidovorans	40137	S	4830	1159	5989	0.00026
Afipia_sp._GAS231	1882747	S	4349	2904	7253	0.00031
Variibacter_gotjawalensis	1333996	S	8266	629	8895	0.00038
Rhizobium_sp._BG4	2613770	S	3341	587	3928	0.00017
Rhizobium_sp._WYJ-E13	2849093	S	3164	367	3531	0.00015
Rhizobium_sp._NXC24	2048897	S	2715	352	3067	0.00013
Rhizobium_sp._ACO-34A	1571470	S	2441	461	2902	0.00013
Rhizobium_sp._SL42	2806346	S	2374	398	2772	0.00012
Rhizobium_sp._WL3	2603277	S	2255	392	2647	0.00011
Rhizobium_sp._K102	2918527	S	1975	1037	3012	0.00013
Rhizobium_sp._11515TR	2028343	S	1909	393	2302	0.00010
Rhizobium_sp._AB2/73	2795216	S	1732	776	2508	0.00011
Rhizobium_sp._NZLR1	2731096	S	1710	473	2183	0.00009
Rhizobium_sp._CIAT894	2020312	S	1571	551	2122	0.00009
Rhizobium_sp._NLR16a	2731112	S	1561	542	2103	0.00009
Rhizobium_sp._NXC14	1981173	S	1441	470	1911	0.00008
Rhizobium_sp._C104	2917727	S	1429	602	2031	0.00009
Rhizobium_sp._007	2785056	S	984	1240	2224	0.00010
Rhizobium_sp._L51/94	2819999	S	965	1052	2017	0.00009
Rhizobium_sp._X9	2815360	S	725	1291	2016	0.00009
Rhizobium_sp._IE4771	1301032	S	640	971	1611	0.00007
Rhizobium_sp._Kim5	2020311	S	612	1013	1625	0.00007
Rhizobium_sp._TAL182	2020313	S	325	685	1010	0.00004
Rhizobium_sp._NIBRBAC000502774	2590777	S	227	793	1020	0.00004
Rhizobium_sp._ZX09	2291939	S	180	620	800	0.00003
Rhizobium_sp._Y9	1914541	S	159	436	595	0.00003
Rhizobium_sp._B230/85	2819994	S	131	1203	1334	0.00006
Rhizobium_sp._T136	555319	S	81	1586	1667	0.00007
Rhizobium_sp._CCGE531	2364271	S	78	2346	2424	0.00010
Rhizobium_sp._N324	1703969	S	52	907	959	0.00004
Rhizobium_sp._B21/90	2819993	S	39	1166	1205	0.00005
Rhizobium_sp._CCGE532	2364272	S	37	2355	2392	0.00010
Rhizobium_sp._N113	1703960	S	11	1208	1219	0.00005
Rhizobium_leguminosarum	384	S	16244	29953	46197	0.00200
Rhizobium_etli	29449	S	6042	5202	11244	0.00049
Rhizobium_pseudoryzae	379684	S	3328	650	3978	0.00017
Rhizobium_gallicum	56730	S	3253	2997	6250	0.00027
Rhizobium_jaguaris	1312183	S	3035	346	3381	0.00015
Rhizobium_phaseoli	396	S	2819	4177	6996	0.00030
Rhizobium_bangladeshense	1138189	S	2374	468	2842	0.00012
Rhizobium_tropici	398	S	1889	407	2296	0.00010
Rhizobium_lentis	1138194	S	1874	473	2347	0.00010
Rhizobium_rosettiformans	1368430	S	1825	753	2578	0.00011
Rhizobium_binae	1138190	S	1638	478	2116	0.00009
Rhizobium_daejeonense	240521	S	1619	467	2086	0.00009
Rhizobium_rhizoryzae	451876	S	1464	188	1652	0.00007
Rhizobium_indicum	2583231	S	1282	822	2104	0.00009
Rhizobium_pusense	648995	S	1093	3320	4413	0.00019
Rhizobium_acidisoli	1538158	S	901	547	1448	0.00006
Rhizobium_oryzihabitans	2267833	S	603	661	1264	0.00005
Rhizobium_hidalgonense	1538159	S	406	660	1066	0.00005
Rhizobium_laguerreae	1076926	S	385	470	855	0.00004
Rhizobium_ruizarguesonis	2081791	S	342	1755	2097	0.00009
Rhizobium_favelukesii	348824	S	34	795	829	0.00004
Agrobacterium_tumefaciens	358	S	10836	11153	21989	0.00095
Agrobacterium_fabrum	1176649	S	889	947	1836	0.00008
Agrobacterium_fabacearum	1183401	S	195	1985	2180	0.00009
Agrobacterium_vitis	373	S	4081	474	4555	0.00020
Agrobacterium_sp._T29	2580515	S	553	354	907	0.00004
Agrobacterium_sp._RAC06	1842536	S	434	876	1310	0.00006
Agrobacterium_sp._MA01	2664893	S	428	845	1273	0.00006
Agrobacterium_sp._CGMCC_11546	2579248	S	235	388	623	0.00003
Agrobacterium_sp._S7/73	2820002	S	156	658	814	0.00004
Agrobacterium_vaccinii	2735528	S	1609	202	1811	0.00008
Agrobacterium_larrymoorei	160699	S	1156	187	1343	0.00006
Agrobacterium_rubi	28099	S	1022	266	1288	0.00006
Agrobacterium_salinitolerans	1183413	S	972	307	1279	0.00006
Agrobacterium_rhizogenes	359	S	804	1547	2351	0.00010
Neorhizobium_galegae	399	S	9775	2549	12324	0.00053
Neorhizobium_sp._NCHU2750	1825976	S	3080	656	3736	0.00016
Neorhizobium_sp._SOG26	2060726	S	2725	533	3258	0.00014
Pseudorhizobium_banfieldiae	1125847	S	1934	1091	3025	0.00013
Pseudorhizobium_flavum	1335061	S	1812	1112	2924	0.00013
Sinorhizobium_meliloti	382	S	31378	22256	53634	0.00232
Sinorhizobium_fredii	380	S	17136	19998	37134	0.00161
Sinorhizobium_americanum	194963	S	10984	4240	15224	0.00066
Sinorhizobium_medicae	110321	S	4314	514	4828	0.00021
Sinorhizobium_sp._BG8	2613773	S	3529	559	4088	0.00018
Sinorhizobium_sp._CCBAU_05631	794846	S	745	915	1660	0.00007
Ensifer_adhaerens	106592	S	12236	5676	17912	0.00078
Ensifer_mexicanus	375549	S	5255	758	6013	0.00026
Ensifer_alkalisoli	1752398	S	3910	715	4625	0.00020
Ensifer_sp._PDNC004	2811423	S	3068	1204	4272	0.00018
Ensifer_sp._T173	555315	S	679	2667	3346	0.00014
Ensifer_sojae	716925	S	3480	1149	4629	0.00020
Shinella_sp._HZN7	879274	S	6200	5137	11337	0.00049
Shinella_sp._PSBB067	2715959	S	4561	3288	7849	0.00034
Shinella_sp._XGS7	2877941	S	3450	3178	6628	0.00029
Shinella_sp._H4-D48	2925841	S	1880	726	2606	0.00011
Shinella_zoogloeoides	352475	S	4686	6401	11087	0.00048
Shinella_oryzae	2871820	S	2592	1107	3699	0.00016
Georhizobium_profundi	2341112	S	4081	868	4949	0.00021
Ciceribacter_thiooxidans	1969821	S	3493	661	4154	0.00018
Peteryoungia_desertarenae	1813451	S	1152	193	1345	0.00006
Candidatus_Liberibacter_solanacearum	556287	S	67	8	75	0.00000
Liberibacter_crescens	1273132	S	21	3	24	0.00000
Candidatus_Liberibacter_americanus	309868	S	18	2	20	0.00000
Candidatus_Liberibacter_asiaticus	34021	S	17	23	40	0.00000
Candidatus_Liberibacter_africanus	34020	S	10	14	24	0.00000
Mesorhizobium_sp._8	2584466	S	10635	2534	13169	0.00057
Mesorhizobium_sp._DCY119	2108445	S	9391	2197	11588	0.00050
Mesorhizobium_sp._L-2-11	2744521	S	6402	2543	8945	0.00039
Mesorhizobium_sp._Pch-S	2082387	S	6215	847	7062	0.00031
Mesorhizobium_sp._M1A.F.Ca.IN.022.06.1.1	2493680	S	6128	2053	8181	0.00035
Mesorhizobium_sp._M3A.F.Ca.ET.080.04.2.1	2493676	S	5875	1843	7718	0.00033
Mesorhizobium_sp._B1-1-8	2589976	S	5634	1451	7085	0.00031
Mesorhizobium_sp._M9A.F.Ca.ET.002.03.1.2	2493668	S	5570	2685	8255	0.00036
Mesorhizobium_sp._M1B.F.Ca.ET.045.04.1.1	2493673	S	5549	2213	7762	0.00034
Mesorhizobium_sp._B2-1-1	2589974	S	5435	1255	6690	0.00029
Mesorhizobium_sp._131-2-1	2744518	S	5336	2946	8282	0.00036
Mesorhizobium_sp._J8	2777475	S	5320	1774	7094	0.00031
Mesorhizobium_sp._M1D.F.Ca.ET.043.01.1.1	2493669	S	5305	3346	8651	0.00037
Mesorhizobium_sp._M1E.F.Ca.ET.045.02.1.1	2493672	S	5287	2763	8050	0.00035
Mesorhizobium_sp._B2-8-5	2589903	S	5021	1716	6737	0.00029
Mesorhizobium_sp._INR15	2654248	S	4718	689	5407	0.00023
Mesorhizobium_sp._M4B.F.Ca.ET.058.02.1.1	2493675	S	4670	2051	6721	0.00029
Mesorhizobium_sp._PAMC28654	2880934	S	4498	857	5355	0.00023
Mesorhizobium_sp._M6A.T.Cr.TU.016.01.1.1	2493677	S	4384	1524	5908	0.00026
Mesorhizobium_sp._B4-1-4	2589888	S	3618	894	4512	0.00020
Mesorhizobium_sp._B2-1-8	2589967	S	3469	1102	4571	0.00020
Mesorhizobium_sp._AA22	1854057	S	3296	2190	5486	0.00024
Mesorhizobium_sp._L-8-10	2744523	S	3247	11256	14503	0.00063
Mesorhizobium_sp._M7D.F.Ca.US.005.01.1.1	2493678	S	3214	1144	4358	0.00019
Mesorhizobium_sp._M8A.F.Ca.ET.057.01.1.1	2493679	S	3121	1247	4368	0.00019
Mesorhizobium_sp._L-8-3	2744522	S	2886	10271	13157	0.00057
Mesorhizobium_sp._NBSH29	2654249	S	2798	201	2999	0.00013
Mesorhizobium_sp._M2A.F.Ca.ET.043.05.1.1	2493671	S	2769	2526	5295	0.00023
Mesorhizobium_sp._113-3-3	2744516	S	2724	1581	4305	0.00019
Mesorhizobium_sp._NZP2077	2483404	S	2713	936	3649	0.00016
Mesorhizobium_sp._M7A.F.Ce.TU.012.03.2.1	2493681	S	2687	1036	3723	0.00016
Mesorhizobium_sp._113-1-2	2744515	S	2544	1320	3864	0.00017
Mesorhizobium_sp._NZP2298	2483403	S	2017	1281	3298	0.00014
Mesorhizobium_sp._113-3-9	2744517	S	1873	1496	3369	0.00015
Mesorhizobium_sp._M2A.F.Ca.ET.046.03.2.1	2493674	S	1601	4649	6250	0.00027
Mesorhizobium_sp._M2A.F.Ca.ET.043.02.1.1	2493670	S	1461	4034	5495	0.00024
Mesorhizobium_sp._WSM1497	278153	S	706	1533	2239	0.00010
Mesorhizobium_sp._131-2-5	2744519	S	416	3042	3458	0.00015
Mesorhizobium_sp._131-3-5	2744520	S	317	1059	1376	0.00006
Mesorhizobium_sp._NZP2234	2483402	S	277	1071	1348	0.00006
Mesorhizobium_terrae	2725666	S	6228	2033	8261	0.00036
Mesorhizobium_opportunistum	593909	S	5221	2168	7389	0.00032
Mesorhizobium_amorphae	71433	S	4699	1134	5833	0.00025
Mesorhizobium_ciceri	39645	S	3810	9771	13581	0.00059
Mesorhizobium_huakuii	28104	S	2953	2219	5172	0.00022
Mesorhizobium_loti	381	S	2916	25343	28259	0.00122
Mesorhizobium_australicum	536018	S	2751	886	3637	0.00016
Mesorhizobium_erdmanii	1777866	S	2738	796	3534	0.00015
Mesorhizobium_japonicum	2066070	S	2340	1894	4234	0.00018
Aquibium_microcysteis	675281	S	11038	3188	14226	0.00062
Aquibium_oceanicum	1670800	S	8623	2068	10691	0.00046
Aminobacter_sp._MSH1	374606	S	6384	3966	10350	0.00045
Aminobacter_sp._SR38	2774562	S	1474	6179	7653	0.00033
Aminobacter_sp._MDW-2	2666139	S	976	4600	5576	0.00024
Aminobacter_aminovorans	83263	S	930	3086	4016	0.00017
Nitratireductor_sp._SY7	2599600	S	7182	1366	8548	0.00037
Nitratireductor_sp._OM-1	1756988	S	3403	595	3998	0.00017
Nitratireductor_kimnyeongensis	430679	S	2196	327	2523	0.00011
Phyllobacterium_sp._T1018	555316	S	2173	280	2453	0.00011
Phyllobacterium_sp._628	2718938	S	1043	150	1193	0.00005
Phyllobacterium_sp._T1293	555317	S	952	120	1072	0.00005
Phyllobacterium_zundukense	1867719	S	2567	366	2933	0.00013
Roseitalea_porphyridii	1852022	S	5082	870	5952	0.00026
Oricola_thermophila	2742145	S	3924	542	4466	0.00019
Hoeflea_sp._IMCC20628	1620421	S	1890	182	2072	0.00009
Hoeflea_phototrophica	244596	S	1816	216	2032	0.00009
Salaquimonas_pukyongi	2712698	S	1414	62	1476	0.00006
Lentilitoribacter_sp._Alg239-R112	2305987	S	90	1	91	0.00000
Methylobacterium_nodulans	114616	S	16786	2216	19002	0.00082
Methylobacterium_sp._17Sr1-1	2202826	S	6477	3230	9707	0.00042
Methylobacterium_sp._WL1	2603276	S	6070	1290	7360	0.00032
Methylobacterium_sp._C1	1479019	S	656	5119	5775	0.00025
Methylobacterium_sp._XJLW	739141	S	449	6032	6481	0.00028
Methylobacterium_aquaticum	270351	S	13451	6231	19682	0.00085
Methylobacterium_durans	2202825	S	10292	1550	11842	0.00051
Methylobacterium_radiodurans	2202828	S	8620	2210	10830	0.00047
Methylobacterium_currus	2051553	S	8429	3721	12150	0.00053
Methylobacterium_organophilum	410	S	7317	4398	11715	0.00051
Methylobacterium_terrae	2202827	S	7071	3432	10503	0.00045
Methylobacterium_brachiatum	269660	S	6332	2428	8760	0.00038
Methylobacterium_mesophilicum	39956	S	6025	1323	7348	0.00032
Methylobacterium_indicum	1775910	S	5877	3074	8951	0.00039
Methylobacterium_tardum	374432	S	5809	2138	7947	0.00034
Methylobacterium_oryzae	334852	S	5125	7584	12709	0.00055
Methylobacterium_radiotolerans	31998	S	2150	12434	14584	0.00063
Methylobacterium_phyllosphaerae	418223	S	837	3150	3987	0.00017
Microvirga_sp._VF16	2807101	S	50745	7904	58649	0.00254
Microvirga_sp._17_mud_1-3	2082949	S	13324	2836	16160	0.00070
Microvirga_ossetica	1882682	S	51589	9008	60597	0.00262
Microvirga_thermotolerans	2651334	S	16698	4577	21275	0.00092
Methylorubrum_populi	223967	S	10800	5072	15872	0.00069
Methylorubrum_extorquens	408	S	8699	14273	22972	0.00099
Methylorubrum_sp._B1-46	2897334	S	4033	1812	5845	0.00025
Methylorubrum_zatmanii	29429	S	253	1287	1540	0.00007
Pseudolabrys_taiwanensis	331696	S	15054	2565	17619	0.00076
Pseudolabrys_sp._FHR47	2562284	S	11792	2147	13939	0.00060
Starkeya_sp._ORNL1	2709380	S	10835	2224	13059	0.00057
Starkeya_novella	921	S	8451	3214	11665	0.00050
Xanthobacter_dioxanivorans	2528964	S	8516	2995	11511	0.00050
Xanthobacter_sp._YC-JY1	2419844	S	2852	3008	5860	0.00025
Xanthobacter_autotrophicus	280	S	2529	2888	5417	0.00023
Ancylobacter_sp._TS-1	1850374	S	6073	2605	8678	0.00038
Ancylobacter_polymorphus	223390	S	5752	2928	8680	0.00038
Ancylobacter_pratisalsi	1745854	S	4868	1138	6006	0.00026
Labrys_sp._KNU-23	2789216	S	6868	715	7583	0.00033
Azorhizobium_caulinodans	7	S	5925	1270	7195	0.00031
Rhodoplanes_sp._Z2-YC6860	674703	S	32689	3252	35941	0.00156
Hyphomicrobium_denitrificans	53399	S	6805	888	7693	0.00033
Hyphomicrobium_nitrativorans	1427356	S	6587	607	7194	0.00031
Hyphomicrobium_sp._MC1	717785	S	3543	301	3844	0.00017
Methyloceanibacter_sp._wino2	2170729	S	3523	817	4340	0.00019
Methyloceanibacter_caenitepidi	1384459	S	3383	737	4120	0.00018
Aquabacter_sp._L1I39	2820278	S	5113	862	5975	0.00026
Methyloligella_sp._GL2	2742204	S	4927	620	5547	0.00024
Rhodomicrobium_vannielii	1069	S	3783	265	4048	0.00018
Caenibius_sp._WL	2872646	S	1611	295	1906	0.00008
Caenibius_tardaugens	169176	S	1080	871	1951	0.00008
Candidatus_Filomicrobium_marinum	1608628	S	1747	54	1801	0.00008
Bosea_sp._Tri-49	1867715	S	12640	2935	15575	0.00067
Bosea_sp._F3-2	2599640	S	9832	3185	13017	0.00056
Bosea_sp._RAC05	1842539	S	8833	2881	11714	0.00051
Bosea_sp._ANAM02	2020412	S	8727	3291	12018	0.00052
Bosea_sp._AS-1	2015316	S	7520	2409	9929	0.00043
Bosea_sp._PAMC_26642	1792307	S	6747	1448	8195	0.00035
Bosea_vaviloviae	1526658	S	7594	1845	9439	0.00041
Devosia_sp._A16	1736675	S	14477	1706	16183	0.00070
Devosia_sp._JXJ_CY_41	2917991	S	3641	622	4263	0.00018
Devosia_sp._SL43	2806348	S	3529	608	4137	0.00018
Devosia_sp._1566	2499144	S	3045	317	3362	0.00015
Devosia_sp._I507	2083786	S	2422	689	3111	0.00013
Devosia_sp._MC521	2759954	S	1088	167	1255	0.00005
Devosia_ginsengisoli	400770	S	4894	856	5750	0.00025
Devosia_oryziradicis	2801335	S	3911	692	4603	0.00020
Devosia_salina	2860336	S	3438	1087	4525	0.00020
Devosia_beringensis	2657486	S	3430	488	3918	0.00017
Devosia_rhizoryzae	2774137	S	2738	282	3020	0.00013
Youhaiella_tibetensis	1447062	S	4936	1074	6010	0.00026
Paradevosia_shaoguanensis	1335043	S	4454	1645	6099	0.00026
Pelagibacterium_halotolerans	531813	S	2291	287	2578	0.00011
Maritalea_myrionectae	454601	S	444	14	458	0.00002
Aureimonas_sp._SA4125	2826993	S	6432	1223	7655	0.00033
Aureimonas_sp._AU20	1349819	S	5463	804	6267	0.00027
Aureimonas_sp._OT7	2816454	S	2773	2334	5107	0.00022
Aureimonas_populi	1701758	S	5106	1004	6110	0.00026
Aureimonas_mangrovi	2758041	S	4396	940	5336	0.00023
Aureimonas_altamirensis	370622	S	2629	920	3549	0.00015
Martelella_sp._AD-3	686597	S	1575	4566	6141	0.00027
Martelella_mediterranea	293089	S	2776	1017	3793	0.00016
Martelella_endophytica	1486262	S	2586	573	3159	0.00014
Martelella_lutilitoris	2583532	S	1498	1272	2770	0.00012
Aurantimonas_sp._HBX-1	2906072	S	8401	2589	10990	0.00048
Pseudorhodoplanes_sinuspersici	1235591	S	12970	966	13936	0.00060
Nordella_sp._HKS_07	2712222	S	12417	693	13110	0.00057
Terrihabitans_soli	708113	S	4517	515	5032	0.00022
Candidatus_Hodgkinia_cicadicola	573658	S	64	0	64	0.00000
Methylocystis_bryophila	655015	S	3807	385	4192	0.00018
Methylocystis_parvus	134	S	3650	431	4081	0.00018
Methylocystis_heyeri	391905	S	3450	384	3834	0.00017
Methylocystis_sp._SC2	187303	S	2162	572	2734	0.00012
Methylocystis_sp._SB2	743836	S	847	1314	2161	0.00009
Methylocystis_rosea	173366	S	2456	1836	4292	0.00019
Methylosinus_trichosporium	426	S	4966	996	5962	0.00026
Methylosinus_sp._C49	2699395	S	4093	802	4895	0.00021
Stappia_indica	538381	S	7562	1833	9395	0.00041
Stappia_sp._ES.058	1881061	S	3946	507	4453	0.00019
Pannonibacter_phragmitetus	121719	S	5445	3913	9358	0.00040
Roseibium_aggregatum	187304	S	4072	584	4656	0.00020
Roseibium_alexandrii	388408	S	1205	115	1320	0.00006
Labrenzia_sp._VG12	2021862	S	2258	278	2536	0.00011
Labrenzia_sp._PHM005	2590016	S	1005	81	1086	0.00005
Labrenzia_sp._THAF82	2587861	S	836	55	891	0.00004
Pseudovibrio_sp._FO-BEG1	911045	S	355	143	498	0.00002
Pseudovibrio_brasiliensis	1898042	S	318	126	444	0.00002
Phreatobacter_stygius	1940610	S	10199	1557	11756	0.00051
Phreatobacter_cathodiphilus	1868589	S	9317	2800	12117	0.00052
Phreatobacter_sp._NMCR1094	2570229	S	6328	1218	7546	0.00033
Chelatococcus_sp._CO-6	1702325	S	9361	5763	15124	0.00065
Chelatococcus_daeguensis	444444	S	4817	2962	7779	0.00034
Kaustia_mangrovi	2593653	S	10081	993	11074	0.00048
Parvibaculum_lavamentivorans	256618	S	3879	2733	6612	0.00029
Pyruvatibacter_mobilis	1712261	S	2698	349	3047	0.00013
Candidatus_Phaeomarinobacter_ectocarpi	1458461	S	1130	60	1190	0.00005
Blastochloris_tepida	2233851	S	7730	2660	10390	0.00045
Blastochloris_viridis	1079	S	6960	1927	8887	0.00038
Methylocella_silvestris	199596	S	3468	412	3880	0.00017
Methylocella_tundrae	227605	S	3075	311	3386	0.00015
Methylovirgula_ligni	569860	S	3185	381	3566	0.00015
Methylovirgula_sp._HY1	2822761	S	2400	143	2543	0.00011
Beijerinckia_indica	533	S	1552	120	1672	0.00007
Acuticoccus_sp._I52.16.1	2928472	S	9931	1085	11016	0.00048
Kaistia_sp._32K	2795690	S	9291	2321	11612	0.00050
Brucella_anthropi	529	S	1730	8339	10069	0.00044
Brucella_intermedia	94625	S	1620	279	1899	0.00008
Brucella_sp._BTU1	2840456	S	257	48	305	0.00001
Brucella_sp._6810	2769351	S	108	155	263	0.00001
Brucella_sp._10RB9215	1149953	S	86	83	169	0.00001
Brucella_sp._09RB8910	1844051	S	82	76	158	0.00001
Brucella_sp._09RB8471	1149952	S	53	87	140	0.00001
Brucella_sp._2280	2592625	S	50	89	139	0.00001
Brucella_sp._BO3	2691913	S	50	73	123	0.00001
Brucella_sp._BO2	693750	S	38	77	115	0.00000
Brucella_sp._458	2821140	S	29	56	85	0.00000
[Ochrobactrum]_quorumnocens	271865	S	635	93	728	0.00003
Brucella_pseudogrignonensis	419475	S	404	127	531	0.00002
Brucella_pituitosa	571256	S	170	60	230	0.00001
Brucella_melitensis	29459	S	84	2665	2749	0.00012
Brucella_inopinata	1218315	S	44	47	91	0.00000
Brucella_suis	29461	S	29	926	955	0.00004
Brucella_abortus	235	S	19	583	602	0.00003
Brucella_ovis	236	S	18	51	69	0.00000
Brucella_ceti	120577	S	13	27	40	0.00000
Pseudochrobactrum_sp._Wa41.01b-1	2864102	S	155	167	322	0.00001
Pseudochrobactrum_sp._XF203	2879116	S	134	132	266	0.00001
Pseudochrobactrum_algeriensis	2834768	S	146	150	296	0.00001
Hartmannibacter_diazotrophicus	1482074	S	5827	1055	6882	0.00030
Breoghania_sp._L-A4	2304600	S	5495	732	6227	0.00027
Lichenihabitans_psoromatis	2528642	S	1830	1038	2868	0.00012
Lichenihabitans_sp._PAMC28606	2880932	S	1539	1014	2553	0.00011
Cohaesibacter_sp._ES.047	1798205	S	987	39	1026	0.00004
Bartonella_apis	1686310	S	341	19	360	0.00002
Bartonella_sp._HY038	2759660	S	84	9	93	0.00000
Bartonella_sp._WD16.2	1933904	S	21	12	33	0.00000
Bartonella_sp._1-1C	515256	S	11	28	39	0.00000
Bartonella_sp._46A	2893471	S	10	1	11	0.00000
Bartonella_australis	388640	S	40	4	44	0.00000
Bartonella_vinsonii	33047	S	29	12	41	0.00000
Bartonella_birtlesii	111504	S	28	7	35	0.00000
Bartonella_quintana	803	S	17	4	21	0.00000
Bartonella_henselae	38323	S	15	3	18	0.00000
Bartonella_ancashensis	1318743	S	15	2	17	0.00000
Bartonella_alsatica	52764	S	14	2	16	0.00000
Bartonella_bacilliformis	774	S	14	2	16	0.00000
Bartonella_grahamii	33045	S	14	7	21	0.00000
Bartonella_kosoyi	2133959	S	11	57	68	0.00000
Bartonella_krasnovii	2267275	S	10	7	17	0.00000
Sphingomonas_sp._HDW15A	2714942	S	16550	1354	17904	0.00077
Sphingomonas_sp._S8-45	2938948	S	16445	2055	18500	0.00080
Sphingomonas_sp._DM2-R-LB4	2899123	S	11303	3987	15290	0.00066
Sphingomonas_sp._MM-1	745310	S	7618	9653	17271	0.00075
Sphingomonas_sp._CL5.1	2653203	S	7023	2426	9449	0.00041
Sphingomonas_sp._AK-PDB1-5	2872652	S	7000	1175	8175	0.00035
Sphingomonas_sp._Cra20	1327635	S	6718	1112	7830	0.00034
Sphingomonas_sp._AP4-R1	2735134	S	6086	798	6884	0.00030
Sphingomonas_sp._LM7	1938607	S	5950	1366	7316	0.00032
Sphingomonas_sp._S2-65	2903960	S	5387	1108	6495	0.00028
Sphingomonas_sp._NBWT7	2596913	S	5290	1787	7077	0.00031
Sphingomonas_sp._AAP5	1523415	S	5036	1353	6389	0.00028
Sphingomonas_sp._FARSPH	2219696	S	4869	4088	8957	0.00039
Sphingomonas_sp._HMP9	1517554	S	3911	1845	5756	0.00025
Sphingomonas_sp._PAMC26645	2565555	S	3773	1340	5113	0.00022
Sphingomonas_sp._KC8	1030157	S	3760	490	4250	0.00018
Sphingomonas_sp._HMP6	1517551	S	3368	700	4068	0.00018
Sphingomonas_sp._LK11	1390395	S	2572	2751	5323	0.00023
Sphingomonas_sp._NIC1	1961362	S	2117	7051	9168	0.00040
Sphingomonas_sp._IC081	304378	S	859	5253	6112	0.00026
Sphingomonas_sediminicola	386874	S	38012	3769	41781	0.00181
Sphingomonas_daechungensis	1176646	S	33007	3306	36313	0.00157
Sphingomonas_lutea	1045317	S	31323	4163	35486	0.00154
Sphingomonas_sabuli	2764186	S	21215	2680	23895	0.00103
Sphingomonas_ginsengisoli_An_et_al._2013	363835	S	21191	2986	24177	0.00105
Sphingomonas_sinipercae	2714944	S	20401	2811	23212	0.00100
Sphingomonas_rhizophila	2071607	S	18740	4910	23650	0.00102
Sphingomonas_xanthus	2594473	S	16502	3765	20267	0.00088
Sphingomonas_piscis	2714943	S	14251	1349	15600	0.00067
Sphingomonas_profundi	2681549	S	9280	1522	10802	0.00047
Sphingomonas_alpina	653931	S	9037	774	9811	0.00042
Sphingomonas_sanxanigenens	397260	S	8300	4031	12331	0.00053
Sphingomonas_changnyeongensis	2698679	S	6558	1298	7856	0.00034
Sphingomonas_koreensis	93064	S	6519	5024	11543	0.00050
Sphingomonas_taxi	1549858	S	5908	1914	7822	0.00034
Sphingomonas_hengshuiensis	1609977	S	5637	758	6395	0.00028
Sphingomonas_panacis	1560345	S	5426	823	6249	0.00027
Sphingomonas_panacisoli	1813879	S	4784	668	5452	0.00024
Sphingomonas_suaedae	2599297	S	4728	633	5361	0.00023
Sphingomonas_radiodurans	2890321	S	4429	601	5030	0.00022
Sphingomonas_insulae	424800	S	3982	1182	5164	0.00022
Sphingomonas_aliaeris	2759526	S	3548	455	4003	0.00017
Sphingomonas_paucimobilis	13689	S	3421	2317	5738	0.00025
Sphingomonas_sanguinis	33051	S	2683	2511	5194	0.00022
Sphingomonas_melonis	152682	S	2490	10273	12763	0.00055
Sphingomonas_lacunae	2698828	S	2000	265	2265	0.00010
Sphingomonas_paeninsulae	2319844	S	1668	72	1740	0.00008
Sphingobium_sp._Cam5-1	2789327	S	6280	2207	8487	0.00037
Sphingobium_sp._EP60837	1855519	S	5296	1460	6756	0.00029
Sphingobium_sp._SYK-6	627192	S	4656	1238	5894	0.00026
Sphingobium_sp._MI1205	407020	S	3573	4905	8478	0.00037
Sphingobium_sp._TKS	1315974	S	3257	4606	7863	0.00034
Sphingobium_sp._YG1	2082188	S	2836	1177	4013	0.00017
Sphingobium_sp._CAP-1	2676077	S	2818	1714	4532	0.00020
Sphingobium_sp._SCG-1	2072936	S	2335	173	2508	0.00011
Sphingobium_sp._RAC03	1843368	S	2328	425	2753	0.00012
Sphingobium_sp._KCTC_72723	2733867	S	2015	345	2360	0.00010
Sphingobium_sp._PAMC28499	2565554	S	719	1354	2073	0.00009
Sphingobium_sp._YBL2	484429	S	332	2074	2406	0.00010
Sphingobium_sp._RSMS	520734	S	310	1737	2047	0.00009
Sphingobium_sp._LF-16	2185111	S	65	1005	1070	0.00005
Sphingobium_yanoikuyae	13690	S	4630	8516	13146	0.00057
Sphingobium_indicum	332055	S	3593	2645	6238	0.00027
Sphingobium_herbicidovorans	76947	S	3349	2890	6239	0.00027
Sphingobium_amiense	135719	S	3124	3842	6966	0.00030
Sphingobium_phenoxybenzoativorans	1592790	S	2978	1215	4193	0.00018
Sphingobium_cloacae	120107	S	2773	4009	6782	0.00029
Sphingobium_xenophagum	121428	S	2553	1646	4199	0.00018
Sphingobium_chlorophenolicum	46429	S	2493	1118	3611	0.00016
Sphingobium_baderi	1332080	S	2257	2221	4478	0.00019
Sphingobium_fuliginis	336203	S	1229	4473	5702	0.00025
Sphingopyxis_sp._PAMC25046	2565556	S	7422	3314	10736	0.00046
Sphingopyxis_sp._QXT-31	1357916	S	6334	1669	8003	0.00035
Sphingopyxis_sp._OPL5	2486273	S	4471	816	5287	0.00023
Sphingopyxis_sp._YF1	2482763	S	4435	996	5431	0.00023
Sphingopyxis_sp._113P3	292913	S	3640	1391	5031	0.00022
Sphingopyxis_sp._BSN-002	2911495	S	3583	623	4206	0.00018
Sphingopyxis_sp._FD7	1914525	S	3137	1281	4418	0.00019
Sphingopyxis_sp._EG6	1874061	S	2908	1414	4322	0.00019
Sphingopyxis_sp._MG	1866325	S	179	1586	1765	0.00008
Sphingopyxis_macrogoltabida	33050	S	6782	3347	10129	0.00044
Sphingopyxis_terrae	33052	S	3775	2023	5798	0.00025
Sphingopyxis_lindanitolerans	2054227	S	3563	1689	5252	0.00023
Sphingopyxis_fribergensis	1515612	S	3510	1379	4889	0.00021
Sphingopyxis_granuli	267128	S	3038	8086	11124	0.00048
Sphingopyxis_alaskensis	117207	S	2908	661	3569	0.00015
Novosphingobium_sp._Gsoil_351	2675225	S	6576	561	7137	0.00031
Novosphingobium_sp._Sx8-5	2896849	S	4460	624	5084	0.00022
Novosphingobium_sp._EMRT-2	2571749	S	3964	2309	6273	0.00027
Novosphingobium_sp._P6W	1609758	S	3408	556	3964	0.00017
Novosphingobium_sp._ES2-1	2780074	S	2598	1328	3926	0.00017
Novosphingobium_sp._THN1	1016987	S	2409	861	3270	0.00014
Novosphingobium_sp._PP1Y	702113	S	1590	1896	3486	0.00015
Novosphingobium_sp._KA1	164608	S	840	4179	5019	0.00022
Novosphingobium_resinovorum	158500	S	4196	2051	6247	0.00027
Novosphingobium_aromaticivorans	48935	S	3621	1653	5274	0.00023
Novosphingobium_decolorationis	2698673	S	3365	1820	5185	0.00022
Novosphingobium_ginsenosidimutans	1176536	S	2799	288	3087	0.00013
Novosphingobium_pentaromativorans	205844	S	1478	2623	4101	0.00018
Rhizorhabdus_wittichii	160791	S	9910	5926	15836	0.00069
Rhizorhabdus_dicambivorans	1850238	S	6245	5192	11437	0.00049
Rhizorhabdus_phycosphaerae	2711156	S	4631	599	5230	0.00023
Allosphingosinicella_indica	941907	S	13126	1626	14752	0.00064
Sphingosinithalassobacter_sp._CS137	2762748	S	5151	1071	6222	0.00027
Sphingosinithalassobacter_tenebrarum	2711215	S	3613	1139	4752	0.00021
Parasphingopyxis_algicola	2026624	S	5089	332	5421	0.00023
Parasphingopyxis_sp._CP4	2724527	S	1282	56	1338	0.00006
Sphingorhabdus_sp._YGSMI21	2077182	S	1480	268	1748	0.00008
Sphingorhabdus_sp._SMR4y	2584094	S	1314	241	1555	0.00007
Sphingorhabdus_sp._M41	1806885	S	1049	143	1192	0.00005
Sphingorhabdus_lacus	392610	S	992	45	1037	0.00004
Sphingorhabdus_lutea	1913578	S	162	13	175	0.00001
Blastomonas_sp._RAC04	1842535	S	1180	1729	2909	0.00013
Blastomonas_fulva	1550728	S	939	1773	2712	0.00012
Hankyongella_ginsenosidimutans	1763828	S	3508	685	4193	0.00018
Tardibacter_chloracetimidivorans	1921510	S	3348	2629	5977	0.00026
Citromicrobium_sp._JL477	1634516	S	2644	1232	3876	0.00017
Novosphingopyxis_iocasae	2762729	S	2398	1354	3752	0.00016
Aquisediminimonas_profunda	1550733	S	1454	56	1510	0.00007
Parasphingorhabdus_halotolerans	2725558	S	525	20	545	0.00002
Parasphingorhabdus_sp._JHSY0214	2806553	S	460	33	493	0.00002
Parasphingorhabdus_litoris	394733	S	414	31	445	0.00002
Erythrobacter_sp._HL-111	1798193	S	3578	684	4262	0.00018
Erythrobacter_sp._HKB08	2502843	S	2680	587	3267	0.00014
Erythrobacter_sp._JK5	2829500	S	2644	799	3443	0.00015
Erythrobacter_sp._SDW2	2907154	S	2606	687	3293	0.00014
Erythrobacter_sp._THAF29	2587851	S	1442	340	1782	0.00008
Erythrobacter_sp._A30-3	2785907	S	1271	1011	2282	0.00010
Erythrobacter_sp._3-20A1M	2653850	S	1255	2001	3256	0.00014
Erythrobacter_sp._LQ02-29	2920384	S	1211	1378	2589	0.00011
Erythrobacter_sp._KY5	2011159	S	1206	94	1300	0.00006
Erythrobacter_sp._SCSIO_43205	2779361	S	678	130	808	0.00003
Erythrobacter_litoralis	39960	S	4730	2035	6765	0.00029
Erythrobacter_neustonensis	1112	S	1978	455	2433	0.00011
Erythrobacter_mangrovi	2739433	S	1905	689	2594	0.00011
Erythrobacter_aureus	2182384	S	1515	273	1788	0.00008
Porphyrobacter_sp._CACIAM_03H1	2003315	S	3626	1089	4715	0.00020
Porphyrobacter_sp._LM_6	1896196	S	1990	715	2705	0.00012
Porphyrobacter_sp._HT-58-2	2023229	S	1892	462	2354	0.00010
Porphyrobacter_sp._GA68	2883480	S	1833	786	2619	0.00011
Qipengyuania_flava	192812	S	5181	2928	8109	0.00035
Qipengyuania_sediminis	1532023	S	3268	464	3732	0.00016
Qipengyuania_soli	2782568	S	2228	410	2638	0.00011
Qipengyuania_aurantiaca	2867233	S	1860	618	2478	0.00011
Qipengyuania_gelatinilytica	2867231	S	1502	289	1791	0.00008
Qipengyuania_seohaensis	266951	S	1256	270	1526	0.00007
Qipengyuania_psychrotolerans	2867238	S	1013	128	1141	0.00005
Qipengyuania_aquimaris	255984	S	980	1031	2011	0.00009
Qipengyuania_xiapuensis	2867236	S	970	1009	1979	0.00009
Tsuneonella_amylolytica	2338327	S	4056	1190	5246	0.00023
Tsuneonella_dongtanensis	692370	S	3898	785	4683	0.00020
Tsuneonella_mangrovi	1982042	S	2660	410	3070	0.00013
Tsuneonella_flava	2055955	S	1157	349	1506	0.00007
Altererythrobacter_sp._B11	2060312	S	4033	1932	5965	0.00026
Altererythrobacter_sp._TH136	2067415	S	3363	628	3991	0.00017
Altererythrobacter_sp._BO-6	2604537	S	1792	281	2073	0.00009
Altererythrobacter_sp._ZODW24	2185142	S	744	36	780	0.00003
Altererythrobacter_epoxidivorans	361183	S	1394	401	1795	0.00008
Altererythrobacter_ishigakiensis	476157	S	578	43	621	0.00003
Croceicoccus_sp._YJ47	2798724	S	2188	1228	3416	0.00015
Croceicoccus_sp._Ery5	1703340	S	770	849	1619	0.00007
Croceicoccus_sp._Ery15	1703338	S	657	1053	1710	0.00007
Croceicoccus_marinus	450378	S	4026	2162	6188	0.00027
Croceicoccus_naphthovorans	1348774	S	1664	1992	3656	0.00016
Aurantiacibacter_gangjinensis	502682	S	1569	151	1720	0.00007
Aurantiacibacter_atlanticus	1648404	S	699	233	932	0.00004
Paraurantiacibacter_namhicola	645517	S	2135	280	2415	0.00010
Pelagerythrobacter_marensis	543877	S	2129	299	2428	0.00011
Croceibacterium_atlanticum	1267766	S	1946	841	2787	0.00012
Sphingosinicella_sp._BN140058	1892855	S	13196	1213	14409	0.00062
Sphingosinicella_flava	2771430	S	6364	951	7315	0.00032
Sphingosinicella_microcystinivorans	335406	S	3786	487	4273	0.00018
Polymorphobacter_sp._PAMC_29362	2835787	S	2317	1586	3903	0.00017
Polymorphobacter_sp._PAMC_29334	2862331	S	2310	1631	3941	0.00017
Sandaracinobacter_sp._M6	2759707	S	3695	253	3948	0.00017
Zymomonas_mobilis	542	S	238	229	467	0.00002
Azospirillum_brasilense	192	S	17998	14377	32375	0.00140
Azospirillum_sp._B510	137722	S	5175	1818	6993	0.00030
Azospirillum_sp._TSA2s	709810	S	4182	2950	7132	0.00031
Azospirillum_sp._TSH100	652764	S	3936	1701	5637	0.00024
Azospirillum_sp._TSH58	664962	S	3376	4094	7470	0.00032
Azospirillum_thermophilum	2202148	S	11855	2511	14366	0.00062
Azospirillum_thiophilum	528244	S	6281	1886	8167	0.00035
Azospirillum_ramasamyi	682998	S	3874	2044	5918	0.00026
Azospirillum_humicireducens	1226968	S	3279	1754	5033	0.00022
Azospirillum_oryzae	286727	S	3226	2547	5773	0.00025
Azospirillum_lipoferum	193	S	3002	2026	5028	0.00022
Azospirillum_baldaniorum	1064539	S	2172	4010	6182	0.00027
Skermanella_mucosa	1789672	S	19568	10348	29916	0.00129
Skermanella_sp._TT6	2775420	S	17679	14718	32397	0.00140
Skermanella_pratensis	2233999	S	15473	6626	22099	0.00096
Skermanella_rosea	1817965	S	14807	10151	24958	0.00108
Nitrospirillum_amazonense	28077	S	6250	671	6921	0.00030
Indioceanicola_profundi	2220096	S	5906	746	6652	0.00029
Niveispirillum_cyanobacteriorum	1612173	S	2806	289	3095	0.00013
Roseomonas_sp._OT10	2897332	S	16783	4044	20827	0.00090
Roseomonas_sp._S08	1750527	S	15413	932	16345	0.00071
Roseomonas_sp._FDAARGOS_362	2018065	S	1261	5339	6600	0.00029
Roseomonas_gilardii	257708	S	10879	4292	15171	0.00066
Roseomonas_haemaphysalidis	2768162	S	9643	1043	10686	0.00046
Roseomonas_marmotae	2768161	S	8706	925	9631	0.00042
Roseomonas_mucosa	207340	S	1298	6472	7770	0.00034
Rhodovastum_atsumiense	504468	S	11488	1097	12585	0.00054
Roseococcus_microcysteis	2771361	S	9953	885	10838	0.00047
Komagataeibacter_xylinus	28448	S	2040	3492	5532	0.00024
Komagataeibacter_saccharivorans	265959	S	814	289	1103	0.00005
Komagataeibacter_europaeus	33995	S	593	293	886	0.00004
Komagataeibacter_nataicola	265960	S	573	257	830	0.00004
Komagataeibacter_oboediens	65958	S	550	258	808	0.00003
Komagataeibacter_medellinensis	1177712	S	470	384	854	0.00004
Komagataeibacter_rhaeticus	215221	S	36	589	625	0.00003
Acidiphilium_multivorum	62140	S	1804	6718	8522	0.00037
Acidiphilium_cryptum	524	S	406	2358	2764	0.00012
Sediminicoccus_rosea	1225128	S	6368	313	6681	0.00029
Lichenicola_cladoniae	1484109	S	4540	209	4749	0.00021
Acidibrevibacterium_fodinaquatile	1969806	S	4376	381	4757	0.00021
Acetobacter_aceti	435	S	1631	590	2221	0.00010
Acetobacter_persici	1076596	S	376	50	426	0.00002
Acetobacter_sp._KACC_21233	2592655	S	355	72	427	0.00002
Acetobacter_ghanensis	431306	S	224	55	279	0.00001
Acetobacter_pasteurianus	438	S	178	379	557	0.00002
Acetobacter_tropicalis	104102	S	113	110	223	0.00001
Acetobacter_orientalis	146474	S	100	13	113	0.00000
Acetobacter_senegalensis	446692	S	87	93	180	0.00001
Acetobacter_ascendens	481146	S	85	95	180	0.00001
Acetobacter_oryzoeni	2500548	S	30	51	81	0.00000
Acetobacter_oryzifermentans	1633874	S	19	164	183	0.00001
Gluconacetobacter_diazotrophicus	33996	S	2904	599	3503	0.00015
Gluconobacter_oxydans	442	S	1005	962	1967	0.00009
Gluconobacter_albidus	318683	S	469	80	549	0.00002
Gluconobacter_sphaericus	574987	S	284	64	348	0.00002
Gluconobacter_frateurii	38308	S	205	51	256	0.00001
Gluconobacter_thailandicus	257438	S	108	74	182	0.00001
Granulibacter_bethesdensis	364410	S	1793	151	1944	0.00008
Asaia_bogorensis	91915	S	1234	202	1436	0.00006
Neoasaia_chiangmaiensis	320497	S	1132	228	1360	0.00006
Kozakia_baliensis	153496	S	828	292	1120	0.00005
Novacetimonas_hansenii	436	S	695	334	1029	0.00004
Oecophyllibacter_saccharovorans	2558360	S	546	17	563	0.00002
Parasaccharibacter_sp._TMW_2.1888	2268025	S	47	201	248	0.00001
Parasaccharibacter_apium	1510841	S	37	151	188	0.00001
Swingsia_sp._F3b2	2558361	S	251	6	257	0.00001
Swingsia_samuiensis	1293412	S	32	5	37	0.00000
Neokomagataea_tanensis	661191	S	152	24	176	0.00001
Entomobacter_blattae	2762277	S	74	5	79	0.00000
Bombella_sp._KACC_21507	2697033	S	42	4	46	0.00000
Hypericibacter_adhaerens	2602016	S	13583	2521	16104	0.00070
Hypericibacter_terrae	2602015	S	11273	1669	12942	0.00056
Magnetospirillum_sp._XM-1	1663591	S	3203	1040	4243	0.00018
Magnetospirillum_sp._ME-1	1639348	S	2912	1026	3938	0.00017
Magnetospirillum_gryphiswaldense	55518	S	3919	317306	321225	0.01390
Magnetospirillum_magneticum	84159	S	3211	330	3541	0.00015
Rhodospirillum_centenum	34018	S	7192	988	8180	0.00035
Rhodospirillum_rubrum	1085	S	3438	251	3689	0.00016
Ferrovibrio_terrae	2594003	S	7640	476	8116	0.00035
Tistrella_mobilis	171437	S	7147	3196	10343	0.00045
Defluviicoccus_vanus	111831	S	4207	368	4575	0.00020
Pararhodospirillum_photometricum	1084	S	2329	169	2498	0.00011
Haematospirillum_jordaniae	1549855	S	404	33	437	0.00002
Candidatus_Endolissoclinum_faulkneri	1263979	S	189	1	190	0.00001
Stella_humosa	94	S	16033	1092	17125	0.00074
Elioraea_tepida	2843330	S	7998	389	8387	0.00036
Thalassospira_sp._A40-3	2785908	S	377	151	528	0.00002
Thalassospira_sp._B30-1	2785911	S	225	346	571	0.00002
Thalassospira_marina	2048283	S	543	32	575	0.00002
Thalassospira_indica	1891279	S	428	262	690	0.00003
Thalassospira_xiamenensis	220697	S	204	297	501	0.00002
Magnetospira_sp._QH-2	1288970	S	1528	49	1577	0.00007
Terasakiella_sp._SH-1	2560057	S	179	4	183	0.00001
Paracoccus_sp._MC1862	2760307	S	3327	376	3703	0.00016
Paracoccus_sp._AK26	2589076	S	2638	464	3102	0.00013
Paracoccus_sp._MA	2895796	S	2525	1397	3922	0.00017
Paracoccus_sp._S8-55	2903900	S	1841	256	2097	0.00009
Paracoccus_sp._H4-D09	2812658	S	1429	311	1740	0.00008
Paracoccus_sp._Arc7-R13	2500532	S	966	1022	1988	0.00009
Paracoccus_sanguinis	1545044	S	4808	1321	6129	0.00027
Paracoccus_yeei	147645	S	3574	5728	9302	0.00040
Paracoccus_liaowanqingii	2560053	S	3210	385	3595	0.00016
Paracoccus_denitrificans	266	S	3075	1907	4982	0.00022
Paracoccus_aminovorans	34004	S	2898	868	3766	0.00016
Paracoccus_zhejiangensis	1077935	S	2746	691	3437	0.00015
Paracoccus_pantotrophus	82367	S	2681	1570	4251	0.00018
Paracoccus_suum	2259340	S	2563	477	3040	0.00013
Paracoccus_contaminans	1945662	S	2404	575	2979	0.00013
Paracoccus_jeotgali	2065379	S	2349	481	2830	0.00012
Paracoccus_aminophilus	34003	S	1856	197	2053	0.00009
Paracoccus_tegillarcae	1529068	S	1215	76	1291	0.00006
Paracoccus_kondratievae	135740	S	1142	230	1372	0.00006
Paracoccus_marcusii	59779	S	924	860	1784	0.00008
Paracoccus_mutanolyticus	1499308	S	327	1128	1455	0.00006
Cereibacter_sphaeroides	1063	S	9673	4479	14152	0.00061
Cereibacter_azotoformans	43057	S	1050	3760	4810	0.00021
Rhodobacter_sp._CZR27	2033869	S	4453	1554	6007	0.00026
Rhodobacter_sp._N10	2807096	S	3079	405	3484	0.00015
Rhodobacter_sp._LPB0142	1850250	S	2874	2073	4947	0.00021
Rhodobacter_capsulatus	1061	S	3431	749	4180	0.00018
Rhodovulum_sp._P5	1564506	S	1927	226	2153	0.00009
Rhodovulum_sp._MB263	308754	S	1773	776	2549	0.00011
Rhodovulum_sulfidophilum	35806	S	3202	1889	5091	0.00022
Paroceanicella_profunda	2579971	S	6855	1880	8735	0.00038
Polymorphum_gilvum	991904	S	6112	1527	7639	0.00033
Pikeienuella_piscinae	2748098	S	5024	492	5516	0.00024
Pontivivens_ytuae	2789856	S	4554	359	4913	0.00021
Silicimonas_algicola	1826607	S	4163	264	4427	0.00019
Thioclava_electrotropha	1549850	S	1764	484	2248	0.00010
Thioclava_nitratireducens	1915078	S	1598	592	2190	0.00009
Pelagovum_pacificum	2588711	S	3716	489	4205	0.00018
Frigidibacter_mobilis	1335048	S	3074	1356	4430	0.00019
Pukyongiella_litopenaei	2605946	S	2549	654	3203	0.00014
Brevirhabdus_pacifica	1267768	S	2540	1263	3803	0.00016
Fuscovulum_blasticum	1075	S	2228	307	2535	0.00011
Gymnodinialimonas_ceratoperidinii	2856823	S	1983	199	2182	0.00009
Haematobacter_massiliensis	195105	S	1950	814	2764	0.00012
Falsirhodobacter_sp._PG104	2692330	S	1845	283	2128	0.00009
Tabrizicola_piscis	2494374	S	1759	174	1933	0.00008
Pseudopuniceibacterium_antarcticum	2613965	S	1742	145	1887	0.00008
Gemmobacter_aquarius	2169400	S	1602	339	1941	0.00008
Pacificitalea_manganoxidans	1411902	S	1553	365	1918	0.00008
Pseudooceanicola_algae	1537215	S	1437	151	1588	0.00007
Monaibacterium_sp._h42	2758038	S	1341	333	1674	0.00007
Roseicitreum_antarcticum	564137	S	1279	71	1350	0.00006
Tritonibacter_mobilis	379347	S	980	462	1442	0.00006
Qingshengfaniella_alkalisoli	2599296	S	908	51	959	0.00004
Yoonia_vestfoldensis	245188	S	877	211	1088	0.00005
Rhodophyticola_sp._CCM32	2916397	S	868	27	895	0.00004
Pseudohalocynthiibacter_aestuariivivens	1591409	S	850	181	1031	0.00004
Rhodobaca_barguzinensis	441209	S	737	34	771	0.00003
Profundibacter_amoris	2171755	S	589	21	610	0.00003
Pseudorhodobacter_turbinis	2500533	S	559	38	597	0.00003
Parasedimentitalea_marina	2483033	S	543	26	569	0.00002
Aestuarium_zhoushanense	2820523	S	429	186	615	0.00003
Cognatishimia_activa	1715691	S	405	18	423	0.00002
Planktomarina_temperata	1284658	S	270	7	277	0.00001
Roseovarius_sp._SCSIO_43702	2823043	S	3011	241	3252	0.00014
Roseovarius_sp._THAF9	2587847	S	1543	399	1942	0.00008
Roseovarius_sp._THAF8	2587846	S	634	1045	1679	0.00007
Roseovarius_sp._THAF27	2587850	S	527	931	1458	0.00006
Roseovarius_sp._TM1035	391613	S	231	470	701	0.00003
Roseovarius_indicus	540747	S	3698	1215	4913	0.00021
Roseovarius_faecimaris	2494550	S	1357	60	1417	0.00006
Roseovarius_mucosus	215743	S	259	533	792	0.00003
Sulfitobacter_sp._THAF37	2587855	S	1416	619	2035	0.00009
Sulfitobacter_sp._JK7-1	2829501	S	1412	79	1491	0.00006
Sulfitobacter_sp._D7	1968541	S	716	283	999	0.00004
Sulfitobacter_sp._JL08	2070369	S	636	15	651	0.00003
Sulfitobacter_sp._SK011	1389004	S	583	15	598	0.00003
Sulfitobacter_sp._DSM_110093	2883127	S	446	135	581	0.00003
Sulfitobacter_sp._BSw21498	664426	S	364	60	424	0.00002
Sulfitobacter_sp._SK012	1389005	S	337	6	343	0.00001
Sulfitobacter_sp._SK025	1389011	S	164	355	519	0.00002
Sulfitobacter_sp._CB2047	1525218	S	118	342	460	0.00002
Sulfitobacter_sp._B30-2	2785912	S	75	168	243	0.00001
Sulfitobacter_alexandrii	1917485	S	2201	1180	3381	0.00015
Sulfitobacter_mediterraneus	83219	S	922	97	1019	0.00004
Sulfitobacter_indolifex	225422	S	603	142	745	0.00003
Sulfitobacter_dubius	218673	S	499	233	732	0.00003
Sulfitobacter_pontiacus	60137	S	202	476	678	0.00003
Salipiger_profundus	1229727	S	4477	2051	6528	0.00028
Salipiger_abyssi	1250539	S	3089	1266	4355	0.00019
Salipiger_sp._CCB-MM3	1792508	S	2778	404	3182	0.00014
Roseivivax_sp._THAF30	2587852	S	2212	468	2680	0.00012
Roseivivax_sp._THAF197b	2588299	S	74	1025	1099	0.00005
Roseivivax_sp._THAF40	2587858	S	60	1074	1134	0.00005
Roseivivax_marinus	1379903	S	4186	696	4882	0.00021
Celeribacter_indicus	1208324	S	3298	1657	4955	0.00021
Celeribacter_ethanolicus	1758178	S	1184	416	1600	0.00007
Celeribacter_baekdonensis	875171	S	518	143	661	0.00003
Celeribacter_marinus	1397108	S	372	13	385	0.00002
Leisingera_aquaemixtae	1396826	S	1758	333	2091	0.00009
Leisingera_sp._NJS204	2508307	S	321	536	857	0.00004
Leisingera_sp._NJS201	2508306	S	311	492	803	0.00003
Leisingera_methylohalidivorans	133924	S	1204	279	1483	0.00006
Phaeobacter_gallaeciensis	60890	S	1472	636	2108	0.00009
Phaeobacter_inhibens	221822	S	1157	470	1627	0.00007
Phaeobacter_piscinae	1580596	S	604	505	1109	0.00005
Phaeobacter_porticola	1844006	S	307	99	406	0.00002
Phaeobacter_sp._LSS9	681157	S	101	156	257	0.00001
Ruegeria_sp._TM1040	292414	S	712	123	835	0.00004
Ruegeria_sp._THAF33	2587853	S	567	150	717	0.00003
Ruegeria_sp._SCSIO_43209	2793010	S	567	110	677	0.00003
Ruegeria_sp._AD91A	2293862	S	434	49	483	0.00002
Ruegeria_pomeroyi	89184	S	1941	367	2308	0.00010
Yangia_pacifica	311180	S	3696	645	4341	0.00019
Sagittula_sp._P11	2009329	S	3614	1577	5191	0.00022
Sulfitobacter_pseudonitzschiae	1402135	S	2349	844	3193	0.00014
Pseudosulfitobacter_sp._DSM_107133	2883100	S	883	363	1246	0.00005
Ponticoccus_alexandrii	1943633	S	2682	417	3099	0.00013
Mameliella_alba	561184	S	2673	521	3194	0.00014
Dinoroseobacter_shibae	215813	S	2484	950	3434	0.00015
Roseobacter_ponti	1891787	S	871	23	894	0.00004
Roseobacter_denitrificans	2434	S	676	112	788	0.00003
Roseobacter_litoralis	42443	S	556	68	624	0.00003
Roseibacterium_elongatum	159346	S	1968	170	2138	0.00009
Oceanicola_sp._D3	2587163	S	1955	103	2058	0.00009
Actibacterium_sp._EMB200-NS6	1609966	S	1921	972	2893	0.00013
Ketogulonicigenium_vulgare	92945	S	945	175	1120	0.00005
Ketogulonicigenium_robustum	92947	S	886	103	989	0.00004
Octadecabacter_sp._SW4	2602067	S	753	114	867	0.00004
Octadecabacter_arcticus	53946	S	394	63	457	0.00002
Octadecabacter_antarcticus	1217908	S	374	49	423	0.00002
Octadecabacter_temperatus	1458307	S	224	5	229	0.00001
Maribius_sp._THAF1	2587842	S	1368	72	1440	0.00006
Antarctobacter_heliothermus	74033	S	1217	65	1282	0.00006
Tateyamaria_omphalii	299262	S	1214	42	1256	0.00005
Jannaschia_sp._CCS1	290400	S	1142	31	1173	0.00005
Thalassococcus_sp._S3	2017482	S	1119	29	1148	0.00005
Thalassobius_gelatinovorus	53501	S	722	39	761	0.00003
Falsihalocynthiibacter_arcticus	1579316	S	240	7	247	0.00001
Caulobacter_segnis	88688	S	9899	3422	13321	0.00058
Caulobacter_sp._S6	2823693	S	7061	737	7798	0.00034
Caulobacter_sp._FWC26	69665	S	2661	1097	3758	0.00016
Caulobacter_mirabilis	69666	S	7230	1280	8510	0.00037
Caulobacter_vibrioides	155892	S	6029	2920	8949	0.00039
Caulobacter_flavus	1679497	S	5652	1483	7135	0.00031
Caulobacter_rhizosphaerae	2010972	S	5057	1373	6430	0.00028
Caulobacter_soli	2708539	S	4186	1242	5428	0.00023
Caulobacter_henricii	69395	S	2233	358	2591	0.00011
Brevundimonas_sp._PAMC22021	2861285	S	2613	539	3152	0.00014
Brevundimonas_sp._LM2	1938605	S	2596	417	3013	0.00013
Brevundimonas_sp._M20	2591463	S	2474	360	2834	0.00012
Brevundimonas_sp._MF30-B	2561924	S	2236	331	2567	0.00011
Brevundimonas_sp._AJA228-03	2752515	S	1807	223	2030	0.00009
Brevundimonas_sp._CS1	2813778	S	610	578	1188	0.00005
Brevundimonas_sp._Bb-A	2560058	S	535	1049	1584	0.00007
Brevundimonas_sp._SGAir0440	2579977	S	535	493	1028	0.00004
Brevundimonas_sp._DS20	1532555	S	514	1214	1728	0.00007
Brevundimonas_sp._GW460-12-10-14-LB2	1827469	S	505	841	1346	0.00006
Brevundimonas_sp._'scallop'	2562582	S	428	720	1148	0.00005
Brevundimonas_naejangsanensis	588932	S	4259	1379	5638	0.00024
Brevundimonas_albigilva	1312364	S	2870	1501	4371	0.00019
Brevundimonas_goettingensis	2774190	S	2792	411	3203	0.00014
Brevundimonas_subvibrioides	74313	S	2403	405	2808	0.00012
Brevundimonas_pondensis	2774189	S	1807	523	2330	0.00010
Brevundimonas_diminuta	293	S	1697	3061	4758	0.00021
Brevundimonas_mediterranea	74329	S	1695	621	2316	0.00010
Brevundimonas_vitisensis	2800818	S	1562	180	1742	0.00008
Brevundimonas_nasdae	172043	S	1395	865	2260	0.00010
Brevundimonas_vesicularis	41276	S	496	1040	1536	0.00007
Brevundimonas_vancanneytii	1325724	S	458	1692	2150	0.00009
Phenylobacterium_zucineum	284016	S	14436	2862	17298	0.00075
Phenylobacterium_parvum	2201350	S	4249	458	4707	0.00020
Terricaulis_silvestris	2686094	S	11808	399	12207	0.00053
Asticcacaulis_excentricus	78587	S	1844	268	2112	0.00009
Asticcacaulis_sp._AND118	2840468	S	1636	232	1868	0.00008
Candidatus_Viadribacter_manganicus	1759059	S	5666	152	5818	0.00025
Hyphomonas_sp._CACIAM_19H1	1873716	S	1456	223	1679	0.00007
Hyphomonas_sp._Mor2	1906738	S	970	20	990	0.00004
Hyphomonas_sp._KY3	2016196	S	774	87	861	0.00004
Hyphomonas_neptunium	81032	S	1322	155	1477	0.00006
Hirschia_baltica	2724	S	88	2	90	0.00000
Marinicauda_algicola	2029849	S	4164	705	4869	0.00021
Maricaulis_maris	74318	S	1522	99	1621	0.00007
Glycocaulis_alkaliphilus	1434191	S	1360	73	1433	0.00006
Hyphobacterium_sp._CCMP332	2749086	S	942	38	980	0.00004
Aquisalinus_flavus	1526572	S	1692	79	1771	0.00008
Parvularcula_bermudensis	208216	S	689	82	771	0.00003
Anaplasma_ovis	142058	S	118	16	134	0.00001
Anaplasma_platys	949	S	54	7	61	0.00000
Anaplasma_marginale	770	S	31	38	69	0.00000
Anaplasma_centrale	769	S	16	11	27	0.00000
Anaplasma_phagocytophilum	948	S	12	1	13	0.00000
Wolbachia_endosymbiont_of_Ctenocephalides_felis_wCfeT	2732593	S	11	27	38	0.00000
Wolbachia_endosymbiont_of_Litomosoides_sigmodontis	80850	S	10	43	53	0.00000
Ehrlichia_ruminantium	779	S	28	17	45	0.00000
Neorickettsia_helminthoeca	33994	S	12	11	23	0.00000
Candidatus_Neoehrlichia_mikurensis	89586	S	14	4	18	0.00000
Rickettsia_tillamookensis	2761623	S	138	67	205	0.00001
Rickettsia_amblyommatis	33989	S	29	33	62	0.00000
Rickettsia_endosymbiont_of_Ixodes_scapularis	444612	S	10	11	21	0.00000
Rickettsia_endosymbiont_of_Oedothorax_gibbosus	931099	S	22	4	26	0.00000
Rickettsia_typhi	785	S	10	6	16	0.00000
Rickettsia_canadensis	788	S	11	1	12	0.00000
Orientia_tsutsugamushi	784	S	32	2	34	0.00000
Candidatus_Sneabacter_namystus	2601646	S	10	1	11	0.00000
Candidatus_Phycorickettsia_trachydisci	2115978	S	48	5	53	0.00000
Candidatus_Midichloria_mitochondrii	234827	S	53	6	59	0.00000
Candidatus_Fokinia_solitaria	1802984	S	18	0	18	0.00000
Rickettsiales_endosymbiont_of_Stachyamoeba_lipophora	2486578	S	34	4	38	0.00000
Candidatus_Deianiraea_vastatrix	2163644	S	25	0	25	0.00000
Luteithermobacter_gelatinilyticus	2582913	S	582	95	677	0.00003
Paremcibacter_congregatus	2043170	S	550	15	565	0.00002
Micavibrio_aeruginosavorus	349221	S	898	10	908	0.00004
Candidatus_Puniceispirillum_marinum	767892	S	163	4	167	0.00001
Candidatus_Hydrogenosomobacter_endosymbioticus	2558174	S	63	1	64	0.00000
endosymbiont_of_Acanthamoeba_sp._UWC8	86106	S	42	0	42	0.00000
Candidatus_Cytomitobacter_indipagum	2601575	S	14	7	21	0.00000
Candidatus_Cytomitobacter_primus	2066024	S	10	4	14	0.00000
Candidatus_Gromoviella_agglomerans	2806609	S	32	1	33	0.00000
Candidatus_Nesciobacter_abundans	2601668	S	22	3	25	0.00000
Candidatus_Nucleicultrix_amoebiphila	1509244	S	98	5	103	0.00000
Candidatus_Paracaedibacter_acanthamoebae	91604	S	89	4	93	0.00000
Magnetococcus_marinus	1124597	S	300	7	307	0.00001
Kordiimonas_pumila	2161677	S	129	2	131	0.00001
Candidatus_Pelagibacter_sp._RS40	1977865	S	23	2	25	0.00000
Candidatus_Pelagibacter_sp._IMCC9063	1002672	S	13	0	13	0.00000
Candidatus_Pelagibacter_sp._FZCC0015	2268451	S	10	2	12	0.00000
Candidatus_Pelagibacter_giovannonii	2563896	S	12	2	14	0.00000
Candidatus_Pelagibacter_ubique	198252	S	11	2	13	0.00000
Candidatus_Fonsibacter_ubiquis	1925548	S	33	3	36	0.00000
Burkholderia_ubonensis	101571	S	7883	4123	12006	0.00052
Burkholderia_multivorans	87883	S	7880	15578	23458	0.00101
Burkholderia_cenocepacia	95486	S	6310	18598	24908	0.00108
Burkholderia_cepacia	292	S	5321	17966	23287	0.00101
Burkholderia_pyrrocinia	60550	S	3389	1474	4863	0.00021
Burkholderia_contaminans	488447	S	2855	1517	4372	0.00019
Burkholderia_ambifaria	152480	S	2784	3431	6215	0.00027
Burkholderia_stagnalis	1503054	S	2674	816	3490	0.00015
Burkholderia_anthina	179879	S	2500	1945	4445	0.00019
Burkholderia_lata	482957	S	2342	1736	4078	0.00018
Burkholderia_dolosa	152500	S	2290	742	3032	0.00013
Burkholderia_stabilis	95485	S	2209	1367	3576	0.00015
Burkholderia_territorii	1503055	S	1859	734	2593	0.00011
Burkholderia_seminalis	488731	S	1635	621	2256	0.00010
Burkholderia_vietnamiensis	60552	S	1475	46314	47789	0.00207
Burkholderia_metallica	488729	S	1136	448	1584	0.00007
Burkholderia_diffusa	488732	S	863	343	1206	0.00005
Burkholderia_pseudomultivorans	1207504	S	734	636	1370	0.00006
Burkholderia_latens	488446	S	398	651	1049	0.00005
Burkholderia_aenigmatica	2015348	S	347	640	987	0.00004
Burkholderia_pseudomallei	28450	S	3554	30439	33993	0.00147
Burkholderia_mayonis	1385591	S	2645	530	3175	0.00014
Burkholderia_thailandensis	57975	S	2437	2202	4639	0.00020
Burkholderia_oklahomensis	342113	S	1752	618	2370	0.00010
Burkholderia_savannae	1637837	S	380	353	733	0.00003
Burkholderia_sp._MSMB1588	1636423	S	158	264	422	0.00002
Burkholderia_sp._MSMB617WGS	1637831	S	140	261	401	0.00002
Burkholderia_mallei	13373	S	92	8526	8618	0.00037
Burkholderia_sp._DHOD12	2571746	S	4590	479	5069	0.00022
Burkholderia_sp._Bp7605	1740163	S	2236	301	2537	0.00011
Burkholderia_sp._LA-2-3-30-S1-D2	1637862	S	967	447	1414	0.00006
Burkholderia_sp._NRF60-BP8	1637853	S	937	404	1341	0.00006
Burkholderia_sp._MSMB0856	1637869	S	928	464	1392	0.00006
Burkholderia_sp._JP2-270	2217913	S	812	406	1218	0.00005
Burkholderia_sp._MS455	2811788	S	717	400	1117	0.00005
Burkholderia_sp._PAMC_26561	1795043	S	712	697	1409	0.00006
Burkholderia_sp._IDO3	1705310	S	434	503	937	0.00004
Burkholderia_sp._PAMC_28687	1795874	S	418	629	1047	0.00005
Burkholderia_sp._KBS0801	1179675	S	187	288	475	0.00002
Burkholderia_sp._LAS2	2813843	S	137	501	638	0.00003
Burkholderia_sp._MS389	2811789	S	89	522	611	0.00003
Burkholderia_sp._MBR-1	2732364	S	73	248	321	0.00001
Burkholderia_sp._KJ006	416344	S	52	269	321	0.00001
Burkholderia_sp._B21-007	2890407	S	23	722	745	0.00003
Burkholderia_gladioli	28095	S	9767	3037	12804	0.00055
Burkholderia_glumae	337	S	3665	21187	24852	0.00108
Burkholderia_plantarii	41899	S	2687	854	3541	0.00015
Burkholderia_perseverans	2615214	S	2264	769	3033	0.00013
Cupriavidus_taiwanensis	164546	S	15898	12871	28769	0.00124
Cupriavidus_pauculus	82633	S	12675	5361	18036	0.00078
Cupriavidus_necator	106590	S	6950	6481	13431	0.00058
Cupriavidus_basilensis	68895	S	6636	3564	10200	0.00044
Cupriavidus_oxalaticus	96344	S	6528	2847	9375	0.00041
Cupriavidus_sp._EM10	2839983	S	2636	1529	4165	0.00018
Cupriavidus_sp._MP-37	2884455	S	1506	1535	3041	0.00013
Cupriavidus_sp._KK10	1478019	S	568	1718	2286	0.00010
Cupriavidus_sp._ISTL7	2771360	S	417	2709	3126	0.00014
Cupriavidus_sp._USMAA2-4	876364	S	363	2529	2892	0.00013
Cupriavidus_sp._USMAHM13	1389192	S	281	2003	2284	0.00010
Cupriavidus_campinensis	151783	S	5388	1909	7297	0.00032
Cupriavidus_metallidurans	119219	S	3886	8672	12558	0.00054
Cupriavidus_pinatubonensis	248026	S	3527	595	4122	0.00018
Cupriavidus_neocaledonicus	1040979	S	1397	1719	3116	0.00013
Cupriavidus_gilardii	82541	S	1349	6627	7976	0.00035
Cupriavidus_nantongensis	1796606	S	1037	2743	3780	0.00016
Cupriavidus_malaysiensis	367825	S	332	2222	2554	0.00011
Paraburkholderia_sp._SOS3	1926494	S	3133	447	3580	0.00015
Paraburkholderia_sp._PGU16	2735433	S	1684	906	2590	0.00011
Paraburkholderia_sp._PGU19	2735434	S	1353	1132	2485	0.00011
Paraburkholderia_pallida	2547399	S	4479	796	5275	0.00023
Paraburkholderia_aromaticivorans	2026199	S	4173	1788	5961	0.00026
Paraburkholderia_caribensis	75105	S	3747	2756	6503	0.00028
Paraburkholderia_acidisoli	2571748	S	3696	653	4349	0.00019
Paraburkholderia_tropica	92647	S	3334	729	4063	0.00018
Paraburkholderia_acidiphila	2571747	S	3246	622	3868	0.00017
Paraburkholderia_edwinii	2861782	S	3039	406	3445	0.00015
Paraburkholderia_phytofirmans	261302	S	2977	1218	4195	0.00018
Paraburkholderia_terricola	169427	S	2901	843	3744	0.00016
Paraburkholderia_atlantica	2654982	S	2783	661	3444	0.00015
Paraburkholderia_megapolitana	420953	S	2537	237	2774	0.00012
Paraburkholderia_phymatum	148447	S	2490	619	3109	0.00013
Paraburkholderia_fungorum	134537	S	2421	555	2976	0.00013
Paraburkholderia_sprentiae	948107	S	2394	511	2905	0.00013
Paraburkholderia_phenoliruptrix	252970	S	2364	664	3028	0.00013
Paraburkholderia_graminis	60548	S	2218	531	2749	0.00012
Paraburkholderia_terrae	311230	S	2083	2328	4411	0.00019
Paraburkholderia_ginsengisoli	311231	S	2036	605	2641	0.00011
Paraburkholderia_caledonica	134536	S	2006	354	2360	0.00010
Paraburkholderia_hospita	169430	S	1941	2160	4101	0.00018
Paraburkholderia_xenovorans	36873	S	1823	2273	4096	0.00018
Paraburkholderia_caffeinilytica	1761016	S	1791	457	2248	0.00010
Paraburkholderia_dokdonella	2211211	S	1663	435	2098	0.00009
Paraburkholderia_dioscoreae	2604047	S	1178	769	1947	0.00008
Ralstonia_solanacearum	305	S	8602	22378	30980	0.00134
Ralstonia_insidiosa	190721	S	2428	1769	4197	0.00018
Ralstonia_mannitolilytica	105219	S	1753	1916	3669	0.00016
Ralstonia_pickettii	329	S	1682	675	2357	0.00010
Ralstonia_sp._56D2	2842456	S	1416	209	1625	0.00007
blood_disease_bacterium_A2-HR_MARDI	1944648	S	12	489	501	0.00002
Ralstonia_syzygii	28097	S	131	347	478	0.00002
Ralstonia_pseudosolanacearum	1310165	S	45	914	959	0.00004
Pandoraea_pnomenusa	93220	S	3482	1660	5142	0.00022
Pandoraea_thiooxydans	445709	S	2730	222	2952	0.00013
Pandoraea_pulmonicola	93221	S	2691	584	3275	0.00014
Pandoraea_vervacti	656178	S	1925	556	2481	0.00011
Pandoraea_faecigallinarum	656179	S	1895	505	2400	0.00010
Pandoraea_sp._XY-2	2518599	S	1838	953	2791	0.00012
Pandoraea_norimbergensis	93219	S	1832	288	2120	0.00009
Pandoraea_apista	93218	S	1604	891	2495	0.00011
Pandoraea_fibrosis	1891094	S	1449	476	1925	0.00008
Pandoraea_oxalativorans	573737	S	1446	674	2120	0.00009
Pandoraea_sputorum	93222	S	1288	563	1851	0.00008
Caballeronia_sp._Lep1P3	2878150	S	2721	660	3381	0.00015
Caballeronia_sp._TF1N1	2878153	S	2228	263	2491	0.00011
Caballeronia_sp._SL2Y3	2878151	S	1429	825	2254	0.00010
Caballeronia_sp._Sq4a	2878152	S	1232	911	2143	0.00009
Caballeronia_sp._M1242	2814653	S	1144	824	1968	0.00009
Caballeronia_sp._SBC2	2705547	S	155	1326	1481	0.00006
Caballeronia_sp._SBC1	2705548	S	125	1495	1620	0.00007
Caballeronia_zhejiangensis	871203	S	3107	754	3861	0.00017
Caballeronia_insecticola	758793	S	2754	599	3353	0.00015
Caballeronia_grimmiae	1071679	S	2527	1311	3838	0.00017
Polynucleobacter_sp._MWH-UH24A	2689110	S	167	10	177	0.00001
Polynucleobacter_sp._MWH-CaK5	2689107	S	71	3	74	0.00000
Polynucleobacter_sp._MWH-UH21B	1743174	S	60	7	67	0.00000
Polynucleobacter_sp._MWH-P3-07-1	1743173	S	59	7	66	0.00000
Polynucleobacter_sp._es-MAR-2	1819725	S	52	8	60	0.00000
Polynucleobacter_sp._MWH-Braz-FAM2G	1855883	S	51	5	56	0.00000
Polynucleobacter_sp._MWH-Spelu-300-X4	2689109	S	50	2	52	0.00000
Polynucleobacter_sp._AP-Nino-20-G2	2576917	S	47	9	56	0.00000
Polynucleobacter_sp._MWH-Aus1W21	1855880	S	47	8	55	0.00000
Polynucleobacter_sp._AP-Sving-400A-A2	2081049	S	46	15	61	0.00000
Polynucleobacter_sp._VK25	1758398	S	45	8	53	0.00000
Polynucleobacter_sp._AP-Titi-500A-B4	2576923	S	45	7	52	0.00000
Polynucleobacter_sp._LimPoW16	1743162	S	45	2	47	0.00000
Polynucleobacter_sp._MG-6-Vaara-E2	2576932	S	44	6	50	0.00000
Polynucleobacter_sp._AP-Kolm-20A-A1	2081041	S	43	21	64	0.00000
Polynucleobacter_sp._es-EL-1	1855652	S	43	6	49	0.00000
Polynucleobacter_sp._MWH-Svant-W18	1855909	S	42	6	48	0.00000
Polynucleobacter_sp._MWH-UH35A	1855619	S	41	5	46	0.00000
Polynucleobacter_sp._JS-JIR-II-50	2576919	S	41	12	53	0.00000
Polynucleobacter_sp._TSB-Sco08W16	1758374	S	37	4	41	0.00000
Polynucleobacter_sp._MWH-UH2A	1855617	S	37	5	42	0.00000
Polynucleobacter_sp._AP-Elch-400A-B2	2576930	S	35	10	45	0.00000
Polynucleobacter_sp._JS-JIR-II-b4	1758390	S	33	11	44	0.00000
Polynucleobacter_sp._MWH-UH25E	1855616	S	33	4	37	0.00000
Polynucleobacter_sp._MWH-S4W17	1855910	S	32	10	42	0.00000
Polynucleobacter_sp._AP-Melu-1000-A1	2081042	S	32	8	40	0.00000
Polynucleobacter_sp._AP-Ainpum-60-G11	2576926	S	31	5	36	0.00000
Polynucleobacter_sp._Adler-ghost	2770234	S	30	9	39	0.00000
Polynucleobacter_sp._MG-Unter2-18	2081052	S	29	16	45	0.00000
Polynucleobacter_sp._AP-Jannik-300A-C4	2576928	S	28	17	45	0.00000
Polynucleobacter_sp._AM-7D1	2689102	S	28	19	47	0.00000
Polynucleobacter_sp._JS-Mosq-20-D10	2576922	S	26	6	32	0.00000
Polynucleobacter_sp._JS-JIR-5-A7	1758395	S	21	32	53	0.00000
Polynucleobacter_sp._UB-Siik-W21	1855646	S	20	31	51	0.00000
Polynucleobacter_sp._MG-5-Ahmo-C2	2081051	S	12	52	64	0.00000
Polynucleobacter_necessarius	576610	S	271	42	313	0.00001
Polynucleobacter_acidiphobus	556053	S	246	16	262	0.00001
Polynucleobacter_asymbioticus	576611	S	169	23	192	0.00001
Polynucleobacter_difficilis	556054	S	149	11	160	0.00001
Polynucleobacter_paneuropaeus	2527775	S	74	7	81	0.00000
Polynucleobacter_wuianus	1743168	S	40	10	50	0.00000
Polynucleobacter_duraquae	1835254	S	26	15	41	0.00000
Lautropia_mirabilis	47671	S	2784	520	3304	0.00014
Chitinimonas_arctica	2594795	S	1581	129	1710	0.00007
Mycetohabitans_rhizoxinica	412963	S	1409	97	1506	0.00007
Mycoavidus_sp._HKI	2840467	S	182	12	194	0.00001
Mycoavidus_sp._B2-EB	2651972	S	99	12	111	0.00000
Mycoavidus_cysteinexigens	1553431	S	152	12	164	0.00001
Limnobacter_sp._SAORIC-580	2732163	S	406	19	425	0.00002
Candidatus_Vallotia_cooleyia	1177211	S	89	10	99	0.00000
Candidatus_Vallotia_lariciata	2018052	S	65	19	84	0.00000
Candidatus_Vallotia_sp._(ex_Adelges_kitamiensis)	2864217	S	53	15	68	0.00000
Candidatus_Vallotia_tarda	1177213	S	38	6	44	0.00000
Ephemeroptericola_cinctiostellae	2268024	S	161	10	171	0.00001
Variovorax_sp._HW608	1034889	S	11391	1998	13389	0.00058
Variovorax_sp._RA8	662548	S	9980	7719	17699	0.00077
Variovorax_sp._WDL1	207745	S	9242	14473	23715	0.00103
Variovorax_sp._PBL-H6	434009	S	8016	7371	15387	0.00067
Variovorax_sp._PBS-H4	434008	S	7991	5060	13051	0.00056
Variovorax_sp._PAMC_28711	1795631	S	4521	798	5319	0.00023
Variovorax_sp._RKNM96	2681552	S	4430	1722	6152	0.00027
Variovorax_sp._PAMC28562	2762323	S	3765	336	4101	0.00018
Variovorax_sp._PAMC26660	2762322	S	3625	931	4556	0.00020
Variovorax_sp._SRS16	282217	S	3158	6558	9716	0.00042
Variovorax_sp._38R	2774875	S	2582	3258	5840	0.00025
Variovorax_sp._PBL-E5	434014	S	2528	6089	8617	0.00037
Variovorax_sp._PDNC026	2811425	S	110	3811	3921	0.00017
Variovorax_sp._PMC12	2126319	S	50	2225	2275	0.00010
Variovorax_paradoxus	34073	S	23125	21296	44421	0.00192
Variovorax_boronicumulans	436515	S	3616	2718	6334	0.00027
Hydrogenophaga_sp._BA0156	2716225	S	5803	4301	10104	0.00044
Hydrogenophaga_sp._PBC	795665	S	5189	6237	11426	0.00049
Hydrogenophaga_sp._YM1	2806262	S	5113	2735	7848	0.00034
Hydrogenophaga_sp._BPS33	2651974	S	4675	3725	8400	0.00036
Hydrogenophaga_sp._SL48	2806347	S	4176	1071	5247	0.00023
Hydrogenophaga_sp._RAC07	1842537	S	3155	1110	4265	0.00018
Hydrogenophaga_sp._PBL-H3	434010	S	3097	2921	6018	0.00026
Hydrogenophaga_sp._PAMC20947	2565558	S	1618	115	1733	0.00008
Hydrogenophaga_sp._NH-16	2184519	S	1544	3581	5125	0.00022
Hydrogenophaga_taeniospiralis	65656	S	3310	1073	4383	0.00019
Hydrogenophaga_pseudoflava	47421	S	1564	2861	4425	0.00019
Hydrogenophaga_crassostreae	1763535	S	1481	99	1580	0.00007
Acidovorax_sp._YS12	2738413	S	3405	3147	6552	0.00028
Acidovorax_sp._JMULE5	2518343	S	3357	1014	4371	0.00019
Acidovorax_sp._KKS102	358220	S	2870	2231	5101	0.00022
Acidovorax_sp._RAC01	1842533	S	2569	2220	4789	0.00021
Acidovorax_sp._1608163	2478662	S	1985	454	2439	0.00011
Acidovorax_sp._HDW3	2714923	S	1932	1478	3410	0.00015
Acidovorax_sp._T1	1858609	S	1365	5240	6605	0.00029
Acidovorax_avenae	80867	S	7137	4762	11899	0.00051
Acidovorax_monticola	1926868	S	4089	1734	5823	0.00025
Acidovorax_antarcticus	2743470	S	3556	2893	6449	0.00028
Acidovorax_carolinensis	553814	S	2634	2272	4906	0.00021
Acidovorax_citrulli	80869	S	1980	2527	4507	0.00020
Acidovorax_cattleyae	80868	S	1811	1307	3118	0.00013
Acidovorax_radicis	758826	S	1791	388	2179	0.00009
Ramlibacter_tataouinensis	94132	S	30897	13067	43964	0.00190
Comamonas_sp._NLF-7-7	2597701	S	2362	1962	4324	0.00019
Comamonas_sp._NLF-1-9	2853163	S	1981	1239	3220	0.00014
Comamonas_sp._B21-038	2918299	S	1239	326	1565	0.00007
Comamonas_sp._Y33R10-2	2853257	S	423	83	506	0.00002
Comamonas_aquatica	225991	S	3280	3384	6664	0.00029
Comamonas_serinivorans	1082851	S	3264	978	4242	0.00018
Comamonas_testosteroni	285	S	1976	3095	5071	0.00022
Comamonas_koreensis	160825	S	1394	887	2281	0.00010
Comamonas_odontotermitis	379895	S	1203	254	1457	0.00006
Comamonas_piscis	1562974	S	1055	219	1274	0.00006
Comamonas_thiooxydans	363952	S	992	2243	3235	0.00014
Comamonas_kerstersii	225992	S	787	447	1234	0.00005
Comamonas_fluminis	2796366	S	614	279	893	0.00004
Rhodoferax_sp._BAB1	2741720	S	3990	1176	5166	0.00022
Rhodoferax_sp._AJA081-3	2752316	S	1418	108	1526	0.00007
Rhodoferax_sp._PAMC_29310	2822760	S	916	108	1024	0.00004
Rhodoferax_sp._MIZ03	2798804	S	725	80	805	0.00003
Rhodoferax_koreense	1842727	S	5702	3163	8865	0.00038
Rhodoferax_sediminis	2509614	S	4374	713	5087	0.00022
Rhodoferax_ferrireducens	192843	S	1850	131	1981	0.00009
Rhodoferax_saidenbachensis	1484693	S	1452	167	1619	0.00007
Rhodoferax_antarcticus	81479	S	855	69	924	0.00004
Rhodoferax_aquaticus	2527691	S	521	55	576	0.00002
Schlegelella_thermodepolymerans	215580	S	9718	4950	14668	0.00063
Schlegelella_brevitalea	413882	S	8161	1233	9394	0.00041
Diaphorobacter_sp._HDW4A	2714924	S	2387	2395	4782	0.00021
Diaphorobacter_sp._HDW4B	2714925	S	2004	270	2274	0.00010
Diaphorobacter_sp._MNS-0	2866628	S	256	2203	2459	0.00011
Diaphorobacter_sp._JS3051	2792224	S	210	3518	3728	0.00016
Diaphorobacter_sp._JS3050	2735554	S	200	2245	2445	0.00011
Diaphorobacter_ruginosibacter	1715720	S	2576	501	3077	0.00013
Diaphorobacter_aerolatus	1288495	S	2095	3434	5529	0.00024
Diaphorobacter_nitroreducens	164759	S	362	1018	1380	0.00006
[Acidovorax]_ebreus	721785	S	357	2154	2511	0.00011
Delftia_tsuruhatensis	180282	S	2732	7906	10638	0.00046
Delftia_acidovorans	80866	S	2296	4471	6767	0.00029
Delftia_lacustris	558537	S	827	4928	5755	0.00025
Delftia_sp._Cs1-4	742013	S	319	770	1089	0.00005
Delftia_sp._HK171	1920191	S	165	462	627	0.00003
Polaromonas_sp._JS666	296591	S	4349	389	4738	0.00021
Polaromonas_sp._SP1	2268087	S	12	4179	4191	0.00018
Polaromonas_naphthalenivorans	216465	S	3141	504	3645	0.00016
Polaromonas_vacuolata	37448	S	367	40	407	0.00002
Kinneretia_sp._DAIF2	2714952	S	7834	2985	10819	0.00047
Kinneretia_sp._XES5	2877940	S	2368	3136	5504	0.00024
Ottowia_sp._27C	2816950	S	3463	717	4180	0.00018
Ottowia_sp._oral_taxon_894	1658672	S	1288	197	1485	0.00006
Ottowia_oryzae	2109914	S	2694	629	3323	0.00014
Alicycliphilus_denitrificans	179636	S	6401	12397	18798	0.00081
Melaminivora_sp._SC2-9	2109913	S	2983	3603	6586	0.00028
Melaminivora_jejuensis	1267217	S	2406	1925	4331	0.00019
Serpentinimonas_maccroryi	1458426	S	2144	715	2859	0.00012
Serpentinimonas_raichei	1458425	S	1713	635	2348	0.00010
Verminephrobacter_eiseniae	364317	S	3341	432	3773	0.00016
Hylemonella_gracilis	80880	S	2764	419	3183	0.00014
Pulveribacter_suum	2116657	S	2635	1444	4079	0.00018
Simplicispira_suum	2109915	S	2025	787	2812	0.00012
Limnohabitans_sp._63ED37-2	1678128	S	1047	120	1167	0.00005
Limnohabitans_sp._103DPR2	1678129	S	363	28	391	0.00002
Curvibacter_sp._AEP1-3	1844971	S	1016	77	1093	0.00005
Candidatus_Symbiobacter_mobilis	1436290	S	924	34	958	0.00004
Massilia_sp._LPB0304	2769491	S	7500	1946	9446	0.00041
Massilia_sp._WG5	1707785	S	7395	3383	10778	0.00047
Massilia_sp._HC52	2852099	S	6602	1893	8495	0.00037
Massilia_sp._DM-R-R2A-13	2899220	S	5170	1206	6376	0.00028
Massilia_sp._NP310	2861282	S	4276	2908	7184	0.00031
Massilia_sp._YMA4	1593482	S	4191	2235	6426	0.00028
Massilia_sp._PAMC28688	2861283	S	3382	533	3915	0.00017
Massilia_sp._NR_4-1	1678028	S	769	2425	3194	0.00014
Massilia_sp._MB5	2919578	S	667	2176	2843	0.00012
Massilia_sp._Dwa41.01b	2709302	S	108	3581	3689	0.00016
Massilia_sp._Se16.2.3	2709303	S	82	2744	2826	0.00012
Massilia_violaceinigra	2045208	S	7508	2178	9686	0.00042
Massilia_putida	1141883	S	7014	2324	9338	0.00040
Massilia_flava	871742	S	6239	1576	7815	0.00034
Massilia_albidiflava	321983	S	4204	1720	5924	0.00026
Massilia_umbonata	864828	S	4160	1716	5876	0.00025
Massilia_lutea	321985	S	4128	1298	5426	0.00023
Massilia_armeniaca	2072590	S	4026	2174	6200	0.00027
Massilia_plicata	321984	S	3626	979	4605	0.00020
Massilia_oculi	945844	S	3429	2246	5675	0.00025
Massilia_antarctica	2765360	S	3019	1155	4174	0.00018
Duganella_sp._GN2-R2	2728020	S	5137	2213	7350	0.00032
Duganella_sp._AF9R3	2728021	S	3375	720	4095	0.00018
Janthinobacterium_sp._17J80-10	2497863	S	2162	332	2494	0.00011
Janthinobacterium_sp._1_2014MBL_MicDiv	1644131	S	2065	765	2830	0.00012
Janthinobacterium_sp._LM6	1938606	S	1014	634	1648	0.00007
Janthinobacterium_sp._PAMC25594	2861284	S	735	460	1195	0.00005
Janthinobacterium_sp._Marseille	375286	S	635	165	800	0.00003
Janthinobacterium_sp._HH102	1537274	S	448	724	1172	0.00005
Janthinobacterium_sp._B9-8	1236179	S	209	62	271	0.00001
Janthinobacterium_agaricidamnosum	55508	S	2932	4779	7711	0.00033
Janthinobacterium_lividum	29581	S	742	777	1519	0.00007
Janthinobacterium_tructae	2590869	S	697	372	1069	0.00005
Janthinobacterium_svalbardensis	368607	S	664	345	1009	0.00004
Herbaspirillum_robiniae	2014887	S	3419	1317	4736	0.00020
Herbaspirillum_seropedicae	964	S	2476	1051	3527	0.00015
Herbaspirillum_frisingense	92645	S	2434	808	3242	0.00014
Herbaspirillum_hiltneri	341045	S	2191	389	2580	0.00011
Herbaspirillum_rubrisubalbicans	80842	S	2139	1035	3174	0.00014
Herbaspirillum_huttiense	863372	S	1563	661	2224	0.00010
Herbaspirillum_sp._meg3	2025949	S	1271	153	1424	0.00006
Collimonas_fungivorans	158899	S	2729	775	3504	0.00015
Collimonas_arenae	279058	S	2144	289	2433	0.00011
Collimonas_pratensis	279113	S	1954	421	2375	0.00010
Noviherbaspirillum_sp._UKPF54	2601898	S	4420	778	5198	0.00022
Undibacterium_sp._KW1	2058624	S	222	96	318	0.00001
Undibacterium_sp._YM2	2058625	S	222	96	318	0.00001
Undibacterium_parvum	401471	S	322	42	364	0.00002
Glaciimonas_sp._PAMC28666	2807626	S	405	26	431	0.00002
Herminiimonas_arsenitoxidans	1809410	S	374	59	433	0.00002
Oxalobacter_formigenes	847	S	252	24	276	0.00001
Achromobacter_xylosoxidans	85698	S	11217	18064	29281	0.00127
Achromobacter_sp._MFA1_R4	1881016	S	3631	1022	4653	0.00020
Achromobacter_sp._AONIH1	1758194	S	3479	4624	8103	0.00035
Achromobacter_sp._77	2756133	S	1361	3007	4368	0.00019
Achromobacter_sp._B7	2282475	S	453	1060	1513	0.00007
Achromobacter_sp._ES-001	2860286	S	392	1264	1656	0.00007
Achromobacter_spanius	217203	S	8809	3573	12382	0.00054
Achromobacter_denitrificans	32002	S	5235	3647	8882	0.00038
Achromobacter_deleyi	1353891	S	4264	2846	7110	0.00031
Achromobacter_insolitus	217204	S	2663	712	3375	0.00015
Achromobacter_mucicolens	1389922	S	2080	2813	4893	0.00021
Achromobacter_pestifer	1353889	S	2075	1391	3466	0.00015
Achromobacter_ruhlandii	72557	S	46	1868	1914	0.00008
Bordetella_sp._H567	1697043	S	3231	384	3615	0.00016
Bordetella_sp._N	1746199	S	3190	354	3544	0.00015
Bordetella_genomosp._13	463040	S	4727	3515	8242	0.00036
Bordetella_bronchialis	463025	S	4054	543	4597	0.00020
Bordetella_genomosp._8	1416806	S	3608	425	4033	0.00017
Bordetella_flabilis	463014	S	3299	280	3579	0.00015
Bordetella_genomosp._9	1416803	S	3243	859	4102	0.00018
Bordetella_hinzii	103855	S	2930	1288	4218	0.00018
Bordetella_petrii	94624	S	2785	3948	6733	0.00029
Bordetella_trematum	123899	S	2180	957	3137	0.00014
Bordetella_pseudohinzii	1331258	S	1840	821	2661	0.00012
Bordetella_bronchiseptica	518	S	1678	6360	8038	0.00035
Bordetella_avium	521	S	1024	135	1159	0.00005
Bordetella_holmesii	35814	S	991	16779	17770	0.00077
Bordetella_genomosp._6	463024	S	539	962	1501	0.00006
Bordetella_pertussis	520	S	339	9342	9681	0.00042
Bordetella_parapertussis	519	S	175	1762	1937	0.00008
Pigmentiphaga_sp._H8	2488560	S	5935	773	6708	0.00029
Pigmentiphaga_aceris	1940612	S	1755	123	1878	0.00008
Castellaniella_defragrans	75697	S	3913	2791	6704	0.00029
Orrella_dioscoreae	1851544	S	3117	1131	4248	0.00018
Orrella_marina	2163011	S	447	82	529	0.00002
Orrella_sp._f23	2782176	S	231	15	246	0.00001
Alcaligenes_faecalis	511	S	811	705	1516	0.00007
Alcaligenes_sp._SORT26	2813780	S	226	42	268	0.00001
Alcaligenes_sp._DN25	1367435	S	51	112	163	0.00001
Alcaligenes_aquatilis	323284	S	158	561	719	0.00003
Alcaligenes_ammonioxydans	2582914	S	29	306	335	0.00001
Pusillimonas_thiosulfatoxidans	2028345	S	885	260	1145	0.00005
Pusillimonas_sp._T7-7	1007105	S	585	102	687	0.00003
Pusillimonas_sp._DMV24BSW_D	2716226	S	254	19	273	0.00001
Advenella_kashmirensis	310575	S	756	35	791	0.00003
Advenella_mimigardefordensis	302406	S	469	21	490	0.00002
Paralcaligenes_sp._KSB-10	2901142	S	1166	47	1213	0.00005
Kerstersia_gyiorum	206506	S	1054	228	1282	0.00006
Oligella_urethralis	90245	S	75	10	85	0.00000
Oligella_ureolytica	90244	S	70	52	122	0.00001
Paenalcaligenes_hominis	643674	S	101	5	106	0.00000
Taylorella_asinigenitalis	84590	S	25	5	30	0.00000
Taylorella_equigenitalis	29575	S	20	3	23	0.00000
Basilea_psittacipulmonis	1472345	S	34	3	37	0.00000
Pelistega_ratti	2652177	S	27	4	31	0.00000
Rhizobacter_gummiphilus	946333	S	15883	3482	19365	0.00084
Rhizobacter_sp._AJA081-3	2753607	S	11681	3336	15017	0.00065
Methylibium_sp._Pch-M	2082386	S	4719	4645	9364	0.00041
Methylibium_petroleiphilum	105560	S	4567	4826	9393	0.00041
Sphaerotilus_sp._FB-5	2914710	S	6994	4853	11847	0.00051
Sphaerotilus_natans	34103	S	6407	2826	9233	0.00040
Rubrivivax_gelatinosus	28068	S	11134	3891	15025	0.00065
Aquincola_tertiaricarbonis	391953	S	9689	3736	13425	0.00058
Mitsuaria_sp._7	1658665	S	8718	1943	10661	0.00046
Leptothrix_cholodnii	34029	S	7641	2737	10378	0.00045
Thiomonas_sp._X19	1050370	S	2947	1055	4002	0.00017
Thiomonas_intermedia	926	S	1862	263	2125	0.00009
Thiomonas_arsenitoxydans	426114	S	776	1242	2018	0.00009
Xylophilus_rhododendri	2697032	S	4990	1603	6593	0.00029
Ideonella_dechloratans	36863	S	4178	2786	6964	0.00030
Tepidimonas_taiwanensis	307486	S	3782	1489	5271	0.00023
Aquabacterium_olei	1296669	S	3553	1041	4594	0.00020
Roseateles_depolymerans	76731	S	3532	757	4289	0.00019
Inhella_inkyongensis	392593	S	2599	457	3056	0.00013
Paucibacter_sp._KCTC_42545	1768242	S	1988	373	2361	0.00010
Candidatus_Ichthyocystis_hellenicum	1561003	S	81	1	82	0.00000
Sutterella_megalosphaeroides	2494234	S	1143	196	1339	0.00006
Sutterella_faecalis	2584944	S	867	119	986	0.00004
Sutterella_wadsworthensis	40545	S	345	40	385	0.00002
Turicimonas_muris	1796652	S	149	11	160	0.00001
Nitrosospira_multiformis	1231	S	32841	955	33796	0.00146
Nitrosospira_lacus	1288494	S	2320	70	2390	0.00010
Nitrosospira_sp._NRS527	155925	S	1320	696	2016	0.00009
Nitrosospira_briensis	35799	S	1120	633	1753	0.00008
Nitrosomonas_communis	44574	S	7935	173	8108	0.00035
Nitrosomonas_ureae	44577	S	597	18	615	0.00003
Nitrosomonas_europaea	915	S	376	53	429	0.00002
Nitrosomonas_eutropha	916	S	241	137	378	0.00002
Nitrosomonas_stercoris	1444684	S	117	67	184	0.00001
Usitatibacter_rugosus	2732067	S	14908	1751	16659	0.00072
Usitatibacter_palustris	2732487	S	11610	1455	13065	0.00057
Thiobacillus_denitrificans	36861	S	16844	3300	20144	0.00087
Sulfuritortus_calidifontis	1914471	S	3478	1528	5006	0.00022
Denitratisoma_sp._DHT3	1981880	S	3134	2433	5567	0.00024
Denitratisoma_oestradiolicum	311182	S	1692	288	1980	0.00009
Sulfuritalea_hydrogenivorans	748811	S	3679	566	4245	0.00018
Methyloversatilis_sp._RAC08	1842540	S	3274	454	3728	0.00016
Sterolibacterium_denitrificans	157592	S	2427	709	3136	0.00014
Sideroxydans_sp._MIZ01	2764705	S	1776	371	2147	0.00009
Sideroxydans_lithotrophicus	63745	S	1288	198	1486	0.00006
Ferrigenium_kumadai	1682490	S	2081	417	2498	0.00011
Candidatus_Nitrotoga_arctica	453162	S	395	81	476	0.00002
Candidatus_Nitrotoga_sp._AM1P	2559597	S	239	52	291	0.00001
Ferriphaselus_amnicola	1188319	S	699	89	788	0.00003
Gallionella_capsiferriformans	370405	S	531	45	576	0.00002
Sulfuriferula_plumbiphila	171865	S	1499	260	1759	0.00008
Sulfuriferula_sp._AH1	1985873	S	745	152	897	0.00004
Sulfuriferula_nivalis	2675298	S	133	10	143	0.00001
Sulfurimicrobium_lacus	2715678	S	2402	298	2700	0.00012
Sulfuricella_denitrificans	649841	S	1166	103	1269	0.00005
Methylotenera_mobilis	359408	S	862	89	951	0.00004
Methylotenera_versatilis	1055487	S	182	20	202	0.00001
Methylovorus_glucosotrophus	266009	S	255	251	506	0.00002
Methylovorus_sp._MP688	887061	S	230	250	480	0.00002
Methylobacillus_flagellatus	405	S	742	189	931	0.00004
Methylophilus_sp._TWE2	1662285	S	288	25	313	0.00001
Methylophilus_medardicus	2588534	S	187	20	207	0.00001
Candidatus_Methylopumilus_turicensis	1581680	S	112	15	127	0.00001
Candidatus_Methylopumilus_universalis	2588536	S	80	23	103	0.00000
Candidatus_Methylopumilus_planktonicus	1581557	S	46	15	61	0.00000
Candidatus_Methylopumilus_rimovensis	2588535	S	25	3	28	0.00000
Methyloradius_palustris	2778876	S	199	16	215	0.00001
Thauera_sp._MZ1T	85643	S	5688	6021	11709	0.00051
Thauera_sp._K11	2005884	S	4894	3092	7986	0.00035
Thauera_humireducens	1134435	S	3479	2116	5595	0.00024
Thauera_chlorobenzoica	96773	S	2669	2488	5157	0.00022
Thauera_aromatica	59405	S	2416	3436	5852	0.00025
Thauera_hydrothermalis	2184083	S	1457	440	1897	0.00008
Azoarcus_sp._KH32C	748247	S	5764	1101	6865	0.00030
Azoarcus_sp._DD4	2027405	S	4054	2747	6801	0.00029
Azoarcus_olearius	418699	S	4908	1913	6821	0.00030
Azoarcus_communis	41977	S	3553	1433	4986	0.00022
Nitrogeniibacter_mangrovi	2016596	S	4160	920	5080	0.00022
Nitrogeniibacter_aestuarii	2815343	S	1964	226	2190	0.00009
Aromatoleum_petrolei	76116	S	5239	1362	6601	0.00029
Aromatoleum_aromaticum	551760	S	4109	2963	7072	0.00031
Aromatoleum_bremense	76115	S	3597	2127	5724	0.00025
Aromatoleum_pumilum	2067960	S	3426	1324	4750	0.00021
Azospira_restricta	404405	S	8570	4598	13168	0.00057
Azospira_inquinata	2785627	S	748	66	814	0.00004
Azospira_oryzae	146939	S	623	1559	2182	0.00009
Azospira_sp._I09	1765049	S	575	1743	2318	0.00010
Niveibacterium_microcysteis	2811415	S	3252	484	3736	0.00016
Oryzomicrobium_terrae	1735038	S	2492	664	3156	0.00014
Rugosibacter_aromaticivorans	1565605	S	644	116	760	0.00003
Dechloromonas_denitrificans	281362	S	3498	912	4410	0.00019
Dechloromonas_sp._HYN0024	2231055	S	871	186	1057	0.00005
Dechloromonas_sp._TW-R-39-2	2654218	S	633	299	932	0.00004
Ferribacterium_limneticum	76259	S	4426	787	5213	0.00023
Quatrionicoccus_australiensis	138118	S	1985	615	2600	0.00011
Fluviibacter_phosphoraccumulans	1751046	S	286	100	386	0.00002
Chromobacterium_sp._ATCC_53434	2059672	S	2243	807	3050	0.00013
Chromobacterium_sp._Rain0013	2292447	S	428	520	948	0.00004
Chromobacterium_sp._Beijing	2735795	S	348	968	1316	0.00006
Chromobacterium_violaceum	536	S	2158	1362	3520	0.00015
Chromobacterium_vaccinii	1108595	S	2081	924	3005	0.00013
Chromobacterium_phragmitis	2202141	S	1473	666	2139	0.00009
Chromobacterium_paludis	2605945	S	1233	501	1734	0.00008
Chromobacterium_rhizoryzae	1778675	S	383	1976	2359	0.00010
Chromobacterium_haemolyticum	394935	S	215	1379	1594	0.00007
Iodobacter_ciconiae	2496266	S	159	43	202	0.00001
Iodobacter_fluviatilis	537	S	106	32	138	0.00001
Jeongeupia_sp._USM3	1906741	S	3407	933	4340	0.00019
Jeongeupia_sp._HS-3	1009682	S	1401	287	1688	0.00007
Paludibacterium_paludis	1225769	S	1581	326	1907	0.00008
Paludibacterium_yongneupense	400061	S	1472	219	1691	0.00007
Paludibacterium_sp._B53371	2806263	S	1052	233	1285	0.00006
Pseudogulbenkiania_sp._NH8B	748280	S	3006	1050	4056	0.00018
Vogesella_sp._LIG4	1192162	S	1899	529	2428	0.00011
Vogesella_sp._XCS3	2877939	S	828	237	1065	0.00005
Aquitalea_aquatilis	1537400	S	597	191	788	0.00003
Aquitalea_denitrificans	519081	S	440	231	671	0.00003
Aquitalea_sp._USM4	1590041	S	379	212	591	0.00003
Aquitalea_magnusonii	332411	S	366	215	581	0.00003
Microvirgula_aerodenitrificans	57480	S	2083	411	2494	0.00011
Laribacter_hongkongensis	168471	S	1505	1391	2896	0.00013
Aquaspirillum_sp._LM1	1938604	S	962	147	1109	0.00005
Chitinibacter_bivalviorum	2739434	S	220	177	397	0.00002
Chitinibacter_fontanus	1737446	S	180	27	207	0.00001
Deefgea_sp._D17	2739061	S	113	45	158	0.00001
Deefgea_sp._D25	2865840	S	108	16	124	0.00001
Deefgea_sp._D13	2864875	S	91	31	122	0.00001
Neisseria_sp._KEM232	655307	S	448	73	521	0.00002
Neisseria_sp._oral_taxon_014	641148	S	166	81	247	0.00001
Neisseria_sp._ZJ785	2709396	S	121	16	137	0.00001
Neisseria_sp._Dent_CA1/247	2912675	S	77	43	120	0.00001
Neisseria_bacilliformis	267212	S	453	117	570	0.00002
Neisseria_shayeganii	607712	S	422	66	488	0.00002
Neisseria_meningitidis	487	S	378	1340	1718	0.00007
Neisseria_musculi	1815583	S	368	36	404	0.00002
Neisseria_chenwenguii	1853278	S	327	42	369	0.00002
Neisseria_dentiae	194197	S	307	39	346	0.00001
Neisseria_elongata	495	S	293	178	471	0.00002
Neisseria_animalis	492	S	145	22	167	0.00001
Neisseria_gonorrhoeae	485	S	142	196	338	0.00001
Neisseria_animaloris	326522	S	124	31	155	0.00001
Neisseria_sicca	490	S	113	256	369	0.00002
Neisseria_weaveri	28091	S	111	48	159	0.00001
Neisseria_brasiliensis	2666100	S	101	100	201	0.00001
Neisseria_canis	493	S	94	26	120	0.00001
Neisseria_lactamica	486	S	91	144	235	0.00001
Neisseria_dumasiana	1931275	S	90	42	132	0.00001
Neisseria_weixii	1853276	S	89	11	100	0.00000
Neisseria_zalophi	640030	S	87	9	96	0.00000
Neisseria_wadsworthii	607711	S	80	19	99	0.00000
Neisseria_arctica	1470200	S	69	7	76	0.00000
Neisseria_mucosa	488	S	64	155	219	0.00001
Neisseria_zoodegmatis	326523	S	50	39	89	0.00000
Neisseria_cinerea	483	S	44	30	74	0.00000
Neisseria_flavescens	484	S	32	28	60	0.00000
Neisseria_macacae	496	S	30	74	104	0.00000
Neisseria_subflava	28449	S	23	20	43	0.00000
Crenobacter_cavernae	2290923	S	3715	1269	4984	0.00022
Chitinolyticbacter_meiyuanensis	682798	S	2573	329	2902	0.00013
Vitreoscilla_filiformis	63	S	1018	194	1212	0.00005
Vitreoscilla_massiliensis	1689272	S	130	15	145	0.00001
Vitreoscilla_sp._C1	96942	S	13	58	71	0.00000
Kingella_potus	265175	S	316	45	361	0.00002
Kingella_denitrificans	502	S	216	144	360	0.00002
Kingella_oralis	505	S	195	32	227	0.00001
Kingella_kingae	504	S	58	9	67	0.00000
Uruburuella_suis	252130	S	334	56	390	0.00002
Uruburuella_testudinis	1282863	S	306	61	367	0.00002
Eikenella_corrodens	539	S	412	260	672	0.00003
Eikenella_exigua	2528037	S	100	64	164	0.00001
Paralysiella_testudinis	2809020	S	268	59	327	0.00001
Alysiella_crassa	153491	S	69	19	88	0.00000
Alysiella_filiformis	194196	S	62	59	121	0.00001
Neisseriaceae_bacterium_CCUG_44465	2917790	S	85	14	99	0.00000
Conchiformibius_steedae	153493	S	81	13	94	0.00000
Snodgrassella_alvi	1196083	S	51	16	67	0.00000
Aquella_oligotrophica	2067065	S	38	1	39	0.00000
Morococcus_cerebrosus	1056807	S	30	172	202	0.00001
Simonsiella_muelleri	72	S	28	5	33	0.00000
Casimicrobium_huifangae	2591109	S	2575	1276	3851	0.00017
Candidatus_Kinetoplastibacterium_crithidii	33056	S	18	0	18	0.00000
Candidatus_Kinetoplastibacterium_oncopeltii	994696	S	14	8	22	0.00000
Candidatus_Kinetoplastibacterium_sorsogonicusi	1576550	S	14	4	18	0.00000
Candidatus_Kinetoplastibacterium_galatii	994695	S	12	8	20	0.00000
Lysobacter_sp._KIS68-7	2904252	S	11096	2113	13209	0.00057
Lysobacter_sp._TY2-98	2290922	S	5569	869	6438	0.00028
Lysobacter_sp._CECT_30171	2822368	S	5277	1236	6513	0.00028
Lysobacter_sp._5GHs7-4	2904253	S	4785	1422	6207	0.00027
Lysobacter_sp._S4-A87	2925843	S	4434	1438	5872	0.00025
Lysobacter_sp._CW239	2762611	S	3630	1944	5574	0.00024
Lysobacter_sp._K5869	2820808	S	2933	1404	4337	0.00019
Lysobacter_sp._H21R4	2781021	S	867	1675	2542	0.00011
Lysobacter_sp._CJ11	2764185	S	715	58	773	0.00003
Lysobacter_sp._HDW10	2714936	S	450	123	573	0.00002
Lysobacter_sp._H23M47	2781024	S	428	2105	2533	0.00011
Lysobacter_soli	453783	S	19305	3944	23249	0.00101
Lysobacter_enzymogenes	69	S	12353	4471	16824	0.00073
Lysobacter_capsici	435897	S	7367	7781	15148	0.00066
Lysobacter_solisilvae_(ex_Woo_and_Kim_2022)	2865112	S	6869	1987	8856	0.00038
Lysobacter_solisilvae_(ex_Kim_et_al._2021)	2763317	S	5701	1129	6830	0.00030
Lysobacter_maris	1605891	S	5085	1202	6287	0.00027
Lysobacter_antibioticus	84531	S	4675	968	5643	0.00024
Lysobacter_arenosi	2795387	S	4474	1430	5904	0.00026
Lysobacter_lycopersici	1324796	S	4165	871	5036	0.00022
Lysobacter_alkalisoli	2591633	S	3787	667	4454	0.00019
Lysobacter_oculi	2698682	S	2989	796	3785	0.00016
Lysobacter_ciconiae	2781022	S	757	1378	2135	0.00009
Lysobacter_gummosus	262324	S	654	5450	6104	0.00026
Lysobacter_avium	2781023	S	471	2140	2611	0.00011
Stenotrophomonas_maltophilia	40324	S	12258	17521	29779	0.00129
Stenotrophomonas_sp._SAU14A_NAIMI4_5	2072413	S	862	533	1395	0.00006
Stenotrophomonas_sp._ESTM1D_MKCIP4_1	2072414	S	853	345	1198	0.00005
Stenotrophomonas_sp._ZAC14D2_NAIMI4_7	2072405	S	446	475	921	0.00004
Stenotrophomonas_sp._ZAC14A_NAIMI4_1	2072412	S	311	578	889	0.00004
Stenotrophomonas_sp._YAU14D1_LEIMI4_1	2072407	S	281	479	760	0.00003
Stenotrophomonas_sp._ZAC14D2_NAIMI4_6	2072406	S	257	498	755	0.00003
Stenotrophomonas_sp._SAU14A_NAIMI4_8	2072409	S	135	762	897	0.00004
Stenotrophomonas_sp._YAU14A_MKIMI4_1	2072408	S	105	592	697	0.00003
Stenotrophomonas_sp._LM091	1904944	S	1676	620	2296	0.00010
Stenotrophomonas_sp._169	2770322	S	1475	234	1709	0.00007
Stenotrophomonas_sp._364	2691571	S	1084	411	1495	0.00006
Stenotrophomonas_sp._NA06056	2742129	S	553	266	819	0.00004
Stenotrophomonas_sp._WZN-1	2005046	S	311	368	679	0.00003
Stenotrophomonas_sp._DR822	2871174	S	216	355	571	0.00002
Stenotrophomonas_sp._Pemsol	2040586	S	175	517	692	0.00003
Stenotrophomonas_sp._pho	2211160	S	128	581	709	0.00003
Stenotrophomonas_sp._SI-NJAU-1	2886359	S	119	508	627	0.00003
Stenotrophomonas_sp._G4	2303750	S	115	476	591	0.00003
Stenotrophomonas_sp._MYb57	1827305	S	102	444	546	0.00002
Stenotrophomonas_sp._ASS1	2282124	S	95	443	538	0.00002
Stenotrophomonas_sp._NY11291	2939415	S	87	966	1053	0.00005
Stenotrophomonas_sp._CW117	2775920	S	70	1551	1621	0.00007
Stenotrophomonas_sp._SXG-1	2682487	S	44	501	545	0.00002
Stenotrophomonas_rhizophila	216778	S	5092	1462	6554	0.00028
Stenotrophomonas_acidaminiphila	128780	S	2997	6959	9956	0.00043
Stenotrophomonas_indicatrix	2045451	S	152	613	765	0.00003
Xanthomonas_translucens	343	S	4939	5955	10894	0.00047
Xanthomonas_campestris	339	S	3965	3403	7368	0.00032
Xanthomonas_sacchari	56458	S	2800	901	3701	0.00016
Xanthomonas_sp._GW	2724121	S	529	658	1187	0.00005
Xanthomonas_sp._SS	2724122	S	473	685	1158	0.00005
Xanthomonas_sp._SI	2724123	S	466	682	1148	0.00005
Xanthomonas_sp._MLO165	2081477	S	123	96	219	0.00001
Xanthomonas_arboricola	56448	S	2162	1581	3743	0.00016
Xanthomonas_oryzae	347	S	1843	585	2428	0.00011
Xanthomonas_theicola	56464	S	1795	534	2329	0.00010
Xanthomonas_citri	346	S	1455	40067	41522	0.00180
Xanthomonas_hyacinthi	56455	S	1395	759	2154	0.00009
Xanthomonas_fragariae	48664	S	1155	203	1358	0.00006
Xanthomonas_albilineans	29447	S	1152	157	1309	0.00006
Xanthomonas_hortorum	56454	S	1103	586	1689	0.00007
Xanthomonas_vesicatoria	56460	S	1063	545	1608	0.00007
Xanthomonas_cucurbitae	56453	S	920	143	1063	0.00005
Xanthomonas_vasicola	56459	S	833	224	1057	0.00005
Xanthomonas_cassavae	56450	S	748	140	888	0.00004
Xanthomonas_euroxanthea	2259622	S	623	393	1016	0.00004
Xanthomonas_hydrangeae	2775159	S	554	128	682	0.00003
Xanthomonas_axonopodis	53413	S	516	380	896	0.00004
Xanthomonas_phaseoli	1985254	S	398	747	1145	0.00005
Xanthomonas_euvesicatoria	456327	S	286	1316	1602	0.00007
Xanthomonas_perforans	442694	S	32	107	139	0.00001
Luteimonas_sp._MC1750	2799326	S	3542	1292	4834	0.00021
Luteimonas_sp._S4-F44	2925842	S	3314	635	3949	0.00017
Luteimonas_sp._JM171	1896164	S	3158	631	3789	0.00016
Luteimonas_sp._D4P002	2901869	S	2999	781	3780	0.00016
Luteimonas_sp._MC1572	2799325	S	2933	1439	4372	0.00019
Luteimonas_sp._YGD11-2	2508168	S	2831	1200	4031	0.00017
Luteimonas_sp._MC1825	2761107	S	2712	1368	4080	0.00018
Luteimonas_granuli	1176533	S	3671	1244	4915	0.00021
Luteimonas_yindakuii	2565782	S	2794	1077	3871	0.00017
Luteimonas_chenhongjianii	2006110	S	2635	563	3198	0.00014
Pseudoxanthomonas_suwonensis	314722	S	7777	3823	11600	0.00050
Pseudoxanthomonas_mexicana	128785	S	4445	5928	10373	0.00045
Pseudoxanthomonas_sp._X-1	2571115	S	3435	3090	6525	0.00028
Pseudoxanthomonas_sp._F37	2932492	S	21	1416	1437	0.00006
Pseudoxanthomonas_daejeonensis	266062	S	3314	811	4125	0.00018
Pseudoxanthomonas_spadix	415229	S	2109	751	2860	0.00012
Thermomonas_sp._XSG	2771436	S	2587	1127	3714	0.00016
Thermomonas_sp._HDW16	2714945	S	1723	469	2192	0.00009
Thermomonas_brevis	215691	S	3542	1453	4995	0.00022
Thermomonas_aquatica	2202149	S	3123	1635	4758	0.00021
Thermomonas_carbonis	1463158	S	2623	544	3167	0.00014
Arenimonas_daejeonensis	370777	S	7274	1455	8729	0.00038
Pseudolysobacter_antarcticus	2511995	S	1991	53	2044	0.00009
Xylella_fastidiosa	2371	S	367	99	466	0.00002
Xylella_taiwanensis	1444770	S	212	10	222	0.00001
Luteibacter_sp._321	2911537	S	3040	885	3925	0.00017
Luteibacter_sp._EIF3	2780091	S	2014	315	2329	0.00010
Luteibacter_sp._335	2911538	S	1912	423	2335	0.00010
Luteibacter_sp._353	2911539	S	1695	514	2209	0.00010
Luteibacter_rhizovicinus	242606	S	2253	310	2563	0.00011
Luteibacter_pinisoli	2589080	S	2182	555	2737	0.00012
Luteibacter_anthropi	564369	S	1687	301	1988	0.00009
Rhodanobacter_denitrificans	666685	S	4563	1859	6422	0.00028
Rhodanobacter_sp._FDAARGOS_1247	2778082	S	2941	1028	3969	0.00017
Rhodanobacter_thiooxydans	416169	S	2616	1275	3891	0.00017
Rhodanobacter_glycinis	582702	S	1951	366	2317	0.00010
Dyella_thiooxydans	445710	S	3586	1141	4727	0.00020
Dyella_japonica	231455	S	1997	609	2606	0.00011
Dyella_telluris	2763498	S	1789	482	2271	0.00010
Dyella_terrae	522259	S	1504	215	1719	0.00007
Dyella_caseinilytica	1849581	S	1150	90	1240	0.00005
Dyella_sp._M7H15-1	2501295	S	768	79	847	0.00004
Frateuria_sp._5GH9-34	2898793	S	3687	1251	4938	0.00021
Frateuria_sp._5GH9-11	1542730	S	3505	1515	5020	0.00022
Frateuria_aurantia	81475	S	1066	140	1206	0.00005
Dokdonella_koreensis	323415	S	6469	1147	7616	0.00033
Aerosticca_soli	2010829	S	3289	4436	7725	0.00033
Ahniella_affigens	2021234	S	1716	45	1761	0.00008
Pseudomonas_sp._ATCC_13867	1294143	S	1555	529	2084	0.00009
Pseudomonas_sp._SCB32	2653853	S	1545	318	1863	0.00008
Pseudomonas_sp._KNUC1026	2893890	S	1426	134	1560	0.00007
Pseudomonas_sp._LPB0260	2614442	S	1421	281	1702	0.00007
Pseudomonas_sp._TCU-HL1	1856685	S	1413	195	1608	0.00007
Pseudomonas_sp._PDNC002	2811422	S	1379	305	1684	0.00007
Pseudomonas_sp._CC6-YY-74	1930532	S	1257	146	1403	0.00006
Pseudomonas_sp._DY-1	1755504	S	1252	154	1406	0.00006
Pseudomonas_sp._Ost2	2678260	S	1225	174	1399	0.00006
Pseudomonas_sp._ABC1	2748080	S	971	135	1106	0.00005
Pseudomonas_sp._MTM4	2705472	S	965	164	1129	0.00005
Pseudomonas_sp._StFLB209	1028989	S	900	228	1128	0.00005
Pseudomonas_sp._L5B5	2883205	S	883	156	1039	0.00004
Pseudomonas_sp._Pc102	2678261	S	867	456	1323	0.00006
Pseudomonas_sp._7SR1	1881017	S	863	155	1018	0.00004
Pseudomonas_sp._CMR5c	658630	S	856	243	1099	0.00005
Pseudomonas_sp._MM211	2866808	S	821	73	894	0.00004
Pseudomonas_sp._p1(2021b)	2874628	S	773	413	1186	0.00005
Pseudomonas_sp._OIL-1	2706126	S	748	149	897	0.00004
Pseudomonas_sp._HN2-3	2886360	S	734	162	896	0.00004
Pseudomonas_sp._MPC6	2498848	S	706	150	856	0.00004
Pseudomonas_sp._LAB-08	143813	S	703	128	831	0.00004
Pseudomonas_sp._MSPm1	2726956	S	671	143	814	0.00004
Pseudomonas_sp._B11D7D	2735906	S	625	117	742	0.00003
Pseudomonas_sp._Marseille-Q3773	2866592	S	576	187	763	0.00003
Pseudomonas_sp._gcc21	2726989	S	566	243	809	0.00004
Pseudomonas_sp._DG56-2	2320270	S	545	59	604	0.00003
Pseudomonas_sp._HLS-6	2049589	S	543	160	703	0.00003
Pseudomonas_sp._ADPe	2774873	S	543	1320	1863	0.00008
Pseudomonas_sp._S09G_359	2054919	S	535	128	663	0.00003
Pseudomonas_sp._Leaf58	1736226	S	533	100	633	0.00003
Pseudomonas_sp._ADAK13	2730847	S	533	123	656	0.00003
Pseudomonas_sp._URMO17WK12:I11	1283291	S	510	341	851	0.00004
Pseudomonas_sp._15A4	2804761	S	483	121	604	0.00003
Pseudomonas_sp._MM213	2866807	S	478	102	580	0.00003
Pseudomonas_sp._Tri1	2823875	S	466	110	576	0.00002
Pseudomonas_sp._31-12	2201356	S	455	115	570	0.00002
Pseudomonas_sp._RtIB026	2749999	S	446	260	706	0.00003
Pseudomonas_sp._LS.1a	2920387	S	444	189	633	0.00003
Pseudomonas_sp._S34	1573718	S	434	102	536	0.00002
Pseudomonas_sp._M1	95619	S	408	953	1361	0.00006
Pseudomonas_sp._S35	1573719	S	393	105	498	0.00002
Pseudomonas_sp._HS6	2850559	S	389	104	493	0.00002
Pseudomonas_sp._DTU12.3	2073078	S	387	97	484	0.00002
Pseudomonas_sp._Seg1	2678259	S	380	87	467	0.00002
Pseudomonas_sp._OE_28.3	2745519	S	379	91	470	0.00002
Pseudomonas_sp._RC3H12	2834406	S	378	230	608	0.00003
Pseudomonas_sp._DR48	2871095	S	376	252	628	0.00003
Pseudomonas_sp._ACM7	2052956	S	370	65	435	0.00002
Pseudomonas_sp._2hn	2866626	S	368	246	614	0.00003
Pseudomonas_sp._PP3	2815936	S	341	130	471	0.00002
Pseudomonas_sp._NIBR-H-19	2901380	S	338	73	411	0.00002
Pseudomonas_sp._NS1(2017)	2025658	S	323	84	407	0.00002
Pseudomonas_sp._DNDY-54	2870860	S	316	152	468	0.00002
Pseudomonas_sp._St316	2678257	S	313	102	415	0.00002
Pseudomonas_sp._HN11	1344094	S	308	70	378	0.00002
Pseudomonas_sp._LG1E9	2219057	S	302	89	391	0.00002
Pseudomonas_sp._M30-35	1981174	S	297	16	313	0.00001
Pseudomonas_sp._R5-89-07	658644	S	296	92	388	0.00002
Pseudomonas_sp._ADAK18	2730848	S	290	50	340	0.00001
Pseudomonas_sp._3-2	2867408	S	266	356	622	0.00003
Pseudomonas_sp._SK3(2021)	2841064	S	266	170	436	0.00002
Pseudomonas_sp._R84	1573712	S	252	119	371	0.00002
Pseudomonas_sp._14181154	2662033	S	251	275	526	0.00002
Pseudomonas_sp._MRSN12121	1611770	S	248	348	596	0.00003
Pseudomonas_sp._CCOS_191	1649877	S	246	205	451	0.00002
Pseudomonas_sp._SK	2729423	S	244	208	452	0.00002
Pseudomonas_sp._SDM007	2812000	S	241	156	397	0.00002
Pseudomonas_sp._R2A2	2213057	S	241	277	518	0.00002
Pseudomonas_sp._FGI182	1259844	S	239	264	503	0.00002
Pseudomonas_sp._CYM-20-01	2870750	S	235	115	350	0.00002
Pseudomonas_sp._HS-18	2879114	S	230	467	697	0.00003
Pseudomonas_sp._SCA2728.1_7	2825975	S	229	127	356	0.00002
Pseudomonas_sp._NIBRBAC000502773	2590776	S	223	113	336	0.00001
Pseudomonas_sp._IzPS59	2774459	S	204	96	300	0.00001
Pseudomonas_sp._FIT81	2837969	S	201	118	319	0.00001
Pseudomonas_sp._phDV1	253237	S	200	692	892	0.00004
Pseudomonas_sp._AO-1	2855434	S	199	197	396	0.00002
Pseudomonas_sp._LPH1	1898684	S	198	179	377	0.00002
Pseudomonas_sp._R76	1573711	S	197	97	294	0.00001
Pseudomonas_sp._LTJR-52	2479392	S	193	63	256	0.00001
Pseudomonas_sp._UW4	1207075	S	183	119	302	0.00001
Pseudomonas_sp._B10	118613	S	179	129	308	0.00001
Pseudomonas_sp._THAF7b	2587845	S	168	332	500	0.00002
Pseudomonas_sp._BIGb0427	2724470	S	161	379	540	0.00002
Pseudomonas_sp._Z003-0.4C(8344-21)	1855380	S	157	110	267	0.00001
Pseudomonas_sp._02C_26	2054914	S	156	363	519	0.00002
Pseudomonas_sp._DR_5-09	1534110	S	150	211	361	0.00002
Pseudomonas_sp._SORT22	2813842	S	145	363	508	0.00002
Pseudomonas_sp._Cab53	2678258	S	144	226	370	0.00002
Pseudomonas_sp._GR_6-02	1659194	S	136	347	483	0.00002
Pseudomonas_sp._HN2	2884805	S	134	117	251	0.00001
Pseudomonas_sp._09C_129	2054915	S	134	163	297	0.00001
Pseudomonas_sp._MPFS	2795724	S	134	229	363	0.00002
Pseudomonas_sp._RBPA9	2746321	S	133	280	413	0.00002
Pseudomonas_sp._S07E_245	2866278	S	133	328	461	0.00002
Pseudomonas_sp._ATCC_43928	676210	S	131	338	469	0.00002
Pseudomonas_sp._FDAARGOS_380	2018067	S	110	88	198	0.00001
Pseudomonas_sp._C27(2019)	2604941	S	109	15	124	0.00001
Pseudomonas_sp._AN-B15	2697023	S	108	315	423	0.00002
Pseudomonas_sp._LBUM920	2126069	S	107	280	387	0.00002
Pseudomonas_sp._SC3(2021)	2871493	S	107	114	221	0.00001
Pseudomonas_sp._PONIH3	1636610	S	105	589	694	0.00003
Pseudomonas_sp._ArH3a	2862945	S	104	272	376	0.00002
Pseudomonas_sp._A2	107445	S	101	547	648	0.00003
Pseudomonas_sp._J380	2605424	S	99	129	228	0.00001
Pseudomonas_sp._RU47	2005388	S	97	259	356	0.00002
Pseudomonas_sp._ADAK22	2730851	S	93	245	338	0.00001
Pseudomonas_sp._BIOMIG1BAC	1758730	S	92	293	385	0.00002
Pseudomonas_sp._S150	2559074	S	88	136	224	0.00001
Pseudomonas_sp._S49	1573720	S	88	238	326	0.00001
Pseudomonas_sp._St29	1500687	S	79	335	414	0.00002
Pseudomonas_sp._Y5-11	2749808	S	78	248	326	0.00001
Pseudomonas_sp._MYb193	1827300	S	77	84	161	0.00001
Pseudomonas_sp._BC42	2933816	S	74	382	456	0.00002
Pseudomonas_sp._A214	1855331	S	74	216	290	0.00001
Pseudomonas_sp._Os17	1500686	S	73	377	450	0.00002
Pseudomonas_sp._7-41	2898483	S	73	320	393	0.00002
Pseudomonas_sp._SWI36	2083052	S	63	177	240	0.00001
Pseudomonas_sp._Y39-6	2749807	S	63	202	265	0.00001
Pseudomonas_sp._LG1D9	2083054	S	61	236	297	0.00001
Pseudomonas_sp._CFA	2651048	S	60	288	348	0.00002
Pseudomonas_sp._DTU12.1	2654238	S	60	248	308	0.00001
Pseudomonas_sp._DR208	2870840	S	58	137	195	0.00001
Pseudomonas_sp._R32	1573704	S	57	144	201	0.00001
Pseudomonas_sp._SXM-1	2169583	S	57	170	227	0.00001
Pseudomonas_sp._R3-18-08	1173283	S	55	166	221	0.00001
Pseudomonas_sp._R1-43-08	1173270	S	54	330	384	0.00002
Pseudomonas_sp._MPDS	2762896	S	54	212	266	0.00001
Pseudomonas_sp._SWI44	2083053	S	54	472	526	0.00002
Pseudomonas_sp._CFSAN084952	2664899	S	54	158	212	0.00001
Pseudomonas_sp._XWY-1	2069256	S	53	308	361	0.00002
Pseudomonas_sp._R2-37-08W	1173273	S	53	259	312	0.00001
Pseudomonas_sp._BYT-1	2816906	S	51	430	481	0.00002
Pseudomonas_sp._LH1G9	2083055	S	48	163	211	0.00001
Pseudomonas_sp._TMW_2.1634	1886807	S	44	112	156	0.00001
Pseudomonas_sp._CIP-10	2892442	S	43	386	429	0.00002
Pseudomonas_sp._TKP	1415630	S	43	145	188	0.00001
Pseudomonas_sp._R4-34-07	658642	S	43	257	300	0.00001
Pseudomonas_sp._Colony2	2861799	S	41	169	210	0.00001
Pseudomonas_sp._NC02	2067572	S	41	131	172	0.00001
Pseudomonas_sp._IAC-BECa141	2793103	S	41	83	124	0.00001
Pseudomonas_sp._St290	1602166	S	41	156	197	0.00001
Pseudomonas_sp._I3-I5	2926671	S	41	158	199	0.00001
Pseudomonas_sp._HN8-3	2886361	S	36	70	106	0.00000
Pseudomonas_sp._B14-6	2738843	S	36	97	133	0.00001
Pseudomonas_sp._R4-39-08	1173288	S	35	213	248	0.00001
Pseudomonas_sp._SW-3	147212	S	34	126	160	0.00001
Pseudomonas_sp._R3-52-08	1173284	S	33	207	240	0.00001
Pseudomonas_sp._OST1909	2777367	S	33	100	133	0.00001
Pseudomonas_sp._BJP69	2597770	S	30	177	207	0.00001
Pseudomonas_sp._13159349	2662034	S	30	283	313	0.00001
Pseudomonas_sp._Eqa60	2799184	S	28	157	185	0.00001
Pseudomonas_sp._So3.2b	2864101	S	28	88	116	0.00001
Pseudomonas_sp._IB20	1702250	S	28	169	197	0.00001
Pseudomonas_sp._R4-35-07	658643	S	27	189	216	0.00001
Pseudomonas_sp._PS1(2021)	2866282	S	26	768	794	0.00003
Pseudomonas_sp._R11-23-07	658632	S	25	231	256	0.00001
Pseudomonas_sp._R2-60-08W	1173280	S	23	166	189	0.00001
Pseudomonas_sp._R2-7-07	658641	S	23	224	247	0.00001
Pseudomonas_sp._JY-Q	1338689	S	21	164	185	0.00001
Pseudomonas_sp._SWI6	2083051	S	20	345	365	0.00002
Pseudomonas_sp._SK2	2841063	S	19	357	376	0.00002
Pseudomonas_sp._JS425	2829498	S	18	610	628	0.00003
Pseudomonas_sp._VLB120	69328	S	18	259	277	0.00001
Pseudomonas_sp._St386	2678256	S	15	121	136	0.00001
Pseudomonas_sp._LTGT-11-2Z	2479393	S	15	411	426	0.00002
Pseudomonas_sp._bs2935	1761895	S	14	419	433	0.00002
Pseudomonas_sp._SWI7	2587597	S	14	87	101	0.00000
Pseudomonas_sp._FDAARGOS_761	2545800	S	10	194	204	0.00001
Pseudomonas_alcaligenes	43263	S	10904	6956	17860	0.00077
Pseudomonas_aeruginosa	287	S	8687	86252	94939	0.00411
Pseudomonas_mendocina	300	S	3855	1301	5156	0.00022
Pseudomonas_furukawaii	1149133	S	2734	782	3516	0.00015
Pseudomonas_oleovorans	301	S	430	1225	1655	0.00007
Pseudomonas_resinovorans	53412	S	1939	398	2337	0.00010
Pseudomonas_multiresinivorans	95301	S	1037	338	1375	0.00006
Pseudomonas_nitroreducens	46680	S	276	568	844	0.00004
Pseudomonas_citronellolis	53408	S	1050	1443	2493	0.00011
Pseudomonas_fluorescens	294	S	8803	6711	15514	0.00067
Pseudomonas_protegens	380021	S	2222	8084	10306	0.00045
Pseudomonas_orientalis	76758	S	1447	367	1814	0.00008
Pseudomonas_azotoformans	47878	S	1170	427	1597	0.00007
Pseudomonas_synxantha	47883	S	1031	660	1691	0.00007
Pseudomonas_rhodesiae	76760	S	890	332	1222	0.00005
Pseudomonas_poae	200451	S	712	352	1064	0.00005
Pseudomonas_mediterranea	183795	S	681	161	842	0.00004
Pseudomonas_tolaasii	29442	S	616	108	724	0.00003
Pseudomonas_trivialis	200450	S	611	202	813	0.00004
Pseudomonas_corrugata	47879	S	584	118	702	0.00003
Pseudomonas_migulae	78543	S	523	266	789	0.00003
Pseudomonas_mucidolens	46679	S	479	65	544	0.00002
Pseudomonas_cedrina	651740	S	418	101	519	0.00002
Pseudomonas_brenneri	129817	S	341	121	462	0.00002
Pseudomonas_congelans	200452	S	330	92	422	0.00002
Pseudomonas_ogarae	1114970	S	267	183	450	0.00002
Pseudomonas_libanensis	75588	S	216	222	438	0.00002
Pseudomonas_veronii	76761	S	193	474	667	0.00003
Pseudomonas_mandelii	75612	S	183	437	620	0.00003
Pseudomonas_extremorientalis	169669	S	67	147	214	0.00001
Pseudomonas_putida	303	S	11758	14465	26223	0.00113
Pseudomonas_oryzihabitans	47885	S	3250	658	3908	0.00017
Pseudomonas_fulva	47880	S	2141	5325	7466	0.00032
Pseudomonas_plecoglossicida	70775	S	722	545	1267	0.00005
Pseudomonas_mosselii	78327	S	373	680	1053	0.00005
Pseudomonas_monteilii	76759	S	355	642	997	0.00004
Pseudomonas_sp._SGAir0191	2217867	S	175	103	278	0.00001
Pseudomonas_shirazica	1940636	S	21	264	285	0.00001
Pseudomonas_stutzeri	316	S	13721	8456	22177	0.00096
Pseudomonas_chloritidismutans	203192	S	138	186	324	0.00001
Pseudomonas_balearica	74829	S	2357	2825	5182	0.00022
Pseudomonas_xanthomarina	271420	S	643	99	742	0.00003
Pseudomonas_luteola	47886	S	201	88	289	0.00001
Pseudomonas_syringae	317	S	2691	10892	13583	0.00059
Pseudomonas_viridiflava	33069	S	1738	194	1932	0.00008
Pseudomonas_cichorii	36746	S	872	75	947	0.00004
Pseudomonas_asturiensis	1190415	S	630	62	692	0.00003
Pseudomonas_amygdali	47877	S	271	1184	1455	0.00006
Pseudomonas_savastanoi	29438	S	98	431	529	0.00002
Pseudomonas_syringae_group_genomosp._7	251699	S	477	52	529	0.00002
Pseudomonas_fuscovaginae	50340	S	276	148	424	0.00002
Pseudomonas_avellanae	46257	S	153	201	354	0.00002
Pseudomonas_coronafaciens	53409	S	90	222	312	0.00001
Pseudomonas_syringae_group_genomosp._3	251701	S	80	865	945	0.00004
Pseudomonas_tremae	200454	S	46	93	139	0.00001
Pseudomonas_sp._Lz4W	1206777	S	31	50	81	0.00000
Pseudomonas_chlororaphis	587753	S	5127	5182	10309	0.00045
Pseudomonas_lundensis	86185	S	501	60	561	0.00002
Pseudomonas_fragi	296	S	320	240	560	0.00002
Pseudomonas_otitidis	319939	S	3363	733	4096	0.00018
Pseudomonas_psychrotolerans	237610	S	3245	679	3924	0.00017
Pseudomonas_knackmussii	65741	S	3199	2642	5841	0.00025
Pseudomonas_oryzae	1392877	S	3116	989	4105	0.00018
Pseudomonas_campi	2731681	S	2347	317	2664	0.00012
Pseudomonas_entomophila	312306	S	2254	907	3161	0.00014
Pseudomonas_cavernae	2320867	S	2107	328	2435	0.00011
Pseudomonas_guangdongensis	1245526	S	1871	603	2474	0.00011
Pseudomonas_lalkuanensis	2604832	S	1807	326	2133	0.00009
Pseudomonas_lini	163011	S	1553	283	1836	0.00008
Pseudomonas_parafulva	157782	S	1322	355	1677	0.00007
Pseudomonas_vanderleydeniana	2745495	S	1267	168	1435	0.00006
Pseudomonas_qingdaonensis	2056231	S	1240	243	1483	0.00006
Pseudomonas_eucalypticola	2599595	S	1209	149	1358	0.00006
Pseudomonas_nanhaiensis	2830842	S	1134	128	1262	0.00005
Pseudomonas_frederiksbergensis	104087	S	1099	300	1399	0.00006
Pseudomonas_rhizosphaerae	216142	S	1093	129	1222	0.00005
Pseudomonas_alvandae	2842348	S	1068	157	1225	0.00005
Pseudomonas_cremoricolorata	157783	S	970	141	1111	0.00005
Pseudomonas_brassicacearum	930166	S	937	1560	2497	0.00011
Pseudomonas_argentinensis	289370	S	900	194	1094	0.00005
Pseudomonas_yamanorum	515393	S	890	182	1072	0.00005
Pseudomonas_tohonis	2725477	S	884	671	1555	0.00007
Pseudomonas_pohangensis	364197	S	826	59	885	0.00004
Pseudomonas_umsongensis	198618	S	824	123	947	0.00004
Pseudomonas_alkylphenolica	237609	S	822	154	976	0.00004
Pseudomonas_muyukensis	2842357	S	812	225	1037	0.00004
Pseudomonas_phragmitis	1931241	S	801	63	864	0.00004
Pseudomonas_zhaodongensis	1176257	S	771	327	1098	0.00005
Pseudomonas_saudiphocaensis	1499686	S	747	157	904	0.00004
Pseudomonas_tructae	2518644	S	699	115	814	0.00004
Pseudomonas_palleroniana	191390	S	672	100	772	0.00003
Pseudomonas_xantholysinigenes	2745490	S	663	170	833	0.00004
Pseudomonas_vancouverensis	95300	S	662	98	760	0.00003
Pseudomonas_xanthosomae	2842356	S	624	185	809	0.00004
Pseudomonas_silesiensis	1853130	S	618	121	739	0.00003
Pseudomonas_koreensis	198620	S	616	219	835	0.00004
Pseudomonas_fakonensis	2842355	S	599	175	774	0.00003
Pseudomonas_agarici	46677	S	576	26	602	0.00003
Pseudomonas_arsenicoxydans	702115	S	574	112	686	0.00003
Pseudomonas_thivervalensis	86265	S	559	108	667	0.00003
Pseudomonas_antarctica	219572	S	554	127	681	0.00003
Pseudomonas_prosekii	1148509	S	539	83	622	0.00003
Pseudomonas_sediminis	1691904	S	536	143	679	0.00003
Pseudomonas_extremaustralis	359110	S	527	107	634	0.00003
Pseudomonas_hamedanensis	2745504	S	522	87	609	0.00003
Pseudomonas_marincola	437900	S	521	78	599	0.00003
Pseudomonas_graminis	158627	S	512	130	642	0.00003
Pseudomonas_lurida	244566	S	495	102	597	0.00003
Pseudomonas_promysalinigenes	485898	S	477	70	547	0.00002
Pseudomonas_maumuensis	2842354	S	467	207	674	0.00003
Pseudomonas_granadensis	1421430	S	455	197	652	0.00003
Pseudomonas_asgharzadehiana	2842349	S	445	96	541	0.00002
Pseudomonas_wenzhouensis	2906062	S	440	157	597	0.00003
Pseudomonas_taetrolens	47884	S	423	51	474	0.00002
Pseudomonas_viciae	2505979	S	409	91	500	0.00002
Pseudomonas_simiae	321846	S	409	93	502	0.00002
Pseudomonas_versuta	1788301	S	348	52	400	0.00002
Pseudomonas_atacamensis	2565368	S	338	298	636	0.00003
Pseudomonas_psychrophila	122355	S	338	44	382	0.00002
Pseudomonas_reinekei	395598	S	330	86	416	0.00002
Pseudomonas_allokribbensis	2774460	S	321	114	435	0.00002
Pseudomonas_oryziphila	2894079	S	297	215	512	0.00002
Pseudomonas_asplenii	53407	S	275	154	429	0.00002
Pseudomonas_toyotomiensis	554344	S	263	221	484	0.00002
Pseudomonas_moraviensis	321662	S	258	399	657	0.00003
Pseudomonas_kribbensis	1628086	S	255	221	476	0.00002
Pseudomonas_khazarica	2502979	S	243	272	515	0.00002
Pseudomonas_alcaliphila	101564	S	236	240	476	0.00002
Pseudomonas_tritici	2745518	S	230	66	296	0.00001
Pseudomonas_gozinkensis	2774461	S	224	95	319	0.00001
Pseudomonas_anuradhapurensis	485870	S	215	175	390	0.00002
Pseudomonas_kunmingensis	1211807	S	211	285	496	0.00002
Pseudomonas_sihuiensis	1274359	S	208	254	462	0.00002
Pseudomonas_iranensis	2745503	S	204	140	344	0.00001
Pseudomonas_chengduensis	489632	S	204	387	591	0.00003
Pseudomonas_azerbaijanoriens	2842350	S	198	120	318	0.00001
Pseudomonas_tensinigenes	2745511	S	192	95	287	0.00001
Pseudomonas_germanica	2815720	S	165	81	246	0.00001
Pseudomonas_zarinae	2745498	S	164	111	275	0.00001
Pseudomonas_zeae	2745510	S	159	72	231	0.00001
Pseudomonas_salmasensis	2745514	S	124	73	197	0.00001
Pseudomonas_monsensis	2745509	S	118	115	233	0.00001
Pseudomonas_lactis	1615674	S	111	74	185	0.00001
Pseudomonas_juntendi	2666183	S	110	941	1051	0.00005
Pseudomonas_donghuensis	1163398	S	91	230	321	0.00001
Pseudomonas_soli	1306993	S	82	294	376	0.00002
Pseudomonas_rhizophila	2045200	S	78	183	261	0.00001
Pseudomonas_glycinae	1785145	S	74	119	193	0.00001
Pseudomonas_asiatica	2219225	S	63	318	381	0.00002
Pseudomonas_sessilinigenes	658629	S	60	138	198	0.00001
Pseudomonas_bijieensis	2681983	S	52	176	228	0.00001
Pseudomonas_cerasi	1583341	S	45	85	130	0.00001
Pseudomonas_shahriarae	2745512	S	32	112	144	0.00001
Pseudomonas_taiwanensis	470150	S	21	238	259	0.00001
Candidatus_Pseudomonas_adelgestsugas	1302376	S	15	0	15	0.00000
Azotobacter_chroococcum	353	S	2931	1671	4602	0.00020
Azotobacter_vinelandii	354	S	1843	1540	3383	0.00015
Azotobacter_salinestris	69964	S	1748	803	2551	0.00011
Halopseudomonas_xinjiangensis	487184	S	839	84	923	0.00004
Halopseudomonas_sabulinigri	472181	S	752	65	817	0.00004
Halopseudomonas_sp._RR6	2918528	S	749	107	856	0.00004
Halopseudomonas_aestusnigri	857252	S	644	429	1073	0.00005
Halopseudomonas_litoralis	797277	S	581	142	723	0.00003
Halopseudomonas_salegens	1434072	S	516	38	554	0.00002
Permianibacter_aggregans	1510150	S	916	27	943	0.00004
Thiopseudomonas_alkaliphila	1697053	S	82	17	99	0.00000
Entomomonas_moraniae	2213226	S	27	3	30	0.00000
Entomomonas_sp._F2A	2785331	S	24	2	26	0.00000
Marinobacter_sp._CA1	2817656	S	877	66	943	0.00004
Marinobacter_sp._Arc7-DN-1	2304594	S	583	79	662	0.00003
Marinobacter_sp._LPB0319	2769486	S	531	34	565	0.00002
Marinobacter_sp._NP-4(2019)	2488665	S	522	95	617	0.00003
Marinobacter_sp._LV10R510-11A	1415568	S	296	13	309	0.00001
Marinobacter_sp._LQ44	1749259	S	258	390	648	0.00003
Marinobacter_sp._es.042	1761794	S	220	200	420	0.00002
Marinobacter_sp._CP1	1671721	S	212	382	594	0.00003
Marinobacter_sp._JH2	2547598	S	194	54	248	0.00001
Marinobacter_sp._BSs20148	490759	S	128	69	197	0.00001
Marinobacter_fonticola	2603215	S	821	41	862	0.00004
Marinobacter_salarius	1420917	S	686	86	772	0.00003
Marinobacter_nauticus	2743	S	558	172	730	0.00003
Marinobacter_salinus	1874317	S	487	31	518	0.00002
Marinobacter_similis	1420916	S	464	39	503	0.00002
Marinobacter_salsuginis	418719	S	392	51	443	0.00002
Marinobacter_adhaerens	1033846	S	154	286	440	0.00002
Marinobacter_psychrophilus	330734	S	90	49	139	0.00001
Klebsiella_pneumoniae	573	S	1171	59180	60351	0.00261
Klebsiella_quasipneumoniae	1463165	S	800	3032	3832	0.00017
Klebsiella_aerogenes	548	S	545	314	859	0.00004
Klebsiella_oxytoca	571	S	522	356	878	0.00004
Klebsiella_sp._A52	2834819	S	19	414	433	0.00002
Klebsiella_variicola	244366	S	369	1353	1722	0.00007
Klebsiella_michiganensis	1134687	S	334	1775	2109	0.00009
Klebsiella_quasivariicola	2026240	S	134	145	279	0.00001
Klebsiella_africana	2489010	S	128	78	206	0.00001
Klebsiella_huaxiensis	2153354	S	112	107	219	0.00001
Klebsiella_grimontii	2058152	S	81	557	638	0.00003
Raoultella_sp._HC6	2923366	S	330	228	558	0.00002
Raoultella_planticola	575	S	236	246	482	0.00002
Raoultella_ornithinolytica	54291	S	195	1491	1686	0.00007
Raoultella_terrigena	577	S	128	260	388	0.00002
Raoultella_electrica	1259973	S	105	271	376	0.00002
Enterobacter_cloacae	550	S	1306	2153	3459	0.00015
Enterobacter_hormaechei	158836	S	449	7154	7603	0.00033
Enterobacter_cancerogenus	69218	S	371	132	503	0.00002
Enterobacter_asburiae	61645	S	349	1669	2018	0.00009
Enterobacter_roggenkampii	1812935	S	264	1117	1381	0.00006
Enterobacter_ludwigii	299767	S	159	398	557	0.00002
Enterobacter_chengduensis	2494701	S	158	113	271	0.00001
Enterobacter_cloacae_complex_sp.	2027919	S	42	1110	1152	0.00005
Enterobacter_sp._BIDMC_29	1329841	S	39	139	178	0.00001
Enterobacter_cloacae_complex_sp._ECNIH7	1915310	S	13	102	115	0.00000
Enterobacter_sp._BIDMC100	1686399	S	10	114	124	0.00001
Enterobacter_chuandaensis	2497875	S	117	80	197	0.00001
Enterobacter_kobei	208224	S	90	1063	1153	0.00005
Enterobacter_sichuanensis	2071710	S	73	70	143	0.00001
Enterobacter_sp._JUb54	2724468	S	345	74	419	0.00002
Enterobacter_sp._SA187	1914861	S	320	60	380	0.00002
Enterobacter_sp._E76	2596949	S	134	284	418	0.00002
Enterobacter_sp._RHBSTW-00994	2742676	S	120	31	151	0.00001
Enterobacter_sp._RHBSTW-00175	2742639	S	89	87	176	0.00001
Enterobacter_sp._Colony194	2866201	S	83	124	207	0.00001
Enterobacter_sp._JBIWA008	2831892	S	59	40	99	0.00000
Enterobacter_sp._JBIWA003	2831890	S	58	83	141	0.00001
Enterobacter_sp._SGAir0187	2836161	S	36	46	82	0.00000
Enterobacter_sp._JBIWA005	2831891	S	36	76	112	0.00000
Enterobacter_sp._18A13	2565914	S	25	119	144	0.00001
Enterobacter_sp._SES19	2705458	S	21	22	43	0.00000
Enterobacter_sp._E20	1560339	S	15	139	154	0.00001
Enterobacter_sp._N18-03635	2500132	S	14	39	53	0.00000
Enterobacter_sp._DNB-S2	2720029	S	10	48	58	0.00000
Enterobacter_huaxiensis	2494702	S	229	72	301	0.00001
Enterobacter_mori	539813	S	183	248	431	0.00002
Enterobacter_oligotrophicus	2478464	S	132	42	174	0.00001
Enterobacter_bugandensis	881260	S	129	243	372	0.00002
Enterobacter_soli	885040	S	84	23	107	0.00000
Citrobacter_freundii	546	S	367	1797	2164	0.00009
Citrobacter_werkmanii	67827	S	66	180	246	0.00001
Citrobacter_sedlakii	67826	S	56	179	235	0.00001
Citrobacter_braakii	57706	S	54	488	542	0.00002
Citrobacter_freundii_complex_sp._CFNIH2	2066049	S	35	45	80	0.00000
Citrobacter_portucalensis	1639133	S	39	443	482	0.00002
Citrobacter_youngae	133448	S	11	40	51	0.00000
Citrobacter_sp._RHB25-C09	2742624	S	153	47	200	0.00001
Citrobacter_sp._R56	1573676	S	152	50	202	0.00001
Citrobacter_sp._BDA59-3	2781952	S	48	24	72	0.00000
Citrobacter_sp._MGH_55	1439319	S	19	107	126	0.00001
Citrobacter_rodentium	67825	S	315	0	315	0.00001
Citrobacter_amalonaticus	35703	S	214	1167	1381	0.00006
Citrobacter_farmeri	67824	S	201	106	307	0.00001
Citrobacter_koseri	545	S	120	183	303	0.00001
Citrobacter_tructae	2562449	S	85	41	126	0.00001
Citrobacter_pasteurii	1563222	S	69	65	134	0.00001
Citrobacter_arsenatis	2546350	S	53	21	74	0.00000
Citrobacter_cronae	1748967	S	21	190	211	0.00001
Cronobacter_dublinensis	413497	S	474	183	657	0.00003
Cronobacter_sakazakii	28141	S	469	481	950	0.00004
Cronobacter_universalis	535744	S	243	185	428	0.00002
Cronobacter_condimenti	1163710	S	236	71	307	0.00001
Cronobacter_malonaticus	413503	S	138	167	305	0.00001
Cronobacter_sp._JZ38	1906275	S	49	157	206	0.00001
Cronobacter_muytjensii	413501	S	38	156	194	0.00001
Leclercia_adecarboxylata	83655	S	636	1123	1759	0.00008
Leclercia_sp._29361	2714951	S	243	98	341	0.00001
Leclercia_sp._J807	2681307	S	60	90	150	0.00001
Leclercia_sp._G3L	2898725	S	43	219	262	0.00001
Leclercia_sp._W17	2282309	S	42	118	160	0.00001
Leclercia_sp._W6	2282310	S	34	64	98	0.00000
Leclercia_sp._119287	2681308	S	28	84	112	0.00000
Leclercia_sp._Colony189	2681309	S	13	225	238	0.00001
Leclercia_sp._LSNIH1	1920114	S	10	138	148	0.00001
Leclercia_pneumoniae	2815358	S	185	88	273	0.00001
Kosakonia_sp._SMBL-WEM22	2725560	S	146	74	220	0.00001
Kosakonia_sp._CCTCC_M2018092	2492396	S	106	117	223	0.00001
Kosakonia_sp._MUSA4	2067958	S	99	58	157	0.00001
Kosakonia_cowanii	208223	S	338	294	632	0.00003
Kosakonia_sacchari	1158459	S	309	155	464	0.00002
Kosakonia_radicincitans	283686	S	144	135	279	0.00001
Kosakonia_arachidis	551989	S	127	37	164	0.00001
Kosakonia_pseudosacchari	1646340	S	121	70	191	0.00001
Kosakonia_oryzae	497725	S	104	82	186	0.00001
Salmonella_enterica	28901	S	1303	79707	81010	0.00351
Salmonella_bongori	54736	S	143	53	196	0.00001
Pluralibacter_gergoviae	61647	S	1109	288	1397	0.00006
[Enterobacter]_lignolyticus	1334193	S	621	163	784	0.00003
Cedecea_neteri	158822	S	877	179	1056	0.00005
Cedecea_lapagei	158823	S	260	66	326	0.00001
Cedecea_sp._FDAARGOS_727	2545798	S	198	40	238	0.00001
Escherichia_coli	562	S	850	15541	16391	0.00071
Escherichia_albertii	208962	S	160	138	298	0.00001
Escherichia_fergusonii	564	S	100	163	263	0.00001
Escherichia_marmotae	1499973	S	75	44	119	0.00001
Escherichia_sp._E4742	2044467	S	48	33	81	0.00000
Lelliottia_amnigena	61646	S	530	147	677	0.00003
Lelliottia_sp._WB101	2153385	S	79	114	193	0.00001
Lelliottia_sp._AC1	2067959	S	69	87	156	0.00001
Kluyvera_ascorbata	51288	S	257	208	465	0.00002
Kluyvera_intermedia	61648	S	176	131	307	0.00001
Kluyvera_sp._CRP	2873269	S	26	69	95	0.00000
Kluyvera_genomosp._3	2774055	S	24	59	83	0.00000
Candidatus_Symbiopectobacterium_sp._SyEd1	2871826	S	204	25	229	0.00001
Blochmannia_endosymbiont_of_Colobopsis_nipponica	2681987	S	23	23	46	0.00000
Candidatus_Hamiltonella_defensa	138072	S	44	7	51	0.00000
secondary_endosymbiont_of_Ctenarytaina_eucalypti	1199245	S	35	1	36	0.00000
Candidatus_Doolittlea_endobia	1778262	S	29	1	30	0.00000
Candidatus_Mikella_endobia	1778264	S	21	2	23	0.00000
Candidatus_Hoaglandella_endobia	1778263	S	13	0	13	0.00000
Candidatus_Tachikawaea_gelatinosa	1410383	S	11	2	13	0.00000
Jejubacter_calystegiae	2579935	S	383	42	425	0.00002
Plesiomonas_shigelloides	703	S	359	115	474	0.00002
Pseudescherichia_vulneris	566	S	357	22	379	0.00002
Buttiauxella_agrestis	82977	S	127	24	151	0.00001
Buttiauxella_ferragutiae	82989	S	36	101	137	0.00001
Buttiauxella_sp._3AFRM03	2479367	S	17	43	60	0.00000
Atlantibacter_hermannii	565	S	307	66	373	0.00002
Yokenella_regensburgei	158877	S	282	121	403	0.00002
Shimwellia_blattae	563	S	257	52	309	0.00001
Scandinavium_goeteborgense	1851514	S	214	40	254	0.00001
Pseudocitrobacter_sp._G163CM	2891570	S	186	47	233	0.00001
Phytobacter_ursingii	1972431	S	144	189	333	0.00001
Phytobacter_diazotrophicus	395631	S	14	94	108	0.00000
Phytobacter_sp._SCO41	1756993	S	10	16	26	0.00000
Shigella_flexneri	623	S	26	1585	1611	0.00007
Shigella_boydii	621	S	19	337	356	0.00002
Candidatus_Moranella_endobia	1048758	S	44	0	44	0.00000
Candidatus_Ishikawaella_capsulata	168169	S	17	1	18	0.00000
Serratia_marcescens	615	S	2188	5077	7265	0.00031
Serratia_plymuthica	82996	S	880	477	1357	0.00006
Serratia_sp._ATCC_39006	104623	S	138	15	153	0.00001
Serratia_sp._FDAARGOS_506	2420306	S	133	136	269	0.00001
Serratia_sp._FGI94	671990	S	120	137	257	0.00001
Serratia_sp._3ACOL1	2448483	S	47	72	119	0.00001
Serratia_sp._1D1416	2447890	S	44	156	200	0.00001
Serratia_sp._MYb239	2033438	S	34	312	346	0.00001
Serratia_sp._FS14	1327989	S	28	146	174	0.00001
Serratia_sp._P2ACOL2	2482769	S	22	72	94	0.00000
Serratia_sp._JUb9	2724469	S	20	173	193	0.00001
Serratia_sp._SCBI	488142	S	15	140	155	0.00001
Serratia_sp._Tan611	2773264	S	15	107	122	0.00001
Serratia_entomophila	42906	S	553	143	696	0.00003
Serratia_rubidaea	61652	S	538	648	1186	0.00005
Serratia_odorifera	618	S	478	82	560	0.00002
Serratia_proteamaculans	28151	S	335	81	416	0.00002
Serratia_fonticola	47917	S	266	248	514	0.00002
Serratia_surfactantfaciens	2741499	S	248	151	399	0.00002
Serratia_liquefaciens	614	S	203	297	500	0.00002
Serratia_quinivorans	137545	S	181	71	252	0.00001
Serratia_symbiotica	138074	S	157	25	182	0.00001
Serratia_inhibens	2338073	S	150	86	236	0.00001
Serratia_grimesii	82995	S	127	15	142	0.00001
Serratia_rhizosphaerae	2597702	S	115	114	229	0.00001
Serratia_ureilytica	300181	S	72	1001	1073	0.00005
Serratia_ficaria	61651	S	37	179	216	0.00001
Serratia_nematodiphila	458197	S	23	241	264	0.00001
Rahnella_aquatilis	34038	S	330	452	782	0.00003
Rahnella_victoriana	1510570	S	250	38	288	0.00001
Rahnella_inusitata	58169	S	229	62	291	0.00001
Rahnella_sp._ERMR1:05	1805933	S	206	30	236	0.00001
Rahnella_aceris	2703885	S	51	103	154	0.00001
Yersinia_pseudotuberculosis	633	S	42	78	120	0.00001
Yersinia_similis	367190	S	29	5	34	0.00000
Yersinia_pestis	632	S	23	2253	2276	0.00010
Yersinia_enterocolitica	630	S	119	128	247	0.00001
Yersinia_ruckeri	29486	S	93	17	110	0.00000
Yersinia_entomophaga	935293	S	83	14	97	0.00000
Yersinia_aldovae	29483	S	66	13	79	0.00000
Yersinia_mollaretii	33060	S	57	12	69	0.00000
Yersinia_aleksiciae	263819	S	53	13	66	0.00000
Yersinia_frederiksenii	29484	S	44	36	80	0.00000
Yersinia_kristensenii	28152	S	43	109	152	0.00001
Yersinia_rohdei	29485	S	41	7	48	0.00000
Yersinia_canariae	2607663	S	38	13	51	0.00000
Yersinia_intermedia	631	S	34	99	133	0.00001
Yersinia_hibernica	2339259	S	13	19	32	0.00000
Yersinia_massiliensis	419257	S	12	34	46	0.00000
Nissabacter_sp._SGAir0207	2126321	S	930	140	1070	0.00005
Gibbsiella_quercinecans	929813	S	538	74	612	0.00003
Ewingella_americana	41202	S	297	42	339	0.00001
Rouxiella_badensis	1646377	S	275	25	300	0.00001
Chania_multitudinisentens	1639108	S	149	17	166	0.00001
Candidatus_Fukatsuia_symbiotica	1878942	S	70	4	74	0.00000
Pantoea_sp._Z09	2886821	S	734	232	966	0.00004
Pantoea_sp._SO10	2575375	S	337	64	401	0.00002
Pantoea_sp._At-9b	592316	S	259	48	307	0.00001
Pantoea_sp._CCBC3-3-1	2490851	S	256	48	304	0.00001
Pantoea_sp._MSR2	2052056	S	242	24	266	0.00001
Pantoea_sp._SM3640	2787629	S	18	126	144	0.00001
Pantoea_sp._MT58	2768165	S	12	91	103	0.00000
Pantoea_agglomerans	549	S	1704	524	2228	0.00010
Pantoea_dispersa	59814	S	1225	319	1544	0.00007
Pantoea_vagans	470934	S	457	701	1158	0.00005
Pantoea_ananatis	553	S	438	112	550	0.00002
Pantoea_deleyi	470932	S	425	99	524	0.00002
Pantoea_alhagi	1891675	S	253	76	329	0.00001
Pantoea_cypripedii	55209	S	248	14	262	0.00001
Pantoea_stewartii	66269	S	243	60	303	0.00001
Pantoea_rwandensis	1076550	S	182	39	221	0.00001
Candidatus_Pantoea_carbekii	1235990	S	25	2	27	0.00000
Pantoea_eucalypti	470933	S	13	90	103	0.00000
Erwinia_sp._E602	2675378	S	761	134	895	0.00004
Erwinia_sp._J780	2681984	S	186	34	220	0.00001
Erwinia_sp._QL-Z3	2547962	S	39	99	138	0.00001
Erwinia_sp._Ejp617	215689	S	22	33	55	0.00000
Erwinia_gerundensis	1619313	S	357	66	423	0.00002
Erwinia_persicina	55211	S	321	64	385	0.00002
Erwinia_rhapontici	55212	S	305	56	361	0.00002
Erwinia_tasmaniensis	338565	S	195	39	234	0.00001
Erwinia_billingiae	182337	S	192	335	527	0.00002
Erwinia_amylovora	552	S	173	74	247	0.00001
Erwinia_tracheiphila	65700	S	143	18	161	0.00001
Candidatus_Erwinia_haradaeae	1922217	S	95	2	97	0.00000
[Pantoea]_beijingensis	1324864	S	87	16	103	0.00000
Erwinia_pyrifoliae	79967	S	55	80	135	0.00001
Mixta_gaviniae	665914	S	596	228	824	0.00004
Mixta_theicola	1458355	S	415	135	550	0.00002
Mixta_calida	665913	S	405	219	624	0.00003
Mixta_intestinalis	1615494	S	219	63	282	0.00001
Mixta_sp._X22927	2872648	S	206	106	312	0.00001
Buchnera_aphidicola	9	S	268	33	301	0.00001
Tatumella_ptyseos	82987	S	105	18	123	0.00001
Tatumella_citrea	53336	S	67	10	77	0.00000
Wigglesworthia_glossinidia	51229	S	20	2	22	0.00000
Dickeya_dadantii	204038	S	550	160	710	0.00003
Dickeya_chrysanthemi	556	S	444	36	480	0.00002
Dickeya_zeae	204042	S	392	155	547	0.00002
Dickeya_dianthicola	204039	S	326	77	403	0.00002
Dickeya_fangzhongdai	1778540	S	208	250	458	0.00002
Dickeya_sp._NCPPB_3274	568766	S	139	22	161	0.00001
Dickeya_sp._Secpp_1600	2037915	S	11	30	41	0.00000
Dickeya_poaceiphila	568768	S	142	15	157	0.00001
Dickeya_solani	1089444	S	131	6407	6538	0.00028
Dickeya_oryzae	1240404	S	23	10	33	0.00000
Dickeya_parazeae	2893572	S	14	15	29	0.00000
Pectobacterium_carotovorum	554	S	268	564	832	0.00004
Pectobacterium_brasiliense	180957	S	194	225	419	0.00002
Pectobacterium_sp._LJ1	2878098	S	99	27	126	0.00001
Pectobacterium_sp._PL64	2738983	S	49	34	83	0.00000
Pectobacterium_atrosepticum	29471	S	137	41	178	0.00001
Pectobacterium_parmentieri	1905730	S	112	33	145	0.00001
Pectobacterium_polaris	2042057	S	106	75	181	0.00001
Pectobacterium_punjabense	2108399	S	99	23	122	0.00001
Pectobacterium_versatile	2488639	S	67	150	217	0.00001
Pectobacterium_wasabiae	55208	S	60	17	77	0.00000
Pectobacterium_odoriferum	78398	S	45	33	78	0.00000
Pectobacterium_aroidearum	1201031	S	36	55	91	0.00000
Pectobacterium_quasiaquaticum	2774015	S	34	32	66	0.00000
Pectobacterium_parvum	2778550	S	20	28	48	0.00000
Pectobacterium_aquaticum	2204145	S	10	12	22	0.00000
Brenneria_izadpanahii	2722756	S	383	400	783	0.00003
Brenneria_goodwinii	1109412	S	260	263	523	0.00002
Brenneria_rubrifaciens	55213	S	231	85	316	0.00001
Lonsdalea_populi	1172565	S	346	86	432	0.00002
Lonsdalea_britannica	1082704	S	288	69	357	0.00002
Musicola_paradisiaca	69223	S	436	0	436	0.00002
Edwardsiella_tarda	636	S	603	1023	1626	0.00007
Edwardsiella_hoshinae	93378	S	321	69	390	0.00002
Edwardsiella_ictaluri	67780	S	217	109	326	0.00001
Edwardsiella_piscicida	1263550	S	64	567	631	0.00003
Edwardsiella_sp._EA181011	1578828	S	18	171	189	0.00001
Hafnia_alvei	569	S	130	169	299	0.00001
Hafnia_paralvei	546367	S	55	23	78	0.00000
Obesumbacterium_proteus	82983	S	48	43	91	0.00000
Morganella_morganii	582	S	637	449	1086	0.00005
Providencia_rettgeri	587	S	152	277	429	0.00002
Providencia_alcalifaciens	126385	S	92	41	133	0.00001
Providencia_heimbachae	333962	S	32	13	45	0.00000
Providencia_sp._R33	2828763	S	30	6	36	0.00000
Providencia_rustigianii	158850	S	25	9	34	0.00000
Providencia_sneebia	516075	S	17	1	18	0.00000
Xenorhabdus_doucetiae	351671	S	81	13	94	0.00000
Xenorhabdus_bovienii	40576	S	75	20	95	0.00000
Xenorhabdus_hominickii	351679	S	64	11	75	0.00000
Xenorhabdus_nematophila	628	S	48	9	57	0.00000
Xenorhabdus_poinarii	40577	S	44	9	53	0.00000
Xenorhabdus_budapestensis	290110	S	40	5	45	0.00000
Proteus_mirabilis	584	S	108	183	291	0.00001
Proteus_vulgaris	585	S	40	114	154	0.00001
Proteus_penneri	102862	S	13	16	29	0.00000
Proteus_hauseri	183417	S	12	2	14	0.00000
Photorhabdus_thracensis	230089	S	84	15	99	0.00000
Photorhabdus_akhurstii	171438	S	65	12	77	0.00000
Photorhabdus_laumondii	2218628	S	46	9	55	0.00000
Photorhabdus_asymbiotica	291112	S	37	4	41	0.00000
Arsenophonus_endosymbiont_of_Aphis_craccivora	1231049	S	20	6	26	0.00000
Arsenophonus_endosymbiont_of_Apis_mellifera	1541805	S	18	6	24	0.00000
Arsenophonus_endosymbiont_of_Aleurodicus_dispersus	235559	S	12	0	12	0.00000
Arsenophonus_nasoniae	638	S	21	7	28	0.00000
Moellerella_wisconsensis	158849	S	25	21	46	0.00000
Sodalis_sp._dw_23	2697027	S	623	41	664	0.00003
Sodalis_endosymbiont_of_Henestaris_halophilus	1929246	S	20	0	20	0.00000
Sodalis_glossinidius	63612	S	355	50	405	0.00002
Sodalis_praecaptivus	1239307	S	317	213	530	0.00002
Candidatus_Sodalis_pierantonius	1486991	S	129	92	221	0.00001
Leminorella_richardii	158841	S	209	28	237	0.00001
Pragia_fontium	82985	S	68	9	77	0.00000
Jinshanibacter_zhutongyuii	2498113	S	51	8	59	0.00000
Limnobaculum_parvum	2172103	S	24	4	28	0.00000
Thioalkalivibrio_sulfidiphilus	1033854	S	2783	1650	4433	0.00019
Thioalkalivibrio_paradoxus	108010	S	2697	816	3513	0.00015
Thioalkalivibrio_nitratireducens	186931	S	2353	646	2999	0.00013
Thioalkalivibrio_versutus	106634	S	1960	266	2226	0.00010
Thioalkalivibrio_sp._K90mix	396595	S	1921	250	2171	0.00009
Spiribacter_sp._E85	2182432	S	5723	562	6285	0.00027
Spiribacter_sp._2438	2666185	S	1098	106	1204	0.00005
Spiribacter_curvatus	1335757	S	1271	72	1343	0.00006
Spiribacter_salinus	1335746	S	799	60	859	0.00004
Acidihalobacter_aeolianus	2792603	S	2340	332	2672	0.00012
Acidihalobacter_ferrooxydans	1765967	S	1792	190	1982	0.00009
Acidihalobacter_yilgarnensis	2819280	S	1309	90	1399	0.00006
Halorhodospira_halophila	1053	S	2574	317	2891	0.00013
Halorhodospira_halochloris	1052	S	437	21	458	0.00002
Aquisalimonas_sp._2447	2740807	S	2464	184	2648	0.00011
Alkalilimnicola_ehrlichii	351052	S	2358	320	2678	0.00012
Ectothiorhodospira_sp._BSL-9	1442136	S	877	310	1187	0.00005
Ectothiorhodospira_haloalkaliphila	421628	S	868	319	1187	0.00005
Ectothiorhodosinus_mongolicus	233100	S	314	22	336	0.00001
Allochromatium_tepidum	553982	S	1954	950	2904	0.00013
Allochromatium_vinosum	1049	S	1900	747	2647	0.00011
Thioflavicoccus_mobilis	80679	S	4359	404	4763	0.00021
Candidatus_Thiodictyon_syntrophicum	1166950	S	4296	234	4530	0.00020
Marichromatium_purpuratum	37487	S	3762	739	4501	0.00019
Thiocapsa_bogorovii	521689	S	3139	170	3309	0.00014
Thiocystis_violascens	73141	S	2395	206	2601	0.00011
Thermochromatium_tepidum	1050	S	1428	339	1767	0.00008
Nitrosococcus_halophilus	133539	S	302	44	346	0.00001
Nitrosococcus_wardiae	1814290	S	295	41	336	0.00001
Nitrosococcus_oceani	1229	S	223	57	280	0.00001
Nitrosococcus_watsonii	473531	S	185	51	236	0.00001
Caldichromatium_japonicum	2699430	S	1120	127	1247	0.00005
Rheinheimera_sp._F8	1763998	S	159	10	169	0.00001
Rheinheimera_sp._D18	2545632	S	45	39	84	0.00000
Rheinheimera_mangrovi	2498451	S	111	13	124	0.00001
Candidatus_Nitrosacidococcus_tergens	553981	S	58	2	60	0.00000
Candidatus_Nitrosoglobus_terrae	1630141	S	55	3	58	0.00000
Wenzhouxiangella_marina	1579979	S	2728	179	2907	0.00013
Wenzhouxiangella_sp._AB-CW3	2771012	S	1540	70	1610	0.00007
Thiohalobacter_sp._COW1	2795687	S	571	1287	1858	0.00008
Thiohalobacter_thiocyanaticus	585455	S	476	1330	1806	0.00008
Guyparkeria_halophila	47960	S	2578	634	3212	0.00014
Sulfurivermis_fontis	1972068	S	2214	867	3081	0.00013
Halothiobacillus_sp._LS2	1860122	S	1029	108	1137	0.00005
Halothiobacillus_neapolitanus	927	S	378	47	425	0.00002
Woeseia_oceani	1548547	S	1345	23	1368	0.00006
Sulfuriflexus_mobilis	1811807	S	538	16	554	0.00002
Granulosicoccus_antarcticus	437505	S	478	8	486	0.00002
Halomonas_sp._THAF5a	2587844	S	2276	872	3148	0.00014
Halomonas_sp._1513	1883416	S	1834	403	2237	0.00010
Halomonas_sp._HG01	1609967	S	1617	708	2325	0.00010
Halomonas_sp._THAF12	2587849	S	1593	977	2570	0.00011
Halomonas_sp._YLGW01	2773308	S	1487	248	1735	0.00008
Halomonas_sp._JS92-SW72	2306583	S	1474	1678	3152	0.00014
Halomonas_sp._MCCC_1A13316	2733487	S	1425	185	1610	0.00007
Halomonas_sp._PGE1	2730360	S	1019	1422	2441	0.00011
Halomonas_sp._Y2R2	2562282	S	542	29	571	0.00002
Halomonas_sp._A40-4	2785909	S	436	116	552	0.00002
Halomonas_sp._SH5A2	2749040	S	377	67	444	0.00002
Halomonas_sp._KO116	1504981	S	306	125	431	0.00002
Halomonas_sp._R57-5	1610576	S	233	96	329	0.00001
Halomonas_sp._FeN2	2832500	S	218	93	311	0.00001
Halomonas_sp._18071143	2855441	S	213	463	676	0.00003
Halomonas_sp._SS10-MC5	2854257	S	210	1799	2009	0.00009
Halomonas_sp._GFAJ-1	1118153	S	172	32	204	0.00001
Halomonas_sp._SF2003	2136172	S	145	618	763	0.00003
Halomonas_sp._NyZ770	2883106	S	99	408	507	0.00002
Halomonas_sp._TD01	999141	S	91	48	139	0.00001
Halomonas_sp._HL-93	1666906	S	83	550	633	0.00003
Halomonas_sp._N3-2A	2014541	S	77	93	170	0.00001
Halomonas_sp._GT	1971364	S	77	54	131	0.00001
Halomonas_sp._hl-4	1761789	S	71	456	527	0.00002
Halomonas_sp._A3H3	1346287	S	40	1024	1064	0.00005
Halomonas_beimenensis	475662	S	2656	516	3172	0.00014
Halomonas_aestuarii	1897729	S	1892	391	2283	0.00010
Halomonas_socia	1081866	S	1703	319	2022	0.00009
Halomonas_sulfidivorans	2733488	S	1569	313	1882	0.00008
Halomonas_tianxiuensis	2497861	S	1540	332	1872	0.00008
Halomonas_elongata	2746	S	1363	138	1501	0.00006
Halomonas_chromatireducens	507626	S	1109	87	1196	0.00005
Halomonas_subglaciescola	29571	S	797	87	884	0.00004
Halomonas_meridiana	29570	S	762	600	1362	0.00006
Halomonas_huangheensis	1178482	S	591	33	624	0.00003
Halomonas_piezotolerans	2609667	S	453	239	692	0.00003
Halomonas_sulfidoxydans	2733484	S	212	1786	1998	0.00009
Halomonas_profundi	2852117	S	203	29	232	0.00001
Halomonas_titanicae	664683	S	173	840	1013	0.00004
Halomonas_hydrothermalis	115561	S	125	350	475	0.00002
Halomonas_venusta	44935	S	106	129	235	0.00001
Halomonas_campaniensis	213554	S	46	208	254	0.00001
Halomonas_alkaliphila	272774	S	17	84	101	0.00000
Cobetia_sp._L2A1	2686360	S	468	56	524	0.00002
Cobetia_sp._cqz5-12	2609415	S	296	383	679	0.00003
Cobetia_sp._4B	2758724	S	134	542	676	0.00003
Cobetia_sp._AM6	2661553	S	113	607	720	0.00003
Cobetia_amphilecti	1055104	S	145	859	1004	0.00004
Cobetia_pacifica	1055101	S	134	398	532	0.00002
Cobetia_marina	28258	S	23	298	321	0.00001
Salinicola_tamaricis	1771309	S	2363	268	2631	0.00011
Halotalea_alkalilenta	376489	S	2325	457	2782	0.00012
Kushneria_phosphatilytica	657387	S	603	23	626	0.00003
Kushneria_konosiri	698828	S	503	109	612	0.00003
Kushneria_marisflavi	157779	S	435	92	527	0.00002
Chromohalobacter_salexigens	158080	S	1519	163	1682	0.00007
Pistricoccus_aurantiacus	1883414	S	1115	74	1189	0.00005
Zymobacter_palmae	33074	S	335	45	380	0.00002
Candidatus_Portiera_aleyrodidarum	91844	S	55	22	77	0.00000
Alcanivorax_sp._N3-2A	2014542	S	1652	1708	3360	0.00015
Alcanivorax_sp._NBRC_101098	1113728	S	11	168	179	0.00001
Alcanivorax_pacificus	1306787	S	1335	468	1803	0.00008
Alcanivorax_dieselolei	285091	S	841	290	1131	0.00005
Alcanivorax_xenomutans	1094342	S	694	375	1069	0.00005
Alcanivorax_borkumensis	59754	S	11	163	174	0.00001
Ketobacter_alkanivorans	1917421	S	258	19	277	0.00001
Marinobacterium_aestuarii	1821621	S	1015	77	1092	0.00005
Marinobacterium_georgiense	48076	S	393	128	521	0.00002
Marinobacterium_sediminicola	518898	S	390	61	451	0.00002
Marinobacterium_sp._LSUCC0821	2668067	S	55	4	59	0.00000
Marinomonas_sp._FW-1	2071621	S	48	9	57	0.00000
Marinomonas_sp._A3A	2065312	S	43	4	47	0.00000
Marinomonas_sp._CT5	2066133	S	26	1	27	0.00000
Marinomonas_primoryensis	178399	S	94	11	105	0.00000
Marinomonas_foliarum	491950	S	88	25	113	0.00000
Marinomonas_profundi	2726122	S	83	22	105	0.00000
Marinomonas_arctica	383750	S	71	13	84	0.00000
Marinomonas_mediterranea	119864	S	67	5	72	0.00000
Marinomonas_algicola	2773454	S	57	10	67	0.00000
Marinomonas_posidonica	936476	S	56	7	63	0.00000
Thalassolituus_sp._C2-1	2597518	S	272	19	291	0.00001
Thalassolituus_oleivorans	187493	S	123	29	152	0.00001
Venatorbacter_cucullus	2661630	S	253	61	314	0.00001
Bacterioplanes_sanyensis	1249553	S	250	15	265	0.00001
Neptunomonas_phycophila	1572645	S	70	8	78	0.00000
Neptunomonas_concharum	1031538	S	65	8	73	0.00000
Neptunomonas_japonica	417574	S	44	4	48	0.00000
Nitrincola_iocasae	2614693	S	133	22	155	0.00001
Amphritea_japonica	452627	S	89	7	96	0.00000
Bermanella_marisrubri	207949	S	56	2	58	0.00000
Saccharospirillum_mangrovi	2161747	S	669	38	707	0.00003
Reinekea_forsetii	1336806	S	287	14	301	0.00001
Gynuella_sunshinyii	1445505	S	173	5	178	0.00001
Hahella_chejuensis	158327	S	483	67	550	0.00002
Hahella_sp._KA22	1628392	S	482	77	559	0.00002
Litoricola_lipolytica	418701	S	427	20	447	0.00002
Spartinivicinus_ruber	2683272	S	291	8	299	0.00001
Oleiphilus_messinensis	141451	S	168	12	180	0.00001
Endozoicomonas_montiporae	1027273	S	163	9	172	0.00001
Cellvibrio_sp._KY-YJ-3	454662	S	7760	784	8544	0.00037
Cellvibrio_sp._KY-GH-1	2303332	S	3409	193	3602	0.00016
Cellvibrio_sp._PSBB023	1945512	S	1276	99	1375	0.00006
Cellvibrio_sp._PSBB006	1987723	S	1067	32	1099	0.00005
Cellvibrio_japonicus	155077	S	749	47	796	0.00003
Teredinibacter_turnerae	2426	S	277	12	289	0.00001
Teredinibacter_haidensis	2731755	S	181	14	195	0.00001
Teredinibacter_purpureus	2731756	S	102	6	108	0.00000
Simiduia_agarivorans	447471	S	464	23	487	0.00002
Saccharophagus_degradans	86304	S	113	3	116	0.00001
Marinagarivorans_sp._GE09	2721545	S	95	7	102	0.00000
Agarilytica_rhodophyticola	1737490	S	69	1	70	0.00000
Microbulbifer_sp._YPW16	2904242	S	997	96	1093	0.00005
Microbulbifer_sp._SH-1	2681547	S	793	130	923	0.00004
Microbulbifer_sp._YPW1	2745199	S	661	127	788	0.00003
Microbulbifer_sp._ALW1	1516059	S	535	97	632	0.00003
Microbulbifer_sp._GL-2	2591606	S	188	35	223	0.00001
Microbulbifer_sp._THAF38	2587856	S	181	68	249	0.00001
Microbulbifer_sp._A4B17	359370	S	150	38	188	0.00001
Microbulbifer_aggregans	1769779	S	643	82	725	0.00003
Microbulbifer_elongatus	86173	S	578	102	680	0.00003
Microbulbifer_hydrolyticus	48074	S	567	112	679	0.00003
Microbulbifer_celer	435905	S	542	72	614	0.00003
Microbulbifer_thermotolerans	252514	S	528	34	562	0.00002
Microbulbifer_agarilyticus	260552	S	295	35	330	0.00001
Microbulbifer_variabilis	266805	S	137	55	192	0.00001
Kineobactrum_salinum	2708301	S	1500	59	1559	0.00007
Halioglobus_japonicus	930805	S	701	40	741	0.00003
Halioglobus_maricola	2601894	S	518	25	543	0.00002
Congregibacter_litoralis	393662	S	612	254	866	0.00004
Aequoribacter_fuscus	2518989	S	165	22	187	0.00001
Spongiibacter_taiwanensis	1748242	S	484	22	506	0.00002
Spongiibacter_nanhainus	2794344	S	470	55	525	0.00002
Spongiibacter_sp._IMCC21906	1620392	S	150	40	190	0.00001
Zhongshania_aliphaticivorans	1470434	S	186	13	199	0.00001
Oceanicoccus_sagamiensis	716816	S	132	2	134	0.00001
Aeromonas_sp._FDAARGOS_1415	2778064	S	438	223	661	0.00003
Aeromonas_sp._CA23	2033032	S	333	131	464	0.00002
Aeromonas_sp._CU5	2033033	S	205	79	284	0.00001
Aeromonas_sp._FDAARGOS_1409	2778058	S	188	237	425	0.00002
Aeromonas_sp._FDAARGOS_1407	2778056	S	76	210	286	0.00001
Aeromonas_sp._ASNIH4	1636609	S	75	336	411	0.00002
Aeromonas_sp._1805	2560028	S	69	164	233	0.00001
Aeromonas_sp._FDAARGOS_1405	2778054	S	59	84	143	0.00001
Aeromonas_sp._FDAARGOS_1410	2778059	S	58	120	178	0.00001
Aeromonas_sp._FDAARGOS_1403	2778052	S	57	148	205	0.00001
Aeromonas_sp._2692-1	2560029	S	38	162	200	0.00001
Aeromonas_sp._FDAARGOS_1417	2778066	S	38	95	133	0.00001
Aeromonas_sp._FDAARGOS_1404	2778053	S	37	116	153	0.00001
Aeromonas_sp._ASNIH3	1636608	S	34	1491	1525	0.00007
Aeromonas_sp._ASNIH1	1636606	S	31	566	597	0.00003
Aeromonas_sp._FDAARGOS_1416	2778065	S	25	62	87	0.00000
Aeromonas_sp._ASNIH2	1636607	S	25	305	330	0.00001
Aeromonas_sp._FDAARGOS_1408	2778057	S	24	120	144	0.00001
Aeromonas_sp._FDAARGOS_1414	2778063	S	23	62	85	0.00000
Aeromonas_sp._FDAARGOS_1419	2778068	S	23	57	80	0.00000
Aeromonas_sp._FDAARGOS_1402	2778051	S	21	202	223	0.00001
Aeromonas_sp._FDAARGOS_1411	2778060	S	20	54	74	0.00000
Aeromonas_sp._ASNIH5	1758179	S	20	320	340	0.00001
Aeromonas_sp._FDAARGOS_1406	2778055	S	18	154	172	0.00001
Aeromonas_sp._WP2-W18-CRE-05	2675707	S	17	617	634	0.00003
Aeromonas_hydrophila	644	S	1934	9905	11839	0.00051
Aeromonas_veronii	654	S	1305	2579	3884	0.00017
Aeromonas_media	651	S	1062	1810	2872	0.00012
Aeromonas_schubertii	652	S	1026	286	1312	0.00006
Aeromonas_salmonicida	645	S	886	924	1810	0.00008
Aeromonas_encheleia	73010	S	863	282	1145	0.00005
Aeromonas_simiae	218936	S	789	768	1557	0.00007
Aeromonas_caviae	648	S	635	4684	5319	0.00023
Aeromonas_rivuli	648794	S	609	163	772	0.00003
Aeromonas_enteropelogenes	29489	S	505	362	867	0.00004
Aeromonas_dhakensis	196024	S	408	698	1106	0.00005
Aeromonas_jandaei	650	S	406	353	759	0.00003
Aeromonas_sanarellii	633415	S	133	609	742	0.00003
Aeromonas_allosaccharophila	656	S	81	112	193	0.00001
Aeromonas_rivipollensis	948519	S	77	104	181	0.00001
Zobellella_denitrificans	347534	S	1930	431	2361	0.00010
Oceanimonas_sp._GK1	511062	S	766	155	921	0.00004
Dongshaea_marina	2047966	S	203	19	222	0.00001
Oceanisphaera_profunda	1416627	S	112	15	127	0.00001
Oceanisphaera_avium	1903694	S	63	10	73	0.00000
Tolumonas_auensis	43948	S	125	53	178	0.00001
Succinivibrio_dextrinosolvens	83771	S	63	3	66	0.00000
Methylococcus_sp._EFPC2	2812648	S	2363	168	2531	0.00011
Methylococcus_sp._Mc7	2860258	S	2123	699	2822	0.00012
Methylococcus_capsulatus	414	S	2029	501	2530	0.00011
Methylococcus_geothermalis	2681310	S	1603	458	2061	0.00009
Methylomonas_sp._LL1	2785785	S	680	31	711	0.00003
Methylomonas_sp._EFPC1	2812647	S	246	137	383	0.00002
Methylomonas_sp._LW13	107637	S	243	127	370	0.00002
Methylomonas_sp._DH-1	1727196	S	234	415	649	0.00003
Methylomonas_koyamae	702114	S	721	690	1411	0.00006
Methylomonas_rhizoryzae	2608981	S	634	25	659	0.00003
Methylomonas_denitrificans	1538553	S	524	36	560	0.00002
Methylomonas_methanica	421	S	480	25	505	0.00002
Methylomonas_paludis	1173101	S	166	7	173	0.00001
Methylomagnum_ishizawai	1760988	S	2590	116	2706	0.00012
Methylogaea_oryzae	1295382	S	2285	181	2466	0.00011
Methylomicrobium_album	39775	S	1854	77	1931	0.00008
Methylomicrobium_sp._wino1	2049332	S	362	364	726	0.00003
Methylocaldum_marinum	1432792	S	2181	130	2311	0.00010
Candidatus_Methylospira_mobilis	1808979	S	796	35	831	0.00004
Methylotuvimicrobium_buryatense	95641	S	210	250	460	0.00002
Methylotuvimicrobium_alcaliphilum	271065	S	203	287	490	0.00002
Methylovulum_psychrotolerans	1704499	S	351	8	359	0.00002
Methylobacter_sp._S3L5C	2839024	S	136	8	144	0.00001
Solimonas_sp._K1W22B-7	2303331	S	8732	919	9651	0.00042
Flagellatimonas_centrodinii	2806210	S	2412	173	2585	0.00011
Sinimarinibacterium_sp._NLF-5-8	2698684	S	1147	630	1777	0.00008
Steroidobacter_denitrificans	465721	S	7777	2147	9924	0.00043
Sulfurifustis_variabilis	1675686	S	10167	653	10820	0.00047
Sulfuricaulis_limicola	1620215	S	3800	295	4095	0.00018
Acidiferrobacter_sp._SPIII_3	1281578	S	1181	324	1505	0.00007
Acidiferrobacter_thiooxydans	163359	S	877	243	1120	0.00005
Shewanella_sp._FJAT-53555	2864204	S	96	81	177	0.00001
Shewanella_sp._FJAT-53764	2864207	S	90	135	225	0.00001
Shewanella_sp._FJAT-54031	2864209	S	84	122	206	0.00001
Shewanella_sp._FJAT-52076	2864202	S	72	97	169	0.00001
Shewanella_sp._FJAT-51860	2864212	S	71	10	81	0.00000
Shewanella_sp._FJAT-53681	2864205	S	65	101	166	0.00001
Shewanella_sp._FJAT-52072	2864213	S	60	76	136	0.00001
Shewanella_sp._SNU_WT4	2590015	S	52	13	65	0.00000
Shewanella_sp._FJAT-53532	2864203	S	49	81	130	0.00001
Shewanella_sp._Scap07	2589987	S	44	5	49	0.00000
Shewanella_sp._WE21	2029986	S	42	21	63	0.00000
Shewanella_sp._FJAT-53870	2864208	S	42	6	48	0.00000
Shewanella_sp._FJAT-53749	2864206	S	41	7	48	0.00000
Shewanella_sp._KX20019	2803864	S	39	4	43	0.00000
Shewanella_sp._MR-4	60480	S	32	33	65	0.00000
Shewanella_sp._Arc9-LZ	2698686	S	30	12	42	0.00000
Shewanella_sp._FJAT-51649	2864210	S	24	35	59	0.00000
Shewanella_sp._FJAT-51754	2864211	S	23	32	55	0.00000
Shewanella_sp._ANA-3	94122	S	23	58	81	0.00000
Shewanella_sp._Pdp11	2059264	S	19	53	72	0.00000
Shewanella_sp._OM3-2	2908650	S	17	2	19	0.00000
Shewanella_sp._WPAGA9	2775245	S	12	30	42	0.00000
Shewanella_khirikhana	1965282	S	296	45	341	0.00001
Shewanella_algae	38313	S	293	246	539	0.00002
Shewanella_cyperi	2814292	S	259	138	397	0.00002
Shewanella_litorisediminis	1173586	S	183	43	226	0.00001
Shewanella_marisflavi	260364	S	180	34	214	0.00001
Shewanella_putrefaciens	24	S	147	472	619	0.00003
Shewanella_sedimentimangrovi	2814293	S	135	100	235	0.00001
Shewanella_amazonensis	60478	S	114	28	142	0.00001
Shewanella_baltica	62322	S	110	104	214	0.00001
Shewanella_dokdonensis	712036	S	110	10	120	0.00001
Shewanella_yunxiaonensis	2829809	S	97	14	111	0.00000
Shewanella_loihica	359303	S	95	158	253	0.00001
Shewanella_sediminis	271097	S	85	11	96	0.00000
Shewanella_avicenniae	2814294	S	75	11	86	0.00000
Shewanella_oneidensis	70863	S	70	20	90	0.00000
Shewanella_pealeana	70864	S	68	11	79	0.00000
Shewanella_benthica	43661	S	61	13	74	0.00000
Shewanella_xiamenensis	332186	S	61	309	370	0.00002
Shewanella_violacea	60217	S	61	10	71	0.00000
Shewanella_woodyi	60961	S	58	6	64	0.00000
Shewanella_psychropiezotolerans	2593655	S	55	9	64	0.00000
Shewanella_carassii	1987584	S	53	57	110	0.00000
Shewanella_denitrificans	192073	S	50	7	57	0.00000
Shewanella_psychrophila	225848	S	46	6	52	0.00000
Shewanella_glacialimarina	2590884	S	45	5	50	0.00000
Shewanella_inventionis	1738770	S	45	21	66	0.00000
Shewanella_halifaxensis	271098	S	45	6	51	0.00000
Shewanella_decolorationis	256839	S	44	48	92	0.00000
Shewanella_psychromarinicola	2487742	S	44	6	50	0.00000
Shewanella_vesiculosa	518738	S	39	9	48	0.00000
Shewanella_piezotolerans	404011	S	36	3	39	0.00000
Shewanella_maritima	2520507	S	33	3	36	0.00000
Shewanella_chilikensis	558541	S	32	92	124	0.00001
Shewanella_donghaensis	238836	S	29	3	32	0.00000
Shewanella_aestuarii	1028752	S	28	10	38	0.00000
Shewanella_indica	768528	S	25	34	59	0.00000
Shewanella_livingstonensis	150120	S	24	5	29	0.00000
Shewanella_bicestrii	2018305	S	12	47	59	0.00000
Shewanella_frigidimarina	56812	S	11	5	16	0.00000
Shewanella_japonica	93973	S	11	27	38	0.00000
Parashewanella_spongiae	342950	S	30	2	32	0.00000
Parashewanella_tropica	2547970	S	21	2	23	0.00000
Alteromonas_sp._RKMC-009	2267264	S	133	38	171	0.00001
Alteromonas_sp._BL110	1714845	S	28	44	72	0.00000
Alteromonas_sp._76-1	2358187	S	16	17	33	0.00000
Alteromonas_macleodii	28108	S	172	63	235	0.00001
Alteromonas_pelagimontana	1858656	S	116	14	130	0.00001
Alteromonas_mediterranea	314275	S	111	52	163	0.00001
Alteromonas_australica	589873	S	30	66	96	0.00000
Alteromonas_naphthalenivorans	715451	S	15	9	24	0.00000
Alteromonas_stellipolaris	233316	S	11	40	51	0.00000
Salinimonas_marina	2785918	S	123	13	136	0.00001
Salinimonas_lutimaris	914153	S	104	19	123	0.00001
Salinimonas_iocasae	2572577	S	93	20	113	0.00000
Salinimonas_sediminis	2303538	S	89	21	110	0.00000
Hydrocarboniclastica_marina	2259620	S	672	91	763	0.00003
Saliniradius_amylolyticus	2183582	S	209	19	228	0.00001
Agarivorans_sp._TSD2052	2937286	S	39	5	44	0.00000
Agarivorans_sp._B2Z047	2652721	S	19	15	34	0.00000
Agarivorans_gilvus	680279	S	49	4	53	0.00000
Agarivorans_aestuarii	1563703	S	31	11	42	0.00000
Agarivorans_albus	182262	S	23	20	43	0.00000
Lacimicrobium_alkaliphilum	1526571	S	183	12	195	0.00001
Paraglaciecola_sp._L1A13	2686359	S	40	4	44	0.00000
Paraglaciecola_sp._L3A3	2686358	S	29	2	31	0.00000
Paraglaciecola_mesophila	197222	S	44	5	49	0.00000
Paraglaciecola_psychrophila	326544	S	43	3	46	0.00000
Glaciecola_nitratireducens	300231	S	65	4	69	0.00000
Paraneptunicella_aestuarii	2831148	S	64	3	67	0.00000
Catenovulum_sediminis	1740262	S	53	3	56	0.00000
Saccharobesus_litoralis	2172099	S	39	2	41	0.00000
Pseudoalteromonas_sp._R3	1709477	S	102	17	119	0.00001
Pseudoalteromonas_sp._A25	116092	S	38	5	43	0.00000
Pseudoalteromonas_sp._GCY	2003316	S	20	21	41	0.00000
Pseudoalteromonas_sp._A22	327511	S	20	45	65	0.00000
Pseudoalteromonas_sp._DL-6	1390185	S	19	17	36	0.00000
Pseudoalteromonas_sp._THAF3	2587843	S	16	19	35	0.00000
Pseudoalteromonas_sp._1_2015MBL_MicDiv	1720343	S	10	28	38	0.00000
Pseudoalteromonas_rubra	43658	S	241	29	270	0.00001
Pseudoalteromonas_viridis	339617	S	121	35	156	0.00001
Pseudoalteromonas_luteoviolacea	43657	S	80	11	91	0.00000
Pseudoalteromonas_piscicida	43662	S	54	59	113	0.00000
Pseudoalteromonas_shioyasakiensis	1190813	S	52	21	73	0.00000
Pseudoalteromonas_spongiae	298657	S	40	7	47	0.00000
Pseudoalteromonas_xiamenensis	882626	S	35	3	38	0.00000
Pseudoalteromonas_tunicata	314281	S	34	4	38	0.00000
Pseudoalteromonas_aliena	247523	S	33	11	44	0.00000
Pseudoalteromonas_ulvae	107327	S	28	2	30	0.00000
Pseudoalteromonas_agarivorans	176102	S	26	68	94	0.00000
Pseudoalteromonas_phenolica	161398	S	25	3	28	0.00000
Pseudoalteromonas_mariniglutinosa	206042	S	24	54	78	0.00000
Pseudoalteromonas_ruthenica	151081	S	23	27	50	0.00000
Pseudoalteromonas_prydzensis	182141	S	23	4	27	0.00000
Pseudoalteromonas_piratica	1348114	S	20	3	23	0.00000
Pseudoalteromonas_translucida	166935	S	18	71	89	0.00000
Pseudoalteromonas_carrageenovora	227	S	18	6	24	0.00000
Pseudoalteromonas_arctica	394751	S	17	12	29	0.00000
Pseudoalteromonas_espejiana	28107	S	14	3	17	0.00000
Pseudoalteromonas_undina	43660	S	12	21	33	0.00000
Pseudoalteromonas_marina	267375	S	10	32	42	0.00000
Psychrosphaera_ytuae	2820710	S	56	9	65	0.00000
Psychrosphaera_aestuarii	1266052	S	24	3	27	0.00000
Flocculibacter_collagenilyticus	2744479	S	32	3	35	0.00000
Ferrimonas_balearica	44012	S	703	88	791	0.00003
Ferrimonas_lipolytica	2724191	S	114	16	130	0.00001
Thalassotalea_sp._PS06	2594005	S	60	8	68	0.00000
Thalassotalea_sp._HSM_43	2552945	S	56	8	64	0.00000
Thalassotalea_sp._LPB0316	2769490	S	33	9	42	0.00000
Thalassotalea_crassostreae	1763536	S	31	3	34	0.00000
Colwellia_sp._20A7	2689569	S	33	4	37	0.00000
Colwellia_sp._MT41	58049	S	31	4	35	0.00000
Colwellia_sp._PAMC_20917	1816218	S	27	2	29	0.00000
Colwellia_sp._Arc7-635	2497879	S	17	3	20	0.00000
Colwellia_sp._Arc7-D	2161872	S	16	5	21	0.00000
Colwellia_psychrerythraea	28229	S	23	3	26	0.00000
Litorilituus_sediminis	718192	S	21	2	23	0.00000
Cognaticolwellia_beringensis	1967665	S	17	5	22	0.00000
Idiomarina_sp._OT37-5b	2100422	S	116	27	143	0.00001
Idiomarina_sp._X4	2055892	S	33	20	53	0.00000
Idiomarina_abyssalis	86102	S	64	9	73	0.00000
Idiomarina_loihiensis	135577	S	53	0	53	0.00000
Idiomarina_piscisalsi	1096243	S	34	20	54	0.00000
Moritella_sp._24	2746230	S	31	10	41	0.00000
Moritella_sp._5	2746231	S	11	32	43	0.00000
Moritella_yayanosii	69539	S	41	13	54	0.00000
Moritella_marina	90736	S	29	7	36	0.00000
Psychromonas_ingrahamii	357794	S	65	10	75	0.00000
Psychromonas_sp._CNPT3	314282	S	23	6	29	0.00000
Vibrio_parahaemolyticus	670	S	208	62	270	0.00001
Vibrio_campbellii	680	S	84	76	160	0.00001
Vibrio_harveyi	669	S	69	23	92	0.00000
Vibrio_alginolyticus	663	S	60	83	143	0.00001
Vibrio_diabolicus	50719	S	34	46	80	0.00000
Vibrio_natriegens	691	S	48	39	87	0.00000
Vibrio_owensii	696485	S	47	27	74	0.00000
Vibrio_rotiferianus	190895	S	28	10	38	0.00000
Vibrio_azureus	512649	S	25	3	28	0.00000
Vibrio_jasicida	766224	S	13	12	25	0.00000
Vibrio_sp._OG9-811	2841925	S	140	21	161	0.00001
Vibrio_sp._THAF190c	2587865	S	72	9	81	0.00000
Vibrio_sp._B1FLJ16	2751178	S	66	13	79	0.00000
Vibrio_sp._HDW18	2714948	S	38	6	44	0.00000
Vibrio_sp._VB16	2785746	S	36	3	39	0.00000
Vibrio_sp._SCSIO_43132	2779363	S	28	9	37	0.00000
Vibrio_sp._ED004	2785124	S	27	14	41	0.00000
Vibrio_sp._SS-MA-C1-2	2908646	S	21	3	24	0.00000
Vibrio_sp._Scap24	2589990	S	20	10	30	0.00000
Vibrio_sp._B1REV9	2751179	S	17	7	24	0.00000
Vibrio_sp._B1FIG11	2751177	S	12	18	30	0.00000
Vibrio_sp._ED002	2785123	S	12	9	21	0.00000
Vibrio_fluvialis	676	S	378	62	440	0.00002
Vibrio_furnissii	29494	S	350	108	458	0.00002
Vibrio_vulnificus	672	S	287	58	345	0.00001
Vibrio_sinaloensis	379097	S	80	11	91	0.00000
Vibrio_europaeus	300876	S	43	16	59	0.00000
Vibrio_tubiashii	29498	S	26	13	39	0.00000
Vibrio_cholerae	666	S	165	2174	2339	0.00010
Vibrio_mimicus	674	S	131	28	159	0.00001
Vibrio_navarrensis	29495	S	110	27	137	0.00001
Vibrio_anguillarum	55601	S	108	18	126	0.00001
Vibrio_nigripulchritudo	28173	S	90	16	106	0.00000
Vibrio_coralliilyticus	190893	S	81	24	105	0.00000
Vibrio_splendidus	29497	S	71	18	89	0.00000
Vibrio_spartinae	1918945	S	71	7	78	0.00000
Vibrio_algicola	2662262	S	69	10	79	0.00000
Vibrio_mediterranei	689	S	68	6	74	0.00000
Vibrio_cyclitrophicus	47951	S	65	15	80	0.00000
Vibrio_alfacsensis	1074311	S	61	27	88	0.00000
Vibrio_tapetis	52443	S	59	4	63	0.00000
Vibrio_scophthalmi	45658	S	58	10	68	0.00000
Vibrio_gazogenes	687	S	56	6	62	0.00000
Vibrio_neptunius	170651	S	55	7	62	0.00000
Vibrio_metoecus	1481663	S	55	16	71	0.00000
Vibrio_panuliri	1381081	S	54	6	60	0.00000
Vibrio_maritimus	990268	S	54	5	59	0.00000
Vibrio_penaeicida	104609	S	52	5	57	0.00000
Vibrio_taketomensis	2572923	S	51	6	57	0.00000
Vibrio_breoganii	553239	S	49	5	54	0.00000
Vibrio_metschnikovii	28172	S	47	8	55	0.00000
Vibrio_astriarenae	1481923	S	46	5	51	0.00000
Vibrio_zhugei	2479546	S	46	10	56	0.00000
Vibrio_chagasii	170679	S	45	7	52	0.00000
Vibrio_cincinnatiensis	675	S	44	8	52	0.00000
Vibrio_aphrogenes	1891186	S	43	5	48	0.00000
Vibrio_ponticus	265668	S	42	3	45	0.00000
Vibrio_crassostreae	246167	S	40	15	55	0.00000
Vibrio_rumoiensis	76258	S	36	20	56	0.00000
Vibrio_tritonius	1435069	S	34	4	38	0.00000
Vibrio_cidicii	1763883	S	34	11	45	0.00000
Vibrio_atlanticus	693153	S	31	6	37	0.00000
Vibrio_ziniensis	2711221	S	31	3	34	0.00000
Vibrio_gigantis	296199	S	29	6	35	0.00000
Vibrio_casei	673372	S	27	7	34	0.00000
Vibrio_kanaloae	170673	S	23	5	28	0.00000
Vibrio_aquimaris	2587862	S	21	2	23	0.00000
Vibrio_bathopelagicus	2777577	S	20	4	24	0.00000
Vibrio_hyugaensis	1534743	S	18	6	24	0.00000
Photobacterium_sp._TLY01	2907534	S	212	36	248	0.00001
Photobacterium_sp._GJ3	2829502	S	190	24	214	0.00001
Photobacterium_gaetbulicola	1295392	S	241	23	264	0.00001
Photobacterium_ganghwense	320778	S	231	53	284	0.00001
Photobacterium_damselae	38293	S	127	70	197	0.00001
Photobacterium_profundum	74109	S	47	5	52	0.00000
Salinivibrio_kushneri	1908198	S	112	16	128	0.00001
Salinivibrio_sp._YCSC6	2003370	S	30	45	75	0.00000
Salinivibrio_costicola	51367	S	23	35	58	0.00000
Grimontia_hollisae	673	S	145	18	163	0.00001
Thaumasiovibrio_subtropicus	1891207	S	55	6	61	0.00000
Aliivibrio_fischeri	668	S	28	3	31	0.00000
Aliivibrio_salmonicida	40269	S	16	9	25	0.00000
Paraphotobacterium_marinum	1755811	S	13	2	15	0.00000
Immundisolibacter_cernigliae	1810504	S	4271	794	5065	0.00022
Acinetobacter_sp._WCHAc010034	1879049	S	269	110	379	0.00002
Acinetobacter_sp._10FS3-1	2563897	S	40	29	69	0.00000
Acinetobacter_sp._CS-2	2798861	S	38	21	59	0.00000
Acinetobacter_sp._Marseille-Q1620	2714110	S	34	2	36	0.00000
Acinetobacter_sp._TGL-Y2	1407071	S	32	2	34	0.00000
Acinetobacter_sp._ASP199	2773709	S	24	8	32	0.00000
Acinetobacter_sp._TTH0-4	1646498	S	23	3	26	0.00000
Acinetobacter_sp._WCHA55	2004646	S	20	21	41	0.00000
Acinetobacter_sp._LoGeW2-3	1808001	S	19	2	21	0.00000
Acinetobacter_sp._NCu2D-2	1608473	S	15	3	18	0.00000
Acinetobacter_sp._ACNIH2	1758189	S	14	25	39	0.00000
Acinetobacter_sp._WCHAc010052	2004647	S	14	8	22	0.00000
Acinetobacter_sp._PK01	2930198	S	13	18	31	0.00000
Acinetobacter_sp._SCLZS86	2908637	S	13	17	30	0.00000
Acinetobacter_sp._SH20PTE14	2905879	S	12	19	31	0.00000
Acinetobacter_sp._WCHA45	2004644	S	11	14	25	0.00000
Acinetobacter_baumannii	470	S	171	900	1071	0.00005
Acinetobacter_pittii	48296	S	52	92	144	0.00001
Acinetobacter_calcoaceticus	471	S	51	7	58	0.00000
Acinetobacter_seifertii	1530123	S	45	20	65	0.00000
Acinetobacter_nosocomialis	106654	S	20	11	31	0.00000
Acinetobacter_indicus	756892	S	141	121	262	0.00001
Acinetobacter_lwoffii	28090	S	109	187	296	0.00001
Acinetobacter_johnsonii	40214	S	104	96	200	0.00001
Acinetobacter_schindleri	108981	S	57	54	111	0.00000
Acinetobacter_haemolyticus	29430	S	55	32	87	0.00000
Acinetobacter_junii	40215	S	53	23	76	0.00000
Acinetobacter_radioresistens	40216	S	50	10	60	0.00000
Acinetobacter_soli	487316	S	47	5	52	0.00000
Acinetobacter_larvae	1789224	S	41	3	44	0.00000
Acinetobacter_cumulans	2136182	S	40	17	57	0.00000
Acinetobacter_bouvetii	202951	S	39	8	47	0.00000
Acinetobacter_variabilis	70346	S	35	55	90	0.00000
Acinetobacter_tandoii	202954	S	24	2	26	0.00000
Acinetobacter_wuhouensis	1879050	S	23	11	34	0.00000
Acinetobacter_gyllenbergii	134534	S	21	1	22	0.00000
Acinetobacter_lanii	2715163	S	21	2	23	0.00000
Acinetobacter_chinensis	2004650	S	19	14	33	0.00000
Acinetobacter_towneri	202956	S	19	47	66	0.00000
Acinetobacter_baylyi	202950	S	19	1	20	0.00000
Acinetobacter_ursingii	108980	S	19	22	41	0.00000
Acinetobacter_dispersus	70348	S	19	1	20	0.00000
Acinetobacter_venetianus	52133	S	18	5	23	0.00000
Acinetobacter_shaoyimingii	2715164	S	18	1	19	0.00000
Acinetobacter_portensis	1839785	S	16	17	33	0.00000
Acinetobacter_equi	1324350	S	12	1	13	0.00000
Acinetobacter_wanghuae	2662362	S	12	1	13	0.00000
Acinetobacter_piscicola	2006115	S	11	6	17	0.00000
Acinetobacter_guillouiae	106649	S	10	5	15	0.00000
Psychrobacter_sp._DAB_AL43B	1028416	S	33	5	38	0.00000
Psychrobacter_sp._WY6	2708350	S	30	26	56	0.00000
Psychrobacter_sp._P11F6	1699621	S	26	23	49	0.00000
Psychrobacter_sp._P2G3	1699622	S	23	57	80	0.00000
Psychrobacter_sp._P11G3	1699623	S	20	10	30	0.00000
Psychrobacter_sp._P11G5	1699624	S	19	49	68	0.00000
Psychrobacter_sp._28M-43	2772254	S	19	10	29	0.00000
Psychrobacter_sp._G	571800	S	14	71	85	0.00000
Psychrobacter_arenosus	256326	S	36	2	38	0.00000
Psychrobacter_urativorans	45610	S	26	4	30	0.00000
Psychrobacter_sanguinis	861445	S	24	9	33	0.00000
Psychrobacter_arcticus	334543	S	23	8	31	0.00000
Psychrobacter_cryohalolentis	330922	S	14	73	87	0.00000
Moraxella_osloensis	34062	S	142	21	163	0.00001
Moraxella_bovoculi	386891	S	50	77	127	0.00001
Moraxella_catarrhalis	480	S	43	13	56	0.00000
Moraxella_cuniculi	34061	S	37	3	40	0.00000
Moraxella_nonliquefaciens	478	S	36	8	44	0.00000
Moraxella_bovis	476	S	35	9	44	0.00000
Moraxella_sp._ZY201115	2904121	S	24	2	26	0.00000
Aquirhabdus_parva	2283318	S	111	4	115	0.00001
Candidatus_Endoriftia_persephone	393765	S	1334	66	1400	0.00006
Candidatus_Vesicomyosocius_sp._SY067_SCS001	2732590	S	19	29	48	0.00000
Bathymodiolus_thermophilus_thioautotrophic_gill_symbiont	2360	S	31	1	32	0.00000
Bathymodiolus_septemdierum_thioautotrophic_gill_symbiont	113267	S	27	2	29	0.00000
Candidatus_Ruthia_endofausta	2738852	S	16	5	21	0.00000
Candidatus_Ruthia_magnifica	386487	S	11	1	12	0.00000
Sedimenticola_thiotaurini	1543721	S	814	36	850	0.00004
Candidatus_Reidiella_endopervernicosa	2738883	S	568	11	579	0.00003
Thiolapillus_brandeum	1076588	S	470	12	482	0.00002
Pseudohongiella_spirulinae	1249552	S	313	8	321	0.00001
Gallaecimonas_mangrovi	2291597	S	211	16	227	0.00001
Celerinatantimonas_diazotrophica	412034	S	59	4	63	0.00000
Candidatus_Thioglobus_autotrophicus	1705394	S	32	3	35	0.00000
Candidatus_Thioglobus_sp._NP1	2508687	S	12	3	15	0.00000
Ignatzschineria_sp._HR5S32	2923279	S	37	3	40	0.00000
Candidatus_Steffania_adelgidicola	1076626	S	20	0	20	0.00000
Candidatus_Pseudothioglobus_singularis	1427364	S	13	5	18	0.00000
Candidatus_Azoamicus_ciliaticola	2652803	S	10	1	11	0.00000
Legionella_sp._MW5194	2662448	S	172	35	207	0.00001
Legionella_sp._PC1000	2746060	S	70	12	82	0.00000
Legionella_sp._PC997	2755562	S	52	10	62	0.00000
Legionella_pneumophila	446	S	215	111	326	0.00001
Legionella_geestiana	45065	S	188	16	204	0.00001
Legionella_spiritensis	452	S	139	15	154	0.00001
Legionella_oakridgensis	29423	S	93	9	102	0.00000
Legionella_sainthelensi	28087	S	77	13	90	0.00000
Legionella_anisa	28082	S	71	19	90	0.00000
Legionella_cherrii	28084	S	67	4	71	0.00000
Legionella_fallonii	96230	S	66	5	71	0.00000
Legionella_antarctica	2708020	S	64	3	67	0.00000
Legionella_israelensis	454	S	64	3	67	0.00000
Legionella_lansingensis	45067	S	59	3	62	0.00000
Legionella_longbeachae	450	S	55	9	64	0.00000
Legionella_jordanis	456	S	53	7	60	0.00000
Legionella_clemsonensis	1867846	S	49	7	56	0.00000
Legionella_waltersii	66969	S	42	7	49	0.00000
Legionella_adelaidensis	45056	S	41	3	44	0.00000
Legionella_hackeliae	449	S	39	7	46	0.00000
Legionella_endosymbiont_of_Polyplax_serrata	2005262	S	13	1	14	0.00000
Tatlockia_micdadei	451	S	64	3	67	0.00000
Fluoribacter_dumoffii	463	S	56	16	72	0.00000
Aquicella_siphonis	254247	S	282	84	366	0.00002
Aquicella_lusitana	254246	S	226	70	296	0.00001
Coxiella_burnetii	777	S	236	61	297	0.00001
Candidatus_Coxiella_mudrowiae	2054173	S	71	6	77	0.00000
Coxiella_endosymbiont_of_Amblyomma_sculptum	2487929	S	34	10	44	0.00000
Coxiella_endosymbiont_of_Amblyomma_nuttalli	2749996	S	28	2	30	0.00000
Candidatus_Rickettsiella_viridis	676208	S	43	16	59	0.00000
Rickettsiella_endosymbiont_of_Dermanyssus_gallinae	2856608	S	29	9	38	0.00000
Thiomicrorhabdus_xiamenensis	2739063	S	109	7	116	0.00001
Thiomicrorhabdus_aquaedulcis	2211106	S	101	5	106	0.00000
Thiomicrorhabdus_sediminis	2580412	S	64	3	67	0.00000
Thiomicrorhabdus_sp._Am19	2791037	S	42	2	44	0.00000
Thiomicrorhabdus_indica	2267253	S	24	1	25	0.00000
Methylophaga_frappieri	754477	S	109	54	163	0.00001
Methylophaga_nitratireducenticrescens	754476	S	106	11	117	0.00001
Methylophaga_sp._TMB456	2881052	S	76	21	97	0.00000
Thiomicrospira_sp._S5	1803865	S	104	74	178	0.00001
Thiomicrospira_microaerophila	406020	S	54	9	63	0.00000
Thiomicrospira_aerophila	92245	S	49	7	56	0.00000
Thiomicrospira_cyclica	147268	S	44	3	47	0.00000
Hydrogenovibrio_thermophilus	265883	S	99	69	168	0.00001
Hydrogenovibrio_marinus	28885	S	52	2	54	0.00000
Hydrogenovibrio_crunogenus	39765	S	46	2	48	0.00000
Thiosulfatimonas_sediminis	2675054	S	113	7	120	0.00001
Piscirickettsia_salmonis	1238	S	89	6	95	0.00000
Cycloclasticus_sp._PY97N	728003	S	10	29	39	0.00000
Cycloclasticus_zancles	1329899	S	10	31	41	0.00000
Thiosulfativibrio_zosterae	2675053	S	51	2	53	0.00000
Thiothrix_litoralis	2891210	S	342	24	366	0.00002
Thiothrix_sp._CT3	96472	S	209	64	273	0.00001
Thiothrix_subterranea	2735563	S	170	43	213	0.00001
Thiothrix_unzii	111769	S	134	64	198	0.00001
Candidatus_Thiothrix_anitrata	2823902	S	109	59	168	0.00001
Beggiatoa_leptomitoformis	288004	S	83	2	85	0.00000
Francisella_tularensis	263	S	34	25	59	0.00000
Francisella_frigiditurris	1542390	S	18	2	20	0.00000
Francisella_persica	954	S	11	2	13	0.00000
Francisella_philomiragia	28110	S	11	22	33	0.00000
Allofrancisella_guangzhouensis	594679	S	22	5	27	0.00000
Salinisphaera_sp._LB1	2183911	S	2651	109	2760	0.00012
endosymbiont_of_unidentified_scaly_snail_isolate_Monju	1248727	S	2196	184	2380	0.00010
Isorropodon_fossajaponicum_symbiont	883811	S	19	6	25	0.00000
Abyssogena_phaseoliformis_symbiont	596095	S	14	5	19	0.00000
Aggregatibacter_actinomycetemcomitans	714	S	98	84	182	0.00001
Aggregatibacter_aphrophilus	732	S	73	29	102	0.00000
Aggregatibacter_sp._2125159857	2820817	S	23	9	32	0.00000
Aggregatibacter_sp._Marseille-P9115	2866570	S	13	9	22	0.00000
Aggregatibacter_sp._oral_taxon_513	712150	S	11	7	18	0.00000
Aggregatibacter_segnis	739	S	11	9	20	0.00000
Haemophilus_parainfluenzae	729	S	91	35	126	0.00001
Haemophilus_influenzae	727	S	47	117	164	0.00001
Haemophilus_haemolyticus	726	S	35	13	48	0.00000
Haemophilus_parahaemolyticus	735	S	21	4	25	0.00000
Haemophilus_pittmaniae	249188	S	14	2	16	0.00000
[Haemophilus]_ducreyi	730	S	11	5	16	0.00000
Actinobacillus_sp._GY-402	2774188	S	82	42	124	0.00001
Actinobacillus_pleuropneumoniae	715	S	46	62	108	0.00000
Actinobacillus_delphinicola	51161	S	16	2	18	0.00000
Actinobacillus_porcitonsillarum	189834	S	16	6	22	0.00000
Actinobacillus_indolicus	51049	S	14	12	26	0.00000
Mannheimia_granulomatis	85402	S	55	9	64	0.00000
Mannheimia_haemolytica	75985	S	46	108	154	0.00001
Mannheimia_varigena	85404	S	37	17	54	0.00000
Mannheimia_sp._USDA-ARS-USMARC-1261	1432056	S	10	7	17	0.00000
Pasteurella_multocida	747	S	105	326	431	0.00002
Pasteurella_skyensis	97481	S	11	1	12	0.00000
Pasteurella_canis	753	S	10	2	12	0.00000
Pasteurella_atlantica	2827233	S	10	1	11	0.00000
Avibacterium_paragallinarum	728	S	39	12	51	0.00000
Avibacterium_volantium	762	S	34	11	45	0.00000
Rodentibacter_haemolyticus	2778911	S	42	5	47	0.00000
Rodentibacter_heylii	1906744	S	20	2	22	0.00000
Glaesserella_parasuis	738	S	28	9	37	0.00000
Glaesserella_sp._15-184	2030797	S	25	6	31	0.00000
Gallibacterium_anatis	750	S	42	13	55	0.00000
Histophilus_somni	731	S	36	11	47	0.00000
Bibersteinia_trehalosi	47735	S	22	7	29	0.00000
Frederiksenia_canicola	123824	S	22	5	27	0.00000
Vespertiliibacter_pulmonis	1443036	S	13	2	15	0.00000
Bisgaardia_hudsonensis	109472	S	11	1	12	0.00000
Cardiobacterium_hominis	2718	S	750	145	895	0.00004
Cardiobacterium_sp._Marseille-Q4385	2866573	S	493	84	577	0.00002
Suttonella_sp._R2A3	2908648	S	107	5	112	0.00000
Dichelobacter_nodosus	870	S	75	20	95	0.00000
Kangiella_koreensis	261964	S	80	8	88	0.00000
Kangiella_profundi	1561924	S	79	14	93	0.00000
Kangiella_sediminilitoris	1144748	S	60	3	63	0.00000
Kangiella_geojedonensis	914150	S	44	2	46	0.00000
Gilliamella_sp._ESL0405	2704653	S	23	4	27	0.00000
Gilliamella_sp._ESL0441	2704654	S	19	15	34	0.00000
Gilliamella_sp._ESL0443	2704655	S	14	3	17	0.00000
Gilliamella_apicola	1196095	S	14	3	17	0.00000
Zophobihabitans_entericus	1635327	S	20	2	22	0.00000
Frischella_perrara	1267021	S	16	5	21	0.00000
Archangium_violaceum	83451	S	53057	8832	61889	0.00268
Archangium_gephyra	48	S	22150	4155	26305	0.00114
Stigmatella_aurantiaca	41	S	13679	1077	14756	0.00064
Cystobacter_fuscus	43	S	12440	2904	15344	0.00066
Melittangium_boletus	83453	S	9063	1939	11002	0.00048
Myxococcus_xanthus	34	S	14354	51757	66111	0.00286
Myxococcus_hansupus	1297742	S	6942	586	7528	0.00033
Myxococcus_stipitatus	83455	S	6052	700	6752	0.00029
Myxococcus_sp._SCHIC003	2813577	S	5400	629	6029	0.00026
Corallococcus_coralloides	184914	S	14190	5346	19536	0.00085
Corallococcus_macrosporus	35	S	8271	1412	9683	0.00042
Corallococcus_sp._EGB	1521117	S	7460	2593	10053	0.00044
Pyxidicoccus_sp._SCPEA002	2813578	S	21522	1011	22533	0.00097
Anaeromyxobacter_sp._Fw109-5	404589	S	26255	3348	29603	0.00128
Anaeromyxobacter_sp._Red232	2918170	S	24971	2622	27593	0.00119
Anaeromyxobacter_sp._Red630	2918171	S	16430	2136	18566	0.00080
Anaeromyxobacter_sp._K	447217	S	4202	8073	12275	0.00053
Anaeromyxobacter_dehalogenans	161493	S	13710	9674	23384	0.00101
Vulgatibacter_incomptus	1391653	S	8668	668	9336	0.00040
Sorangium_cellulosum	56	S	116794	13851	130645	0.00565
Polyangium_aurulentum	2567896	S	28416	2445	30861	0.00134
Chondromyces_crocatus	52	S	12230	509	12739	0.00055
Pajaroellobacter_abortibovis	1882918	S	188	5	193	0.00001
Sandaracinus_amylolyticus	927083	S	46639	2439	49078	0.00212
Labilithrix_luteola	1391654	S	14340	603	14943	0.00065
Haliangium_ochraceum	80816	S	18115	950	19065	0.00082
Geomonas_sp._RF6	2897342	S	3478	433	3911	0.00017
Geomonas_paludis	2740185	S	2668	1373	4041	0.00017
Geomonas_nitrogeniifigens	2847991	S	2515	1321	3836	0.00017
Geomonas_subterranea	2847989	S	2117	1002	3119	0.00013
Geomonas_oryzisoli	2847992	S	1994	1116	3110	0.00013
Geobacter_sp._FeAm09	2597769	S	2275	287	2562	0.00011
Geobacter_sp._SVR	2495594	S	1614	232	1846	0.00008
Geobacter_sp._DSM_9736	1277350	S	1077	76	1153	0.00005
Geobacter_sulfurreducens	35554	S	2757	620	3377	0.00015
Geobacter_pickeringii	345632	S	2468	616	3084	0.00013
Geobacter_metallireducens	28232	S	1532	351	1883	0.00008
Geobacter_benzoatilyticus	2815309	S	1111	241	1352	0.00006
Citrifermentans_bremense	60035	S	2056	814	2870	0.00012
Citrifermentans_bemidjiense	225194	S	1939	704	2643	0.00011
Geotalea_uraniireducens	351604	S	1298	95	1393	0.00006
Geotalea_daltonii	1203471	S	730	57	787	0.00003
Geoalkalibacter_subterraneus	483547	S	1118	960	2078	0.00009
Trichlorobacter_lovleyi	313985	S	663	89	752	0.00003
Desulfuromonas_versatilis	2802975	S	4184	733	4917	0.00021
Desulfuromonas_sp._DDH964	1823759	S	3044	567	3611	0.00016
Desulfuromonas_sp._AOP6	1566351	S	1006	117	1123	0.00005
Desulfuromonas_soudanensis	1603606	S	2668	299	2967	0.00013
Pelobacter_propionicus	29543	S	1672	583	2255	0.00010
Syntrophotalea_acetylenica	29542	S	866	167	1033	0.00004
Syntrophotalea_carbinolica	19	S	625	48	673	0.00003
Syntrophotalea_acetylenivorans	1842532	S	510	74	584	0.00003
Pseudodesulfovibrio_mercurii	641491	S	2130	509	2639	0.00011
Pseudodesulfovibrio_indicus	1716143	S	1930	416	2346	0.00010
Pseudodesulfovibrio_aespoeensis	182210	S	1592	1104	2696	0.00012
Pseudodesulfovibrio_cashew	2678688	S	1227	240	1467	0.00006
Pseudodesulfovibrio_sp._SF6	2810563	S	535	53	588	0.00003
Pseudodesulfovibrio_sp._zrk46	2725288	S	462	78	540	0.00002
Pseudodesulfovibrio_tunisiensis	463192	S	867	85	952	0.00004
Pseudodesulfovibrio_profundus	57320	S	351	344	695	0.00003
Pseudodesulfovibrio_piezophilus	879567	S	156	21	177	0.00001
Desulfovibrio_sp._IOR2	2583823	S	1391	255	1646	0.00007
Desulfovibrio_sp._86	2666132	S	431	122	553	0.00002
Desulfovibrio_sp._G11	631220	S	325	236	561	0.00002
Desulfovibrio_vulgaris	881	S	1589	66	1655	0.00007
Desulfovibrio_sulfodismutans	63561	S	1531	372	1903	0.00008
Desulfovibrio_desulfuricans	876	S	1240	271	1511	0.00007
Desulfovibrio_piger	901	S	1125	212	1337	0.00006
Desulfovibrio_fairfieldensis	44742	S	899	75	974	0.00004
Desulfovibrio_ferrophilus	241368	S	570	45	615	0.00003
Candidatus_Desulfovibrio_trichonymphae	1725232	S	208	16	224	0.00001
Solidesulfovibrio_carbinoliphilus	345370	S	2902	349	3251	0.00014
Solidesulfovibrio_magneticus	184917	S	1317	756	2073	0.00009
Solidesulfovibrio_carbinolicus	296842	S	1139	880	2019	0.00009
Oceanidesulfovibrio_marinus	370038	S	2513	152	2665	0.00012
Desulfocurvibacter_africanus	873	S	1979	142	2121	0.00009
Desulfolutivibrio_sulfoxidireducens	2773299	S	1977	522	2499	0.00011
Megalodesulfovibrio_gigas	879	S	1380	66	1446	0.00006
Oleidesulfovibrio_alaskensis	58180	S	441	592	1033	0.00004
Maridesulfovibrio_salexigens	880	S	128	15	143	0.00001
Maridesulfovibrio_hydrothermalis	191026	S	84	10	94	0.00000
Paradesulfovibrio_bizertensis	376490	S	213	20	233	0.00001
Lawsonia_intracellularis	29546	S	35	0	35	0.00000
Desulfomicrobium_baculatum	899	S	1352	89	1441	0.00006
Desulfomicrobium_orale	132132	S	701	168	869	0.00004
Desulfohalobium_retbaense	45663	S	474	21	495	0.00002
Desulfosarcina_ovata	83564	S	1545	77	1622	0.00007
Desulfosarcina_alkanivorans	571177	S	1479	614	2093	0.00009
Desulfosarcina_widdelii	947919	S	1342	149	1491	0.00006
Desulfococcus_multivorans	897	S	1186	215	1401	0.00006
Desulfatibacillum_aliphaticivorans	218208	S	831	27	858	0.00004
Desulfoluna_sp._ASN36	2810562	S	686	35	721	0.00003
Desulfonema_magnum	45655	S	337	12	349	0.00002
Desulfonema_limicola	45656	S	61	5	66	0.00000
Desulfobacter_postgatei	2293	S	192	29	221	0.00001
Desulfobacter_hydrogenophilus	2291	S	173	29	202	0.00001
Desulforapulum_autotrophicum	2296	S	257	29	286	0.00001
Desulfobacula_toluolica	28223	S	93	7	100	0.00000
Desulfobulbus_propionicus	894	S	1308	75	1383	0.00006
Desulfobulbus_oralis	1986146	S	976	207	1183	0.00005
Desulfobulbus_oligotrophicus	1909699	S	249	206	455	0.00002
Desulfurivibrio_alkaliphilus	427923	S	1139	60	1199	0.00005
Desulfomarina_profundi	2772557	S	129	12	141	0.00001
Desulfosudis_oleivorans	181663	S	972	59	1031	0.00004
Desulfosediminicola_ganghwensis	2569540	S	343	38	381	0.00002
Desulfosediminicola_flagellatus	2569541	S	112	11	123	0.00001
Desulfotalea_psychrophila	84980	S	107	18	125	0.00001
Desulfocapsa_sulfexigens	65555	S	106	6	112	0.00000
Persicimonas_caeni	2292766	S	7060	222	7282	0.00032
Bradymonas_sediminis	1548548	S	2348	169	2517	0.00011
Bradymonadales_bacterium_V1718	2600177	S	811	38	849	0.00004
Syntrophobacter_fumaroxidans	119484	S	1685	677	2362	0.00010
Desulfoglaeba_alkanexedens	361111	S	1472	74	1546	0.00007
Desulfarculus_baarsii	453230	S	3134	1772	4906	0.00021
Desulfomonile_tiedjei	2358	S	617	6	623	0.00003
Desulfobacca_acetoxidans	60893	S	592	14	606	0.00003
Syntrophus_aciditrophicus	316277	S	518	32	550	0.00002
Dissulfurimicrobium_hydrothermale	1750598	S	274	16	290	0.00001
Candidatus_Desulfofervidus_auxilii	1621989	S	208	4	212	0.00001
Hippea_maritima	84405	S	43	1	44	0.00000
Campylobacter_gracilis	824	S	167	12	179	0.00001
Campylobacter_showae	204	S	162	15	177	0.00001
Campylobacter_concisus	199	S	143	21	164	0.00001
Campylobacter_curvus	200	S	140	15	155	0.00001
Campylobacter_sp._19-13652	2840180	S	23	3	26	0.00000
Campylobacter_sp._CCUG_57310	2517362	S	20	4	24	0.00000
Campylobacter_sp._RM6914	1032243	S	20	2	22	0.00000
Campylobacter_sp._RM16192	1660080	S	14	3	17	0.00000
Campylobacter_rectus	203	S	70	9	79	0.00000
Campylobacter_jejuni	197	S	38	265	303	0.00001
Campylobacter_pinnipediorum	1965231	S	27	4	31	0.00000
Campylobacter_hyointestinalis	198	S	26	7	33	0.00000
Campylobacter_iguaniorum	1244531	S	23	3	26	0.00000
Campylobacter_lari	201	S	18	8	26	0.00000
Campylobacter_fetus	196	S	17	20	37	0.00000
Campylobacter_coli	195	S	15	13	28	0.00000
Candidatus_Campylobacter_infans	2561898	S	14	1	15	0.00000
Campylobacter_mucosalis	202	S	14	1	15	0.00000
Campylobacter_lanienae	75658	S	13	3	16	0.00000
Campylobacter_helveticus	28898	S	11	5	16	0.00000
Campylobacter_hominis	76517	S	10	3	13	0.00000
Campylobacter_avium	522485	S	10	1	11	0.00000
Sulfurimonas_sp._HSL-3221	2894755	S	654	56	710	0.00003
Sulfurimonas_sp._SWIR-19	2878390	S	54	40	94	0.00000
Sulfurimonas_sp._B2	2590551	S	17	2	19	0.00000
Sulfurimonas_hydrogeniphila	2509341	S	40	11	51	0.00000
Sulfurimonas_paralvinellae	317658	S	25	3	28	0.00000
Sulfurimonas_gotlandica	1176482	S	15	1	16	0.00000
Sulfurimonas_autotrophica	202747	S	12	1	13	0.00000
Sulfuricurvum_kujiense	148813	S	69	5	74	0.00000
Helicobacter_pylori	210	S	196	74	270	0.00001
Helicobacter_sp._NHP19-0012	2849642	S	39	15	54	0.00000
Helicobacter_sp._NHP19-0003	2849641	S	32	8	40	0.00000
Helicobacter_heilmannii	35817	S	44	21	65	0.00000
Helicobacter_bizzozeronii	56877	S	37	5	42	0.00000
Helicobacter_suis	104628	S	35	11	46	0.00000
Helicobacter_canis	29419	S	32	13	45	0.00000
Helicobacter_typhlonius	76936	S	24	21	45	0.00000
Helicobacter_mustelae	217	S	22	7	29	0.00000
Helicobacter_bilis	37372	S	16	10	26	0.00000
Helicobacter_cinaedi	213	S	15	6	21	0.00000
Helicobacter_felis	214	S	15	2	17	0.00000
Helicobacter_himalayensis	1591088	S	12	2	14	0.00000
Helicobacter_pullorum	35818	S	12	3	15	0.00000
Helicobacter_enhydrae	222136	S	12	3	15	0.00000
Helicobacter_apodemus	135569	S	11	2	13	0.00000
Helicobacter_cholecystus	45498	S	10	3	13	0.00000
Wolinella_succinogenes	844	S	65	35	100	0.00000
Nitratifractor_salsuginis	269261	S	397	40	437	0.00002
Sulfurovum_sp._HSL1-3	2893889	S	53	19	72	0.00000
Sulfurovum_sp._NBC37-1	387093	S	41	25	66	0.00000
Sulfurovum_sp._XGS-02	2925411	S	24	3	27	0.00000
Sulfurovum_indicum	2779528	S	49	6	55	0.00000
Sulfurovum_lithotrophicum	206403	S	46	32	78	0.00000
Hydrogenimonas_urashimensis	2740515	S	442	58	500	0.00002
Aliarcobacter_cryaerophilus	28198	S	37	34	71	0.00000
Arcobacter_ellisii	913109	S	11	16	27	0.00000
Arcobacter_nitrofigilis	28199	S	10	3	13	0.00000
Arcobacter_suis	1278212	S	10	9	19	0.00000
Malaciobacter_canalis	1912871	S	11	20	31	0.00000
Malaciobacter_molluscorum	1032072	S	10	4	14	0.00000
Halarcobacter_anaerophilus	877500	S	23	6	29	0.00000
Poseidonibacter_lekithochrous	1904463	S	16	7	23	0.00000
Pseudoarcobacter_acticola	1849015	S	10	9	19	0.00000
Sulfurospirillum_cavolei	366522	S	66	6	72	0.00000
Sulfurospirillum_sp._UCH001	1581011	S	15	2	17	0.00000
Sulfurospirillum_sp._JPD-1	220622	S	10	44	54	0.00000
Sulfurospirillum_halorespirans	194424	S	43	30	73	0.00000
Sulfurospirillum_multivorans	66821	S	12	9	21	0.00000
Sulfurospirillum_barnesii	44674	S	11	0	11	0.00000
Nitrosophilus_alvini	2714855	S	89	31	120	0.00001
Nitrosophilus_labii	2706014	S	34	18	52	0.00000
Nitratiruptor_sp._YY09-18	2724901	S	28	34	62	0.00000
Nitratiruptor_sp._SB155-2	387092	S	23	43	66	0.00000
Caminibacter_mediatlanticus	291048	S	47	37	84	0.00000
Caminibacter_pacificus	1424653	S	23	15	38	0.00000
Nautilia_profundicola	244787	S	32	16	48	0.00000
Nautilia_sp._PV-1	2579250	S	11	5	16	0.00000
Acidithiobacillus_caldus	33059	S	860	118	978	0.00004
Acidithiobacillus_ferrivorans	160808	S	554	103	657	0.00003
Acidithiobacillus_ferrooxidans	920	S	409	355	764	0.00003
Acidithiobacillus_ferriphilus	1689834	S	234	45	279	0.00001
Acidithiobacillus_thiooxidans	930	S	214	12	226	0.00001
Acidithiobacillus_ferridurans	1232575	S	28	226	254	0.00001
Acidithiobacillus_sp._'AMD_consortium'	2614801	S	21	266	287	0.00001
Bdellovibrio_bacteriovorus	959	S	531	65	596	0.00003
Bdellovibrio_sp._LBG001	2835041	S	118	13	131	0.00001
Bdellovibrio_sp._ZAP7	2231053	S	75	28	103	0.00000
Bdellovibrio_sp._NC01	2220073	S	61	6	67	0.00000
Bdellovibrio_sp._KM01	2748865	S	53	21	74	0.00000
Pseudobdellovibrio_exovorus	453816	S	96	6	102	0.00000
Bacteriovorax_stolpii	960	S	111	23	134	0.00001
Halobacteriovorax_marinus	97084	S	43	17	60	0.00000
Halobacteriovorax_sp._BALOs_7	2109558	S	23	5	28	0.00000
Silvanigrella_aquatica	1915309	S	36	7	43	0.00000
Fluviispira_sanaruensis	2493639	S	31	6	37	0.00000
Hydrogenophilus_thermoluteolus	297	S	936	181	1117	0.00005
Mariprofundus_ferrinatatus	1921087	S	341	32	373	0.00002
Mariprofundus_aestuarium	1921086	S	188	20	208	0.00001
Gemmata_obscuriglobus	114	S	36450	5485	41935	0.00181
Gemmata_massiliana	1210884	S	15403	6541	21944	0.00095
Gemmata_sp._SH-PL17	1630693	S	14192	6791	20983	0.00091
Urbifossiella_limnaea	2528023	S	64642	5854	70496	0.00305
Frigoriglobus_tundricola	2774151	S	43922	7206	51128	0.00221
Limnoglobus_roseus	2598579	S	31365	1529	32894	0.00142
Tuwongella_immobilis	692036	S	2880	130	3010	0.00013
Telmatocola_sphagniphila	1123043	S	2488	26	2514	0.00011
Lacipirellula_limnantheis	2528024	S	18052	2545	20597	0.00089
Lacipirellula_parvula	2650471	S	17617	2121	19738	0.00085
Pirellulimonas_nuda	2528009	S	11734	1372	13106	0.00057
Botrimarina_mediterranea	2528022	S	10174	1025	11199	0.00048
Aeoliella_mucimassa	2527972	S	3822	343	4165	0.00018
Adhaeretor_mobilis	1930276	S	2397	252	2649	0.00011
Bythopirellula_goksoeyrii	1400387	S	2241	175	2416	0.00010
Lignipirellula_cremea	2528010	S	7425	932	8357	0.00036
Stieleria_maiorica	2795974	S	3296	719	4015	0.00017
Stieleria_neptunia	2527979	S	3113	376	3489	0.00015
Anatilimnocola_aggregata	2528021	S	6515	784	7299	0.00032
Rosistilla_oblonga	2527990	S	1853	920	2773	0.00012
Rosistilla_carotiformis	2528017	S	1365	609	1974	0.00009
Rosistilla_ulvae	1930277	S	1196	728	1924	0.00008
Bremerella_volcania	2527984	S	4809	388	5197	0.00022
Pirellula_staleyi	125	S	3600	149	3749	0.00016
Pirellula_sp._SH-Sr6A	1632865	S	937	27	964	0.00004
Roseimaritima_ulvae	980254	S	3057	218	3275	0.00014
Roseimaritima_multifibrata	1930274	S	816	101	917	0.00004
Rubripirellula_lacrimiformis	1930273	S	1623	341	1964	0.00008
Mariniblastus_fucicola	980251	S	1132	23	1155	0.00005
Rhodopirellula_baltica	265606	S	1124	84	1208	0.00005
Aureliella_helgolandensis	2527968	S	1031	88	1119	0.00005
Thermogutta_terrifontis	1331910	S	1274	42	1316	0.00006
Tautonia_plasticadhaerens	2527974	S	42555	3900	46455	0.00201
Aquisphaera_giovannonii	406548	S	29075	5226	34301	0.00148
Paludisphaera_borealis	1387353	S	18148	4261	22409	0.00097
Singulisphaera_acidiphila	466153	S	14897	2341	17238	0.00075
Isosphaera_pallida	128	S	3168	244	3412	0.00015
Planctomyces_sp._SH-PL62	1636152	S	18055	6943	24998	0.00108
Planctomyces_sp._SH-PL14	1632864	S	14201	937	15138	0.00065
Caulifigura_coniformis	2527983	S	9783	684	10467	0.00045
Gimesia_panareensis	2527978	S	2678	331	3009	0.00013
Gimesia_chilikensis	2605989	S	1514	935	2449	0.00011
Gimesia_maris	122	S	958	154	1112	0.00005
Gimesia_alba	2527973	S	676	124	800	0.00003
Gimesia_fumaroli	2527976	S	600	125	725	0.00003
Gimesia_algae	2527971	S	562	147	709	0.00003
Gimesia_aquarii	2527964	S	440	30	470	0.00002
Gimesia_benthica	2608982	S	420	602	1022	0.00004
Maioricimonas_rarisocia	2528026	S	8683	1175	9858	0.00043
Alienimonas_californiensis	2527989	S	7685	603	8288	0.00036
Symmachiella_dynata	2527995	S	3109	197	3306	0.00014
Rubinisphaera_brasiliensis	119	S	1925	204	2129	0.00009
Fuerstiella_marisgermanici	1891926	S	1739	33	1772	0.00008
Calycomorphotria_hydatis	2528027	S	1667	66	1733	0.00008
Planctopirus_ephydatiae	2528019	S	636	279	915	0.00004
Planctopirus_limnophila	120	S	548	225	773	0.00003
Crateriforma_conspicua	2527996	S	1519	340	1859	0.00008
Polystyrenella_longa	2528007	S	622	58	680	0.00003
Thalassoglobus_polymorphus	2527994	S	585	33	618	0.00003
Humisphaera_borealis	2807512	S	14415	370	14785	0.00064
Phycisphaera_mikurensis	547188	S	5512	463	5975	0.00026
Mucisphaera_calidilacus	2527982	S	2644	157	2801	0.00012
Poriferisphaera_corsica	2528020	S	339	2	341	0.00001
Anaerohalosphaera_lusitana	1936003	S	480	11	491	0.00002
Limihaloglobus_sulfuriphilus	1851148	S	256	11	267	0.00001
Sedimentisphaera_cyanobacteriorum	1940790	S	87	93	180	0.00001
Sedimentisphaera_salicampi	1941349	S	77	14	91	0.00000
Candidatus_Kuenenia_stuttgartiensis	174633	S	263	1	264	0.00001
Candidatus_Uabimicrobium_amorphum	2596890	S	137	2	139	0.00001
Opitutus_sp._GAS368	1882749	S	8722	1177	9899	0.00043
Opitutus_terrae	107709	S	7860	338	8198	0.00035
Lacunisphaera_limnophila	1838286	S	9615	1225	10840	0.00047
Nibricoccus_aquaticus	2576891	S	3543	145	3688	0.00016
Oleiharenicola_sp._KSB-15	2862869	S	3533	172	3705	0.00016
Ereboglobus_luteus	1796921	S	2359	106	2465	0.00011
Ruficoccus_sp._ZRK36	2866311	S	1185	168	1353	0.00006
Coraliomargarita_akajimensis	395922	S	297	7	304	0.00001
Verrucomicrobium_sp._GAS474	1882831	S	3620	351	3971	0.00017
Verrucomicrobium_spinosum	2736	S	2617	133	2750	0.00012
Roseimicrobium_sp._ORNL1	2711231	S	5144	157	5301	0.00023
Luteolibacter_luteus	2728835	S	2639	113	2752	0.00012
Luteolibacter_ambystomatis	2824561	S	2286	145	2431	0.00011
Sulfuriroseicoccus_oceanibius	2707525	S	658	60	718	0.00003
Akkermansia_muciniphila	239935	S	1298	158	1456	0.00006
Akkermansia_glycaniphila	1679444	S	519	42	561	0.00002
Methylacidimicrobium_sp._AP8	2730359	S	930	136	1066	0.00005
Methylacidimicrobium_sp._B4	2796139	S	859	161	1020	0.00004
Methylacidiphilum_sp._IT6	2795386	S	27	2	29	0.00000
Methylacidiphilum_sp._IT5	2795384	S	17	36	53	0.00000
Methylacidiphilum_kamchatkense	431057	S	44	2	46	0.00000
Methylacidiphilum_infernorum	511746	S	26	53	79	0.00000
Candidatus_Xiphinematobacter_sp._Idaho_Grape	1704307	S	162	10	172	0.00001
Kiritimatiella_glycovorans	1307763	S	1421	1538	2959	0.00013
Tichowtungia_aerotolerans	2697043	S	494	15	509	0.00002
Candidatus_Protochlamydia_naegleriophila	389348	S	65	25	90	0.00000
Candidatus_Protochlamydia_amoebophila	362787	S	43	16	59	0.00000
Parachlamydia_acanthamoebae	83552	S	43	9	52	0.00000
Neochlamydia_sp._S13	1353976	S	42	6	48	0.00000
Candidatus_Rhabdochlamydia_porcellionis	225148	S	13	31	44	0.00000
Candidatus_Rhabdochlamydia_oedothoracis	2720720	S	11	20	31	0.00000
Waddlia_chondrophila	71667	S	49	8	57	0.00000
Simkania_negevensis	83561	S	37	3	40	0.00000
Chlamydia_suis	83559	S	12	43	55	0.00000
Candidatus_Velamenicoccus_archaeovorus	1930593	S	432	1	433	0.00002
Hymenobacter_sp._PAMC_26628	1484118	S	1392	326	1718	0.00007
Hymenobacter_sp._5317J-9	2932250	S	1363	302	1665	0.00007
Hymenobacter_sp._PAMC_26554	1484116	S	1253	118	1371	0.00006
Hymenobacter_sp._APR13	1356852	S	1146	436	1582	0.00007
Hymenobacter_sp._BRD128	2675878	S	970	124	1094	0.00005
Hymenobacter_sp._5116S-3	2932248	S	777	111	888	0.00004
Hymenobacter_sp._5116S-27	2932249	S	771	113	884	0.00004
Hymenobacter_sp._BT18	2835648	S	737	89	826	0.00004
Hymenobacter_sp._DG01	2584940	S	656	165	821	0.00004
Hymenobacter_sp._NBH84	2596915	S	612	85	697	0.00003
Hymenobacter_sp._S2-20-2	2761579	S	574	82	656	0.00003
Hymenobacter_sp._5413J-13	2932251	S	557	75	632	0.00003
Hymenobacter_sp._5420S-77	2932254	S	526	67	593	0.00003
Hymenobacter_sp._BRD67	2675877	S	477	447	924	0.00004
Hymenobacter_sp._DG25B	1385664	S	463	158	621	0.00003
Hymenobacter_sp._DG25A	1385663	S	381	134	515	0.00002
Hymenobacter_sp._HDW8	2714932	S	223	701	924	0.00004
Hymenobacter_sp._5516S-25	2933777	S	191	733	924	0.00004
Hymenobacter_sp._5516J-16	2932253	S	190	774	964	0.00004
Hymenobacter_monticola	1705399	S	1363	239	1602	0.00007
Hymenobacter_busanensis	2607656	S	1351	137	1488	0.00006
Hymenobacter_oligotrophus	2319843	S	1136	113	1249	0.00005
Hymenobacter_sedentarius	1411621	S	1129	160	1289	0.00006
Hymenobacter_nivis	1850093	S	943	231	1174	0.00005
Hymenobacter_jejuensis	2502781	S	857	58	915	0.00004
Hymenobacter_swuensis	1446467	S	697	146	843	0.00004
Hymenobacter_tibetensis	497967	S	546	79	625	0.00003
Hymenobacter_qilianensis	1385715	S	470	80	550	0.00002
Hymenobacter_baengnokdamensis	2615203	S	467	490	957	0.00004
Hymenobacter_radiodurans	2496028	S	247	812	1059	0.00005
Pontibacter_russatus	2694929	S	2455	219	2674	0.00012
Pontibacter_pudoricolor	2694930	S	1711	175	1886	0.00008
Pontibacter_actiniarum	323450	S	967	220	1187	0.00005
Pontibacter_akesuensis	388950	S	671	91	762	0.00003
Pontibacter_korlensis	400092	S	436	58	494	0.00002
Pontibacter_sp._SGAir0037	2571030	S	385	61	446	0.00002
Rufibacter_radiotolerans	1379910	S	731	73	804	0.00003
Rufibacter_tibetensis	512763	S	507	73	580	0.00003
Rufibacter_sp._DG15C	1379909	S	436	197	633	0.00003
Adhaeribacter_radiodurans	2745197	S	671	71	742	0.00003
Adhaeribacter_swui	2086471	S	609	75	684	0.00003
Nibribacter_ruber	2698458	S	389	172	561	0.00002
Spirosoma_sp._CJU-R4	2728024	S	770	50	820	0.00004
Spirosoma_sp._KUDC1026	2745947	S	472	36	508	0.00002
Spirosoma_sp._RHs26	2898794	S	294	18	312	0.00001
Spirosoma_sp._KCTC_42546	2520506	S	272	29	301	0.00001
Spirosoma_sp._KCTC_72228	2710596	S	228	25	253	0.00001
Spirosoma_rigui	564064	S	578	36	614	0.00003
Spirosoma_taeanense	2735870	S	572	45	617	0.00003
Spirosoma_montaniterrae	1178516	S	479	26	505	0.00002
Spirosoma_pollinicola	2057025	S	322	35	357	0.00002
Spirosoma_radiotolerans	1379870	S	307	20	327	0.00001
Spirosoma_aerolatum	1211326	S	301	12	313	0.00001
Spirosoma_endbachense	2666025	S	237	118	355	0.00002
Spirosoma_aureum	2692134	S	233	140	373	0.00002
Rhodocytophaga_rosea	2704465	S	470	14	484	0.00002
Cytophaga_hutchinsonii	985	S	134	10	144	0.00001
Aquirufa_nivalisilvae	2516557	S	51	12	63	0.00000
Aquirufa_sp._9H-EGSE	2696560	S	51	15	66	0.00000
Dyadobacter_fermentans	94254	S	1072	95	1167	0.00005
Dyadobacter_sp._LJ419	2906456	S	244	16	260	0.00001
Dyadobacter_sp._NIV53	2861765	S	122	7	129	0.00001
Dyadobacter_sandarakinus	2747268	S	335	31	366	0.00002
Fibrella_aestuarina	651143	S	973	68	1041	0.00005
Fibrella_sp._ES10-3-2-2	1834519	S	475	30	505	0.00002
Runella_slithyformis	106	S	315	22	337	0.00001
Runella_rosea	2259595	S	227	19	246	0.00001
Runella_sp._SP2	2268026	S	183	9	192	0.00001
Larkinella_sp._IE-0392	2907205	S	273	16	289	0.00001
Leadbetterella_byssophila	316068	S	67	27	94	0.00000
Arcticibacterium_luteifluviistationis	1784714	S	53	3	56	0.00000
Chryseolinea_soli	2321403	S	2512	67	2579	0.00011
Fulvivirga_sp._SS9-22	2904245	S	155	11	166	0.00001
Fulvivirga_sp._W9P-11	2904246	S	104	29	133	0.00001
Fulvivirga_sp._SW1-E11	2904247	S	85	32	117	0.00001
Fulvivirga_lutea	2810512	S	99	8	107	0.00000
Echinicola_sp._SCS_3-6	2859768	S	71	25	96	0.00000
Echinicola_sp._20G	2781961	S	60	6	66	0.00000
Echinicola_strongylocentroti	1795355	S	110	16	126	0.00001
Echinicola_vietnamensis	390884	S	106	44	150	0.00001
Echinicola_rosea	1807691	S	94	35	129	0.00001
Echinicola_soli	2591634	S	83	6	89	0.00000
Algoriphagus_sp._Y33	2772483	S	96	6	102	0.00000
Algoriphagus_sp._NBT04N3	2705473	S	59	15	74	0.00000
Algoriphagus_sanaruensis	1727163	S	88	7	95	0.00000
Algoriphagus_machipongonensis	388413	S	71	4	75	0.00000
Cyclobacterium_amurskyense	320787	S	61	6	67	0.00000
Cyclobacterium_marinum	104	S	57	12	69	0.00000
Aquiflexum_balticum	280473	S	90	11	101	0.00000
Mongoliitalea_daihaiensis	2782006	S	58	5	63	0.00000
Belliella_baltica	232259	S	49	19	68	0.00000
Flammeovirga_pectinis	2494373	S	46	12	58	0.00000
Flammeovirga_kamogawensis	373891	S	24	6	30	0.00000
Flammeovirga_yaeyamensis	367791	S	23	44	67	0.00000
Candidatus_Amoebophilus_asiaticus	281120	S	72	1	73	0.00000
Candidatus_Cardinium_hertigii	247481	S	21	3	24	0.00000
Marivirga_tractuosa	1006	S	99	28	127	0.00001
Mangrovivirga_cuniculi	2715131	S	76	4	80	0.00000
Bernardetia_litoralis	999	S	46	3	49	0.00000
Flavobacterium_sp._MDT1-60	1979344	S	771	133	904	0.00004
Flavobacterium_sp._M31R6	2739062	S	681	90	771	0.00003
Flavobacterium_sp._CLA17	2724135	S	569	89	658	0.00003
Flavobacterium_sp._KBS0721	1179672	S	465	128	593	0.00003
Flavobacterium_sp._MMS21-Er5	2937442	S	432	152	584	0.00003
Flavobacterium_sp._B183	907046	S	417	80	497	0.00002
Flavobacterium_sp._F-70	2893884	S	409	73	482	0.00002
Flavobacterium_sp._F-323	2893885	S	402	75	477	0.00002
Flavobacterium_sp._F-29	2893883	S	395	75	470	0.00002
Flavobacterium_sp._SLB02	2665645	S	364	67	431	0.00002
Flavobacterium_sp._Sr18	935222	S	354	53	407	0.00002
Flavobacterium_sp._140616W15	2478552	S	326	61	387	0.00002
Flavobacterium_sp._HJ-32-4	1160795	S	311	18	329	0.00001
Flavobacterium_sp._K5-23	2746225	S	299	61	360	0.00002
Flavobacterium_sp._LPB0248	2614441	S	279	123	402	0.00002
Flavobacterium_sp._F-340	2893886	S	260	70	330	0.00001
Flavobacterium_sp._IGB_4-14	1871076	S	181	13	194	0.00001
Flavobacterium_sp._GENT5	1751095	S	156	30	186	0.00001
Flavobacterium_sp._KSM-R2A30	2897181	S	146	42	188	0.00001
Flavobacterium_sp._KSM-R2A25	2895947	S	114	26	140	0.00001
Flavobacterium_sp._CECT_9288	2845819	S	113	109	222	0.00001
Flavobacterium_sp._CHNK8	2871165	S	109	105	214	0.00001
Flavobacterium_sp._CJ74	2294119	S	86	5	91	0.00000
Flavobacterium_sp._GENT11	1751100	S	80	191	271	0.00001
Flavobacterium_sp._SHINM13	1751056	S	78	172	250	0.00001
Flavobacterium_sp._KK2020170	2830782	S	70	17	87	0.00000
Flavobacterium_sp._I3-2	2748319	S	53	63	116	0.00001
Flavobacterium_sp._WSW3-B6	2856519	S	52	5	57	0.00000
Flavobacterium_sp._CS20	2775246	S	48	14	62	0.00000
Flavobacterium_sp._xlx-214	2654325	S	41	7	48	0.00000
Flavobacterium_commune	1306519	S	6958	916	7874	0.00034
Flavobacterium_anhuiense	459526	S	967	305	1272	0.00006
Flavobacterium_endoglycinae	2816357	S	905	161	1066	0.00005
Flavobacterium_gilvum	1492737	S	853	105	958	0.00004
Flavobacterium_johnsoniae	986	S	595	215	810	0.00004
Flavobacterium_crocinum	2183896	S	466	113	579	0.00003
Flavobacterium_nackdongense	2547394	S	448	33	481	0.00002
Flavobacterium_fluviale	2249356	S	354	109	463	0.00002
Flavobacterium_nitrogenifigens	1617283	S	332	137	469	0.00002
Flavobacterium_faecale	1355330	S	202	22	224	0.00001
Flavobacterium_magnum	2162713	S	191	17	208	0.00001
Flavobacterium_album	2175091	S	182	11	193	0.00001
Flavobacterium_sangjuense	2518177	S	168	15	183	0.00001
Flavobacterium_pallidum	2172098	S	152	12	164	0.00001
Flavobacterium_psychrophilum	96345	S	146	41	187	0.00001
Flavobacterium_crassostreae	1763534	S	115	25	140	0.00001
Flavobacterium_inviolabile	2748320	S	107	13	120	0.00001
Flavobacterium_enshiense	1341165	S	101	9	110	0.00000
Flavobacterium_branchiophilum	55197	S	92	7	99	0.00000
Flavobacterium_sediminis	2201181	S	91	70	161	0.00001
Flavobacterium_alkalisoli	2602769	S	85	6	91	0.00000
Flavobacterium_kingsejongi	1678728	S	80	9	89	0.00000
Flavobacterium_sediminilitoris	2024526	S	77	8	85	0.00000
Flavobacterium_jumunjinense	998845	S	76	10	86	0.00000
Flavobacterium_haoranii	683124	S	64	21	85	0.00000
Flavobacterium_indicum	312277	S	63	8	71	0.00000
Flavobacterium_columnare	996	S	58	84	142	0.00001
Flavobacterium_oreochromis	2906078	S	51	16	67	0.00000
Flavobacterium_davisii	2906077	S	48	15	63	0.00000
Flavobacterium_covae	2906076	S	41	43	84	0.00000
Flavobacterium_arcticum	1784713	S	33	3	36	0.00000
Muricauda_sp._SCSIO_65647	2908843	S	89	3	92	0.00000
Muricauda_sp._SCSIO_64092	2908842	S	62	1	63	0.00000
Muricauda_aquimarina	254955	S	91	38	129	0.00001
Muricauda_ruestringensis	111501	S	86	7	93	0.00000
Muricauda_lutaonensis	516051	S	86	16	102	0.00000
Muricauda_oceani	2698672	S	68	29	97	0.00000
Muricauda_aurantiaca	1383885	S	58	4	62	0.00000
Capnocytophaga_sp._oral_taxon_902	2748316	S	37	72	109	0.00000
Capnocytophaga_sp._oral_taxon_878	1316596	S	26	8	34	0.00000
Capnocytophaga_sp._FDAARGOS_737	2545799	S	15	8	23	0.00000
Capnocytophaga_canimorsus	28188	S	69	15	84	0.00000
Capnocytophaga_gingivalis	1017	S	64	7	71	0.00000
Capnocytophaga_sputigena	1019	S	61	19	80	0.00000
Capnocytophaga_haemolytica	45243	S	55	4	59	0.00000
Capnocytophaga_ochracea	1018	S	27	33	60	0.00000
Capnocytophaga_stomatis	1848904	S	18	3	21	0.00000
Capnocytophaga_endodontalis	2708117	S	16	6	22	0.00000
Capnocytophaga_cynodegmi	28189	S	12	2	14	0.00000
Polaribacter_sp._SM13	2818493	S	56	12	68	0.00000
Polaribacter_sp._SA4-10	754397	S	32	6	38	0.00000
Polaribacter_sp._NJDZ03	2855841	S	24	25	49	0.00000
Polaribacter_sp._G4M1	2808900	S	24	5	29	0.00000
Polaribacter_sp._KT25b	1855336	S	21	7	28	0.00000
Polaribacter_sp._Hel1_33_78	1336804	S	20	3	23	0.00000
Polaribacter_sp._L12M9	2738844	S	19	9	28	0.00000
Polaribacter_sp._SA4-12	1312072	S	18	5	23	0.00000
Polaribacter_sp._ALD11	2058137	S	17	5	22	0.00000
Polaribacter_sp._L3A8	2686361	S	17	12	29	0.00000
Polaribacter_sp._Q13	2806551	S	16	9	25	0.00000
Polaribacter_sp._MED152	313598	S	16	2	18	0.00000
Polaribacter_litorisediminis	1908341	S	32	3	35	0.00000
Polaribacter_reichenbachii	996801	S	29	3	32	0.00000
Polaribacter_vadi	1774273	S	24	3	27	0.00000
Polaribacter_sejongensis	985043	S	21	13	34	0.00000
Gramella_sp._GC03-9	2920386	S	67	14	81	0.00000
Gramella_sp._MT6	2705471	S	44	5	49	0.00000
Gramella_sp._MAR_2010_147	1250205	S	34	3	37	0.00000
Gramella_flava	1486245	S	104	26	130	0.00001
Gramella_fulva	2126553	S	85	6	91	0.00000
Gramella_forsetii	411153	S	56	11	67	0.00000
Gramella_echinicola	279359	S	42	4	46	0.00000
Gramella_salexigens	1913577	S	41	3	44	0.00000
Robiginitalea_biformata	252307	S	328	17	345	0.00001
Nonlabens_sp._Hel1_33_55	1336802	S	39	2	41	0.00000
Nonlabens_sp._MB-3u-79	2058134	S	26	3	29	0.00000
Nonlabens_sp._Ci31	2608253	S	21	2	23	0.00000
Nonlabens_sp._MIC269	1476901	S	14	34	48	0.00000
Nonlabens_ponticola	2496866	S	55	3	58	0.00000
Nonlabens_spongiae	331648	S	48	13	61	0.00000
Nonlabens_dokdonensis	328515	S	24	2	26	0.00000
Nonlabens_marinus	930802	S	24	3	27	0.00000
Winogradskyella_sp._HaHa_3_26	2749995	S	32	13	45	0.00000
Winogradskyella_sp._PC-19	754417	S	24	6	30	0.00000
Winogradskyella_sp._PG-2	754409	S	23	2	25	0.00000
Winogradskyella_sp._MH6	2929510	S	23	6	29	0.00000
Winogradskyella_sp._J14-2	1936080	S	19	5	24	0.00000
Winogradskyella_forsetii	2686077	S	53	18	71	0.00000
Winogradskyella_schleiferi	2686078	S	27	14	41	0.00000
Winogradskyella_sediminis	1382466	S	25	6	31	0.00000
Winogradskyella_helgolandensis	2697010	S	20	4	24	0.00000
Tenacibaculum_sp._SZ-18	754423	S	28	24	52	0.00000
Tenacibaculum_jejuense	584609	S	29	2	31	0.00000
Tenacibaculum_todarodis	1850252	S	28	7	35	0.00000
Tenacibaculum_maritimum	107401	S	26	6	32	0.00000
Tenacibaculum_mesophilum	104268	S	21	8	29	0.00000
Tenacibaculum_singaporense	2358479	S	20	6	26	0.00000
Tenacibaculum_dicentrarchi	669041	S	16	6	22	0.00000
Aequorivita_sp._H23M31	2494375	S	61	26	87	0.00000
Aequorivita_sublithincola	101385	S	51	47	98	0.00000
Cellulophaga_sp._L1A9	2686362	S	25	15	40	0.00000
Cellulophaga_sp._HaHaR_3_176	1942464	S	22	5	27	0.00000
Cellulophaga_algicola	59600	S	32	6	38	0.00000
Cellulophaga_baltica	76594	S	29	18	47	0.00000
Cellulophaga_lytica	979	S	27	10	37	0.00000
Myroides_fluvii	2572594	S	46	18	64	0.00000
Myroides_odoratus	256	S	45	14	59	0.00000
Myroides_phaeus	702745	S	28	22	50	0.00000
Antarcticibacterium_flavum	2058175	S	57	9	66	0.00000
Antarcticibacterium_arcticum	2585771	S	57	5	62	0.00000
Antarcticibacterium_sp._1MA-6-2	2908210	S	52	5	57	0.00000
Maribacter_sp._MJ134	2496865	S	40	3	43	0.00000
Maribacter_sp._HTCC2170	313603	S	24	1	25	0.00000
Maribacter_sp._1_2014MBL_MicDiv	1644130	S	12	11	23	0.00000
Maribacter_cobaltidurans	1178778	S	35	22	57	0.00000
Maribacter_hydrothermalis	1836467	S	26	3	29	0.00000
Maribacter_dokdonensis	320912	S	10	9	19	0.00000
Kordia_antarctica	1218801	S	113	7	120	0.00001
Kordia_sp._SMS9	2282170	S	49	2	51	0.00000
Formosa_sp._Hel1_33_131	1336794	S	31	3	34	0.00000
Formosa_sp._Hel1_31_208	1798225	S	27	2	29	0.00000
Formosa_sp._L2A11	2686363	S	25	7	32	0.00000
Formosa_sp._Hel3_A1_48	1336795	S	19	4	23	0.00000
Formosa_agariphila	320324	S	23	4	27	0.00000
Formosa_sediminum	2594004	S	21	4	25	0.00000
Sinomicrobium_sp._HD2P242	2900738	S	142	5	147	0.00001
Salegentibacter_salegens	143223	S	47	6	53	0.00000
Salegentibacter_sp._T436	1729720	S	41	31	72	0.00000
Salegentibacter_mishustinae	270918	S	37	25	62	0.00000
Aquimarina_sp._TRL1	2736252	S	35	2	37	0.00000
Aquimarina_sp._BL5	1714860	S	32	3	35	0.00000
Aquimarina_sp._AD1	1714848	S	26	3	29	0.00000
Aquimarina_sp._AD10	1714849	S	25	1	26	0.00000
Algibacter_sp._L3A6	2686366	S	42	13	55	0.00000
Algibacter_sp._L1A34	2686365	S	29	9	38	0.00000
Algibacter_alginicilyticus	1736674	S	31	6	37	0.00000
Zunongwangia_sp._SCSIO_43204	2779359	S	54	26	80	0.00000
Zunongwangia_profunda	398743	S	48	28	76	0.00000
Lacinutrix_sp._WUR7	2653681	S	29	5	34	0.00000
Lacinutrix_sp._Bg11-31	2057808	S	20	3	23	0.00000
Lacinutrix_sp._5H-3-7-4	983544	S	18	5	23	0.00000
Lacinutrix_venerupis	1486034	S	21	3	24	0.00000
Flagellimonas_sp._CMM7	2654676	S	60	3	63	0.00000
Flagellimonas_sp._HMM57	2905121	S	27	1	28	0.00000
Dokdonia_sp._PRO95	1239415	S	14	7	21	0.00000
Dokdonia_sp._4H-3-7-5	983548	S	12	11	23	0.00000
Dokdonia_sp._MED134	313590	S	11	7	18	0.00000
Dokdonia_donghaensis	326320	S	15	6	21	0.00000
Mariniflexile_sp._TRM1-10	2027857	S	78	5	83	0.00000
Aggregatimonas_sangjinii	2583587	S	73	3	76	0.00000
Lutibacter_profundi	1622118	S	37	2	39	0.00000
Lutibacter_sp._A64	2918526	S	16	4	20	0.00000
Lutibacter_sp._A80	2918453	S	13	3	16	0.00000
Leeuwenhoekiella_palythoae	573501	S	26	18	44	0.00000
Leeuwenhoekiella_sp._ZYFB001	2719912	S	20	11	31	0.00000
Zobellia_galactanivorans	63186	S	62	3	65	0.00000
Tamlana_carrageenivorans	2069432	S	31	10	41	0.00000
Tamlana_sp._s12	1630406	S	20	7	27	0.00000
Muriicola_soli	2507538	S	58	3	61	0.00000
Flavobacteriaceae_bacterium_10Alg115	2584122	S	58	3	61	0.00000
Arenibacter_algicola	616991	S	56	13	69	0.00000
Psychroflexus_torquis	57029	S	34	1	35	0.00000
Psychroflexus_sp._ALD_RP9	2777186	S	19	1	20	0.00000
Seonamhaeicola_sp._ML3	2937786	S	29	2	31	0.00000
Seonamhaeicola_sp._S2-3	1936081	S	23	4	27	0.00000
Mesoflavibacter_sp._SCSIO_43206	2779362	S	17	34	51	0.00000
Pukyongia_salina	2094025	S	49	2	51	0.00000
Galbibacter_sp._BG1	1170699	S	48	4	52	0.00000
Euzebyella_marina	1761453	S	47	18	65	0.00000
Zhouia_spongiae	2202721	S	46	8	54	0.00000
Constantimarinum_furrinae	2562285	S	43	3	46	0.00000
Aegicerativicinus_sediminis	2893202	S	40	2	42	0.00000
Changchengzhania_lutea	2049305	S	37	3	40	0.00000
Costertonia_aggregata	343403	S	36	6	42	0.00000
Olleya_sp._Bg11-27	2058135	S	11	25	36	0.00000
Olleya_aquimaris	639310	S	12	4	16	0.00000
Marixanthomonas_sp._SCSIO_43207	2779360	S	34	7	41	0.00000
Flavivirga_eckloniae	1803846	S	34	2	36	0.00000
Gilvibacter_sp._SZ-19	754429	S	32	3	35	0.00000
Sediminicola_sp._YIK13	1453352	S	32	2	34	0.00000
Croceibacter_atlanticus	313588	S	31	4	35	0.00000
Wenyingzhuangia_fucanilytica	1790137	S	30	4	34	0.00000
Siansivirga_zeaxanthinifaciens	762954	S	28	5	33	0.00000
Sabulilitoribacter_sp._BrNp1-15	2916754	S	27	4	31	0.00000
Oceanihabitans_sp._IOP_32	2529032	S	26	8	34	0.00000
Bizionia_sp._M204	2675331	S	26	4	30	0.00000
Gillisia_sp._Hel1_33_143	1336796	S	25	6	31	0.00000
Urechidicola_croceus	1850246	S	23	9	32	0.00000
Amniculibacterium_sp._G2-70	2767188	S	22	21	43	0.00000
Psychroserpens_sp._NJDZ02	2570561	S	13	20	33	0.00000
Chryseobacterium_sp._6424	2039166	S	105	26	131	0.00001
Chryseobacterium_sp.	1871047	S	62	26	88	0.00000
Chryseobacterium_sp._F4	2852098	S	52	3	55	0.00000
Chryseobacterium_sp._cx-624	2758037	S	49	9	58	0.00000
Chryseobacterium_sp._SC2-2	2929800	S	47	28	75	0.00000
Chryseobacterium_sp._ZHDP1	2838877	S	44	37	81	0.00000
Chryseobacterium_sp._G0201	2487065	S	41	12	53	0.00000
Chryseobacterium_sp._Y16C	2920939	S	36	25	61	0.00000
Chryseobacterium_sp._IHB_B_17019	1721091	S	34	6	40	0.00000
Chryseobacterium_sp._LJ668	2864040	S	33	6	39	0.00000
Chryseobacterium_sp._StRB126	878220	S	29	10	39	0.00000
Chryseobacterium_sp._POL2	2713414	S	28	19	47	0.00000
Chryseobacterium_sp._MEBOG07	2879939	S	28	9	37	0.00000
Chryseobacterium_sp._C-17	2898076	S	27	15	42	0.00000
Chryseobacterium_sp._DH-B6	2759528	S	27	13	40	0.00000
Chryseobacterium_sp._3008163	2478663	S	27	15	42	0.00000
Chryseobacterium_sp._SNU_WT5	2594269	S	26	9	35	0.00000
Chryseobacterium_sp._PCH239	2825845	S	26	22	48	0.00000
Chryseobacterium_sp._T16E-39	2015076	S	25	3	28	0.00000
Chryseobacterium_sp._MEBOG06	2879938	S	24	6	30	0.00000
Chryseobacterium_sp._ADR-1	2929799	S	23	8	31	0.00000
Chryseobacterium_sp._G0186	2487064	S	20	14	34	0.00000
Chryseobacterium_indologenes	253	S	125	62	187	0.00001
Chryseobacterium_taklimakanense	536441	S	103	56	159	0.00001
Chryseobacterium_indoltheticum	254	S	88	23	111	0.00000
Chryseobacterium_shandongense	1493872	S	85	55	140	0.00001
Chryseobacterium_camelliae	1265445	S	80	46	126	0.00001
Chryseobacterium_arthrosphaerae	651561	S	68	37	105	0.00000
Chryseobacterium_gallinarum	1324352	S	53	19	72	0.00000
Chryseobacterium_gleum	250	S	48	64	112	0.00000
Chryseobacterium_salivictor	2547600	S	47	6	53	0.00000
Chryseobacterium_carnipullorum	1124835	S	45	17	62	0.00000
Chryseobacterium_daecheongense	192389	S	41	7	48	0.00000
Chryseobacterium_aureum	2497456	S	40	10	50	0.00000
Chryseobacterium_nepalense	1854498	S	39	6	45	0.00000
Chryseobacterium_cucumeris	1813611	S	39	25	64	0.00000
Chryseobacterium_lactis	1241981	S	31	32	63	0.00000
Chryseobacterium_manosquense	2754694	S	29	23	52	0.00000
Chryseobacterium_piperi	558152	S	28	3	31	0.00000
Chryseobacterium_balustinum	246	S	27	10	37	0.00000
Chryseobacterium_nakagawai	1241982	S	20	33	53	0.00000
Chryseobacterium_glaciei	1685010	S	20	4	24	0.00000
Chryseobacterium_joostei	112234	S	20	8	28	0.00000
Chryseobacterium_bernardetii	1241978	S	10	89	99	0.00000
Kaistella_sp._97-N-M2	2908645	S	64	8	72	0.00000
Kaistella_sp._GW4-15	2878534	S	24	2	26	0.00000
Kaistella_daneshvariae	2487074	S	83	8	91	0.00000
Candidatus_Kaistella_beijingensis	2820270	S	41	15	56	0.00000
Kaistella_jeonii	266749	S	35	2	37	0.00000
Kaistella_flava_(ex_Peng_et_al._2021)	2038776	S	34	6	40	0.00000
Kaistella_antarctica	266748	S	27	2	29	0.00000
Kaistella_carnis	1241979	S	20	6	26	0.00000
Epilithonimonas_vandammei	2487072	S	44	66	110	0.00000
Epilithonimonas_zeae	1416779	S	36	5	41	0.00000
Elizabethkingia_meningoseptica	238	S	40	3	43	0.00000
Elizabethkingia_anophelis	1117645	S	39	52	91	0.00000
Elizabethkingia_sp._JS20170427COW	2583851	S	27	4	31	0.00000
Elizabethkingia_sp._2-6	2575699	S	10	23	33	0.00000
Elizabethkingia_miricola	172045	S	36	33	69	0.00000
Elizabethkingia_ursingii	1756150	S	19	5	24	0.00000
Cruoricaptor_ignavus	1118202	S	96	13	109	0.00000
Empedobacter_brevis	247	S	35	13	48	0.00000
Empedobacter_falsenii	343874	S	34	22	56	0.00000
Empedobacter_stercoris	1628248	S	20	7	27	0.00000
Apibacter_raozihei	2500547	S	19	28	47	0.00000
Ornithobacterium_rhinotracheale	28251	S	71	48	119	0.00001
Cloacibacterium_caeni	2004710	S	36	36	72	0.00000
Cloacibacterium_normanense	237258	S	14	10	24	0.00000
Riemerella_anatipestifer	34085	S	37	14	51	0.00000
Weeksella_virosa	1014	S	34	14	48	0.00000
Bergeyella_cardium	1585976	S	28	5	33	0.00000
Faecalibacter_bovis	2898187	S	19	3	22	0.00000
Blattabacterium_cuenoti	1653831	S	178	69	247	0.00001
Fluviicola_taffensis	191579	S	123	5	128	0.00001
Crocinitomix_sp._GM2_3_6_6	2862509	S	42	0	42	0.00000
Owenweeksia_hongkongensis	253245	S	79	4	83	0.00000
Croceimicrobium_hydrocarbonivorans	2761580	S	52	8	60	0.00000
Candidatus_Sulcia_muelleri	336810	S	30	7	37	0.00000
Candidatus_Walczuchella_monophlebidarum	1415657	S	14	0	14	0.00000
Rhodocaloribacter_litoris	2558931	S	7125	686	7811	0.00034
Rhodothermus_marinus	29549	S	5903	321	6224	0.00027
Salinibacter_ruber	146919	S	3960	61	4021	0.00017
Chitinophaga_sp._XS-30	2604421	S	727	246	973	0.00004
Chitinophaga_sp._KRA15-503	2829818	S	358	180	538	0.00002
Chitinophaga_oryzae	2725414	S	599	80	679	0.00003
Chitinophaga_filiformis	104663	S	396	56	452	0.00002
Chitinophaga_alhagiae	2203219	S	372	6	378	0.00002
Chitinophaga_pinensis	79329	S	301	56	357	0.00002
Chitinophaga_agri	2703787	S	216	49	265	0.00001
Chitinophaga_caeni	2029983	S	180	24	204	0.00001
Niastella_koreensis	354356	S	2054	204	2258	0.00010
Flavisolibacter_tropicus	1492898	S	1055	147	1202	0.00005
Flavisolibacter_ginsenosidimutans	661481	S	761	42	803	0.00003
Pseudocnuella_soli	2502779	S	1397	159	1556	0.00007
Paraflavitalea_soli	2315862	S	1085	78	1163	0.00005
Flavihumibacter_sp._IMCC34838	2838156	S	501	42	543	0.00002
Flavihumibacter_sp._IMCC34837	2838157	S	398	26	424	0.00002
Lacibacter_sp._S13-6-6	2760713	S	800	34	834	0.00004
Pseudobacter_ginsenosidimutans	661488	S	659	54	713	0.00003
Niabella_ginsenosidivorans	1176587	S	299	30	329	0.00001
Niabella_soli	446683	S	295	35	330	0.00001
Arachidicoccus_sp._BS20	1850526	S	153	40	193	0.00001
Arachidicoccus_sp._5GH13-10	2875539	S	134	13	147	0.00001
Arachidicoccus_sp._B3-10	2545455	S	94	6	100	0.00000
Arachidicoccus_ginsenosidivorans	496057	S	108	10	118	0.00001
Arachidicoccus_soli	2341117	S	92	7	99	0.00000
Phnomibacter_ginsenosidimutans	2676868	S	414	46	460	0.00002
Ferruginibacter_sp._KIS38-8	2875540	S	192	19	211	0.00001
Ferruginibacter_lapsinanis	563172	S	149	14	163	0.00001
Filimonas_lacunae	477680	S	325	36	361	0.00002
Panacibacter_ginsenosidivorans	1813871	S	322	14	336	0.00001
Alistipes_dispar	2585119	S	854	97	951	0.00004
Alistipes_communis	2585118	S	838	497	1335	0.00006
Alistipes_onderdonkii	328813	S	762	744	1506	0.00007
Alistipes_finegoldii	214856	S	760	601	1361	0.00006
Alistipes_megaguti	2364787	S	625	64	689	0.00003
Alistipes_senegalensis	1288121	S	617	126	743	0.00003
Alistipes_shahii	328814	S	540	280	820	0.00004
Alistipes_sp._dk3624	2662363	S	492	88	580	0.00003
Alistipes_indistinctus	626932	S	478	80	558	0.00002
Prevotella_sp._Rep29	2691580	S	96	8	104	0.00000
Prevotella_sp._E13-17	2913616	S	93	6	99	0.00000
Prevotella_sp._oral_taxon_475	712471	S	84	6	90	0.00000
Prevotella_sp._E15-22	2937774	S	79	11	90	0.00000
Prevotella_sp._E9-3	2913621	S	52	9	61	0.00000
Prevotella_sp._E2-28	2913620	S	44	4	48	0.00000
Prevotella_sp._E13-3	2913617	S	10	111	121	0.00001
Prevotella_dentalis	52227	S	420	79	499	0.00002
Prevotella_multiformis	282402	S	138	55	193	0.00001
Prevotella_denticola	28129	S	134	41	175	0.00001
Prevotella_intermedia	28131	S	114	47	161	0.00001
Prevotella_melaninogenica	28132	S	87	28	115	0.00000
Prevotella_copri	165179	S	78	28	106	0.00000
Prevotella_ruminicola	839	S	73	3	76	0.00000
Prevotella_enoeca	76123	S	70	12	82	0.00000
Prevotella_buccalis	28127	S	55	47	102	0.00000
Prevotella_oris	28135	S	38	4	42	0.00000
Prevotella_jejuni	1177574	S	29	10	39	0.00000
Prevotella_nigrescens	28133	S	29	16	45	0.00000
Prevotella_fusca	589436	S	23	4	27	0.00000
Prevotella_bryantii	77095	S	17	1	18	0.00000
Prevotella_herbatica	2801997	S	15	0	15	0.00000
Prevotella_veroralis	28137	S	11	2	13	0.00000
Prevotella_scopos	589437	S	11	5	16	0.00000
Prevotella_histicola	470565	S	10	1	11	0.00000
Paraprevotella_xylaniphila	454155	S	87	59	146	0.00001
Pseudoprevotella_muciniphila	2133944	S	80	6	86	0.00000
Bacteroides_sp._CBA7301	2715212	S	93	21	114	0.00000
Bacteroides_sp._M10	2763022	S	39	67	106	0.00000
Bacteroides_fragilis	817	S	108	169	277	0.00001
Bacteroides_cellulosilyticus	246787	S	92	26	118	0.00001
Bacteroides_zoogleoformans	28119	S	91	20	111	0.00000
Bacteroides_thetaiotaomicron	818	S	83	44	127	0.00001
Bacteroides_eggerthii	28111	S	83	72	155	0.00001
Bacteroides_heparinolyticus	28113	S	76	16	92	0.00000
Bacteroides_helcogenes	290053	S	62	2	64	0.00000
Bacteroides_salyersiae	291644	S	62	46	108	0.00000
Bacteroides_uniformis	820	S	61	137	198	0.00001
Bacteroides_stercoris	46506	S	59	45	104	0.00000
Bacteroides_zhangwenhongii	2650157	S	52	28	80	0.00000
Bacteroides_xylanisolvens	371601	S	46	117	163	0.00001
Bacteroides_caccae	47678	S	43	9	52	0.00000
Bacteroides_faecis	674529	S	43	28	71	0.00000
Bacteroides_nordii	291645	S	42	24	66	0.00000
Bacteroides_intestinalis	329854	S	35	5	40	0.00000
Bacteroides_luhongzhouii	2650158	S	33	13	46	0.00000
Bacteroides_ovatus	28116	S	28	48	76	0.00000
Bacteroides_caecimuris	1796613	S	27	30	57	0.00000
Bacteroides_coprosuis	151276	S	15	1	16	0.00000
Phocaeicola_salanitronis	376805	S	127	43	170	0.00001
Phocaeicola_coprophilus	387090	S	71	32	103	0.00000
Phocaeicola_dorei	357276	S	47	70	117	0.00001
Phocaeicola_vulgatus	821	S	30	29	59	0.00000
Tannerella_serpentiformis	712710	S	443	17	460	0.00002
Tannerella_forsythia	28112	S	155	15	170	0.00001
Parabacteroides_goldsteinii	328812	S	122	25	147	0.00001
Parabacteroides_merdae	46503	S	117	101	218	0.00001
Parabacteroides_distasonis	823	S	92	217	309	0.00001
Parabacteroides_johnsonii	387661	S	61	38	99	0.00000
Sodaliphilus_pleomorphus	2606626	S	420	161	581	0.00003
Duncaniella_dubosii	2518971	S	92	12	104	0.00000
Muribaculum_gordoncarteri	2530390	S	146	10	156	0.00001
Muribaculum_intestinale	1796646	S	112	6	118	0.00001
Porphyromonas_sp._oral_taxon_275	712435	S	438	36	474	0.00002
Porphyromonas_asaccharolytica	28123	S	111	7	118	0.00001
Porphyromonas_gingivalis	837	S	95	13	108	0.00000
Porphyromonas_cangingivalis	36874	S	70	8	78	0.00000
Porphyromonas_somerae	322095	S	44	9	53	0.00000
Porphyromonas_crevioricanis	393921	S	43	7	50	0.00000
Porphyromonas_endodontalis	28124	S	33	2	35	0.00000
Proteiniphilum_saccharofermentans	1642647	S	100	6	106	0.00000
Proteiniphilum_sp._JNU-WLY501	2829812	S	49	1	50	0.00000
Petrimonas_mucosa	1642646	S	144	5	149	0.00001
Barnesiella_viscericola	397865	S	175	176	351	0.00002
Coprobacter_secundus	1501392	S	30	21	51	0.00000
Butyricimonas_faecalis	2093856	S	57	54	111	0.00000
Butyricimonas_virosa	544645	S	36	9	45	0.00000
Odoribacter_splanchnicus	28118	S	55	5	60	0.00000
Paludibacter_propionicigenes	185300	S	78	2	80	0.00000
Salinivirga_cyanobacteriivorans	1307839	S	64	1	65	0.00000
Tenuifilum_thalassicum	2590900	S	53	1	54	0.00000
Draconibacterium_orientale	1168034	S	96	9	105	0.00000
Draconibacterium_halophilum	2706887	S	63	5	68	0.00000
Maribellus_comscasis	2681766	S	52	3	55	0.00000
Alkalitalea_saponilacus	889453	S	71	4	75	0.00000
Labilibaculum_antarcticum	1717717	S	51	3	54	0.00000
Mucilaginibacter_sp._14171R-50	2703789	S	176	8	184	0.00001
Mucilaginibacter_sp._SMC90	2929803	S	160	8	168	0.00001
Mucilaginibacter_sp._F39-2	2728022	S	119	7	126	0.00001
Mucilaginibacter_sp._21P	2778902	S	97	4	101	0.00000
Mucilaginibacter_daejeonensis	398049	S	282	16	298	0.00001
Mucilaginibacter_mali	2740462	S	265	9	274	0.00001
Mucilaginibacter_ginsenosidivorans	398053	S	246	8	254	0.00001
Mucilaginibacter_celer	2305508	S	223	9	232	0.00001
Mucilaginibacter_gotjawali	1550579	S	216	6	222	0.00001
Mucilaginibacter_paludis	423351	S	196	9	205	0.00001
Mucilaginibacter_ginsenosidivorax	862126	S	185	7	192	0.00001
Mucilaginibacter_xinganensis	1234841	S	162	7	169	0.00001
Mucilaginibacter_rubeus	2027860	S	160	370	530	0.00002
Mucilaginibacter_mallensis	652787	S	131	4	135	0.00001
Mucilaginibacter_ginkgonis	2682091	S	114	5	119	0.00001
Mucilaginibacter_gossypii	551996	S	64	45	109	0.00000
Pedobacter_sp._HDW13	2714940	S	105	15	120	0.00001
Pedobacter_sp._PACM_27299	1727164	S	90	14	104	0.00000
Pedobacter_sp._SW-16	2766984	S	79	16	95	0.00000
Pedobacter_sp._KBS0701	2578106	S	73	26	99	0.00000
Pedobacter_sp._D749	2856523	S	73	26	99	0.00000
Pedobacter_sp._G11	2482728	S	69	10	79	0.00000
Pedobacter_sp._Q8-18	2895286	S	59	5	64	0.00000
Pedobacter_heparinus	984	S	138	13	151	0.00001
Pedobacter_endophyticus	2789740	S	130	13	143	0.00001
Pedobacter_schmidteae	2201271	S	118	11	129	0.00001
Pedobacter_roseus	336820	S	94	33	127	0.00001
Pedobacter_ginsengisoli	363852	S	86	12	98	0.00000
Pedobacter_steynii	430522	S	85	9	94	0.00000
Pedobacter_cryoconitis	188932	S	71	7	78	0.00000
Pedobacter_suwonensis	332999	S	64	15	79	0.00000
Pedobacter_aquae	2605747	S	50	5	55	0.00000
Sphingobacterium_sp._DR205	2713573	S	120	12	132	0.00001
Sphingobacterium_sp._CZ-2	2557994	S	61	13	74	0.00000
Sphingobacterium_sp._dk4302	2662364	S	57	6	63	0.00000
Sphingobacterium_sp._UDSM-2020	2795738	S	45	13	58	0.00000
Sphingobacterium_sp._PCS056	2931400	S	42	8	50	0.00000
Sphingobacterium_sp._ML3W	1538644	S	37	11	48	0.00000
Sphingobacterium_sp._SRCM116780	2907623	S	36	6	42	0.00000
Sphingobacterium_spiritivorum	258	S	148	87	235	0.00001
Sphingobacterium_thalpophilum	259	S	109	102	211	0.00001
Sphingobacterium_lactis	797291	S	100	73	173	0.00001
Sphingobacterium_mizutaii	1010	S	90	12	102	0.00000
Sphingobacterium_multivorum	28454	S	68	122	190	0.00001
Sphingobacterium_hotanense	649196	S	63	17	80	0.00000
Sphingobacterium_psychroaquaticum	561061	S	59	10	69	0.00000
Sphingobacterium_daejeonense	371142	S	53	12	65	0.00000
Sphingobacterium_paramultivorum	2886510	S	18	15	33	0.00000
Sphingobacterium_siyangense	459529	S	15	53	68	0.00000
Anseongella_ginsenosidimutans	496056	S	298	11	309	0.00001
Olivibacter_sp._LS-1	2592345	S	122	6	128	0.00001
Olivibacter_sp._SDN3	2764720	S	74	10	84	0.00000
Solitalea_canadensis	995	S	101	8	109	0.00000
Solitalea_sp._S2-8	2911172	S	92	10	102	0.00000
Pseudopedobacter_saltans	151895	S	76	54	130	0.00001
Haliscomenobacter_hydrossis	2350	S	379	5	384	0.00002
Saprospira_grandis	1008	S	87	2	89	0.00000
Candidatus_Sulfidibacterium_hydrothermale	2875962	S	94	2	96	0.00000
Chlorobaculum_limnaeum	274537	S	1171	195	1366	0.00006
Chlorobaculum_tepidum	1097	S	614	175	789	0.00003
Chlorobaculum_parvum	274539	S	614	120	734	0.00003
Pelodictyon_luteolum	1100	S	541	102	643	0.00003
Pelodictyon_phaeoclathratiforme	34090	S	147	9	156	0.00001
Chlorobium_limicola	1092	S	255	17	272	0.00001
Chlorobium_phaeobacteroides	1096	S	124	13	137	0.00001
Chlorobium_phaeovibrioides	1094	S	101	23	124	0.00001
Prosthecochloris_sp._GSB1	281093	S	577	44	621	0.00003
Prosthecochloris_sp._CIB_2401	1868325	S	201	56	257	0.00001
Prosthecochloris_sp._HL-130-GSB	1974213	S	156	32	188	0.00001
Prosthecochloris_aestuarii	1102	S	132	16	148	0.00001
Chloroherpeton_thalassium	100716	S	249	4	253	0.00001
Candidatus_Cyclonatronum_proteinivorum	1457365	S	442	39	481	0.00002
Melioribacter_roseus	1134405	S	153	12	165	0.00001
Ignavibacterium_album	591197	S	97	9	106	0.00000
Gemmatirosa_kalamazoonesis	861299	S	60277	5714	65991	0.00286
Gemmatimonas_groenlandica	2732249	S	9106	1037	10143	0.00044
Gemmatimonas_aurantiaca	173480	S	6727	685	7412	0.00032
Gemmatimonas_phototrophica	1379270	S	5718	791	6509	0.00028
Fibrobacter_succinogenes	833	S	198	3	201	0.00001
Candidatus_Cloacimonas_acidaminovorans	456827	S	78	2	80	0.00000
Luteitalea_sp._TBR-22	2802971	S	60294	10621	70915	0.00307
Luteitalea_pratensis	1855912	S	54778	6275	61053	0.00264
Granulicella_sp._WH15	2602070	S	3600	680	4280	0.00019
Granulicella_sp._5B5	1617967	S	2832	478	3310	0.00014
Granulicella_mallensis	940614	S	2654	325	2979	0.00013
Granulicella_tundricola	940615	S	1971	267	2238	0.00010
Terriglobus_roseus	392734	S	3131	677	3808	0.00016
Terriglobus_albidus	1592106	S	2393	228	2621	0.00011
Terriglobus_saanensis	870903	S	1583	209	1792	0.00008
Acidobacterium_capsulatum	33075	S	3097	375	3472	0.00015
Acidobacterium_sp._4Y35	2763107	S	2599	178	2777	0.00012
Candidatus_Koribacter_versatilis	658062	S	4345	145	4490	0.00019
Edaphobacter_sp._12200R-103	2703788	S	1895	333	2228	0.00010
Edaphobacter_sp._4G125	2763071	S	1113	167	1280	0.00006
Acidisarcina_polymorpha	2211140	S	2108	152	2260	0.00010
Paludibaculum_fermentans	1473598	S	9379	273	9652	0.00042
Chloracidobacterium_aggregatum	2851959	S	1625	1034	2659	0.00012
Chloracidobacterium_validum	2821543	S	1221	22	1243	0.00005
Chloracidobacterium_sp._D	2821536	S	111	580	691	0.00003
Chloracidobacterium_thermophilum	458033	S	108	519	627	0.00003
Sulfidibacter_corallicola	2818388	S	3211	70	3281	0.00014
Thermotomaculum_hydrothermale	981385	S	126	6	132	0.00001
Nitrospira_moscoviensis	42253	S	6229	556	6785	0.00029
Nitrospira_japonica	1325564	S	4124	507	4631	0.00020
Nitrospira_sp._KM1	1936990	S	3018	292	3310	0.00014
Candidatus_Nitrospira_inopinata	1715989	S	2338	208	2546	0.00011
Leptospirillum_ferrooxidans	180	S	211	5	216	0.00001
Leptospirillum_ferriphilum	178606	S	76	152	228	0.00001
Leptospirillum_sp._Group_II_'CF-1'	1660083	S	44	91	135	0.00001
Dissulfurispira_thermophila	2715679	S	128	5	133	0.00001
Thermodesulfovibrio_yellowstonii	28262	S	114	2	116	0.00001
Spirochaeta_thermophila	154	S	978	24	1002	0.00004
Spirochaeta_africana	46355	S	355	20	375	0.00002
Salinispira_pacifica	1307761	S	148	5	153	0.00001
Sediminispirochaeta_smaragdinae	55206	S	132	4	136	0.00001
Oceanispirochaeta_crateris	2518645	S	57	3	60	0.00000
Thiospirochaeta_perfilievii	252967	S	13	1	14	0.00000
Treponema_brennaborense	81028	S	205	67	272	0.00001
Treponema_primitia	88058	S	169	9	178	0.00001
Treponema_azotonutricium	150829	S	142	5	147	0.00001
Treponema_caldarium	215591	S	97	12	109	0.00000
Treponema_socranskii	53419	S	82	28	110	0.00000
Treponema_sp._Marseille-Q4132	2766701	S	61	20	81	0.00000
Treponema_sp._OMZ_838	1539298	S	19	14	33	0.00000
Treponema_parvum	138851	S	75	3	78	0.00000
Treponema_succinifaciens	167	S	67	48	115	0.00000
Treponema_vincentii	69710	S	65	48	113	0.00000
Treponema_medium	58231	S	44	39	83	0.00000
Treponema_denticola	158	S	27	7	34	0.00000
Treponema_phagedenis	162	S	23	8	31	0.00000
Treponema_pedis	409322	S	22	4	26	0.00000
Treponema_peruense	2787628	S	20	2	22	0.00000
Treponema_putidum	221027	S	16	9	25	0.00000
Treponema_paraluiscuniculi	53435	S	10	93	103	0.00000
Sphaerochaeta_associata	1129264	S	159	18	177	0.00001
Sphaerochaeta_coccoides	273376	S	124	6	130	0.00001
Sphaerochaeta_globosa	1131703	S	81	10	91	0.00000
Sphaerochaeta_pleomorpha	1131707	S	38	5	43	0.00000
Breznakiella_homolactica	2798577	S	236	20	256	0.00001
Borrelia_sp._HM	1882662	S	23	103	126	0.00001
Leptospira_santarosai	28183	S	101	1	102	0.00000
Leptospira_kmetyi	408139	S	94	1	95	0.00000
Leptospira_weilii	28184	S	71	1	72	0.00000
Leptospira_tipperaryensis	2564040	S	62	0	62	0.00000
Leptospira_noguchii	28182	S	42	0	42	0.00000
Leptospira_mayottensis	1137606	S	42	0	42	0.00000
Leptospira_borgpetersenii	174	S	30	0	30	0.00000
Leptospira_kobayashii	1917830	S	28	0	28	0.00000
Leptospira_biflexa	172	S	26	0	26	0.00000
Leptospira_interrogans	173	S	14	154	168	0.00001
Turneriella_parva	29510	S	570	5	575	0.00002
Brachyspira_pilosicoli	52584	S	29	30	59	0.00000
Pyramidobacter_piscolens	638849	S	977	62	1039	0.00004
Aminomonas_paucivorans	81412	S	915	108	1023	0.00004
Fretibacterium_fastidiosum	651822	S	891	13	904	0.00004
Thermanaerovibrio_acidaminovorans	81462	S	476	152	628	0.00003
Thermanaerovibrio_velox	108007	S	222	44	266	0.00001
Cloacibacillus_porcorum	1197717	S	657	131	788	0.00003
Jonquetella_anthropi	428712	S	527	79	606	0.00003
Aminobacterium_colombiense	81468	S	150	9	159	0.00001
Acetomicrobium_mobile	97477	S	101	3	104	0.00000
Thermovirga_lienii	336261	S	73	59	132	0.00001
Candidatus_Bipolaricaulis_anaerobius	2026885	S	1174	48	1222	0.00005
Candidatus_Nanosynbacter_featherlites	2572088	S	52	23	75	0.00000
Candidatus_Nanosynbacter_lyticus	2093824	S	30	55	85	0.00000
Nanosynbacter_sp._HMT-352	2899133	S	29	64	93	0.00000
Candidatus_Saccharimonas_aalborgensis	1332188	S	93	0	93	0.00000
Candidatus_Minimicrobia_vallesae	2841264	S	13	57	70	0.00000
Candidatus_Babela_massiliensis	673862	S	106	2	108	0.00000
Candidatus_Absconditicoccus_praedator	2735562	S	77	0	77	0.00000
Candidatus_Chazhemtobacterium_aquaticus	2715735	S	77	0	77	0.00000
Thermotoga_caldifontis	1508419	S	171	30	201	0.00001
Thermotoga_sp._2812B	1157948	S	11	82	93	0.00000
Thermotoga_profunda	1508420	S	13	1	14	0.00000
Thermotoga_petrophila	93929	S	10	157	167	0.00001
Pseudothermotoga_hypogea	57487	S	79	34	113	0.00000
Pseudothermotoga_thermarum	119394	S	32	8	40	0.00000
Fervidobacterium_pennivorans	93466	S	52	94	146	0.00001
Fervidobacterium_nodosum	2424	S	10	8	18	0.00000
Thermosipho_ferrireducens	2571116	S	34	8	42	0.00000
Thermosipho_melanesiensis	46541	S	11	15	26	0.00000
Kosmotoga_pacifica	1330330	S	44	104	148	0.00001
Kosmotoga_olearia	651457	S	32	72	104	0.00000
Mesotoga_infera	1236046	S	81	11	92	0.00000
Mesotoga_prima	1184387	S	46	7	53	0.00000
Defluviitoga_tunisiensis	1006576	S	26	42	68	0.00000
Tepiditoga_spiralis	2108365	S	19	4	23	0.00000
Petrotoga_mobilis	69499	S	13	11	24	0.00000
Athalassotoga_saccharophila	1441386	S	84	2	86	0.00000
Thermocrinis_minervae	381751	S	156	16	172	0.00001
Thermocrinis_ruber	75906	S	24	2	26	0.00000
Thermocrinis_albus	136094	S	24	2	26	0.00000
Hydrogenobacter_sp._T-8	1632019	S	74	13	87	0.00000
Hydrogenobacter_thermophilus	940	S	22	4	26	0.00000
Aquifex_aeolicus	63363	S	61	2	63	0.00000
Persephonella_marina	309805	S	125	8	133	0.00001
Sulfurihydrogenibium_azorense	309806	S	111	13	124	0.00001
Thermosulfidibacter_takaii	412593	S	129	4	133	0.00001
Thermovibrio_ammonificans	228745	S	163	35	198	0.00001
Desulfurobacterium_thermolithotrophum	64160	S	33	5	38	0.00000
Thermosulfurimonas_marina	2047767	S	292	34	326	0.00001
Thermosulfuriphilus_ammonigenes	1936021	S	155	6	161	0.00001
Thermodesulfatator_indicus	171695	S	133	15	148	0.00001
Thermodesulfobacterium_commune	1741	S	32	14	46	0.00000
Thermodesulfobacterium_geofontis	1295609	S	30	10	40	0.00000
Thermodesulfobacterium_sp._TA1	2234087	S	13	4	17	0.00000
Caldimicrobium_thiodismutans	1653476	S	41	6	47	0.00000
Geovibrio_thiophilus	139438	S	145	33	178	0.00001
Flexistipes_sinusarabici	2352	S	71	9	80	0.00000
Calditerrivibrio_nitroreducens	477976	S	71	12	83	0.00000
Denitrovibrio_acetiphilus	118000	S	56	8	64	0.00000
Mucispirillum_schaedleri	248039	S	52	6	58	0.00000
Deferribacter_desulfuricans	197162	S	39	8	47	0.00000
Caldithrix_abyssi	187145	S	459	4	463	0.00002
Desulfurispirillum_indicum	936456	S	425	194	619	0.00003
Fusobacterium_nucleatum	851	S	36	52	88	0.00000
Fusobacterium_sp._oral_taxon_203	671211	S	12	22	34	0.00000
Fusobacterium_sp._NSJ-57	2764326	S	12	16	28	0.00000
Fusobacterium_ulcerans	861	S	22	3	25	0.00000
Fusobacterium_gastrosuis	1755100	S	18	5	23	0.00000
Fusobacterium_necrophorum	859	S	12	4	16	0.00000
Fusobacterium_pseudoperiodonticum	2663009	S	11	10	21	0.00000
Cetobacterium_somerae	188913	S	17	2	19	0.00000
Leptotrichia_sp._oral_taxon_212	712357	S	20	14	34	0.00000
Leptotrichia_sp._oral_taxon_847	1785996	S	12	15	27	0.00000
Leptotrichia_shahii	157691	S	14	37	51	0.00000
Sebaldella_termitidis	826	S	28	2	30	0.00000
Elusimicrobium_minutum	423605	S	164	1	165	0.00001
Endomicrobium_proavitum	1408281	S	62	22	84	0.00000
Candidatus_Endomicrobium_trichonymphae	1408204	S	39	13	52	0.00000
Coprothermobacter_proteolyticus	35786	S	162	32	194	0.00001
Caldisericum_exile	693075	S	146	0	146	0.00001
Dictyoglomus_thermophilum	14	S	21	40	61	0.00000
Dictyoglomus_turgidum	513050	S	12	23	35	0.00000
Atribacter_laminatus	2847778	S	84	2	86	0.00000
Fusarium_oxysporum	5507	S	10330	2456	12786	0.00055
Fusarium_equiseti	61235	S	6638	733	7371	0.00032
Fusarium_scirpi	2211609	S	2458	224	2682	0.00012
Fusarium_acuminatum	5515	S	8425	365	8790	0.00038
Fusarium_avenaceum	40199	S	212	6	218	0.00001
Fusarium_longipes	694270	S	332	9	341	0.00001
Fusarium_poae	36050	S	324	68	392	0.00002
Fusarium_sporotrichioides	5514	S	232	15	247	0.00001
Fusarium_sambucinum	5128	S	211	67	278	0.00001
Fusarium_pseudograminearum	101028	S	190	58	248	0.00001
Fusarium_venenatum	56646	S	135	153	288	0.00001
Fusarium_graminearum	5518	S	104	228	332	0.00001
Fusarium_culmorum	5516	S	92	68	160	0.00001
Fusarium_decemcellulare	57161	S	1111	15	1126	0.00005
Fusarium_nygamai	42673	S	374	106	480	0.00002
Fusarium_fujikuroi	5127	S	203	18	221	0.00001
Fusarium_pseudonygamai	47755	S	143	32	175	0.00001
Fusarium_thapsinum	120644	S	140	29	169	0.00001
Fusarium_verticillioides	117187	S	69	87	156	0.00001
Fusarium_dimerum	57145	S	564	10	574	0.00002
Fusarium_nelsonii	77846	S	234	54	288	0.00001
Fusarium_chlamydosporum	86545	S	153	35	188	0.00001
Fusarium_graminum	86546	S	191	42	233	0.00001
Fusarium_heterosporum	42747	S	186	40	226	0.00001
Fusarium_lateritium	5523	S	442	8	450	0.00002
Fusarium_musae	1042133	S	85	101	186	0.00001
Metarhizium_album	92629	S	732	18	750	0.00003
Metarhizium_guizhouense	169041	S	504	320	824	0.00004
Metarhizium_rileyi	1649241	S	475	54	529	0.00002
Metarhizium_acridum	92637	S	266	127	393	0.00002
Metarhizium_anisopliae	5530	S	158	226	384	0.00002
Metarhizium_humberi	2596975	S	140	103	243	0.00001
Metarhizium_majus	1650735	S	132	70	202	0.00001
Metarhizium_brunneum	500148	S	128	126	254	0.00001
Metarhizium_robertsii	568076	S	83	72	155	0.00001
Ustilaginoidea_virens	1159556	S	1091	36	1127	0.00005
Pochonia_chlamydosporia	280754	S	257	15	272	0.00001
Trichoderma_citrinoviride	58853	S	503	44	547	0.00002
Trichoderma_reesei	51453	S	443	29	472	0.00002
Trichoderma_pleuroti	500994	S	354	29	383	0.00002
Trichoderma_afroharzianum	1567482	S	249	45	294	0.00001
Trichoderma_atroviride	63577	S	247	45	292	0.00001
Trichoderma_erinaceum	202914	S	245	31	276	0.00001
Trichoderma_hamatum	49224	S	213	12	225	0.00001
Trichoderma_koningiopsis	337941	S	209	24	233	0.00001
Trichoderma_gamsii	398673	S	197	23	220	0.00001
Trichoderma_asperellum	101201	S	175	10	185	0.00001
Trichoderma_harzianum	5544	S	165	30	195	0.00001
Trichoderma_longibrachiatum	5548	S	47	438	485	0.00002
Trichoderma_virens	29875	S	43	410	453	0.00002
Trichoderma_koningii	97093	S	39	353	392	0.00002
Trichoderma_viride	5547	S	15	189	204	0.00001
Beauveria_felina	37994	S	959	31	990	0.00004
Beauveria_pseudobassiana	931006	S	424	68	492	0.00002
Beauveria_brongniartii	118266	S	384	106	490	0.00002
Beauveria_rudraprayagi	1481906	S	211	306	517	0.00002
Beauveria_bassiana	176275	S	169	259	428	0.00002
Cordyceps_fumosorosea	114497	S	1320	72	1392	0.00006
Purpureocillium_lilacinum	33203	S	2840	120	2960	0.00013
Drechmeria_coniospora	98403	S	1217	34	1251	0.00005
Clonostachys_rosea	29856	S	687	31	718	0.00003
Colletotrichum_higginsianum	80884	S	1803	251	2054	0.00009
Thermothielavioides_terrestris	2587410	S	2201	117	2318	0.00010
Thermothelomyces_thermophilus	78579	S	1755	68	1823	0.00008
Neurospora_crassa	5141	S	550	19	569	0.00002
Pyricularia_pennisetigena	1578925	S	653	100	753	0.00003
Pyricularia_oryzae	318829	S	605	159	764	0.00003
Pyricularia_grisea	148305	S	412	61	473	0.00002
Neopestalotiopsis_rosae	1562205	S	264	254	518	0.00002
Neopestalotiopsis_clavispora	289240	S	180	188	368	0.00002
Botrytis_cinerea	40559	S	280	1	281	0.00001
Aspergillus_puulaauensis	1220207	S	2416	97	2513	0.00011
Aspergillus_chevalieri	182096	S	1045	103	1148	0.00005
Aspergillus_luchuensis	1069201	S	480	40	520	0.00002
Aspergillus_fumigatus	746128	S	393	28	421	0.00002
Aspergillus_oryzae	5062	S	77	194	271	0.00001
Aspergillus_flavus	5059	S	22	58	80	0.00000
Penicillium_chrysogenum	5076	S	2650	235	2885	0.00012
Penicillium_citrinum	5077	S	285	26	311	0.00001
Penicillium_aurantiogriseum	36655	S	263	41	304	0.00001
Penicillium_expansum	27334	S	217	34	251	0.00001
Penicillium_italicum	40296	S	159	23	182	0.00001
Penicillium_digitatum	36651	S	126	11	137	0.00001
Paecilomyces_niveus	5093	S	243	12	255	0.00001
Paecilomyces_variotii	264951	S	235	25	260	0.00001
Talaromyces_rugulosus	121627	S	293	17	310	0.00001
Paraphaeosphaeria_minitans	565426	S	732	182	914	0.00004
Ampelomyces_quisqualis	50730	S	561	44	605	0.00003
Zymoseptoria_tritici	1047171	S	328	4	332	0.00001
Cercospora_beticola	122368	S	250	0	250	0.00001
Eremothecium_gossypii	33169	S	221	155	376	0.00002
Eremothecium_cymbalariae	45285	S	36	1	37	0.00000
Eremothecium_sinecaudum	45286	S	12	6	18	0.00000
Lachancea_thermotolerans	381046	S	99	5	104	0.00000
Naumovozyma_dairenensis	27289	S	61	2	63	0.00000
Naumovozyma_castellii	27288	S	36	2	38	0.00000
Saccharomyces_eubayanus	1080349	S	40	1	41	0.00000
Saccharomyces_cerevisiae	4932	S	30	5	35	0.00000
Saccharomyces_paradoxus	27291	S	12	1	13	0.00000
Kluyveromyces_marxianus	4911	S	58	8	66	0.00000
Kluyveromyces_lactis	28985	S	21	1	22	0.00000
Tetrapisispora_blattae	1071379	S	50	1	51	0.00000
Tetrapisispora_phaffii	113608	S	29	0	29	0.00000
Kazachstania_naganishii	588726	S	56	2	58	0.00000
Kazachstania_africana	432096	S	13	0	13	0.00000
Torulaspora_globosa	48254	S	45	2	47	0.00000
Torulaspora_delbrueckii	4950	S	18	1	19	0.00000
[Candida]_glabrata	5478	S	54	1	55	0.00000
Zygosaccharomyces_rouxii	4956	S	35	1	36	0.00000
Zygotorulaspora_mrakii	42260	S	26	2	28	0.00000
Candida_dubliniensis	42374	S	74	4	78	0.00000
Candida_albicans	5476	S	33	2	35	0.00000
Candida_orthopsilosis	273371	S	28	0	28	0.00000
Scheffersomyces_stipitis	4924	S	64	1	65	0.00000
Debaryomyces_hansenii	4959	S	37	0	37	0.00000
Ogataea_parapolymorpha	1005962	S	91	2	93	0.00000
Brettanomyces_bruxellensis	5007	S	32	4	36	0.00000
Brettanomyces_nanus	13502	S	31	8	39	0.00000
Pichia_kudriavzevii	4909	S	19	0	19	0.00000
Yarrowia_lipolytica	4952	S	157	1	158	0.00001
Sugiyamaella_lignohabitans	796027	S	97	6	103	0.00000
Saccharomycodes_ludwigii	36035	S	21	2	23	0.00000
Komagataella_phaffii	460519	S	18	0	18	0.00000
Schizosaccharomyces_pombe	4896	S	49	1	50	0.00000
Pseudozyma_flocculosa	84751	S	2489	20	2509	0.00011
Ustilago_maydis	5270	S	543	14	557	0.00002
Sporisorium_graminicola	280036	S	456	66	522	0.00002
Malassezia_restricta	76775	S	205	30	235	0.00001
Phlebiopsis_gigantea	82310	S	675	4	679	0.00003
Rhizoctonia_solani	456999	S	137	5	142	0.00001
Marasmius_oreades	181124	S	110	4	114	0.00000
Cryptococcus_neoformans	5207	S	139	6	145	0.00001
Cryptococcus_gattii_VGI	37769	S	60	34	94	0.00000
Phytophthora_cinnamomi	4785	S	1365	230	1595	0.00007
Phytophthora_fragariae	53985	S	1086	155	1241	0.00005
Phytophthora_parasitica	4792	S	831	110	941	0.00004
Phytophthora_cryptogea	4786	S	703	58	761	0.00003
Phytophthora_infestans	4787	S	514	772	1286	0.00006
Phytophthora_cactorum	29920	S	440	66	506	0.00002
Phytophthora_boehmeriae	109152	S	366	44	410	0.00002
Pythium_aphanidermatum	65070	S	581	17	598	0.00003
