name	taxonomy_id	taxonomy_lvl	kraken_assigned_reads	added_reads	new_est_reads	fraction_total_reads
Streptomyces_sp._BJ20	2930049	S	33502	12827	46329	0.00376
Streptomyces_sp._Go_40/10	2825844	S	14762	6118	20880	0.00169
Streptomyces_sp._CdTB01	1725411	S	9946	2697	12643	0.00103
Streptomyces_sp._jing01	2726118	S	9382	4924	14306	0.00116
Streptomyces_sp._HM190	2695266	S	9343	2789	12132	0.00098
Streptomyces_sp._DSM_40868	2721173	S	9195	3168	12363	0.00100
Streptomyces_sp._P3	2135430	S	9166	2186	11352	0.00092
Streptomyces_sp._AMCC400023	2056258	S	8827	3455	12282	0.00100
Streptomyces_sp._SAT1	1849967	S	8753	3061	11814	0.00096
Streptomyces_sp._3214.6	1882757	S	8544	2368	10912	0.00089
Streptomyces_sp._WAC_01438	2203204	S	7840	2508	10348	0.00084
Streptomyces_sp._Z423-1	2730915	S	7186	2005	9191	0.00075
Streptomyces_sp._Go-475	2072505	S	6336	2782	9118	0.00074
Streptomyces_sp._MG62	2838015	S	6312	2222	8534	0.00069
Streptomyces_sp._NEAU-sy36	2751189	S	6305	2242	8547	0.00069
Streptomyces_sp._SCSIO_64649	2878388	S	6280	1117	7397	0.00060
Streptomyces_sp._ZYC-3	2797636	S	6215	1177	7392	0.00060
Streptomyces_sp._ST1015	1848900	S	6181	1218	7399	0.00060
Streptomyces_sp._SN-593	659352	S	6006	1358	7364	0.00060
Streptomyces_sp._A2-16	2781734	S	5947	1774	7721	0.00063
Streptomyces_sp._JB150	2714844	S	5557	1870	7427	0.00060
Streptomyces_sp._MG28	2865673	S	5531	1864	7395	0.00060
Streptomyces_sp._891-h	2720714	S	5392	934	6326	0.00051
Streptomyces_sp._CB01881	2078691	S	5371	1033	6404	0.00052
Streptomyces_sp._BH-MK-02	2880933	S	5138	1032	6170	0.00050
Streptomyces_sp._So13.3	2136173	S	4904	865	5769	0.00047
Streptomyces_sp._GQFP	2907545	S	4866	791	5657	0.00046
Streptomyces_sp._NA02950	2742137	S	4772	901	5673	0.00046
Streptomyces_sp._NHF165	2175864	S	4724	791	5515	0.00045
Streptomyces_sp._HP-A2021	2927875	S	4708	2431	7139	0.00058
Streptomyces_sp._LRE541	2931983	S	4679	1003	5682	0.00046
Streptomyces_sp._RTd22	1841249	S	4519	1790	6309	0.00051
Streptomyces_sp._MA3_2.13	2867410	S	4485	564	5049	0.00041
Streptomyces_sp._Rer75	2750011	S	4421	1940	6361	0.00052
Streptomyces_sp._SCUT-3	2684469	S	4393	1662	6055	0.00049
Streptomyces_sp._3025	2923272	S	4253	726	4979	0.00040
Streptomyces_sp._RPA4-2	2721244	S	3967	1112	5079	0.00041
Streptomyces_sp._YIM_121038	2136401	S	3719	1049	4768	0.00039
Streptomyces_sp._MBT27	1488356	S	3622	978	4600	0.00037
Streptomyces_sp._SYP-A7193	2662065	S	3471	1923	5394	0.00044
Streptomyces_sp._NA04227	2742136	S	3469	748	4217	0.00034
Streptomyces_sp._C8S0	2585716	S	3456	940	4396	0.00036
Streptomyces_sp._W1SF4	2305220	S	3342	1129	4471	0.00036
Streptomyces_sp._QHH-9511	2684468	S	3341	875	4216	0.00034
Streptomyces_sp._GMY02	1333528	S	3264	539	3803	0.00031
Streptomyces_sp._MST-110588	2833628	S	3249	743	3992	0.00032
Streptomyces_sp._GS7	2692234	S	3173	823	3996	0.00032
Streptomyces_sp._CCM_MD2014	1561022	S	3156	2607	5763	0.00047
Streptomyces_sp._HSG2	2797167	S	2892	565	3457	0.00028
Streptomyces_sp._SUK_48	2582831	S	2850	1639	4489	0.00036
Streptomyces_sp._135	2838850	S	2827	885	3712	0.00030
Streptomyces_sp._EAS-AB2608	2779671	S	2818	4267	7085	0.00058
Streptomyces_sp._BHT-5-2	2866715	S	2779	834	3613	0.00029
Streptomyces_sp._CB09001	2083284	S	2767	1698	4465	0.00036
Streptomyces_sp._SirexAA-E	862751	S	2746	772	3518	0.00029
Streptomyces_sp._PBH53	1577075	S	2687	3885	6572	0.00053
Streptomyces_sp._SM18	1736046	S	2676	696	3372	0.00027
Streptomyces_sp._CMB-StM0423	2059884	S	2597	1168	3765	0.00031
Streptomyces_sp._HF10	2692233	S	2543	1648	4191	0.00034
Streptomyces_sp._Tu_2975	2676871	S	2541	765	3306	0.00027
Streptomyces_sp._S1D4-11	2721246	S	2442	1677	4119	0.00033
Streptomyces_sp._WAC_01529	2203205	S	2393	803	3196	0.00026
Streptomyces_sp._fd1-xmd	1812480	S	2319	947	3266	0.00027
Streptomyces_sp._TN58	234612	S	2180	926	3106	0.00025
Streptomyces_sp._INR7	2607753	S	2171	1028	3199	0.00026
Streptomyces_sp._S4.7	2705439	S	2083	653	2736	0.00022
Streptomyces_sp._WAC_06738	2203210	S	1689	1558	3247	0.00026
Streptomyces_sp._YPW6	2840373	S	1563	756	2319	0.00019
Streptomyces_sp._Mg1	465541	S	1478	1280	2758	0.00022
Streptomyces_sp._WY228	2855836	S	1445	729	2174	0.00018
Streptomyces_sp._CNQ-509	444103	S	1442	1304	2746	0.00022
Streptomyces_sp._ADI95-16	1522758	S	1402	1143	2545	0.00021
Streptomyces_sp._769	1262452	S	1313	941	2254	0.00018
Streptomyces_sp._AgN23	1188315	S	1286	1096	2382	0.00019
Streptomyces_sp._RPA4-5	2721245	S	1162	713	1875	0.00015
Streptomyces_sp._2323.1	1938841	S	1162	673	1835	0.00015
Streptomyces_sp._S8	1837283	S	1023	821	1844	0.00015
Streptomyces_sp._NA02536	2742133	S	1022	2583	3605	0.00029
Streptomyces_sp._3211	1964449	S	1000	1213	2213	0.00018
Streptomyces_sp._RLB1-33	2721243	S	989	2824	3813	0.00031
Streptomyces_sp._S063	2005885	S	954	616	1570	0.00013
Streptomyces_sp._XC_2026	2782004	S	918	774	1692	0.00014
Streptomyces_sp._NEAU-S7GS2	2202000	S	874	684	1558	0.00013
Streptomyces_sp._ID38640	1265399	S	843	587	1430	0.00012
Streptomyces_sp._HNA39	2850561	S	832	888	1720	0.00014
Streptomyces_sp._WA6-1-16	2879427	S	820	784	1604	0.00013
Streptomyces_sp._MOE7	1961713	S	796	910	1706	0.00014
Streptomyces_sp._Sge12	1972846	S	789	1176	1965	0.00016
Streptomyces_sp._11-1-2	1851167	S	737	1345	2082	0.00017
Streptomyces_sp._M2	646637	S	716	3839	4555	0.00037
Streptomyces_sp._Tue_6075	1661694	S	631	683	1314	0.00011
Streptomyces_sp._CRSS-Y-16	2906474	S	597	3386	3983	0.00032
Streptomyces_sp._SS52	2563602	S	592	2789	3381	0.00027
Streptomyces_sp._A144	2871487	S	590	2650	3240	0.00026
Streptomyces_sp._CFMR_7	1649184	S	587	959	1546	0.00013
Streptomyces_sp._SGAir0924	2109593	S	557	2718	3275	0.00027
Streptomyces_sp._CB00271	2750025	S	548	714	1262	0.00010
Streptomyces_sp._NA03103	2742134	S	544	3461	4005	0.00033
Streptomyces_sp._M56	1495638	S	530	1387	1917	0.00016
Streptomyces_sp._V17-9	2831149	S	513	2382	2895	0.00023
Streptomyces_sp._BSE6.1	2605730	S	509	2310	2819	0.00023
Streptomyces_sp._endophyte_N2	2153485	S	507	1411	1918	0.00016
Streptomyces_sp._WAC00303	2933779	S	499	686	1185	0.00010
Streptomyces_sp._CLI2509	1984801	S	462	1572	2034	0.00017
Streptomyces_sp._Tu6071	355249	S	451	1370	1821	0.00015
Streptomyces_sp._CB09030	2913412	S	424	1376	1800	0.00015
Streptomyces_sp._CB04723	2748873	S	414	703	1117	0.00009
Streptomyces_sp._VN1	1821625	S	395	1623	2018	0.00016
Streptomyces_sp._HU2014	2939414	S	386	1286	1672	0.00014
Streptomyces_sp._PAMC_26508	1265601	S	348	1246	1594	0.00013
Streptomyces_sp._KPB2	2305221	S	338	2721	3059	0.00025
Streptomyces_sp._S501	2420135	S	321	1244	1565	0.00013
Streptomyces_sp._LBUM_1480	2609808	S	317	3143	3460	0.00028
Streptomyces_sp._WAC00288	2094021	S	299	1209	1508	0.00012
Streptomyces_sp._2114.2	1881022	S	271	1633	1904	0.00015
Streptomyces_sp._S1A1-7	2594459	S	269	2593	2862	0.00023
Streptomyces_sp._WA1-19	2884220	S	265	1358	1623	0.00013
Streptomyces_sp._LBUM_1482	2609809	S	224	5746	5970	0.00048
Streptomyces_sp._R527F	1664033	S	219	1216	1435	0.00012
Streptomyces_sp._A1-5	2738410	S	199	909	1108	0.00009
Streptomyces_sp._RLB3-17	2594455	S	187	3006	3193	0.00026
Streptomyces_sp._GF20	2692235	S	183	991	1174	0.00010
Streptomyces_sp._CA-256286	2801033	S	169	1026	1195	0.00010
Streptomyces_sp._LBUM_1475	2609807	S	149	4484	4633	0.00038
Streptomyces_sp._604F	1476754	S	137	1214	1351	0.00011
Streptomyces_sp._CC0208	2306165	S	134	3565	3699	0.00030
Streptomyces_sp._FR-008	206662	S	123	971	1094	0.00009
Streptomyces_sp._RLB3-6	2594457	S	123	3979	4102	0.00033
Streptomyces_sp._NBU3104	2911367	S	117	740	857	0.00007
Streptomyces_sp._PLM4	2929798	S	108	861	969	0.00008
Streptomyces_sp._OUCMDZ-3434	1535304	S	99	1016	1115	0.00009
Streptomyces_sp._S1D4-20	2594462	S	99	2772	2871	0.00023
Streptomyces_sp._RLB1-9	2594454	S	89	5055	5144	0.00042
Streptomyces_sp._GBA_94-10	1218177	S	85	1067	1152	0.00009
Streptomyces_sp._PVA_94-07	1225337	S	73	1058	1131	0.00009
Streptomyces_sp._A10(2020)	2782013	S	72	811	883	0.00007
Streptomyces_sp._S1D4-14	2594461	S	54	3632	3686	0.00030
Streptomyces_sp._S1D4-23	2594463	S	53	2924	2977	0.00024
Streptomyces_sp._ICC4	2099584	S	28	1958	1986	0.00016
Streptomyces_sp._ICC1	2099583	S	24	1450	1474	0.00012
Streptomyces_sp._SM17	565560	S	20	797	817	0.00007
Streptomyces_cyanogenus	80860	S	25081	9723	34804	0.00282
Streptomyces_hygroscopicus	1912	S	15076	19802	34878	0.00283
Streptomyces_rapamycinicus	1226757	S	3588	782	4370	0.00035
Streptomyces_yatensis	155177	S	1422	920	2342	0.00019
Streptomyces_violaceusniger	68280	S	1386	809	2195	0.00018
Streptomyces_malaysiensis	92644	S	337	968	1305	0.00011
Streptomyces_venezuelae	54571	S	18359	6027	24386	0.00198
Streptomyces_cadmiisoli	2184053	S	5070	1099	6169	0.00050
Streptomyces_qaidamensis	1783515	S	3939	1472	5411	0.00044
Streptomyces_aurantiacus	47760	S	3752	776	4528	0.00037
Streptomyces_alboniger	132473	S	2154	711	2865	0.00023
Streptomyces_koyangensis	188770	S	1403	1272	2675	0.00022
Streptomyces_harbinensis	1176198	S	15616	3810	19426	0.00158
Streptomyces_griseorubiginosus	67304	S	11689	3346	15035	0.00122
Streptomyces_chartreusis	1969	S	11481	4871	16352	0.00133
Streptomyces_actuosus	1885	S	11168	4091	15259	0.00124
Streptomyces_griseochromogenes	68214	S	10876	2621	13497	0.00110
Streptomyces_incarnatus	665007	S	9225	2543	11768	0.00095
Streptomyces_collinus	42684	S	9131	4756	13887	0.00113
Streptomyces_capitiformicae	2014920	S	8176	1203	9379	0.00076
Streptomyces_seoulensis	73044	S	7593	2523	10116	0.00082
Streptomyces_davaonensis	348043	S	7528	1811	9339	0.00076
Streptomyces_bingchenggensis	379067	S	7294	1228	8522	0.00069
Streptomyces_asoensis	249586	S	7262	1872	9134	0.00074
Streptomyces_griseus	1911	S	2745	2157	4902	0.00040
Streptomyces_sp._M54	2759525	S	322	776	1098	0.00009
Streptomyces_anulatus	1892	S	2001	1926	3927	0.00032
Streptomyces_microflavus	1919	S	1043	4304	5347	0.00043
Streptomyces_globisporus	1908	S	845	5776	6621	0.00054
Streptomyces_albus	1888	S	7052	3187	10239	0.00083
Streptomyces_viridosporus	67581	S	6997	2529	9526	0.00077
Streptomyces_fodineus	1904616	S	6945	2145	9090	0.00074
Streptomyces_tendae	1932	S	6730	2420	9150	0.00074
Streptomyces_aquilus	2548456	S	6604	1690	8294	0.00067
Streptomyces_cyaneochromogenes	2496836	S	6551	1675	8226	0.00067
Streptomyces_galilaeus	33899	S	6527	1871	8398	0.00068
Streptomyces_broussonetiae	2686304	S	6524	1711	8235	0.00067
Streptomyces_antibioticus	1890	S	6427	1972	8399	0.00068
Streptomyces_lincolnensis	1915	S	6269	1569	7838	0.00064
Streptomyces_ferrugineus	1413221	S	6201	1755	7956	0.00065
Streptomyces_lydicus	47763	S	6197	3840	10037	0.00081
Streptomyces_dangxiongensis	1442032	S	6144	1857	8001	0.00065
Streptomyces_formicae	1616117	S	6122	1710	7832	0.00064
Streptomyces_roseochromogenus	285450	S	5929	1606	7535	0.00061
Streptomyces_buecherae	2763006	S	5332	1170	6502	0.00053
Streptomyces_calvus	67282	S	5327	1868	7195	0.00058
Streptomyces_roseirectus	2768066	S	5226	1093	6319	0.00051
Streptomyces_spectabilis	68270	S	5074	1453	6527	0.00053
Streptomyces_phaeolivaceus	2653200	S	5068	1224	6292	0.00051
Streptomyces_avermitilis	33903	S	5067	1256	6323	0.00051
Streptomyces_tsukubensis	83656	S	5014	932	5946	0.00048
Streptomyces_glaucescens	1907	S	4918	1836	6754	0.00055
Streptomyces_griseoviridis	45398	S	4883	1346	6229	0.00051
Streptomyces_niveus	193462	S	4871	1928	6799	0.00055
Streptomyces_nodosus	40318	S	4855	1037	5892	0.00048
Streptomyces_cattleya	29303	S	4812	1217	6029	0.00049
Streptomyces_nigra	1827580	S	4765	1617	6382	0.00052
Streptomyces_deccanensis	424188	S	4672	1731	6403	0.00052
Streptomyces_armeniacus	83291	S	4649	607	5256	0.00043
Streptomyces_xanthii	2768069	S	4473	1165	5638	0.00046
Streptomyces_bathyalis	2710756	S	4456	635	5091	0.00041
Streptomyces_pluripotens	1355015	S	4243	822	5065	0.00041
Streptomyces_chromofuscus	42881	S	4185	1399	5584	0.00045
Streptomyces_prasinus	67345	S	4143	1177	5320	0.00043
Streptomyces_coeruleorubidus	116188	S	4084	1746	5830	0.00047
Streptomyces_dengpaensis	2049881	S	4066	961	5027	0.00041
Streptomyces_vietnamensis	362257	S	4037	1187	5224	0.00042
Streptomyces_ambofaciens	1889	S	3984	2088	6072	0.00049
Streptomyces_rimosus	1927	S	3963	863	4826	0.00039
Streptomyces_hawaiiensis	67305	S	3918	1517	5435	0.00044
Streptomyces_parvulus	146923	S	3901	1495	5396	0.00044
Streptomyces_durmitorensis	319947	S	3810	703	4513	0.00037
Streptomyces_pactum	68249	S	3746	1319	5065	0.00041
Streptomyces_xinghaiensis	1038928	S	3737	977	4714	0.00038
Streptomyces_genisteinicus	2768068	S	3548	968	4516	0.00037
Streptomyces_tuirus	68278	S	3548	1564	5112	0.00041
Streptomyces_liangshanensis	2717324	S	3543	762	4305	0.00035
Streptomyces_alboflavus	67267	S	3504	846	4350	0.00035
Streptomyces_globosus	68209	S	3487	1100	4587	0.00037
Streptomyces_griseocarneus	51201	S	3479	1049	4528	0.00037
Streptomyces_aureoverticillatus	66871	S	3445	814	4259	0.00035
Streptomyces_albulus	68570	S	3428	916	4344	0.00035
Streptomyces_rectiverticillatus	173860	S	3372	934	4306	0.00035
Streptomyces_luteoverticillatus	66425	S	3315	944	4259	0.00035
Streptomyces_olivoreticuli	68246	S	3314	813	4127	0.00033
Streptomyces_clavuligerus	1901	S	3308	666	3974	0.00032
Streptomyces_paludis	2282738	S	3246	606	3852	0.00031
Streptomyces_ficellus	1977088	S	3137	970	4107	0.00033
Streptomyces_lunaelactis	1535768	S	3063	561	3624	0.00029
Streptomyces_lavendulae	1914	S	2946	896	3842	0.00031
Streptomyces_subrutilus	36818	S	2889	927	3816	0.00031
Streptomyces_hundungensis	1077946	S	2877	758	3635	0.00029
Streptomyces_peucetius	1950	S	2866	678	3544	0.00029
Streptomyces_exfoliatus	1905	S	2857	853	3710	0.00030
Streptomyces_atratus	1893	S	2755	481	3236	0.00026
Streptomyces_vinaceus	1960	S	2703	841	3544	0.00029
Streptomyces_tirandamycinicus	2174846	S	2690	785	3475	0.00028
Streptomyces_fagopyri	2662397	S	2674	794	3468	0.00028
Streptomyces_katrae	68223	S	2592	850	3442	0.00028
Streptomyces_pristinaespiralis	38300	S	2580	919	3499	0.00028
Streptomyces_gilvosporeus	553510	S	2511	678	3189	0.00026
Streptomyces_kanamyceticus	1967	S	2509	749	3258	0.00026
Streptomyces_spongiicola	1690221	S	2424	807	3231	0.00026
Streptomyces_nitrosporeus	28894	S	2421	591	3012	0.00024
Streptomyces_mobaraensis	35621	S	2413	89011	91424	0.00742
Streptomyces_gardneri	66892	S	2369	857	3226	0.00026
Streptomyces_angustmyceticus	285578	S	2287	823	3110	0.00025
Streptomyces_inhibens	2293571	S	2265	605	2870	0.00023
Streptomyces_rutgersensis	53451	S	2228	935	3163	0.00026
Streptomyces_huasconensis	1854574	S	2194	751	2945	0.00024
Streptomyces_pratensis	1169025	S	2184	463	2647	0.00021
Streptomyces_leeuwenhoekii	1437453	S	2182	1374	3556	0.00029
Streptomyces_finlayi	67296	S	2174	423	2597	0.00021
Streptomyces_qinzhouensis	2599401	S	2126	434	2560	0.00021
Streptomyces_cyaneogriseus	68192	S	2112	1476	3588	0.00029
Streptomyces_nojiriensis	66374	S	2032	775	2807	0.00023
Streptomyces_gobiensis	2875706	S	1891	299	2190	0.00018
Streptomyces_antimycoticus	68175	S	1086	1045	2131	0.00017
Streptomyces_decoyicus	249567	S	1086	550	1636	0.00013
Streptomyces_auratus	114687	S	998	606	1604	0.00013
Streptomyces_xiamenensis	408015	S	941	758	1699	0.00014
Streptomyces_lydicamycinicus	1546107	S	941	515	1456	0.00012
Streptomyces_fungicidicus	68203	S	865	2350	3215	0.00026
Streptomyces_platensis	58346	S	843	578	1421	0.00012
Streptomyces_coelicolor	1902	S	276	2073	2349	0.00019
Streptomyces_albidoflavus	1886	S	269	3764	4033	0.00033
Streptomyces_sampsonii	42239	S	171	1294	1465	0.00012
Streptomyces_olivaceus	47716	S	683	2368	3051	0.00025
Streptomyces_alfalfae	1642299	S	636	3423	4059	0.00033
Streptomyces_filamentosus	67294	S	586	682	1268	0.00010
Streptomyces_californicus	67351	S	535	1642	2177	0.00018
Streptomyces_cavourensis	67258	S	508	864	1372	0.00011
Streptomyces_griseofuscus	146922	S	495	2107	2602	0.00021
Streptomyces_mirabilis	68239	S	427	2439	2866	0.00023
Streptomyces_murinus	33900	S	410	1095	1505	0.00012
Streptomyces_fradiae	1906	S	395	5752	6147	0.00050
Streptomyces_albireticuli	1940	S	306	1228	1534	0.00012
Streptomyces_scabiei	1930	S	303	2563	2866	0.00023
Streptomyces_autolyticus	75293	S	290	939	1229	0.00010
Streptomyces_noursei	1971	S	269	1010	1279	0.00010
Streptomyces_lividans	1916	S	242	3380	3622	0.00029
Streptomyces_cinereoruber	67260	S	212	1054	1266	0.00010
Streptomyces_rochei	1928	S	163	1160	1323	0.00011
Streptomyces_rubrolavendulae	285473	S	149	1022	1171	0.00010
Streptomyces_violaceoruber	1935	S	134	559	693	0.00006
Kitasatospora_sp._MMS16-BH015	2018025	S	3818	1109	4927	0.00040
Kitasatospora_sp._NA04385	2742135	S	3200	1595	4795	0.00039
Kitasatospora_setae	2066	S	3307	1590	4897	0.00040
Kitasatospora_aureofaciens	1894	S	2692	981	3673	0.00030
Kitasatospora_albolonga	68173	S	1057	736	1793	0.00015
Streptacidiphilus_sp._P02-A3a	2704468	S	3797	1055	4852	0.00039
Streptacidiphilus_sp._PB12-B1b	2705012	S	3137	1110	4247	0.00034
Streptacidiphilus_bronchialis	2126346	S	4729	1356	6085	0.00049
Yinghuangia_sp._ASG_101	2896848	S	4852	737	5589	0.00045
Microbacterium_sp._No._7	1714373	S	2948	1292	4240	0.00034
Microbacterium_sp._4R-513	2567934	S	2555	457	3012	0.00024
Microbacterium_sp._10M-3C3	2483401	S	2396	740	3136	0.00025
Microbacterium_sp._JZ31	1906274	S	2198	588	2786	0.00023
Microbacterium_sp._SSW1-51	2851650	S	1761	441	2202	0.00018
Microbacterium_sp._ABRD_28	2268461	S	1681	222	1903	0.00015
Microbacterium_sp._YJN-G	2763257	S	1635	527	2162	0.00018
Microbacterium_sp._XT11	367477	S	1588	331	1919	0.00016
Microbacterium_sp._BH-3-3-3	1906742	S	1575	364	1939	0.00016
Microbacterium_sp._NIBRBAC000506063	2734618	S	1393	561	1954	0.00016
Microbacterium_sp._cx-55	2875948	S	1370	196	1566	0.00013
Microbacterium_sp._LKL04	912630	S	1335	308	1643	0.00013
Microbacterium_sp._PM5	2014534	S	1334	239	1573	0.00013
Microbacterium_sp._SSW1-36	2851648	S	1320	287	1607	0.00013
Microbacterium_sp._Y-01	2048898	S	1281	511	1792	0.00015
Microbacterium_sp._A18JL241	2782166	S	1271	287	1558	0.00013
Microbacterium_sp._H1-D42	2925844	S	1248	198	1446	0.00012
Microbacterium_sp._1S1	2606451	S	1024	447	1471	0.00012
Microbacterium_sp._CBA3102	2603598	S	1004	247	1251	0.00010
Microbacterium_sp._TPU_3598	1938334	S	893	236	1129	0.00009
Microbacterium_sp._Nx66	2766784	S	824	552	1376	0.00011
Microbacterium_sp._RG1	2489212	S	537	406	943	0.00008
Microbacterium_sp._SGAir0570	2070348	S	231	811	1042	0.00008
Microbacterium_sp._1.5R	1916917	S	229	958	1187	0.00010
Microbacterium_sp._CGR1	1696072	S	229	991	1220	0.00010
Microbacterium_sp._PAMC22086	2861281	S	202	424	626	0.00005
Microbacterium_sp._str._'China'	2103230	S	145	752	897	0.00007
Microbacterium_sp._PAMC_28756	1795053	S	61	955	1016	0.00008
Microbacterium_sp._Se5.02b	2864103	S	14	1388	1402	0.00011
Microbacterium_sp._KUDC0406	2909588	S	13	1265	1278	0.00010
Microbacterium_cremeum	2782169	S	4798	982	5780	0.00047
Microbacterium_atlanticum	2782168	S	3250	693	3943	0.00032
Microbacterium_hominis	162426	S	3080	8481	11561	0.00094
Microbacterium_foliorum	104336	S	3060	618	3678	0.00030
Microbacterium_oleivorans	273677	S	2640	497	3137	0.00025
Microbacterium_lemovicicum	1072463	S	2051	449	2500	0.00020
Microbacterium_resistens	156977	S	2029	359	2388	0.00019
Microbacterium_sediminis	904291	S	1956	860	2816	0.00023
Microbacterium_oryzae	743009	S	1797	508	2305	0.00019
Microbacterium_pygmaeum	370764	S	1756	212	1968	0.00016
Microbacterium_testaceum	2033	S	1686	299	1985	0.00016
Microbacterium_aurum	36805	S	1638	504	2142	0.00017
Microbacterium_caowuchunii	2614638	S	1572	286	1858	0.00015
Microbacterium_wangchenii	2541726	S	1544	339	1883	0.00015
Microbacterium_chocolatum	84292	S	1496	324	1820	0.00015
Microbacterium_luteum	2782167	S	1450	592	2042	0.00017
Microbacterium_lushaniae	2614639	S	1418	315	1733	0.00014
Microbacterium_protaetiae	2509458	S	1414	310	1724	0.00014
Microbacterium_oxydans	82380	S	1322	1004	2326	0.00019
Microbacterium_esteraromaticum	57043	S	1298	278	1576	0.00013
Microbacterium_hydrocarbonoxydans	273678	S	975	170	1145	0.00009
Microbacterium_schleiferi	69362	S	959	315	1274	0.00010
Microbacterium_fandaimingii	2708079	S	708	55	763	0.00006
Microbacterium_binotii	462710	S	542	403	945	0.00008
Microbacterium_chengjingii	2769067	S	505	25	530	0.00004
Microbacterium_amylolyticum	936337	S	480	98	578	0.00005
Microbacterium_endophyticum	1526412	S	305	19	324	0.00003
Microbacterium_paraoxydans	199592	S	235	1569	1804	0.00015
Microbacterium_paludicola	300019	S	231	847	1078	0.00009
Agromyces_sp._H17E-10	2932244	S	2877	1010	3887	0.00032
Agromyces_sp._LHK192	2498704	S	2632	813	3445	0.00028
Agromyces_sp._CFWR-12	2929802	S	2004	1258	3262	0.00026
Agromyces_soli	659012	S	2970	1136	4106	0.00033
Agromyces_flavus	589382	S	2898	964	3862	0.00031
Agromyces_aureus	453304	S	2317	689	3006	0.00024
Agromyces_protaetiae	2509455	S	2234	664	2898	0.00024
Agromyces_archimandritae	2781962	S	2055	609	2664	0.00022
Agromyces_marinus	1389020	S	2030	774	2804	0.00023
Agromyces_intestinalis	2592652	S	1957	1157	3114	0.00025
Agromyces_laixinhei	2585717	S	1640	395	2035	0.00017
Agromyces_badenianii	2080742	S	1615	555	2170	0.00018
Curtobacterium_sp._BH-2-1-1	1905847	S	1564	534	2098	0.00017
Curtobacterium_sp._L6-1	2841594	S	1465	482	1947	0.00016
Curtobacterium_sp._MR_MD2014	1561023	S	1100	528	1628	0.00013
Curtobacterium_sp._YC1	2795488	S	1080	505	1585	0.00013
Curtobacterium_sp._TC1	2862880	S	959	516	1475	0.00012
Curtobacterium_sp._24E2	2804758	S	935	534	1469	0.00012
Curtobacterium_sp._SGAir0471	2070337	S	814	706	1520	0.00012
Curtobacterium_sp._TXMA1	2876939	S	653	586	1239	0.00010
Curtobacterium_sp._C1	2898151	S	327	1118	1445	0.00012
Curtobacterium_sp._Csp2	2495430	S	280	1094	1374	0.00011
Curtobacterium_sp._Csp1	2495429	S	29	751	780	0.00006
Curtobacterium_flaccumfaciens	2035	S	2372	1082	3454	0.00028
Curtobacterium_luteum	33881	S	1632	591	2223	0.00018
Rathayibacter_sp._VKM_Ac-2759	2609252	S	2004	736	2740	0.00022
Rathayibacter_sp._VKM_Ac-2760	2609253	S	1796	961	2757	0.00022
Rathayibacter_sp._VKM_Ac-2804	2609257	S	1239	951	2190	0.00018
Rathayibacter_sp._VKM_Ac-2801	2609255	S	769	737	1506	0.00012
Rathayibacter_sp._VKM_Ac-2762	2609254	S	358	989	1347	0.00011
Rathayibacter_sp._VKM_Ac-2805	2609258	S	285	812	1097	0.00009
Rathayibacter_festucae	110937	S	2022	2279	4301	0.00035
Rathayibacter_tanaceti	1671680	S	1210	323	1533	0.00012
Rathayibacter_tritici	33888	S	744	236	980	0.00008
Rathayibacter_iranicus	59737	S	707	95	802	0.00007
Rathayibacter_rathayi	33887	S	678	189	867	0.00007
Rathayibacter_toxicus	145458	S	263	21	284	0.00002
Leucobacter_sp._H25R-14	2932245	S	1487	248	1735	0.00014
Leucobacter_sp._NB_10	2873270	S	1461	410	1871	0.00015
Leucobacter_sp._Psy1	2875729	S	1178	149	1327	0.00011
Leucobacter_sp._CX169	2813744	S	931	250	1181	0.00010
Leucobacter_sp._H21R-36	2932246	S	471	1249	1720	0.00014
Leucobacter_sp._H21R-40	2932247	S	390	1035	1425	0.00012
Leucobacter_muris	1935379	S	1588	581	2169	0.00018
Leucobacter_triazinivorans	1784719	S	1390	687	2077	0.00017
Leucobacter_luti	340320	S	521	46	567	0.00005
Leucobacter_insecticola	2714934	S	425	34	459	0.00004
Leucobacter_viscericola	2714935	S	397	38	435	0.00004
Leucobacter_denitrificans	683042	S	293	43	336	0.00003
Leucobacter_coleopterorum	2714933	S	272	27	299	0.00002
Leifsonia_sp._21MFCrub1.1	1798223	S	2149	2705	4854	0.00039
Leifsonia_sp._ZF2019	2781978	S	2074	621	2695	0.00022
Leifsonia_sp._PS1209	2724914	S	1907	565	2472	0.00020
Leifsonia_shinshuensis	150026	S	2790	883	3673	0.00030
Leifsonia_xyli	1575	S	1512	218	1730	0.00014
Agrococcus_sp._SGAir0287	2070347	S	2416	796	3212	0.00026
Agrococcus_sp._SCSIO52902	2933290	S	2214	1171	3385	0.00027
Agrococcus_sp._Marseille-Q4369	2810513	S	2195	841	3036	0.00025
Agrococcus_jejuensis	399736	S	2405	825	3230	0.00026
Agrococcus_carbonis	684552	S	2273	1136	3409	0.00028
Clavibacter_michiganensis	28447	S	8798	9114	17912	0.00145
Clavibacter_zhangzhiyongii	2768071	S	1185	613	1798	0.00015
Clavibacter_sp._A6099	2860285	S	590	412	1002	0.00008
Protaetiibacter_sp._SSC-01	2759943	S	2297	945	3242	0.00026
Protaetiibacter_intestinalis	2419774	S	2218	889	3107	0.00025
Protaetiibacter_larvae	2592654	S	1599	564	2163	0.00018
Salinibacterium_sp._ZJ450	2708338	S	1386	227	1613	0.00013
Salinibacterium_sp._ZJ70	2708084	S	1314	364	1678	0.00014
Salinibacterium_sp._dk2585	2603292	S	1003	175	1178	0.00010
Salinibacterium_sp._M195	2583374	S	312	34	346	0.00003
Salinibacterium_sp._UTAS2018	2508880	S	310	29	339	0.00003
Salinibacterium_hongtaonis	2079791	S	497	53	550	0.00004
Cryobacterium_sp._LW097	1978566	S	1081	239	1320	0.00011
Cryobacterium_sp._PAMC25264	2861288	S	564	359	923	0.00007
Cryobacterium_soli	2220095	S	795	437	1232	0.00010
Cryobacterium_arcticum	670052	S	662	531	1193	0.00010
Frondihabitans_sp._PAMC_28766	1795630	S	1872	271	2143	0.00017
Frondihabitans_sp._762G35	1446794	S	1741	411	2152	0.00017
Microcella_flavibacter	1804990	S	1907	980	2887	0.00023
Microcella_alkaliphila	279828	S	1150	216	1366	0.00011
Plantibacter_sp._PA-3-X8	2480625	S	599	583	1182	0.00010
Plantibacter_sp._M259	2583822	S	587	554	1141	0.00009
Plantibacter_flavus	150123	S	630	544	1174	0.00010
Microterricola_viridarii	412690	S	3022	802	3824	0.00031
Cnuibacter_physcomitrellae	1619308	S	2304	547	2851	0.00023
Gryllotalpicola_protaetiae	2419771	S	2271	467	2738	0.00022
Herbiconiux_sp._SALV-R1	2735133	S	2151	468	2619	0.00021
Frigoribacterium_sp._NBH87	2596916	S	2068	663	2731	0.00022
Mycetocola_zhujimingii	2079792	S	768	93	861	0.00007
Mycetocola_sp._JXN-3	2116510	S	675	104	779	0.00006
Mycetocola_spongiae	2859226	S	540	72	612	0.00005
Subtercola_sp._AK-R2A1-2	2895559	S	1128	105	1233	0.00010
Subtercola_sp._PAMC28395	2846775	S	643	64	707	0.00006
Chryseoglobus_indicus	2750620	S	381	817	1198	0.00010
Chryseoglobus_sp._28M-23	2772253	S	324	659	983	0.00008
Humibacter_sp._WJ7-1	2599293	S	1778	428	2206	0.00018
Amnibacterium_sp._L3-i23	2905871	S	1697	441	2138	0.00017
Gulosibacter_sediminis	1729695	S	1503	460	1963	0.00016
Marisediminicola_antarctica	674079	S	1468	194	1662	0.00013
Diaminobutyricimonas_sp._LJ205	2683590	S	1107	223	1330	0.00011
Glaciihabitans_sp._INWT7	2596912	S	958	81	1039	0.00008
Agreia_sp._COWG	2773266	S	932	119	1051	0.00009
Rhodoluna_limnophila	232537	S	69	5	74	0.00001
Candidatus_Rhodoluna_planktonica	535712	S	59	3	62	0.00001
Rhodoluna_lacicola	529884	S	35	2	37	0.00000
Aquiluna_borgnonia	2499157	S	97	10	107	0.00001
Candidatus_Aquiluna_sp._UB-MaderosW2red	1855377	S	56	4	60	0.00000
Pseudoclavibacter_sp._Marseille-Q3772	2866588	S	233	45	278	0.00002
Aurantimicrobium_photophilum	1987356	S	62	5	67	0.00001
Aurantimicrobium_minutum	708131	S	34	11	45	0.00000
Aurantimicrobium_sp._MWH-Uga1	2079575	S	31	10	41	0.00000
Pontimonas_salivibrio	1159327	S	100	4	104	0.00001
Arthrobacter_sp._NicSoilC5	2831000	S	3398	1677	5075	0.00041
Arthrobacter_sp._QL17	2895818	S	1698	379	2077	0.00017
Arthrobacter_sp._QXT-31	1357915	S	1693	430	2123	0.00017
Arthrobacter_sp._FW305-BF8	2879617	S	1502	379	1881	0.00015
Arthrobacter_sp._NicSoilB8	2830998	S	1374	335	1709	0.00014
Arthrobacter_sp._PM3	2017685	S	1370	221	1591	0.00013
Arthrobacter_sp._UKPF54-2	2600159	S	1264	501	1765	0.00014
Arthrobacter_sp._KBS0702	2578107	S	1226	458	1684	0.00014
Arthrobacter_sp._PAMC25564	2565366	S	1195	303	1498	0.00012
Arthrobacter_sp._24S4-2	2575374	S	1135	238	1373	0.00011
Arthrobacter_sp._U41	1849032	S	1129	304	1433	0.00012
Arthrobacter_sp._ERGS1:01	1704044	S	1115	196	1311	0.00011
Arthrobacter_sp._NicSoilB4	2830997	S	1086	320	1406	0.00011
Arthrobacter_sp._FB24	290399	S	1027	322	1349	0.00011
Arthrobacter_sp._PGP41	2079227	S	1011	350	1361	0.00011
Arthrobacter_sp._Helios	2828862	S	1010	150	1160	0.00009
Arthrobacter_sp._FW306-2-2C-D06B	2879618	S	885	156	1041	0.00008
Arthrobacter_sp._PAMC25284	2861279	S	789	187	976	0.00008
Arthrobacter_sp._zg-Y462	2886936	S	786	145	931	0.00008
Arthrobacter_sp._PAMC_25486	1494608	S	641	94	735	0.00006
Arthrobacter_sp._zg-Y809	2886940	S	580	193	773	0.00006
Arthrobacter_sp._NtRootA1	2830983	S	487	141	628	0.00005
Arthrobacter_sp._StoSoilB5	2830992	S	477	128	605	0.00005
Arthrobacter_sp._StoSoilB20	2830995	S	468	126	594	0.00005
Arthrobacter_sp._NicSoilB11	2830999	S	439	1678	2117	0.00017
Arthrobacter_sp._FW306-06-A	2879621	S	423	1424	1847	0.00015
Arthrobacter_sp._D5-1	1477518	S	412	258	670	0.00005
Arthrobacter_sp._YN	2020486	S	360	145	505	0.00004
Arthrobacter_sp._StoSoilB19	2830994	S	308	1353	1661	0.00013
Arthrobacter_sp._C1-1	2813727	S	260	32	292	0.00002
Arthrobacter_sp._FW306-07-I	2879622	S	255	1370	1625	0.00013
Arthrobacter_sp._FW306-05-C	2879620	S	243	1220	1463	0.00012
Arthrobacter_sp._StoSoilB13	2830993	S	131	230	361	0.00003
Arthrobacter_sp._StoSoilA2	2830990	S	126	215	341	0.00003
Arthrobacter_sp._AQ5-05	2184581	S	25	445	470	0.00004
Arthrobacter_crystallopoietes	37928	S	3203	536	3739	0.00030
Arthrobacter_agilis	37921	S	2606	379	2985	0.00024
Arthrobacter_sulfonylureivorans	2486855	S	2027	305	2332	0.00019
Arthrobacter_woluwensis	156980	S	1193	254	1447	0.00012
Arthrobacter_dokdonellae	2211210	S	1147	177	1324	0.00011
Arthrobacter_jiangjiafuii	2817475	S	849	212	1061	0.00009
Arthrobacter_alpinus	656366	S	718	1076	1794	0.00015
Arthrobacter_sunyaminii	2816859	S	586	181	767	0.00006
Kocuria_rosea	1275	S	2404	741	3145	0.00026
Kocuria_flava	446860	S	2121	1046	3167	0.00026
Kocuria_turfanensis	388357	S	2022	681	2703	0.00022
Kocuria_palustris	71999	S	1243	478	1721	0.00014
Kocuria_rhizophila	72000	S	949	1458	2407	0.00020
Kocuria_varians	1272	S	771	536	1307	0.00011
Kocuria_sp._TGY1127_2	2711328	S	318	51	369	0.00003
Kocuria_sp._KD4	2719588	S	168	283	451	0.00004
Kocuria_sp._BT304	1702043	S	85	431	516	0.00004
Kocuria_indica	1049583	S	177	350	527	0.00004
Pseudarthrobacter_sp._L1SW	2851598	S	842	330	1172	0.00010
Pseudarthrobacter_sp._BIM_B-2242	2772401	S	824	190	1014	0.00008
Pseudarthrobacter_sp._NBSH8	2596911	S	459	168	627	0.00005
Pseudarthrobacter_sp._NIBRBAC000502772	2590775	S	407	300	707	0.00006
Pseudarthrobacter_sp._SSS035	2931399	S	402	357	759	0.00006
Pseudarthrobacter_sp._NIBRBAC000502770	2590785	S	353	982	1335	0.00011
Pseudarthrobacter_sp._NIBRBAC000502771	2590774	S	348	1066	1414	0.00011
Pseudarthrobacter_phenanthrenivorans	361575	S	878	418	1296	0.00011
Pseudarthrobacter_chlorophenolicus	85085	S	865	303	1168	0.00009
Pseudarthrobacter_equi	728066	S	784	288	1072	0.00009
Pseudarthrobacter_psychrotolerans	2697569	S	609	239	848	0.00007
Pseudarthrobacter_sulfonivorans	121292	S	334	353	687	0.00006
Micrococcus_luteus	1270	S	2607	4746	7353	0.00060
Micrococcus_sp._KD337-16	2856555	S	1151	701	1852	0.00015
Micrococcus_sp._KBS0714	1179670	S	32	266	298	0.00002
Micrococcus_yunnanensis	566027	S	33	258	291	0.00002
Sinomonas_atrocyanea	37927	S	2678	867	3545	0.00029
Sinomonas_sp._R1AF57	2020377	S	2408	569	2977	0.00024
Glutamicibacter_creatinolyticus	162496	S	873	181	1054	0.00009
Glutamicibacter_protophormiae	37930	S	867	446	1313	0.00011
Glutamicibacter_halophytocola	1933880	S	409	70	479	0.00004
Glutamicibacter_mishrai	1775880	S	322	68	390	0.00003
Glutamicibacter_arilaitensis	256701	S	270	99	369	0.00003
Glutamicibacter_nicotianae	37929	S	198	582	780	0.00006
Glutamicibacter_sp._ZJUTW	1155384	S	60	270	330	0.00003
Paenarthrobacter_ureafaciens	37931	S	1297	1843	3140	0.00025
Paenarthrobacter_aurescens	43663	S	525	274	799	0.00006
Paenarthrobacter_sp._YJN-5	2735316	S	244	497	741	0.00006
Paenarthrobacter_sp._YJN-D	2735317	S	112	225	337	0.00003
Paenarthrobacter_nicotinovorans	29320	S	117	200	317	0.00003
Rothia_kristinae	37923	S	1342	784	2126	0.00017
Rothia_mucilaginosa	43675	S	375	66	441	0.00004
Rothia_nasimurium	85336	S	198	74	272	0.00002
Rothia_aeria	172042	S	155	66	221	0.00002
Rothia_dentocariosa	2047	S	109	55	164	0.00001
Rothia_amarae	169480	S	72	31	103	0.00001
Rothia_terrae	396015	S	71	29	100	0.00001
Rothia_sp._ZJ932	2810516	S	69	10	79	0.00001
Citricoccus_sp._SGAir0253	2567881	S	2178	584	2762	0.00022
Nesterenkonia_sp._NBAIMH1	2600320	S	705	44	749	0.00006
Paeniglutamicibacter_sp._Y32M11	2853258	S	389	55	444	0.00004
Psychromicrobium_lacuslunae	1618207	S	273	29	302	0.00002
Neomicrococcus_aestuarii	556325	S	249	84	333	0.00003
Auritidibacter_sp._NML130574	2170745	S	176	18	194	0.00002
Renibacterium_salmoninarum	1646	S	155	8	163	0.00001
Cellulomonas_sp._H30R-01	2704467	S	4529	1974	6503	0.00053
Cellulomonas_sp._Y8	2591145	S	4235	2013	6248	0.00051
Cellulomonas_sp._JZ18	2654191	S	3262	1556	4818	0.00039
Cellulomonas_sp._C5510	2871170	S	3120	1402	4522	0.00037
Cellulomonas_sp._zg-ZUI188	2819978	S	2778	865	3643	0.00030
Cellulomonas_sp._zg-ZUI157	2819979	S	2559	995	3554	0.00029
Cellulomonas_sp._zg-ZUI222	2816956	S	2552	1066	3618	0.00029
Cellulomonas_sp._EW123	2608402	S	2336	1535	3871	0.00031
Cellulomonas_sp._PSBB021	2003551	S	2183	1972	4155	0.00034
Cellulomonas_fimi	1708	S	3352	2981	6333	0.00051
Cellulomonas_iranensis	76862	S	2972	1542	4514	0.00037
Cellulomonas_shaoxiangyii	2566013	S	2900	1334	4234	0.00034
Cellulomonas_flavigena	1711	S	2582	1098	3680	0.00030
Cellulomonas_gilvus	11	S	2341	1151	3492	0.00028
Cellulomonas_taurus	2729175	S	1754	609	2363	0.00019
Actinotalea_sp._JY-7876	2758442	S	3041	1212	4253	0.00035
Oerskovia_sp._KBS0722	1179673	S	2406	848	3254	0.00026
Pseudactinotalea_sp._HY158	2654547	S	2179	341	2520	0.00020
Paraoerskovia_marina	545619	S	1674	474	2148	0.00017
Janibacter_melonis	262209	S	3079	1122	4201	0.00034
Janibacter_limosus	53458	S	1980	568	2548	0.00021
Janibacter_indicus	857417	S	1058	1661	2719	0.00022
Janibacter_sp._YB324	2761047	S	694	1466	2160	0.00018
Phycicoccus_sp._HDW14	2714941	S	4123	1452	5575	0.00045
Phycicoccus_endophyticus	1690220	S	3376	1050	4426	0.00036
Pedococcus_dokdonensis	443156	S	4663	1493	6156	0.00050
Tetrasphaera_sp._HKS02	1813880	S	3745	1056	4801	0.00039
Intrasporangium_calvum	53358	S	3538	976	4514	0.00037
Arsenicicoccus_sp._oral_taxon_190	1658671	S	2911	1208	4119	0.00033
Cellulosimicrobium_cellulans	1710	S	6704	7446	14150	0.00115
Cellulosimicrobium_sp._BI34T	2587808	S	2731	1368	4099	0.00033
Cellulosimicrobium_sp._JZ28	1906273	S	605	1469	2074	0.00017
Cellulosimicrobium_sp._72-3	2731680	S	305	1409	1714	0.00014
Cellulosimicrobium_sp._TH-20	1980001	S	284	1352	1636	0.00013
Xylanimonas_protaetiae	2509457	S	2854	1405	4259	0.00035
Xylanimonas_cellulosilytica	186189	S	2461	971	3432	0.00028
Xylanimonas_allomyrinae	2509459	S	2388	833	3221	0.00026
Isoptericola_variabilis	139208	S	3320	1949	5269	0.00043
Isoptericola_dokdonensis	372663	S	2718	1163	3881	0.00031
Ornithinimicrobium_avium	2283195	S	3134	882	4016	0.00033
Ornithinimicrobium_sp._HY006	2508882	S	2091	747	2838	0.00023
Ornithinimicrobium_sp._INDO-MA30-4	2908651	S	345	64	409	0.00003
Ornithinimicrobium_flavum	1288636	S	2083	714	2797	0.00023
Ornithinimicrobium_ciconiae	2594265	S	1721	279	2000	0.00016
Ornithinimicrobium_pratense	2593973	S	1366	415	1781	0.00014
Serinicoccus_chungangensis	767452	S	2256	806	3062	0.00025
Serinicoccus_hydrothermalis	1758689	S	1949	923	2872	0.00023
Serinicoccus_marinus	247333	S	1788	894	2682	0.00022
Serinicoccus_profundi	1078471	S	1788	676	2464	0.00020
Georgenia_yuyongxinii	2589797	S	6022	1609	7631	0.00062
Georgenia_sp._TF02-10	2917725	S	4311	1759	6070	0.00049
Georgenia_wutianyii	2585135	S	3134	1194	4328	0.00035
Georgenia_faecalis	2483799	S	2829	872	3701	0.00030
Brachybacterium_sp._CBA3105	2887346	S	2197	527	2724	0.00022
Brachybacterium_sp._SGAir0954	2571029	S	2165	628	2793	0.00023
Brachybacterium_sp._P6-10-X1	1903186	S	1682	305	1987	0.00016
Brachybacterium_faecium	43669	S	1690	541	2231	0.00018
Brachybacterium_saurashtrense	556288	S	1619	482	2101	0.00017
Brachybacterium_ginsengisoli	1331682	S	1583	481	2064	0.00017
Brachybacterium_vulturis	2017484	S	1106	428	1534	0.00012
Brachybacterium_avium	2017485	S	1025	397	1422	0.00012
Dermabacter_vaginalis	1630135	S	491	335	826	0.00007
Dermabacter_jinjuensis	1667168	S	448	373	821	0.00007
Devriesea_agamarum	472569	S	262	14	276	0.00002
Brevibacterium_sp._CS2	2575923	S	1979	859	2838	0.00023
Brevibacterium_sp._SMBL_HHYL_HB1	2777556	S	790	196	986	0.00008
Brevibacterium_sp._HY170	2898795	S	298	101	399	0.00003
Brevibacterium_sp._'Marine'	2725563	S	270	210	480	0.00004
Brevibacterium_sp._W7.2	2823518	S	243	1353	1596	0.00013
Brevibacterium_casei	33889	S	1980	1534	3514	0.00029
Brevibacterium_luteolum	199591	S	1049	451	1500	0.00012
Brevibacterium_linens	1703	S	965	662	1627	0.00013
Brevibacterium_aurantiacum	273384	S	622	453	1075	0.00009
Brevibacterium_oceani	358099	S	620	153	773	0.00006
Brevibacterium_atlanticum	2697563	S	606	140	746	0.00006
Brevibacterium_sandarakinum	629680	S	538	109	647	0.00005
Brevibacterium_limosum	2697565	S	474	196	670	0.00005
Brevibacterium_siliguriense	1136497	S	335	111	446	0.00004
Brevibacterium_pigmentatum	1496080	S	262	223	485	0.00004
Dermacoccus_nishinomiyaensis	1274	S	2003	932	2935	0.00024
Dermacoccus_sp._PAMC28757	2762331	S	1425	544	1969	0.00016
Luteipulveratus_mongoliensis	571913	S	2421	365	2786	0.00023
Allobranchiibius_sp._GilTou73	2904523	S	2041	485	2526	0.00021
Yimella_sp._cx-51	2770551	S	1315	279	1594	0.00013
Haloactinobacterium_kanbiaonis	2675754	S	2985	472	3457	0.00028
Ruania_sp._LR1S40	2897774	S	1770	405	2175	0.00018
Ruania_sp._M4N3S171	2897773	S	1034	165	1199	0.00010
Ruania_zhangjianzhongii	2603206	S	1724	185	1909	0.00015
Ruania_alkalisoli	2779775	S	1223	235	1458	0.00012
Pengzhenrongella_sicca	2819238	S	3765	1138	4903	0.00040
Luteimicrobium_xylanilyticum	1133546	S	3089	1053	4142	0.00034
Beutenbergia_cavernae	84757	S	3879	714	4593	0.00037
Miniimonas_sp._S16	2171623	S	2608	1546	4154	0.00034
Sanguibacter_keddieii	60920	S	2312	749	3061	0.00025
Sanguibacter_sp._HDW7	2714931	S	2152	735	2887	0.00023
Gephyromycinifex_aptenodytis	2716227	S	976	115	1091	0.00009
Austwickia_chelonae	100225	S	767	60	827	0.00007
Dermatophilus_congolensis	1863	S	199	17	216	0.00002
Kytococcus_sedentarius	1276	S	1864	728	2592	0.00021
Demequina_sp._TMPB413	2881056	S	745	61	806	0.00007
Jonesia_denitrificans	43674	S	91	16	107	0.00001
Tropheryma_whipplei	2039	S	35	0	35	0.00000
Mycolicibacterium_rutilum	370526	S	10518	2834	13352	0.00108
Mycolicibacterium_litorale	758802	S	6729	1708	8437	0.00068
Mycolicibacterium_celeriflavum	1249101	S	5363	934	6297	0.00051
Mycolicibacterium_pulveris	36813	S	4909	747	5656	0.00046
Mycolicibacterium_fortuitum	1766	S	4453	1597	6050	0.00049
Mycolicibacterium_smegmatis	1772	S	4330	2317	6647	0.00054
Mycolicibacterium_sp._YH-1	2908837	S	2435	2057	4492	0.00036
Mycolicibacterium_phlei	1771	S	4267	1314	5581	0.00045
Mycolicibacterium_moriokaense	39691	S	4245	467	4712	0.00038
Mycolicibacterium_vaccae	1810	S	3340	603	3943	0.00032
Mycolicibacterium_parafortuitum	39692	S	3253	594	3847	0.00031
Mycolicibacterium_monacense	85693	S	3239	1614	4853	0.00039
Mycolicibacterium_chubuense	1800	S	3187	645	3832	0.00031
Mycolicibacterium_hassiacum	46351	S	3181	795	3976	0.00032
Mycolicibacterium_mageritense	53462	S	3112	477	3589	0.00029
Mycolicibacterium_neoaurum	1795	S	3042	519	3561	0.00029
Mycolicibacterium_madagascariense	212765	S	3039	414	3453	0.00028
Mycolicibacterium_duvalii	39688	S	2979	537	3516	0.00029
Mycolicibacterium_rhodesiae	36814	S	2958	444	3402	0.00028
Mycolicibacterium_sediminis	1286180	S	2958	486	3444	0.00028
Mycolicibacterium_gadium	1794	S	2842	351	3193	0.00026
Mycolicibacterium_psychrotolerans	216929	S	2824	574	3398	0.00028
Mycolicibacterium_arabiense	1286181	S	2799	387	3186	0.00026
Mycolicibacterium_baixiangningiae	2761578	S	2759	412	3171	0.00026
Mycolicibacterium_thermoresistibile	1797	S	2635	538	3173	0.00026
Mycolicibacterium_chitae	1792	S	2560	553	3113	0.00025
Mycolicibacterium_poriferae	39694	S	2524	485	3009	0.00024
Mycolicibacterium_gilvum	1804	S	2505	847	3352	0.00027
Mycolicibacterium_aurum	1791	S	2494	292	2786	0.00023
Mycolicibacterium_fluoranthenivorans	258505	S	2312	271	2583	0.00021
Mycolicibacterium_confluentis	28047	S	2195	297	2492	0.00020
Mycolicibacterium_phocaicum	319706	S	2122	1091	3213	0.00026
Mycolicibacterium_tokaiense	39695	S	2070	291	2361	0.00019
Mycolicibacterium_fallax	1793	S	1886	676	2562	0.00021
Mycolicibacterium_aichiense	1799	S	1875	288	2163	0.00018
Mycolicibacterium_austroafricanum	39687	S	1840	7708	9548	0.00077
Mycolicibacterium_boenickei	146017	S	1819	2551	4370	0.00035
Mycolicibacterium_mengxianglii	2736649	S	1792	170	1962	0.00016
Mycolicibacterium_insubricum	444597	S	1691	424	2115	0.00017
Mycolicibacterium_anyangense	1431246	S	1670	245	1915	0.00016
Mycobacterium_doricum	126673	S	1651	354	2005	0.00016
Mycolicibacterium_helvum	1534349	S	1560	171	1731	0.00014
Mycolicibacterium_mucogenicum	56689	S	1538	621	2159	0.00018
Mycolicibacterium_alvei	67081	S	1260	317	1577	0.00013
Mycolicibacterium_sarraceniae	1534348	S	1202	142	1344	0.00011
Mycolicibacterium_septicum	98668	S	851	589	1440	0.00012
Mycolicibacterium_farcinogenes	1802	S	613	1831	2444	0.00020
Mycolicibacterium_vanbaalenii	110539	S	283	4903	5186	0.00042
Mycolicibacterium_nivoides	2487344	S	181	914	1095	0.00009
Mycobacterium_sp._JS623	212767	S	13307	981	14288	0.00116
Mycobacterium_sp._IDR2000157661	2867005	S	3362	544	3906	0.00032
Mycobacterium_sp._EPa45	1545728	S	1859	283	2142	0.00017
Mycobacterium_sp._DL592	2675524	S	1829	264	2093	0.00017
Mycobacterium_sp._YC-RL4	1682113	S	1710	551	2261	0.00018
Mycobacterium_sp._MS1601	1936029	S	1615	200	1815	0.00015
Mycobacterium_sp._TY59	2775496	S	1245	207	1452	0.00012
Mycobacterium_sp._DL440	2675523	S	1220	242	1462	0.00012
Mycobacterium_sp._WY10	1920667	S	453	1473	1926	0.00016
Mycobacterium_sp._PYR15	2051552	S	136	1296	1432	0.00012
Mycobacterium_sp._20KCMC460	2903536	S	52	1403	1455	0.00012
Mycobacterium_sp._MOTT36Y	1168287	S	38	548	586	0.00005
Mycobacterium_sp._IWGMT90018-18076	2871094	S	11	541	552	0.00004
Mycobacterium_saskatchewanense	220927	S	2187	406	2593	0.00021
Mycobacterium_parmense	185642	S	2111	385	2496	0.00020
Mycobacterium_kubicae	120959	S	1875	304	2179	0.00018
Mycobacterium_shigaense	722731	S	1672	222	1894	0.00015
Mycobacterium_simiae	1784	S	1568	125	1693	0.00014
Mycobacterium_heidelbergense	53376	S	1510	346	1856	0.00015
Mycobacterium_florentinum	292462	S	1485	316	1801	0.00015
Mycobacterium_lentiflavum	141349	S	1458	329	1787	0.00015
Mycobacterium_stomatepiae	470076	S	1431	272	1703	0.00014
Mycobacterium_goodii	134601	S	13332	4222	17554	0.00142
Mycobacterium_avium	1764	S	3068	2743	5811	0.00047
Mycobacterium_mantenii	560555	S	1529	175	1704	0.00014
Mycobacterium_intracellulare	1767	S	1509	10561	12070	0.00098
Mycobacterium_colombiense	339268	S	1473	239	1712	0.00014
Mycobacterium_marseillense	701042	S	1381	310	1691	0.00014
Mycobacterium_paraintracellulare	1138383	S	319	2316	2635	0.00021
Mycobacterium_holsaticum	152142	S	5158	710	5868	0.00048
Mycobacterium_dioxanotrophicus	482462	S	3975	852	4827	0.00039
Mycobacterium_rufum	318424	S	3578	930	4508	0.00037
Mycobacterium_grossiae	1552759	S	3139	828	3967	0.00032
Mycobacterium_branderi	43348	S	2883	311	3194	0.00026
Mycobacterium_crocinum	388459	S	2135	1228	3363	0.00027
Mycobacterium_conspicuum	44010	S	2095	236	2331	0.00019
Mycobacterium_canettii	78331	S	679	386	1065	0.00009
Mycobacterium_tuberculosis	1773	S	402	7547	7949	0.00065
Mycobacterium_diernhoferi	1801	S	1954	345	2299	0.00019
Mycobacterium_paragordonae	1389713	S	1951	219	2170	0.00018
Mycobacterium_frederiksbergense	117567	S	1950	534	2484	0.00020
Mycobacterium_cookii	1775	S	1937	170	2107	0.00017
Mycobacterium_noviomagense	459858	S	1832	128	1960	0.00016
Mycobacterium_paraterrae	577492	S	1705	166	1871	0.00015
Mycobacterium_gordonae	1778	S	1574	117	1691	0.00014
Mycobacterium_heckeshornense	110505	S	1557	112	1669	0.00014
Mycobacterium_kansasii	1768	S	1450	138	1588	0.00013
Mycobacterium_koreense	1069220	S	1439	373	1812	0.00015
Mycobacterium_paraseoulense	590652	S	1424	288	1712	0.00014
Mycobacterium_malmoense	1780	S	1398	210	1608	0.00013
Mycobacterium_vicinigordonae	1719132	S	1371	66	1437	0.00012
Mycobacterium_shinjukuense	398694	S	1364	121	1485	0.00012
Mycobacterium_xenopi	1789	S	1337	145	1482	0.00012
Mycobacterium_riyadhense	486698	S	1335	50	1385	0.00011
Mycobacterium_lacus	169765	S	1255	83	1338	0.00011
Mycobacterium_virginiense	1795032	S	1203	282	1485	0.00012
Mycobacterium_ostraviense	2738409	S	1187	120	1307	0.00011
Mycobacterium_seoulense	386911	S	1151	270	1421	0.00012
Mycobacterium_basiliense	2094119	S	1117	35	1152	0.00009
Mycobacterium_spongiae	886343	S	1059	25	1084	0.00009
Mycobacterium_haemophilum	29311	S	748	33	781	0.00006
Mycobacterium_senegalense	1796	S	289	1397	1686	0.00014
Mycobacterium_marinum	1781	S	285	1166	1451	0.00012
Mycobacterium_leprae	1769	S	178	4	182	0.00001
Mycobacterium_novum	2492438	S	170	2054	2224	0.00018
Mycobacterium_lepromatosis	480418	S	167	3	170	0.00001
Mycobacterium_pallens	370524	S	134	1404	1538	0.00012
Mycobacterium_ulcerans	1809	S	112	620	732	0.00006
Mycobacterium_shottsii	133549	S	75	153	228	0.00002
Mycobacterium_pseudoshottsii	265949	S	26	185	211	0.00002
Mycolicibacter_sp._MYC340	2855503	S	1025	239	1264	0.00010
Mycolicibacter_sp._MYC098	2872309	S	895	209	1104	0.00009
Mycolicibacter_sp._MYC017	2875777	S	646	484	1130	0.00009
Mycolicibacter_sp._MYC123	2855502	S	178	711	889	0.00007
Mycolicibacter_sp._MYC101	2872311	S	166	647	813	0.00007
Mycolicibacter_terrae	1788	S	1306	373	1679	0.00014
Mycolicibacter_hiberniae	29314	S	1167	227	1394	0.00011
Mycolicibacter_minnesotensis	1118379	S	808	128	936	0.00008
Mycolicibacter_sinensis	875328	S	143	1413	1556	0.00013
Mycobacteroides_abscessus	36809	S	1806	1392	3198	0.00026
Mycobacteroides_chelonae	1774	S	1096	378	1474	0.00012
Mycobacteroides_saopaulense	1578165	S	701	105	806	0.00007
Mycobacteroides_immunogenum	83262	S	633	133	766	0.00006
Mycobacteroides_salmoniphilum	404941	S	613	69	682	0.00006
[Mycobacterium]_stephanolepidis	1520670	S	323	124	447	0.00004
Mycolicibacillus_parakoreensis	1069221	S	1549	399	1948	0.00016
Hoyosella_subflava	639313	S	732	35	767	0.00006
Nocardia_asteroides	1824	S	12211	3986	16197	0.00131
Nocardia_brasiliensis	37326	S	6320	1648	7968	0.00065
Nocardia_farcinica	37329	S	5566	3524	9090	0.00074
Nocardia_cyriacigeorgica	135487	S	4433	1810	6243	0.00051
Nocardia_terpenica	455432	S	4233	718	4951	0.00040
Nocardia_gipuzkoensis	2749991	S	3848	1369	5217	0.00042
Nocardia_nova	37330	S	3200	426	3626	0.00029
Nocardia_arthritidis	228602	S	2639	316	2955	0.00024
Nocardia_wallacei	480035	S	2620	718	3338	0.00027
Nocardia_sp._CS682	1047172	S	2198	511	2709	0.00022
Nocardia_otitidiscaviarum	1823	S	2137	401	2538	0.00021
Nocardia_yunnanensis	2382165	S	2133	503	2636	0.00021
Nocardia_tengchongensis	2055889	S	2132	510	2642	0.00021
Nocardia_huaxiensis	2755382	S	2132	397	2529	0.00021
Nocardia_yamanashiensis	209247	S	2119	402	2521	0.00020
Nocardia_iowensis	204891	S	2014	419	2433	0.00020
Nocardia_seriolae	37332	S	2008	519	2527	0.00021
Nocardia_mangyaensis	2213200	S	1843	471	2314	0.00019
Rhodococcus_sp._X156	2499145	S	2829	935	3764	0.00031
Rhodococcus_sp._MTM3W5.2	1805827	S	2305	527	2832	0.00023
Rhodococcus_sp._SGAir0479	2567884	S	2265	633	2898	0.00024
Rhodococcus_sp._W8901	2742603	S	1953	493	2446	0.00020
Rhodococcus_sp._PBTS_1	1653478	S	1849	459	2308	0.00019
Rhodococcus_sp._RDE2	2885078	S	1292	1178	2470	0.00020
Rhodococcus_sp._ABRD24	2507582	S	1185	199	1384	0.00011
Rhodococcus_sp._R79	2811421	S	1050	678	1728	0.00014
Rhodococcus_sp._USK10	2789739	S	866	586	1452	0.00012
Rhodococcus_sp._B7740	1564114	S	864	111	975	0.00008
Rhodococcus_sp._P1Y	1302308	S	798	68	866	0.00007
Rhodococcus_sp._WMMA185	679318	S	764	91	855	0.00007
Rhodococcus_sp._USK13	2806442	S	569	425	994	0.00008
Rhodococcus_sp._WAY2	2663121	S	484	449	933	0.00008
Rhodococcus_sp._S2-17	1990687	S	272	847	1119	0.00009
Rhodococcus_sp._ZPP	2749906	S	272	816	1088	0.00009
Rhodococcus_sp._WB9	2594007	S	264	333	597	0.00005
Rhodococcus_sp._DMU1	2722825	S	258	906	1164	0.00009
Rhodococcus_sp._M8	1925550	S	204	591	795	0.00006
Rhodococcus_sp._2G	1570939	S	179	686	865	0.00007
Rhodococcus_sp._p52	935199	S	127	639	766	0.00006
Rhodococcus_sp._WB1	1033922	S	121	968	1089	0.00009
Rhodococcus_sp._21391	2683591	S	112	487	599	0.00005
Rhodococcus_sp._P-2	2795031	S	97	111	208	0.00002
Rhodococcus_sp._LW-XY12	2856851	S	89	743	832	0.00007
Rhodococcus_sp._DMF-1	2907624	S	56	414	470	0.00004
Rhodococcus_sp._YL-1	1045808	S	51	212	263	0.00002
Rhodococcus_sp._PSBB049	2812863	S	51	685	736	0.00006
Rhodococcus_sp._AQ5-07	2054902	S	44	141	185	0.00002
Rhodococcus_sp._BH4	1807790	S	40	247	287	0.00002
Rhodococcus_sp._H-CA8f	1727214	S	40	160	200	0.00002
Rhodococcus_sp._NJ-530	2490853	S	31	168	199	0.00002
Rhodococcus_sp._008	1723645	S	24	140	164	0.00001
Rhodococcus_sp._C1	644410	S	12	133	145	0.00001
Rhodococcus_opacus	37919	S	5146	4889	10035	0.00081
Rhodococcus_rhodochrous	1829	S	4351	2355	6706	0.00054
Rhodococcus_equi	43767	S	3275	1111	4386	0.00036
Rhodococcus_fascians	1828	S	2424	491	2915	0.00024
Rhodococcus_pyridinivorans	103816	S	1597	5840	7437	0.00060
Rhodococcus_triatomae	300028	S	1549	424	1973	0.00016
Rhodococcus_coprophilus	38310	S	1303	214	1517	0.00012
Rhodococcus_koreensis	99653	S	1221	341	1562	0.00013
Rhodococcus_jostii	132919	S	961	372	1333	0.00011
Rhodococcus_ruber	1830	S	816	2453	3269	0.00027
Rhodococcus_qingshengii	334542	S	364	1929	2293	0.00019
Rhodococcus_erythropolis	1833	S	360	1489	1849	0.00015
Rhodococcus_globerulus	33008	S	703	73	776	0.00006
Rhodococcus_aetherivorans	191292	S	226	1942	2168	0.00018
Corynebacterium_cyclohexanicum	322009	S	2050	746	2796	0.00023
Corynebacterium_frankenforstense	1230998	S	1498	387	1885	0.00015
Corynebacterium_sphenisci	191493	S	1355	346	1701	0.00014
Corynebacterium_bovis	36808	S	1349	255	1604	0.00013
Corynebacterium_xerosis	1725	S	1276	610	1886	0.00015
Corynebacterium_halotolerans	225326	S	1106	225	1331	0.00011
Corynebacterium_freneyi	134034	S	951	336	1287	0.00010
Corynebacterium_nuruki	1032851	S	911	181	1092	0.00009
Corynebacterium_sp._CNCTC7651	2815361	S	441	73	514	0.00004
Corynebacterium_sp._NML98-0116	702967	S	248	74	322	0.00003
Corynebacterium_sp._1864	2820399	S	67	147	214	0.00002
Corynebacterium_sp._FDAARGOS_1242	2778078	S	66	171	237	0.00002
Corynebacterium_sp._4H37-19	2684405	S	47	3	50	0.00000
Corynebacterium_sp._sy039	2599641	S	16	1	17	0.00000
Corynebacterium_maris	575200	S	822	113	935	0.00008
Corynebacterium_vitaeruminis	38305	S	782	195	977	0.00008
Corynebacterium_variabile	1727	S	724	370	1094	0.00009
Corynebacterium_timonense	441500	S	723	149	872	0.00007
Corynebacterium_doosanense	1121358	S	720	305	1025	0.00008
Corynebacterium_humireducens	1223514	S	717	182	899	0.00007
Corynebacterium_liangguodongii	2079535	S	678	128	806	0.00007
Corynebacterium_marinum	349751	S	648	226	874	0.00007
Corynebacterium_yudongzhengii	2080740	S	647	107	754	0.00006
Corynebacterium_mycetoides	38302	S	635	280	915	0.00007
Corynebacterium_comes	2675218	S	568	126	694	0.00006
Corynebacterium_imitans	156978	S	544	241	785	0.00006
Corynebacterium_sanguinis	2594913	S	530	329	859	0.00007
Corynebacterium_jeikeium	38289	S	508	1169	1677	0.00014
Corynebacterium_atypicum	191610	S	507	136	643	0.00005
Corynebacterium_uterequi	1072256	S	504	69	573	0.00005
Corynebacterium_terpenotabidum	89154	S	483	114	597	0.00005
Corynebacterium_glyciniphilum	1404244	S	474	48	522	0.00004
Corynebacterium_provencense	1737425	S	453	81	534	0.00004
Corynebacterium_lujinxingii	2763010	S	438	131	569	0.00005
Corynebacterium_urealyticum	43771	S	436	337	773	0.00006
Corynebacterium_uberis	2883169	S	426	42	468	0.00004
Corynebacterium_ureicelerivorans	401472	S	424	122	546	0.00004
Corynebacterium_qintianiae	2709392	S	391	98	489	0.00004
Corynebacterium_glaucum	187491	S	386	70	456	0.00004
Corynebacterium_falsenii	108486	S	385	142	527	0.00004
Corynebacterium_aurimucosum	169292	S	374	145	519	0.00004
Corynebacterium_glucuronolyticum	39791	S	371	71	442	0.00004
Corynebacterium_tuberculostearicum	38304	S	347	185	532	0.00004
Corynebacterium_kroppenstedtii	161879	S	342	28	370	0.00003
Corynebacterium_genitalium	38288	S	336	64	400	0.00003
Corynebacterium_efficiens	152794	S	334	53	387	0.00003
Corynebacterium_striatum	43770	S	312	230	542	0.00004
Corynebacterium_coyleae	53374	S	311	71	382	0.00003
Corynebacterium_testudinoris	136857	S	299	52	351	0.00003
Corynebacterium_incognita	2754725	S	291	57	348	0.00003
Corynebacterium_occultum	2675219	S	288	40	328	0.00003
Corynebacterium_lactis	1231000	S	286	38	324	0.00003
Corynebacterium_zhongnanshanii	2768834	S	254	27	281	0.00002
Corynebacterium_aquilae	203263	S	249	30	279	0.00002
Corynebacterium_matruchotii	43768	S	245	14	259	0.00002
Corynebacterium_riegelii	156976	S	241	56	297	0.00002
Corynebacterium_renale	1724	S	207	19	226	0.00002
Corynebacterium_endometrii	2488819	S	196	30	226	0.00002
Corynebacterium_flavescens	28028	S	186	42	228	0.00002
Corynebacterium_lizhenjunii	2709394	S	185	23	208	0.00002
Corynebacterium_camporealensis	161896	S	175	38	213	0.00002
Corynebacterium_simulans	146827	S	171	124	295	0.00002
Corynebacterium_phocae	161895	S	170	17	187	0.00002
Corynebacterium_epidermidicanis	1050174	S	159	23	182	0.00001
Corynebacterium_urogenitale	2487892	S	157	24	181	0.00001
Corynebacterium_kalinowskii	2675216	S	157	53	210	0.00002
Corynebacterium_minutissimum	38301	S	153	151	304	0.00002
Corynebacterium_singulare	161899	S	147	99	246	0.00002
Corynebacterium_cystitidis	35757	S	131	6	137	0.00001
Corynebacterium_propinquum	43769	S	128	47	175	0.00001
Corynebacterium_gerontici	2079234	S	125	22	147	0.00001
Corynebacterium_diphtheriae	1717	S	124	152	276	0.00002
Corynebacterium_macginleyi	38290	S	122	25	147	0.00001
Corynebacterium_argentoratense	42817	S	120	20	140	0.00001
Corynebacterium_pelargi	1471400	S	117	37	154	0.00001
Corynebacterium_kefirresidentii	1979527	S	117	71	188	0.00002
Corynebacterium_resistens	258224	S	114	59	173	0.00001
Corynebacterium_stationis	1705	S	107	25	132	0.00001
Corynebacterium_choanae	1862358	S	99	7	106	0.00001
Corynebacterium_deserti	1408191	S	97	33	130	0.00001
Corynebacterium_casei	160386	S	94	104	198	0.00002
Corynebacterium_pseudodiphtheriticum	37637	S	94	28	122	0.00001
Corynebacterium_ulcerans	65058	S	85	45	130	0.00001
Corynebacterium_pseudopelargi	2080757	S	76	25	101	0.00001
Corynebacterium_glutamicum	1718	S	75	1047	1122	0.00009
Corynebacterium_accolens	38284	S	69	174	243	0.00002
Corynebacterium_ammoniagenes	1697	S	68	13	81	0.00001
Corynebacterium_anserum	2684406	S	61	5	66	0.00001
Corynebacterium_pseudotuberculosis	1719	S	57	23	80	0.00001
Corynebacterium_mustelae	571915	S	55	3	58	0.00000
Corynebacterium_hindlerae	699041	S	44	92	136	0.00001
Corynebacterium_callunae	1721	S	43	13	56	0.00000
Corynebacterium_crudilactis	1652495	S	42	34	76	0.00001
Corynebacterium_segmentosum	43990	S	41	104	145	0.00001
Corynebacterium_suranareeae	2506452	S	41	11	52	0.00000
Corynebacterium_amycolatum	43765	S	36	274	310	0.00003
Corynebacterium_rouxii	2719119	S	34	20	54	0.00000
Corynebacterium_silvaticum	2320431	S	29	11	40	0.00000
Corynebacterium_kutscheri	35755	S	17	2	19	0.00000
Gordonia_sp._PP30	2935861	S	1752	452	2204	0.00018
Gordonia_sp._KTR9	337191	S	1300	258	1558	0.00013
Gordonia_sp._YC-JH1	2059875	S	1296	864	2160	0.00018
Gordonia_sp._PDNC005	2811424	S	1080	147	1227	0.00010
Gordonia_sp._WA4-43	2878678	S	223	782	1005	0.00008
Gordonia_sp._JH63	2698900	S	186	626	812	0.00007
Gordonia_sp._135	2676309	S	84	581	665	0.00005
Gordonia_sp._1D	1737359	S	49	766	815	0.00007
Gordonia_polyisoprenivorans	84595	S	2689	501	3190	0.00026
Gordonia_terrae	2055	S	1873	1072	2945	0.00024
Gordonia_insulae	2420509	S	1637	222	1859	0.00015
Gordonia_phthalatica	1136941	S	1581	598	2179	0.00018
Gordonia_bronchialis	2054	S	1465	332	1797	0.00015
Gordonia_amarae	36821	S	1389	261	1650	0.00013
Gordonia_iterans	1004901	S	1382	436	1818	0.00015
Gordonia_jinghuaiqii	2758710	S	1352	246	1598	0.00013
Gordonia_otitidis	249058	S	1214	192	1406	0.00011
Gordonia_rubripertincta	36822	S	1209	699	1908	0.00015
Gordonia_pseudoamarae	2831662	S	1182	208	1390	0.00011
Gordonia_zhaorongruii	2597659	S	886	148	1034	0.00008
Gordonia_alkanivorans	84096	S	311	1180	1491	0.00012
Gordonia_hongkongensis	1701090	S	210	685	895	0.00007
Gordonia_amicalis	89053	S	208	1563	1771	0.00014
Skermania_piniformis	39122	S	1570	179	1749	0.00014
Tsukamurella_paurometabola	2061	S	3012	1408	4420	0.00036
Tsukamurella_tyrosinosolvens	57704	S	2450	1047	3497	0.00028
Tsukamurella_pulmonis	47312	S	1792	614	2406	0.00020
Tsukamurella_sp._PLM1	2929795	S	1742	545	2287	0.00019
Dietzia_sp._oral_taxon_368	712270	S	1012	1749	2761	0.00022
Dietzia_lutea	546160	S	1171	661	1832	0.00015
Dietzia_psychralcaliphila	139021	S	1169	322	1491	0.00012
Dietzia_timorensis	499555	S	982	524	1506	0.00012
Tomitella_gaofuii	2760083	S	1891	554	2445	0.00020
Tomitella_fengzijianii	2597660	S	1578	499	2077	0.00017
Segniliparus_rotundus	286802	S	929	50	979	0.00008
Lawsonella_clevelandensis	1528099	S	162	16	178	0.00001
Nocardioides_sp._G188	2849501	S	16604	5566	22170	0.00180
Nocardioides_sp._JS614	196162	S	10242	3362	13604	0.00110
Nocardioides_sp._LMS-CY	2840457	S	9755	3537	13292	0.00108
Nocardioides_sp._TF02-7	2917724	S	8000	2872	10872	0.00088
Nocardioides_sp._HDW12B	2714939	S	7858	2806	10664	0.00087
Nocardioides_sp._zg-579	2663857	S	6322	3547	9869	0.00080
Nocardioides_sp._W7	2931390	S	6123	2297	8420	0.00068
Nocardioides_sp._S-1144	2582905	S	5750	2438	8188	0.00066
Nocardioides_sp._cx-173	2898796	S	5737	2173	7910	0.00064
Nocardioides_sp._SCSIO_67246	2872154	S	5298	1539	6837	0.00055
Nocardioides_sp._603	2483798	S	5237	2685	7922	0.00064
Nocardioides_sp._zg-1228	2763008	S	5124	2484	7608	0.00062
Nocardioides_sp._InS609-2	2760705	S	4709	1187	5896	0.00048
Nocardioides_sp._S5	2017486	S	4592	2593	7185	0.00058
Nocardioides_sp._MC1495	2736757	S	4522	1762	6284	0.00051
Nocardioides_sp._CF8	110319	S	4154	1940	6094	0.00049
Nocardioides_sp._JQ2195	2592334	S	3990	912	4902	0.00040
Nocardioides_sp._zg-536	2803858	S	3977	1906	5883	0.00048
Nocardioides_sp._dk884	2662361	S	3499	4182	7681	0.00062
Nocardioides_sp._ZJ1313	2685869	S	3419	4118	7537	0.00061
Nocardioides_sp._WS12	2486272	S	3396	653	4049	0.00033
Nocardioides_sp._Kera_G14	2884264	S	3279	733	4012	0.00033
Nocardioides_mesophilus	433659	S	12686	4192	16878	0.00137
Nocardioides_cynanchi	2558918	S	8445	2184	10629	0.00086
Nocardioides_ungokensis	1643322	S	8231	3214	11445	0.00093
Nocardioides_anomalus	2712223	S	7705	2587	10292	0.00084
Nocardioides_humi	449461	S	6236	2335	8571	0.00070
Nocardioides_euryhalodurans	2518370	S	5922	2010	7932	0.00064
Nocardioides_aromaticivorans	200618	S	5515	2347	7862	0.00064
Nocardioides_dongkuii	2760089	S	5511	3062	8573	0.00070
Nocardioides_okcheonensis	2894081	S	5410	2758	8168	0.00066
Nocardioides_rotundus	1774216	S	4884	2101	6985	0.00057
Nocardioides_aquaticus	160826	S	4600	1564	6164	0.00050
Nocardioides_marinisabuli	419476	S	4430	2757	7187	0.00058
Nocardioides_sambongensis	2589074	S	4279	1353	5632	0.00046
Nocardioides_dokdonensis	450734	S	3947	2092	6039	0.00049
Nocardioides_seonyuensis	2518371	S	3541	1061	4602	0.00037
Nocardioides_panacisoli	627624	S	3463	935	4398	0.00036
Nocardioides_houyundeii	2045452	S	3461	1166	4627	0.00038
Nocardioides_piscis	2714938	S	3029	1313	4342	0.00035
Nocardioides_daphniae	402297	S	2502	1277	3779	0.00031
Nocardioides_jishulii	2575440	S	2088	853	2941	0.00024
Nocardioides_baekrokdamisoli	1804624	S	1669	223	1892	0.00015
Nocardioides_yefusunii	2500546	S	1641	513	2154	0.00017
Aeromicrobium_sp._Leaf245	1736306	S	2465	819	3284	0.00027
Aeromicrobium_sp._zg-629	2663859	S	2115	744	2859	0.00023
Aeromicrobium_sp._A1-2	2107713	S	1801	271	2072	0.00017
Aeromicrobium_erythreum	2041	S	3025	969	3994	0.00032
Aeromicrobium_choanae	1736691	S	2577	824	3401	0.00028
Aeromicrobium_chenweiae	2079793	S	2492	908	3400	0.00028
Aeromicrobium_yanjiei	2662028	S	2341	790	3131	0.00025
Aeromicrobium_marinum	219314	S	2053	484	2537	0.00021
Pimelobacter_simplex	2045	S	5196	2178	7374	0.00060
Marmoricola_scoriae	642780	S	5191	2158	7349	0.00060
Friedmanniella_luteola	546871	S	4015	884	4899	0.00040
Mumia_sp._ZJ1417	2708082	S	3340	622	3962	0.00032
Micropruina_glycogenica	75385	S	1781	277	2058	0.00017
Microlunatus_sagamiharensis	546874	S	3909	969	4878	0.00040
Microlunatus_soli	630515	S	2418	249	2667	0.00022
Microlunatus_elymi	2596828	S	2167	246	2413	0.00020
Microlunatus_phosphovorus	29405	S	1986	252	2238	0.00018
Microlunatus_sp._Gsoil_973	2672569	S	1916	153	2069	0.00017
Tessaracoccus_sp._J1M15	2829499	S	1598	486	2084	0.00017
Tessaracoccus_sp._MC1865	2760310	S	1176	313	1489	0.00012
Tessaracoccus_defluvii	1285901	S	1812	1183	2995	0.00024
Tessaracoccus_aquimaris	1332264	S	1638	789	2427	0.00020
Tessaracoccus_flavescens	399497	S	1248	983	2231	0.00018
Tessaracoccus_flavus	1610493	S	1189	767	1956	0.00016
Tessaracoccus_timonensis	2161816	S	831	323	1154	0.00009
Brevilactibacter_coleopterorum	2714937	S	2406	1129	3535	0.00029
Brevilactibacter_sp._MC1595	2819349	S	2232	911	3143	0.00026
Propionibacterium_acidifaciens	556499	S	1601	380	1981	0.00016
Propionibacterium_australiense	119981	S	1125	206	1331	0.00011
Propionibacterium_freudenreichii	1744	S	1108	1168	2276	0.00018
Acidipropionibacterium_jensenii	1749	S	1446	931	2377	0.00019
Acidipropionibacterium_acidipropionici	1748	S	1335	815	2150	0.00017
Acidipropionibacterium_virtanenii	2057246	S	876	169	1045	0.00008
Cutibacterium_acnes	1747	S	1856	693	2549	0.00021
Cutibacterium_avidum	33010	S	731	202	933	0.00008
Cutibacterium_granulosum	33011	S	476	95	571	0.00005
Cutibacterium_modestum	2559073	S	193	25	218	0.00002
Auraticoccus_monumenti	675864	S	2831	546	3377	0.00027
Arachnia_propionica	1750	S	1118	130	1248	0.00010
Arachnia_rubra	1547448	S	652	71	723	0.00006
Raineyella_fluvialis	2662261	S	1722	234	1956	0.00016
Vaginimicrobium_propionicum	1871034	S	70	26	96	0.00001
Kribbella_flavida	182640	S	6587	1562	8149	0.00066
Kribbella_qitaiheensis	1544730	S	5293	837	6130	0.00050
Actinopolymorpha_singaporensis	117157	S	5843	695	6538	0.00053
Micromonospora_sp._WMMC415	2675222	S	4896	1813	6709	0.00054
Micromonospora_sp._HM134	2583243	S	3870	1706	5576	0.00045
Micromonospora_sp._WMMA2032	2039870	S	3811	2451	6262	0.00051
Micromonospora_sp._B006	2201999	S	3172	2427	5599	0.00045
Micromonospora_sp._L5	648999	S	329	3522	3851	0.00031
Micromonospora_krabiensis	307121	S	6064	2066	8130	0.00066
Micromonospora_terminaliae	1914461	S	5875	2941	8816	0.00072
Micromonospora_carbonacea	47853	S	5861	2572	8433	0.00068
Micromonospora_echinaurantiaca	47857	S	5590	2692	8282	0.00067
Micromonospora_echinofusca	47858	S	4800	2167	6967	0.00057
Micromonospora_inositola	47865	S	4519	2216	6735	0.00055
Micromonospora_siamensis	299152	S	4495	2123	6618	0.00054
Micromonospora_coriariae	285665	S	4414	1565	5979	0.00049
Micromonospora_echinospora	1877	S	4399	1531	5930	0.00048
Micromonospora_viridifaciens	1881	S	4390	1910	6300	0.00051
Micromonospora_purpureochromogenes	47872	S	4260	2230	6490	0.00053
Micromonospora_ferruginea	2749844	S	4212	2418	6630	0.00054
Micromonospora_auratinigra	261654	S	4211	2197	6408	0.00052
Micromonospora_coxensis	356852	S	4107	2259	6366	0.00052
Micromonospora_maris	1003110	S	3931	1196	5127	0.00042
Micromonospora_endophytica_(Xie_et_al._2001)_Li_et_al._2019	515350	S	3897	1187	5084	0.00041
Micromonospora_sagamiensis	47875	S	3765	1435	5200	0.00042
Micromonospora_narathiwatensis	299146	S	3703	1725	5428	0.00044
Micromonospora_chokoriensis	356851	S	3440	1107	4547	0.00037
Micromonospora_zamorensis	709883	S	3354	1070	4424	0.00036
Micromonospora_rifamycinica	291594	S	3310	1472	4782	0.00039
Micromonospora_craniellae	2294034	S	2733	1760	4493	0.00036
Micromonospora_tulbaghiae	479978	S	2349	2536	4885	0.00040
Micromonospora_aurantiaca	47850	S	1727	11806	13533	0.00110
Actinoplanes_sp._N902-109	649831	S	14148	3007	17155	0.00139
Actinoplanes_sp._L3-i22	2836373	S	13462	3083	16545	0.00134
Actinoplanes_sp._OR16	946334	S	11232	2807	14039	0.00114
Actinoplanes_sp._SE50	2033844	S	10	19303	19313	0.00157
Actinoplanes_friuliensis	196914	S	13351	2093	15444	0.00125
Actinoplanes_ianthinogenes	122358	S	12041	4267	16308	0.00132
Actinoplanes_teichomyceticus	1867	S	11241	4241	15482	0.00126
Actinoplanes_missouriensis	1866	S	10084	2919	13003	0.00106
Actinoplanes_derwentensis	113562	S	7907	1108	9015	0.00073
Phytohabitans_suffuscus	624315	S	9449	2567	12016	0.00098
Phytohabitans_flavus	1076124	S	7804	1636	9440	0.00077
Couchioplanes_caeruleus	56438	S	17032	4482	21514	0.00175
Plantactinospora_sp._KBS50	2024580	S	6434	1639	8073	0.00066
Plantactinospora_sp._BB1	2071627	S	1333	3954	5287	0.00043
Plantactinospora_sp._BC1	2108470	S	1330	3989	5319	0.00043
Dactylosporangium_vinaceum	53362	S	15004	1707	16711	0.00136
Actinocatenispora_thailandica	227318	S	5152	1521	6673	0.00054
Actinocatenispora_sera	390989	S	4942	1539	6481	0.00053
Catellatospora_sp._IY07-71	2728827	S	9195	2066	11261	0.00091
Polymorphospora_rubra	338584	S	8384	1904	10288	0.00083
Natronosporangium_hydrolyticum	2811111	S	3799	260	4059	0.00033
Verrucosispora_sp._NA02020	2742132	S	2636	2147	4783	0.00039
Salinispora_tropica	168695	S	2289	390	2679	0.00022
Amycolatopsis_sp._DSM_110486	2865832	S	6461	1308	7769	0.00063
Amycolatopsis_sp._WQ_127309	2932773	S	6255	1768	8023	0.00065
Amycolatopsis_sp._FDAARGOS_1241	2778070	S	6006	1317	7323	0.00059
Amycolatopsis_sp._Hca4	2742131	S	5718	2140	7858	0.00064
Amycolatopsis_sp._CA-230715	2745196	S	5344	822	6166	0.00050
Amycolatopsis_sp._YIM_10	2653857	S	4615	1372	5987	0.00049
Amycolatopsis_sp._FU40	2914159	S	3470	1580	5050	0.00041
Amycolatopsis_sp._AA4	1896961	S	2993	1586	4579	0.00037
Amycolatopsis_sp._BJA-103	1911175	S	2395	995	3390	0.00028
Amycolatopsis_sp._TNS106	2861750	S	2014	1239	3253	0.00026
Amycolatopsis_sp._EV170708-02-1	2919322	S	1636	1702	3338	0.00027
Amycolatopsis_acidiphila	715473	S	6487	1397	7884	0.00064
Amycolatopsis_mediterranei	33910	S	5587	6846	12433	0.00101
Amycolatopsis_pretoriensis	218821	S	5454	1786	7240	0.00059
Amycolatopsis_thermalba	944492	S	4566	1934	6500	0.00053
Amycolatopsis_methanolica	1814	S	4513	1809	6322	0.00051
Amycolatopsis_keratiniphila	129921	S	2469	2182	4651	0.00038
Amycolatopsis_japonica	208439	S	1298	1311	2609	0.00021
Amycolatopsis_albispora	1804986	S	4113	2398	6511	0.00053
Amycolatopsis_aidingensis	2842453	S	3773	450	4223	0.00034
Amycolatopsis_orientalis	31958	S	2718	955	3673	0.00030
Pseudonocardia_sp._DSM_110487	2865833	S	15066	2135	17201	0.00140
Pseudonocardia_sp._CGMCC_4.1532	2761535	S	6327	3730	10057	0.00082
Pseudonocardia_sp._HH130630-07	1690815	S	4923	1569	6492	0.00053
Pseudonocardia_sp._AL041005-10	445576	S	4231	1607	5838	0.00047
Pseudonocardia_sp._HH130629-09	1641402	S	3502	1611	5113	0.00041
Pseudonocardia_sp._EC080625-04	1096868	S	62	1816	1878	0.00015
Pseudonocardia_sp._EC080610-09	1688404	S	23	2113	2136	0.00017
Pseudonocardia_sp._EC080619-01	1096856	S	13	3515	3528	0.00029
Pseudonocardia_dioxanivorans	240495	S	10682	2899	13581	0.00110
Pseudonocardia_broussonetiae	2736640	S	8651	2919	11570	0.00094
Pseudonocardia_autotrophica	2074	S	5176	1430	6606	0.00054
Pseudonocardia_abyssalis	2792008	S	4732	2512	7244	0.00059
Saccharomonospora_cyanea	40989	S	33652	9471	43123	0.00350
Saccharomonospora_glauca	40990	S	5086	1368	6454	0.00052
Saccharomonospora_azurea	40988	S	4381	1013	5394	0.00044
Saccharomonospora_xinjiangensis	75294	S	3660	539	4199	0.00034
Saccharomonospora_marina	632569	S	3622	817	4439	0.00036
Saccharomonospora_viridis	1852	S	2148	288	2436	0.00020
Saccharopolyspora_erythraea	1836	S	9269	3310	12579	0.00102
Saccharopolyspora_gregorii	33914	S	3358	674	4032	0.00033
Saccharopolyspora_spinosa	60894	S	2132	1294	3426	0.00028
Saccharopolyspora_pogona	333966	S	1674	1930	3604	0.00029
Saccharopolyspora_sp._ASAGF58	2719023	S	1442	1843	3285	0.00027
Saccharothrix_syringae	103733	S	6794	2363	9157	0.00074
Saccharothrix_sp._6-C	2781735	S	6074	2072	8146	0.00066
Saccharothrix_espanaensis	103731	S	5757	1690	7447	0.00060
Lentzea_guizhouensis	1586287	S	17788	3689	21477	0.00174
Kutzneria_sp._CA-103260	2802641	S	8242	1749	9991	0.00081
Kutzneria_albida	43357	S	5068	1156	6224	0.00051
Actinoalloteichus_hoggarensis	1470176	S	2725	365	3090	0.00025
Actinoalloteichus_hymeniacidonis	340345	S	1772	167	1939	0.00016
Actinoalloteichus_sp._GBA129-24	1612551	S	135	1467	1602	0.00013
Actinoalloteichus_fjordicus	1612552	S	103	1352	1455	0.00012
Actinosynnema_pretiosum	42197	S	2198	4301	6499	0.00053
Actinosynnema_mirum	40567	S	226	2213	2439	0.00020
Kibdelosporangium_phytohabitans	860235	S	5672	682	6354	0.00052
Allokutzneria_albata	211114	S	5520	1318	6838	0.00055
Alloactinosynnema_sp._L-07	1653480	S	3946	867	4813	0.00039
Prauserella_marina	530584	S	2782	245	3027	0.00025
Allosaccharopolyspora_coralli	2665642	S	2231	471	2702	0.00022
Actinomadura_sp._NAK00032	2742128	S	17182	6413	23595	0.00191
Actinomadura_sp._WMMB_499	1219491	S	16453	4013	20466	0.00166
Actinomadura_sp._WMMA1423	2591108	S	11645	3659	15304	0.00124
Actinomadura_verrucosospora	46165	S	14665	4690	19355	0.00157
Actinomadura_madurae	1993	S	12613	4062	16675	0.00135
Actinomadura_graeca	2750812	S	9473	2268	11741	0.00095
Thermomonospora_amylolytica	1411117	S	41416	14709	56125	0.00455
Thermomonospora_curvata	2020	S	32472	8896	41368	0.00336
Nonomuraea_coxensis	404386	S	24215	7114	31329	0.00254
Nonomuraea_nitratireducens	2656914	S	19662	4317	23979	0.00195
Nonomuraea_sp._ATCC_55076	1909395	S	13124	4343	17467	0.00142
Nonomuraea_gerenzanensis	93944	S	11513	4006	15519	0.00126
Streptosporangium_roseum	2001	S	11910	3521	15431	0.00125
Streptosporangium_sp._'caverna'	2202249	S	9504	2232	11736	0.00095
Thermobispora_bispora	2006	S	6155	1429	7584	0.00062
Nocardiopsis_sp._MT53	2865672	S	3921	934	4855	0.00039
Nocardiopsis_sp._HDS12	2831968	S	1166	1029	2195	0.00018
Nocardiopsis_gilva	280236	S	3464	711	4175	0.00034
Nocardiopsis_dassonvillei	2014	S	2369	2744	5113	0.00041
Nocardiopsis_alba	53437	S	2008	371	2379	0.00019
Thermobifida_halotolerans	483545	S	2788	959	3747	0.00030
Thermobifida_alba	53522	S	2602	1104	3706	0.00030
Thermobifida_fusca	2021	S	1349	244	1593	0.00013
Streptomonospora_litoralis	2498135	S	3656	731	4387	0.00036
Spiractinospora_alimapuensis	2820884	S	2270	153	2423	0.00020
Blastococcus_sp._PRF04-17	2933797	S	17000	6007	23007	0.00187
Blastococcus_saxobsidens	138336	S	14325	4549	18874	0.00153
Modestobacter_marinus	477641	S	15398	5499	20897	0.00170
Modestobacter_sp._L9-4	2851567	S	9295	3658	12953	0.00105
Geodermatophilus_obscurus	1861	S	23406	8139	31545	0.00256
Actinomyces_sp._oral_taxon_414	712122	S	1203	254	1457	0.00012
Actinomyces_sp._MAS-1	2755559	S	836	162	998	0.00008
Actinomyces_sp._Z16	2079536	S	672	239	911	0.00007
Actinomyces_sp._432	2057798	S	575	128	703	0.00006
Actinomyces_sp._Chiba101	1851395	S	551	257	808	0.00007
Actinomyces_sp._oral_taxon_171	706438	S	312	246	558	0.00005
Actinomyces_sp._oral_taxon_169	712116	S	153	277	430	0.00003
Actinomyces_sp._oral_taxon_897	2081702	S	114	385	499	0.00004
Actinomyces_sp._HMT897	2789424	S	100	330	430	0.00003
Actinomyces_sp._HMT_175	2789425	S	86	352	438	0.00004
Actinomyces_sp._zg-332	2708340	S	18	2	20	0.00000
Actinomyces_radicidentis	111015	S	1466	620	2086	0.00017
Actinomyces_howellii	52771	S	1114	172	1286	0.00010
Actinomyces_respiraculi	2744574	S	769	187	956	0.00008
Actinomyces_slackii	52774	S	744	123	867	0.00007
Actinomyces_procaprae	2560010	S	658	240	898	0.00007
Actinomyces_weissii	675090	S	554	106	660	0.00005
Actinomyces_faecalis	2722820	S	544	77	621	0.00005
Actinomyces_qiguomingii	2057800	S	528	72	600	0.00005
Actinomyces_viscosus	1656	S	475	198	673	0.00005
Actinomyces_naeslundii	1655	S	469	265	734	0.00006
Actinomyces_marmotae	2737173	S	414	228	642	0.00005
Actinomyces_oris	544580	S	384	1171	1555	0.00013
Actinomyces_wuliandei	2057743	S	378	102	480	0.00004
Actinomyces_gaoshouyii	1960083	S	377	193	570	0.00005
Actinomyces_lilanjuaniae	2321394	S	308	76	384	0.00003
Actinomyces_trachealis	2763540	S	253	47	300	0.00002
Actinomyces_pacaensis	1852377	S	73	9	82	0.00001
Schaalia_sp._19OD2882	2794089	S	527	73	600	0.00005
Schaalia_sp._JY-X169	2758572	S	170	6	176	0.00001
Schaalia_sp._ZJ405	2709403	S	130	11	141	0.00001
Schaalia_odontolytica	1660	S	768	190	958	0.00008
Schaalia_meyeri	52773	S	398	76	474	0.00004
Schaalia_cardiffensis	181487	S	259	39	298	0.00002
Schaalia_turicensis	131111	S	104	87	191	0.00002
Flaviflexus_salsibiostraticola	1282737	S	792	205	997	0.00008
Flaviflexus_sp._dk850	2758573	S	410	127	537	0.00004
Flaviflexus_ciconiae	2496867	S	290	35	325	0.00003
Trueperella_pecoris	2733571	S	512	144	656	0.00005
Trueperella_pyogenes	1661	S	341	195	536	0.00004
Trueperella_bialowiezensis	312285	S	290	14	304	0.00002
Nanchangia_anserum	2692125	S	659	68	727	0.00006
Pauljensenia_hongkongensis	178339	S	639	243	882	0.00007
Actinotignum_schaalii	59505	S	273	16	289	0.00002
Actinobaculum_sp._313	2495645	S	253	14	267	0.00002
Arcanobacterium_haemolyticum	28264	S	73	34	107	0.00001
Arcanobacterium_phocae	131112	S	41	12	53	0.00000
Arcanobacterium_phocisimile	1302235	S	29	8	37	0.00000
Arcanobacterium_sp._2701	2722751	S	23	5	28	0.00000
Mobiluncus_curtisii	2051	S	149	38	187	0.00002
Changpingibacter_yushuensis	2758440	S	145	43	188	0.00002
Varibaculum_sp._EMRHCC_39	2811781	S	67	18	85	0.00001
Boudabousia_tangfeifanii	1912795	S	49	3	52	0.00000
Fannyhessea_vaginae	82135	S	44	12	56	0.00000
Frankia_inefficax	298654	S	7459	882	8341	0.00068
Frankia_sp._QA3	710111	S	2970	1300	4270	0.00035
Frankia_sp._ArI3	1858	S	2239	1564	3803	0.00031
Candidatus_Frankia_datiscae	2716812	S	3049	449	3498	0.00028
Frankia_casuarinae	106370	S	2619	285	2904	0.00024
Frankia_alni	1859	S	2472	1846	4318	0.00035
Jiangella_sp._DSM_45060	1798224	S	7208	2193	9401	0.00076
Jiangella_alkaliphila	419479	S	6061	1768	7829	0.00064
Bifidobacterium_choerinum	35760	S	974	355	1329	0.00011
Bifidobacterium_pseudolongum	1694	S	922	307	1229	0.00010
Bifidobacterium_scardovii	158787	S	751	67	818	0.00007
Bifidobacterium_longum	216816	S	698	1044	1742	0.00014
Bifidobacterium_bifidum	1681	S	538	195	733	0.00006
Bifidobacterium_pullorum	78448	S	471	151	622	0.00005
Bifidobacterium_animalis	28025	S	429	1025	1454	0.00012
Bifidobacterium_subtile	77635	S	382	48	430	0.00003
Bifidobacterium_adolescentis	1680	S	371	84	455	0.00004
Bifidobacterium_asteroides	1684	S	331	8	339	0.00003
Bifidobacterium_eulemuris	1765219	S	303	76	379	0.00003
Bifidobacterium_lemurum	1603886	S	267	68	335	0.00003
Bifidobacterium_thermophilum	33905	S	258	44	302	0.00002
Bifidobacterium_breve	1685	S	253	255	508	0.00004
Bifidobacterium_actinocoloniiforme	638619	S	234	7	241	0.00002
Bifidobacterium_angulatum	1683	S	231	60	291	0.00002
Bifidobacterium_dentium	1689	S	189	13	202	0.00002
Bifidobacterium_catenulatum	1686	S	129	181	310	0.00003
Bifidobacterium_pseudocatenulatum	28026	S	127	78	205	0.00002
Bifidobacterium_imperatoris	2020965	S	63	37	100	0.00001
Bifidobacterium_saguini	762210	S	45	24	69	0.00001
Bifidobacterium_indicum	1691	S	28	42	70	0.00001
Bifidobacterium_coryneforme	1687	S	15	22	37	0.00000
Parascardovia_denticolens	78258	S	130	18	148	0.00001
Gardnerella_vaginalis	2702	S	29	39	68	0.00001
Scardovia_inopinata	78259	S	26	8	34	0.00000
Nakamurella_multipartita	53461	S	3750	725	4475	0.00036
Nakamurella_panacisegetis	1090615	S	2143	322	2465	0.00020
Nakamurella_sp._PAMC28650	2762325	S	1917	222	2139	0.00017
Nakamurella_antarctica	1902245	S	421	31	452	0.00004
Catenulispora_acidiphila	304895	S	5447	805	6252	0.00051
Jatrophihabitans_sp._GAS493	1907575	S	2305	211	2516	0.00020
Jatrophihabitans_telluris	2038343	S	2279	200	2479	0.00020
Stackebrandtia_nassauensis	283811	S	3017	284	3301	0.00027
Natronoglycomyces_albus	2811108	S	495	16	511	0.00004
Kineococcus_radiotolerans	131568	S	3262	910	4172	0.00034
Epidermidibacterium_keratini	1891644	S	2120	1085	3205	0.00026
Actinopolyspora_erythraea	414996	S	1749	179	1928	0.00016
Acidothermus_cellulolyticus	28049	S	1376	61	1437	0.00012
Candidatus_Planktophila_versatilis	1884905	S	56	9	65	0.00001
Candidatus_Planktophila_lacus	1884913	S	55	6	61	0.00000
Candidatus_Planktophila_sulfonica	1884904	S	43	11	54	0.00000
Candidatus_Planktophila_dulcis	1884914	S	36	16	52	0.00000
Candidatus_Planktophila_limnetica	573600	S	23	2	25	0.00000
Candidatus_Planktophila_vernalis	1884907	S	22	3	25	0.00000
Candidatus_Nanopelagicus_hibericus	1884915	S	21	12	33	0.00000
Candidatus_Nanopelagicus_limnes	1884634	S	12	14	26	0.00000
Conexibacter_sp._SYSU_D00693	2812560	S	42811	10334	53145	0.00431
Conexibacter_sp._S30A1	2937800	S	11160	1160	12320	0.00100
Conexibacter_sp._DBS9H8	2937801	S	10610	1019	11629	0.00094
Conexibacter_woesei	191495	S	53337	9284	62621	0.00508
Miltoncostaea_marina	2843215	S	14477	3648	18125	0.00147
Miltoncostaea_oceani	2843216	S	13426	2033	15459	0.00125
Baekduia_soli	496014	S	38508	6425	44933	0.00365
Rubrobacter_xylanophilus	49319	S	7339	823	8162	0.00066
Rubrobacter_marinus	2653852	S	4936	435	5371	0.00044
Rubrobacter_tropicus	2653851	S	3662	264	3926	0.00032
Rubrobacter_radiotolerans	42256	S	2274	303	2577	0.00021
Rubrobacter_indicoceani	2051957	S	1158	91	1249	0.00010
Aquihabitans_sp._Kera_3	2884263	S	9972	1633	11605	0.00094
Aquihabitans_sp._G128	2849779	S	7887	1608	9495	0.00077
Actinomarinicola_tropica	2789776	S	9283	1852	11135	0.00090
Iamia_sp._SCSIO_61187	2722752	S	8523	1382	9905	0.00080
Ilumatobacter_coccineus	467094	S	3921	239	4160	0.00034
Acidimicrobium_ferrooxidans	53635	S	1590	118	1708	0.00014
Eggerthella_lenta	84112	S	914	590	1504	0.00012
Eggerthella_guodeyinii	2690837	S	900	469	1369	0.00011
Eggerthella_sp._YY7918	502558	S	213	95	308	0.00003
Gordonibacter_urolithinfaciens	1335613	S	519	439	958	0.00008
Gordonibacter_pamelaeae	471189	S	418	514	932	0.00008
Adlercreutzia_equolifaciens	446660	S	445	354	799	0.00006
Adlercreutzia_hattorii	2707299	S	260	410	670	0.00005
Arabiibacter_massiliensis	1870985	S	1148	267	1415	0.00011
Raoultibacter_timonensis	1907662	S	638	56	694	0.00006
Berryella_intestinalis	1531429	S	510	596	1106	0.00009
Slackia_heliotrinireducens	84110	S	409	12	421	0.00003
Denitrobacterium_detoxificans	79604	S	255	109	364	0.00003
Cryptobacterium_curtum	84163	S	48	4	52	0.00000
Phoenicibacter_congonensis	1944646	S	41	16	57	0.00000
Olsenella_timonensis	1805478	S	953	311	1264	0.00010
Olsenella_uli	133926	S	522	68	590	0.00005
Olsenella_sp._oral_taxon_807	712411	S	330	23	353	0.00003
Parolsenella_massiliensis	1871022	S	516	302	818	0.00007
Parolsenella_catena	2003188	S	449	291	740	0.00006
Thermophilibacter_immobilis	2779519	S	639	252	891	0.00007
Parafannyhessea_umbonata	604330	S	624	384	1008	0.00008
Atopobium_sp._oral_taxon_416	712157	S	148	18	166	0.00001
Lancefieldella_parvula	1382	S	21	2	23	0.00000
Collinsella_aerofaciens	74426	S	854	466	1320	0.00011
Collinsella_stercoris	147206	S	642	106	748	0.00006
Collinsella_sp._zg1085	2844380	S	28	1	29	0.00000
Coriobacterium_glomerans	33871	S	425	14	439	0.00004
Egibacter_rhizosphaerae	1670831	S	4369	262	4631	0.00038
Egicoccus_halophilus	1670830	S	4065	637	4702	0.00038
Euzebya_pacifica	1608957	S	3563	302	3865	0.00031
Priestia_megaterium	1404	S	121301	98962	220263	0.01787
Priestia_filamentosa	1402861	S	32101	3018	35119	0.00285
Priestia_aryabhattai	412384	S	1949	7459	9408	0.00076
Priestia_flexa	86664	S	1042	238	1280	0.00010
Priestia_koreensis	284581	S	776	195	971	0.00008
Priestia_sp._J2	2886505	S	288	1754	2042	0.00017
Bacillus_paralicheniformis	1648923	S	9201	4509	13710	0.00111
Bacillus_subtilis	1423	S	5841	175851	181692	0.01474
Bacillus_velezensis	492670	S	858	15421	16279	0.00132
Bacillus_amyloliquefaciens	1390	S	248	6401	6649	0.00054
Bacillus_siamensis	659243	S	62	139	201	0.00002
Bacillus_mojavensis	72360	S	129	113	242	0.00002
Bacillus_halotolerans	260554	S	96	183	279	0.00002
Bacillus_licheniformis	1402	S	226	6844	7070	0.00057
Bacillus_vallismortis	72361	S	209	182	391	0.00003
Bacillus_tequilensis	227866	S	209	135	344	0.00003
Bacillus_atrophaeus	1452	S	164	199	363	0.00003
Bacillus_inaquosorum	483913	S	50	351	401	0.00003
Bacillus_spizizenii	96241	S	39	103	142	0.00001
Bacillus_sp._S3	486398	S	2845	589	3434	0.00028
Bacillus_sp._1NLA3E	666686	S	1598	404	2002	0.00016
Bacillus_sp._Y1	352858	S	1151	313	1464	0.00012
Bacillus_sp._FJAT-18017	1705566	S	864	165	1029	0.00008
Bacillus_sp._JY-23	2933872	S	648	180	828	0.00007
Bacillus_sp._PAMC26568	2760090	S	434	31	465	0.00004
Bacillus_sp._FJAT-22090	1581038	S	416	83	499	0.00004
Bacillus_sp._THAF10	2587848	S	381	91	472	0.00004
Bacillus_sp._FJAT-42376	2014076	S	380	101	481	0.00004
Bacillus_sp._KH172YL63	2709784	S	355	88	443	0.00004
Bacillus_sp._NSP9.1	1071078	S	272	15	287	0.00002
Bacillus_sp._OxB-1	98228	S	234	41	275	0.00002
Bacillus_sp._SB49	1071080	S	185	23	208	0.00002
Bacillus_sp._N1-1	2682541	S	176	68	244	0.00002
Bacillus_sp._M4U3P1	2592382	S	156	15	171	0.00001
Bacillus_sp._Cs-700	2589818	S	120	48	168	0.00001
Bacillus_sp._NP247	2846779	S	70	74	144	0.00001
Bacillus_sp._WP8	756828	S	65	62	127	0.00001
Bacillus_sp._3a	580459	S	63	284	347	0.00003
Bacillus_sp._MBGLi79	2070759	S	62	250	312	0.00003
Bacillus_sp._H8-1	2930532	S	45	617	662	0.00005
Bacillus_sp._FCW2	2867004	S	45	264	309	0.00003
Bacillus_sp._N3536	2666127	S	44	46	90	0.00001
Bacillus_sp._N447-1	2789208	S	43	324	367	0.00003
Bacillus_sp._JS	1127744	S	38	346	384	0.00003
Bacillus_sp._N5-665	2925318	S	29	43	72	0.00001
Bacillus_sp._BD59S	2499213	S	27	30	57	0.00000
Bacillus_sp._ZJS3	2928154	S	27	48	75	0.00001
Bacillus_sp._AM1(2019)	2665175	S	26	310	336	0.00003
Bacillus_sp._275	1941347	S	26	2325	2351	0.00019
Bacillus_sp._LJBS17	2859227	S	24	327	351	0.00003
Bacillus_sp._SYJ	2529386	S	19	45	64	0.00001
Bacillus_sp._MD-5	2009331	S	19	162	181	0.00001
Bacillus_sp._JNUCC-24	2842458	S	15	160	175	0.00001
Bacillus_sp._LJBS06	2809036	S	14	128	142	0.00001
Bacillus_sp._PDNC022	2812759	S	12	34	46	0.00000
Bacillus_sp._COPE52	2233998	S	12	10	22	0.00000
Bacillus_pseudomycoides	64104	S	3886	1255	5141	0.00042
Bacillus_cereus	1396	S	2330	40196	42526	0.00345
Bacillus_thuringiensis	1428	S	824	8047	8871	0.00072
Bacillus_mycoides	1405	S	740	943	1683	0.00014
Bacillus_cytotoxicus	580165	S	629	547	1176	0.00010
Bacillus_wiedmannii	1890302	S	209	247	456	0.00004
Bacillus_anthracis	1392	S	110	4864	4974	0.00040
Bacillus_sp._ABP14	1892404	S	74	320	394	0.00003
Bacillus_sp._JAS24-2	2217832	S	15	54	69	0.00001
Bacillus_luti	2026191	S	97	73	170	0.00001
Bacillus_nitratireducens	2026193	S	59	76	135	0.00001
Bacillus_toyonensis	155322	S	58	389	447	0.00004
Bacillus_paranthracis	2026186	S	57	1017	1074	0.00009
Bacillus_albus	2026189	S	24	81	105	0.00001
Bacillus_tropicus	2026188	S	15	366	381	0.00003
Bacillus_bombysepticus	658666	S	11	83	94	0.00001
Bacillus_infantis	324767	S	4950	1010	5960	0.00048
Bacillus_glycinifermentans	1664069	S	1218	285	1503	0.00012
Bacillus_dafuensis	1742359	S	1157	304	1461	0.00012
Bacillus_safensis	561879	S	898	916	1814	0.00015
Bacillus_methanolicus	1471	S	814	283	1097	0.00009
Bacillus_badius	1455	S	747	216	963	0.00008
[Brevibacterium]_frigoritolerans	450367	S	674	176	850	0.00007
Bacillus_aquiflavi	2672567	S	614	120	734	0.00006
Bacillus_pumilus	1408	S	582	396	978	0.00008
Bacillus_weihaiensis	1547283	S	541	134	675	0.00005
Bacillus_gobiensis	1441095	S	446	95	541	0.00004
Bacillus_smithii	1479	S	353	143	496	0.00004
Bacillus_shivajii	1983719	S	315	34	349	0.00003
Bacillus_altitudinis	293387	S	279	838	1117	0.00009
Bacillus_fonticola	2728853	S	311	62	373	0.00003
Bacillus_cabrialesii	2487276	S	201	139	340	0.00003
Bacillus_rugosus	2715209	S	144	105	249	0.00002
Bacillus_haynesii	1925021	S	19	45	64	0.00001
Bacillus_intestinalis	1963032	S	10	2199	2209	0.00018
Alkalihalobacillus_clausii	79880	S	18783	2617	21400	0.00174
Alkalihalobacillus_krulwichiae	199441	S	371	81	452	0.00004
Alkalihalobacillus_sp._LMS39	2924032	S	318	50	368	0.00003
Alkalihalobacillus_lehensis	300825	S	114	30	144	0.00001
Alkalihalobacillus_miscanthi	2598861	S	93	26	119	0.00001
Lysinibacillus_sp._PLM2	2929796	S	2298	686	2984	0.00024
Lysinibacillus_sp._SGAir0095	2070463	S	1911	572	2483	0.00020
Lysinibacillus_sp._2017	2169540	S	421	142	563	0.00005
Lysinibacillus_sp._CD3-6	2892541	S	388	114	502	0.00004
Lysinibacillus_sp._Ag94	2936682	S	364	32	396	0.00003
Lysinibacillus_sp._YS11	2072025	S	94	255	349	0.00003
Lysinibacillus_sp._ACHW1.5	2913506	S	84	200	284	0.00002
Lysinibacillus_sp._GJ-1	2896845	S	25	279	304	0.00002
Lysinibacillus_timonensis	2086577	S	5654	2147	7801	0.00063
Lysinibacillus_fusiformis	28031	S	566	488	1054	0.00009
Lysinibacillus_parviboronicapiens	436516	S	356	93	449	0.00004
Lysinibacillus_sphaericus	1421	S	353	344	697	0.00006
Lysinibacillus_agricola	2590012	S	321	73	394	0.00003
Lysinibacillus_capsici	2115968	S	98	151	249	0.00002
Lysinibacillus_varians	1145276	S	19	152	171	0.00001
Peribacillus_asahii	228899	S	7441	2720	10161	0.00082
Peribacillus_simplex	1478	S	780	365	1145	0.00009
Peribacillus_butanolivorans	421767	S	635	179	814	0.00007
Peribacillus_psychrosaccharolyticus	1407	S	496	126	622	0.00005
Peribacillus_muralis	264697	S	323	59	382	0.00003
Cytobacillus_oceanisediminis	665099	S	2858	1292	4150	0.00034
Cytobacillus_ciccensis	1670641	S	1703	456	2159	0.00018
Cytobacillus_firmus	1399	S	1091	460	1551	0.00013
Cytobacillus_gottheilii	859144	S	990	237	1227	0.00010
Cytobacillus_sp._CY-G	2901381	S	708	181	889	0.00007
Cytobacillus_kochii	859143	S	609	135	744	0.00006
Neobacillus_drentensis	220684	S	5752	1844	7596	0.00062
Neobacillus_mesonae	1193713	S	2196	542	2738	0.00022
Heyndrickxia_oleronia	38875	S	6684	1817	8501	0.00069
Heyndrickxia_vini	1476025	S	832	177	1009	0.00008
Metabacillus_sp._KUDC1714	2745198	S	1327	333	1660	0.00013
Metabacillus_sp._cB07	2806989	S	709	195	904	0.00007
Metabacillus_sp._B2-18	2897333	S	560	640	1200	0.00010
Metabacillus_sediminilitoris	2567941	S	1769	478	2247	0.00018
Metabacillus_litoralis	152268	S	912	673	1585	0.00013
Metabacillus_dongyingensis	2874282	S	538	137	675	0.00005
Metabacillus_endolithicus	1535204	S	448	426	874	0.00007
Niallia_circulans	1397	S	3252	679	3931	0.00032
Niallia_sp._Man26	2912824	S	889	150	1039	0.00008
Terribacillus_goriensis	386490	S	2880	446	3326	0.00027
Terribacillus_aidingensis	586416	S	477	76	553	0.00004
Virgibacillus_sp._Bac332	2419842	S	431	38	469	0.00004
Virgibacillus_sp._MSP4-1	2700081	S	338	52	390	0.00003
Virgibacillus_sp._NKC19-16	2831673	S	284	17	301	0.00002
Virgibacillus_sp._SK37	403957	S	213	69	282	0.00002
Virgibacillus_sp._Bac330	2419841	S	139	44	183	0.00001
Virgibacillus_sp._6R	1911587	S	27	204	231	0.00002
Virgibacillus_phasianinus	2017483	S	455	43	498	0.00004
Virgibacillus_necropolis	163877	S	395	38	433	0.00004
Virgibacillus_halodenitrificans	1482	S	359	99	458	0.00004
Virgibacillus_dokdonensis	302167	S	98	32	130	0.00001
Virgibacillus_pantothenticus	1473	S	54	394	448	0.00004
Gracilibacillus_salitolerans	2663022	S	1624	315	1939	0.00016
Gracilibacillus_sp._SSPM10-3	2932255	S	606	265	871	0.00007
Gracilibacillus_sp._SSWR10-1	2932256	S	539	241	780	0.00006
Oceanobacillus_kimchii	746691	S	1627	193	1820	0.00015
Oceanobacillus_zhaokaii	2052660	S	583	82	665	0.00005
Oceanobacillus_iheyensis	182710	S	543	107	650	0.00005
Geobacillus_subterraneus	129338	S	512	308	820	0.00007
Geobacillus_genomosp._3	1921421	S	307	78	385	0.00003
Geobacillus_stearothermophilus	1422	S	262	324	586	0.00005
Geobacillus_sp._46C-IIa	1963025	S	128	52	180	0.00001
Geobacillus_sp._JS12	1813182	S	34	104	138	0.00001
Geobacillus_sp._Y412MC52	550542	S	18	57	75	0.00001
Geobacillus_sp._C56-T3	691437	S	18	69	87	0.00001
Geobacillus_thermocatenulatus	33938	S	68	63	131	0.00001
Geobacillus_thermoleovorans	33941	S	33	339	372	0.00003
[Bacillus]_caldolyticus	1394	S	13	139	152	0.00001
Geobacillus_kaustophilus	1462	S	12	100	112	0.00001
Geobacillus_thermodenitrificans	33940	S	29	180	209	0.00002
Geobacillus_zalihae	213419	S	20	133	153	0.00001
Anoxybacillus_sediminis	2613334	S	851	143	994	0.00008
Anoxybacillus_sp._PDR2	1636720	S	57	364	421	0.00003
Anoxybacillus_flavithermus	33934	S	336	196	532	0.00004
Anoxybacillus_caldiproteolyticus	247480	S	333	54	387	0.00003
Anoxybacillus_amylolyticus	294699	S	293	47	340	0.00003
Anoxybacillus_gonensis	198467	S	30	162	192	0.00002
Anoxybacillus_kamchatkensis	196180	S	24	120	144	0.00001
Mesobacillus_foraminis	279826	S	1059	206	1265	0.00010
Mesobacillus_jeotgali	129985	S	650	246	896	0.00007
Mesobacillus_sp._S13	2880221	S	578	236	814	0.00007
Hydrogenibacillus_sp._N12	2866627	S	1639	149	1788	0.00015
Parageobacillus_thermoglucosidasius	1426	S	247	125	372	0.00003
Parageobacillus_caldoxylosilyticus	81408	S	242	90	332	0.00003
Parageobacillus_toebii	153151	S	233	111	344	0.00003
Parageobacillus_genomosp._1	1295642	S	171	59	230	0.00002
Parageobacillus_sp._KH3-4	2916802	S	167	65	232	0.00002
Halobacillus_sp._SSTM10-2	2932258	S	204	49	253	0.00002
Halobacillus_sp._SSBR10-3	2932257	S	202	22	224	0.00002
Halobacillus_sp._SSHM10-5	2932259	S	198	54	252	0.00002
Halobacillus_mangrovi	402384	S	216	29	245	0.00002
Halobacillus_litoralis	45668	S	183	27	210	0.00002
Halobacillus_halophilus	1570	S	161	20	181	0.00001
Sutcliffiella_horikoshii	79883	S	591	119	710	0.00006
Sutcliffiella_cohnii	33932	S	523	165	688	0.00006
Rossellomorea_marisflavi	189381	S	634	177	811	0.00007
Rossellomorea_vietnamensis	218284	S	398	112	510	0.00004
Gottfriedia_acidiceleris	371036	S	966	207	1173	0.00010
Radiobacillus_sp._80	2844358	S	417	84	501	0.00004
Radiobacillus_deserti	2594883	S	357	72	429	0.00003
Psychrobacillus_sp._INOP01	2829187	S	302	72	374	0.00003
Psychrobacillus_sp._AK_1817	2303505	S	67	67	134	0.00001
Psychrobacillus_glaciei	2283160	S	326	83	409	0.00003
Fictibacillus_phosphorivorans	1221500	S	339	76	415	0.00003
Fictibacillus_arsenicus	255247	S	284	67	351	0.00003
Weizmannia_coagulans	1398	S	597	216	813	0.00007
Lentibacillus_amyloliquefaciens	1472767	S	247	37	284	0.00002
Lentibacillus_sp._CBA3610	2518176	S	184	20	204	0.00002
Salicibibacter_cibarius	2743000	S	118	28	146	0.00001
Salicibibacter_kimchii	2099786	S	103	8	111	0.00001
Salicibibacter_halophilus	2502791	S	102	26	128	0.00001
Salicibibacter_cibi	2743001	S	74	10	84	0.00001
Caldibacillus_thermoamylovorans	35841	S	441	110	551	0.00004
Pontibacillus_sp._ALD_SL1	2777185	S	214	27	241	0.00002
Pontibacillus_sp._HMF3514	2692425	S	208	31	239	0.00002
Lederbergia_lenta	1467	S	425	77	502	0.00004
Anaerobacillus_isosaccharinicus	1532552	S	398	66	464	0.00004
Sediminibacillus_sp._DP4-553-S	2729421	S	378	48	426	0.00003
Pradoshia_sp._D12	2651284	S	371	80	451	0.00004
Alkalihalophilus_pseudofirmus	79885	S	356	45	401	0.00003
Paraliobacillus_zengyii	2213194	S	335	41	376	0.00003
Salisediminibacterium_selenitireducens	85683	S	156	20	176	0.00001
Salisediminibacterium_beveridgei	632773	S	148	18	166	0.00001
Evansella_cellulosilytica	1413	S	303	33	336	0.00003
Halalkalibacterium_halodurans	86665	S	292	139	431	0.00004
Mangrovibacillus_cuniculi	2593652	S	281	108	389	0.00003
Aeribacillus_pallidus	33936	S	276	95	371	0.00003
Amphibacillus_xylanus	1449	S	223	30	253	0.00002
Caldalkalibacillus_thermarum	296745	S	168	23	191	0.00002
Salimicrobium_jeotgali	1230341	S	136	15	151	0.00001
Paenibacillus_sp._CAA11	1532905	S	2298	345	2643	0.00021
Paenibacillus_sp._B01	2660554	S	1929	517	2446	0.00020
Paenibacillus_sp._32O-W	1695218	S	1283	97	1380	0.00011
Paenibacillus_sp._H1-7	2282849	S	1244	88	1332	0.00011
Paenibacillus_sp._RUD330	2023772	S	1216	100	1316	0.00011
Paenibacillus_sp._Y412MC10	481743	S	790	1230	2020	0.00016
Paenibacillus_sp._YPD9-1	2908839	S	778	73	851	0.00007
Paenibacillus_sp._R14(2021)	2859228	S	705	76	781	0.00006
Paenibacillus_sp._sptzw28	715179	S	702	48	750	0.00006
Paenibacillus_sp._JNUCC-32	2777984	S	669	1109	1778	0.00014
Paenibacillus_sp._HWE-109	1306526	S	668	44	712	0.00006
Paenibacillus_sp._JZ16	1906272	S	528	102	630	0.00005
Paenibacillus_sp._BIHB4019	1870819	S	522	31	553	0.00004
Paenibacillus_sp._URB8-2	2741301	S	388	74	462	0.00004
Paenibacillus_sp._PK3_47	2072642	S	381	41	422	0.00003
Paenibacillus_sp._PAMC21692	2762320	S	339	247	586	0.00005
Paenibacillus_sp._FSL_R7-0273	1536772	S	307	39	346	0.00003
Paenibacillus_sp._FSL_H7-0357	1536774	S	300	32	332	0.00003
Paenibacillus_sp._JNUCC-31	2777983	S	252	56	308	0.00003
Paenibacillus_sp._DCT19	2211212	S	251	33	284	0.00002
Paenibacillus_sp._FSL_R7-0331	1536773	S	250	33	283	0.00002
Paenibacillus_sp._YPG26	2878915	S	248	37	285	0.00002
Paenibacillus_sp._19GGS1-52	2758563	S	206	15	221	0.00002
Paenibacillus_sp._481	2835869	S	186	13	199	0.00002
Paenibacillus_sp._FSL_R5-0912	1536771	S	163	64	227	0.00002
Paenibacillus_sp._E222	2748863	S	163	46	209	0.00002
Paenibacillus_sp._IHB_B_3084	867076	S	153	74	227	0.00002
Paenibacillus_sp._FSL_P4-0081	1536769	S	150	66	216	0.00002
Paenibacillus_sp._IHBB_10380	1566358	S	136	19	155	0.00001
Paenibacillus_sp._N3/727	2925845	S	121	125	246	0.00002
Paenibacillus_sp._FSL_H7-0737	1536775	S	95	23	118	0.00001
Paenibacillus_sp._FSL_R5-0345	1536770	S	83	18	101	0.00001
Paenibacillus_sp._Cedars	1980674	S	62	311	373	0.00003
Paenibacillus_sp._37	2607911	S	22	209	231	0.00002
Paenibacillus_sp._M-152	2487928	S	22	290	312	0.00003
Paenibacillus_sp._lzh-N1	2069255	S	21	298	319	0.00003
Paenibacillus_sp._S02	2823904	S	19	131	150	0.00001
Paenibacillus_sp._DR312	2871175	S	13	169	182	0.00001
Paenibacillus_sp._S25	2823905	S	11	151	162	0.00001
Paenibacillus_ihbetae	1870820	S	4068	451	4519	0.00037
Paenibacillus_macerans	44252	S	2904	201	3105	0.00025
Paenibacillus_mucilaginosus	61624	S	2426	131	2557	0.00021
Paenibacillus_cellulositrophicus	562959	S	1734	134	1868	0.00015
Paenibacillus_albicereus	2726185	S	1570	377	1947	0.00016
Paenibacillus_lycopersici	2704462	S	1541	144	1685	0.00014
Paenibacillus_thiaminolyticus	49283	S	1366	190	1556	0.00013
Paenibacillus_konkukensis	2020716	S	1148	101	1249	0.00010
Paenibacillus_cellulosilyticus	375489	S	1016	98	1114	0.00009
Paenibacillus_rhizovicinus	2704463	S	963	98	1061	0.00009
Paenibacillus_dendritiformis	130049	S	937	132	1069	0.00009
Paenibacillus_beijingensis	1126833	S	920	81	1001	0.00008
Paenibacillus_chitinolyticus	79263	S	689	65	754	0.00006
Paenibacillus_stellifer	169760	S	648	93	741	0.00006
Paenibacillus_protaetiae	2509456	S	622	67	689	0.00006
Paenibacillus_polymyxa	1406	S	622	1627	2249	0.00018
Paenibacillus_naphthalenovorans	162209	S	551	59	610	0.00005
Paenibacillus_durus	44251	S	538	163	701	0.00006
Paenibacillus_azoreducens	116718	S	507	46	553	0.00004
Paenibacillus_albus	2495582	S	495	50	545	0.00004
Paenibacillus_lautus	1401	S	494	526	1020	0.00008
Paenibacillus_algicola	2565926	S	471	58	529	0.00004
Paenibacillus_xylanilyticus	248903	S	449	74	523	0.00004
Paenibacillus_yonginensis	1462996	S	395	146	541	0.00004
Paenibacillus_sabinae	365617	S	384	78	462	0.00004
Paenibacillus_alvei	44250	S	381	38	419	0.00003
Paenibacillus_donghaensis	414771	S	372	31	403	0.00003
Paenibacillus_riograndensis	483937	S	153	120	273	0.00002
Paenibacillus_sonchi	373687	S	99	132	231	0.00002
Paenibacillus_lutimineralis	2707005	S	341	35	376	0.00003
Paenibacillus_lentus	1338368	S	341	26	367	0.00003
Paenibacillus_agaridevorans	171404	S	324	330	654	0.00005
Paenibacillus_guangzhouensis	1473112	S	315	23	338	0.00003
Paenibacillus_physcomitrellae	1619311	S	310	89	399	0.00003
Paenibacillus_swuensis	1178515	S	301	32	333	0.00003
Paenibacillus_tritici	1873425	S	293	36	329	0.00003
Paenibacillus_baekrokdamisoli	1712516	S	258	21	279	0.00002
Paenibacillus_tianjinensis	2810347	S	254	35	289	0.00002
Paenibacillus_barcinonensis	198119	S	252	33	285	0.00002
Paenibacillus_larvae	1464	S	237	21	258	0.00002
Paenibacillus_kribbensis	172713	S	233	73	306	0.00002
Paenibacillus_odorifer	189426	S	233	35	268	0.00002
Paenibacillus_borealis	160799	S	231	68	299	0.00002
Paenibacillus_psychroresistens	1778678	S	224	9	233	0.00002
Paenibacillus_sophorae	1333845	S	221	66	287	0.00002
Paenibacillus_bovis	1616788	S	202	19	221	0.00002
Paenibacillus_graminis	189425	S	188	84	272	0.00002
Paenibacillus_brasilensis	128574	S	184	71	255	0.00002
Paenibacillus_pabuli	1472	S	178	54	232	0.00002
Paenibacillus_crassostreae	1763538	S	173	20	193	0.00002
Paenibacillus_antarcticus	253703	S	145	17	162	0.00001
Paenibacillus_terrae	159743	S	142	58	200	0.00002
Paenibacillus_jilunlii	682956	S	132	77	209	0.00002
Paenibacillus_uliginis	683737	S	124	116	240	0.00002
Paenibacillus_xylanexedens	528191	S	92	55	147	0.00001
Paenibacillus_peoriae	59893	S	80	401	481	0.00004
Paenibacillus_glucanolyticus	59843	S	77	394	471	0.00004
Brevibacillus_choshinensis	54911	S	3134	507	3641	0.00030
Brevibacillus_brevis	1393	S	1538	603	2141	0.00017
Brevibacillus_marinus	2496837	S	757	88	845	0.00007
Brevibacillus_composti	2796470	S	727	136	863	0.00007
Brevibacillus_agri	51101	S	651	116	767	0.00006
Brevibacillus_sp._MMS20-4M-10-Y	2895522	S	393	38	431	0.00004
Brevibacillus_sp._DP1.3A	2738867	S	92	62	154	0.00001
Brevibacillus_sp._HD3.3A	2738979	S	61	199	260	0.00002
Brevibacillus_sp._7WMA2	2683193	S	18	65	83	0.00001
Brevibacillus_laterosporus	1465	S	530	643	1173	0.00010
Brevibacillus_formosus	54913	S	182	118	300	0.00002
Brevibacillus_parabrevis	54914	S	57	190	247	0.00002
Cohnella_sp._LGH	1619153	S	1200	423	1623	0.00013
Cohnella_sp._MFER-1	2728023	S	508	74	582	0.00005
Cohnella_candidum	2674991	S	1449	153	1602	0.00013
Cohnella_cholangitidis	2598458	S	527	99	626	0.00005
Cohnella_abietis	2507935	S	176	19	195	0.00002
Thermobacillus_composti	377615	S	1734	206	1940	0.00016
Saccharibacillus_brassicae	2583377	S	1126	104	1230	0.00010
Aneurinibacillus_soli	1500254	S	550	135	685	0.00006
Aneurinibacillus_sp._XH2	1450761	S	12	378	390	0.00003
Planococcus_sp._PAMC_21323	1526927	S	108	39	147	0.00001
Planococcus_sp._MB-3u-03	2058136	S	102	57	159	0.00001
Planococcus_sp._107-1	2908840	S	95	33	128	0.00001
Planococcus_maritimus	192421	S	187	62	249	0.00002
Planococcus_lenghuensis	2213202	S	180	27	207	0.00002
Planococcus_glaciei	459472	S	160	36	196	0.00002
Planococcus_plakortidis	1038856	S	147	69	216	0.00002
Planococcus_massiliensis	1499687	S	136	25	161	0.00001
Planococcus_antarcticus	161360	S	113	27	140	0.00001
Planococcus_rifietoensis	200991	S	111	66	177	0.00001
Planococcus_versutus	1302659	S	109	39	148	0.00001
Planococcus_halotolerans	2233542	S	106	24	130	0.00001
Planococcus_donghaensis	414778	S	72	32	104	0.00001
Planococcus_halocryophilus	1215089	S	64	26	90	0.00001
Planococcus_faecalis	1598147	S	21	63	84	0.00001
Planococcus_kocurii	1374	S	20	60	80	0.00001
Sporosarcina_sp._Marseille-Q4063	2810514	S	168	21	189	0.00002
Sporosarcina_sp._Te-1	2818390	S	154	26	180	0.00001
Sporosarcina_sp._PTS2304	2283194	S	127	26	153	0.00001
Sporosarcina_sp._resist	2762563	S	45	108	153	0.00001
Sporosarcina_sp._P37	1930546	S	17	71	88	0.00001
Sporosarcina_sp._P33	1930764	S	10	46	56	0.00000
Sporosarcina_ureae	1571	S	363	77	440	0.00004
Sporosarcina_ureilytica	298596	S	125	29	154	0.00001
Sporosarcina_pasteurii	1474	S	105	24	129	0.00001
Sporosarcina_psychrophila	1476	S	32	92	124	0.00001
Solibacillus_silvestris	76853	S	337	98	435	0.00004
Solibacillus_sp._R5-41	2048654	S	314	104	418	0.00003
Ureibacillus_thermosphaericus	51173	S	361	304	665	0.00005
Ureibacillus_thermophilus	367743	S	211	85	296	0.00002
Rummeliibacillus_stabekisii	241244	S	370	146	516	0.00004
Paenisporosarcina_antarctica	417367	S	197	46	243	0.00002
Paenisporosarcina_cavernae	2320858	S	135	58	193	0.00002
Kurthia_sp._11kri321	1750719	S	167	70	237	0.00002
Kurthia_zopfii	1650	S	136	55	191	0.00002
Viridibacillus_sp._JNUCC-6	2779527	S	297	85	382	0.00003
Jeotgalibacillus_malaysiensis	1508404	S	179	43	222	0.00002
Tumebacillus_avium	1903704	S	1553	815	2368	0.00019
Tumebacillus_algifaecis	1214604	S	652	288	940	0.00008
Alicyclobacillus_acidocaldarius	405212	S	1807	133	1940	0.00016
Alicyclobacillus_acidoterrestris	1450	S	241	32	273	0.00002
Alicyclobacillus_mengziensis	2931921	S	197	11	208	0.00002
Alicyclobacillus_sp._SO9	2665646	S	110	6	116	0.00001
Alicyclobacillus_sp._TC	2606450	S	60	5	65	0.00001
Kyrpidia_spormannii	2055160	S	238	135	373	0.00003
Kyrpidia_tusciae	33943	S	177	143	320	0.00003
Effusibacillus_dendaii	2743772	S	230	26	256	0.00002
Staphylococcus_aureus	1280	S	149	1356	1505	0.00012
Staphylococcus_sp._CCM_9025	2892440	S	56	18	74	0.00001
Staphylococcus_sp._17KM0847	2583989	S	53	18	71	0.00001
Staphylococcus_sp._MI_10-1553	1912064	S	13	4	17	0.00000
Staphylococcus_haemolyticus	1283	S	111	97	208	0.00002
Staphylococcus_epidermidis	1282	S	92	57	149	0.00001
Staphylococcus_pseudintermedius	283734	S	47	38	85	0.00001
Staphylococcus_delphini	53344	S	18	12	30	0.00000
Staphylococcus_capitis	29388	S	69	51	120	0.00001
Staphylococcus_hominis	1290	S	67	33	100	0.00001
Staphylococcus_simiae	308354	S	64	24	88	0.00001
Staphylococcus_pasteuri	45972	S	61	52	113	0.00001
Staphylococcus_simulans	1286	S	53	15	68	0.00001
Staphylococcus_lugdunensis	28035	S	52	55	107	0.00001
Staphylococcus_xylosus	1288	S	52	19	71	0.00001
Staphylococcus_gallinarum	1293	S	50	3	53	0.00000
Staphylococcus_felis	46127	S	50	15	65	0.00001
Staphylococcus_lutrae	155085	S	49	15	64	0.00001
Staphylococcus_nepalensis	214473	S	44	11	55	0.00000
Staphylococcus_chromogenes	46126	S	44	15	59	0.00000
Staphylococcus_arlettae	29378	S	43	23	66	0.00001
Staphylococcus_pseudoxylosus	2282419	S	43	17	60	0.00000
Staphylococcus_agnetis	985762	S	41	11	52	0.00000
Staphylococcus_auricularis	29379	S	40	10	50	0.00000
Staphylococcus_saccharolyticus	33028	S	40	10	50	0.00000
Staphylococcus_hyicus	1284	S	37	12	49	0.00000
Staphylococcus_cohnii	29382	S	37	27	64	0.00001
Staphylococcus_caprae	29380	S	37	17	54	0.00000
Staphylococcus_saprophyticus	29385	S	36	14	50	0.00000
Staphylococcus_lloydii	2781774	S	36	12	48	0.00000
Staphylococcus_succinus	61015	S	34	8	42	0.00000
Staphylococcus_pettenkoferi	170573	S	34	6	40	0.00000
Staphylococcus_condimenti	70255	S	33	10	43	0.00000
Staphylococcus_debuckii	2044912	S	31	11	42	0.00000
Staphylococcus_edaphicus	1955013	S	31	6	37	0.00000
Staphylococcus_carnosus	1281	S	28	8	36	0.00000
Staphylococcus_piscifermentans	70258	S	28	8	36	0.00000
Staphylococcus_kloosii	29384	S	27	10	37	0.00000
Staphylococcus_schleiferi	1295	S	26	42	68	0.00001
Staphylococcus_equorum	246432	S	24	37	61	0.00001
Staphylococcus_muscae	1294	S	22	6	28	0.00000
Staphylococcus_warneri	1292	S	21	22	43	0.00000
Staphylococcus_schweitzeri	1654388	S	18	10	28	0.00000
Staphylococcus_argenteus	985002	S	17	87	104	0.00001
Staphylococcus_roterodami	2699836	S	16	11	27	0.00000
Macrococcus_armenti	2875764	S	91	40	131	0.00001
Macrococcus_canis	1855823	S	67	27	94	0.00001
Macrococcus_caseolyticus	69966	S	45	112	157	0.00001
Macrococcus_brunensis	198483	S	42	9	51	0.00000
Mammaliicoccus_sciuri	1296	S	121	65	186	0.00002
Mammaliicoccus_lentus	42858	S	74	44	118	0.00001
Mammaliicoccus_vitulinus	71237	S	58	24	82	0.00001
Mammaliicoccus_stepanovicii	643214	S	48	13	61	0.00001
Jeotgalicoccus_sp._ATCC_8456	946435	S	33	5	38	0.00000
Jeotgalicoccus_sp._WY2	2708346	S	31	9	40	0.00000
Jeotgalicoccus_saudimassiliensis	1461582	S	51	8	59	0.00000
Salinicoccus_halodurans	407035	S	57	14	71	0.00001
Abyssicoccus_albus	1817405	S	42	12	54	0.00000
Nosocomiicoccus_ampullae	489910	S	20	2	22	0.00000
Kroppenstedtia_eburnea	714067	S	289	25	314	0.00003
Kroppenstedtia_pulmonis	1380685	S	124	8	132	0.00001
Staphylospora_marina	2490858	S	397	51	448	0.00004
Polycladomyces_abyssicola	1125966	S	336	26	362	0.00003
Novibacillus_thermophilus	1471761	S	276	26	302	0.00002
Laceyella_sacchari	37482	S	197	36	233	0.00002
Thermoactinomyces_vulgaris	2026	S	120	19	139	0.00001
Exiguobacterium_alkaliphilum	1428684	S	253	64	317	0.00003
Exiguobacterium_sp._N4-1P	2051906	S	66	29	95	0.00001
Exiguobacterium_sp._Helios	2735868	S	56	22	78	0.00001
Exiguobacterium_sp._PFWT01	2829816	S	29	34	63	0.00001
Exiguobacterium_sp._AT1b	360911	S	27	31	58	0.00000
Exiguobacterium_sp._MH3	1399115	S	16	23	39	0.00000
Exiguobacterium_mexicanum	340146	S	177	46	223	0.00002
Exiguobacterium_acetylicum	41170	S	83	140	223	0.00002
Exiguobacterium_antarcticum	132920	S	80	23	103	0.00001
Exiguobacterium_sibiricum	332410	S	80	33	113	0.00001
Gemella_sp._zg-570	2840371	S	20	18	38	0.00000
Gemella_haemolysans	1379	S	34	14	48	0.00000
Gemella_sanguinis	84135	S	23	15	38	0.00000
Gemella_morbillorum	29391	S	13	13	26	0.00000
Listeria_monocytogenes	1639	S	212	107	319	0.00003
Listeria_ivanovii	1638	S	111	27	138	0.00001
Listeria_innocua	1642	S	76	75	151	0.00001
Listeria_weihenstephanensis	1006155	S	76	12	88	0.00001
Listeria_seeligeri	1640	S	75	30	105	0.00001
Listeria_sp._PSOL-1	1844999	S	75	14	89	0.00001
Listeria_grayi	1641	S	67	14	81	0.00001
Listeria_welshimeri	1643	S	51	56	107	0.00001
Listeria_marthii	529731	S	43	17	60	0.00000
Brochothrix_thermosphacta	2756	S	57	14	71	0.00001
Sporolactobacillus_terrae	269673	S	169	17	186	0.00002
Limosilactobacillus_fermentum	1613	S	147	121	268	0.00002
Limosilactobacillus_pontis	35787	S	89	38	127	0.00001
Limosilactobacillus_mucosae	97478	S	58	21	79	0.00001
Limosilactobacillus_reuteri	1598	S	44	41	85	0.00001
Limosilactobacillus_panis	47493	S	43	14	57	0.00000
Limosilactobacillus_frumenti	104955	S	17	5	22	0.00000
Limosilactobacillus_vaginalis	1633	S	13	5	18	0.00000
Limosilactobacillus_gastricus	227942	S	11	3	14	0.00000
Lactobacillus_delbrueckii	1584	S	135	255	390	0.00003
Lactobacillus_sp._CBA3606	2099789	S	16	7	23	0.00000
Lactobacillus_sp._3B(2020)	2695882	S	14	3	17	0.00000
Lactobacillus_sp._CBA3605	2099788	S	12	3	15	0.00000
Lactobacillus_iners	147802	S	23	23	46	0.00000
Lactobacillus_johnsonii	33959	S	21	14	35	0.00000
Lactobacillus_jensenii	109790	S	20	5	25	0.00000
Lactobacillus_terrae	2269374	S	18	2	20	0.00000
Lactobacillus_panisapium	2012495	S	15	2	17	0.00000
Lactobacillus_crispatus	47770	S	12	6	18	0.00000
Lactobacillus_kefiranofaciens	267818	S	11	13	24	0.00000
Lactobacillus_amylovorus	1604	S	10	16	26	0.00000
Levilactobacillus_zymae	267363	S	118	33	151	0.00001
Levilactobacillus_brevis	1580	S	67	25	92	0.00001
Levilactobacillus_suantsaii	2292255	S	44	13	57	0.00000
Levilactobacillus_koreensis	637971	S	38	4	42	0.00000
Lacticaseibacillus_rhamnosus	47715	S	53	8	61	0.00000
Lacticaseibacillus_manihotivorans	88233	S	35	9	44	0.00000
Lacticaseibacillus_casei	1582	S	32	10	42	0.00000
Lacticaseibacillus_paracasei	1597	S	29	104	133	0.00001
Lacticaseibacillus_chiayiensis	2100821	S	27	3	30	0.00000
Lacticaseibacillus_zeae	57037	S	18	7	25	0.00000
Leuconostoc_gelidum	1244	S	21	2	23	0.00000
Leuconostoc_mesenteroides	1245	S	18	62	80	0.00001
Leuconostoc_pseudomesenteroides	33968	S	17	22	39	0.00000
Leuconostoc_carnosum	1252	S	16	8	24	0.00000
Leuconostoc_lactis	1246	S	13	26	39	0.00000
Lactiplantibacillus_pentosus	1589	S	70	17	87	0.00001
Lactiplantibacillus_plantarum	1590	S	57	41	98	0.00001
Lactiplantibacillus_paraplantarum	60520	S	26	7	33	0.00000
Weissella_cibaria	137591	S	29	12	41	0.00000
Weissella_confusa	1583	S	23	10	33	0.00000
Weissella_soli	155866	S	16	3	19	0.00000
Weissella_paramesenteroides	1249	S	15	8	23	0.00000
Weissella_viridescens	1629	S	12	3	15	0.00000
Weissella_hellenica	46256	S	12	7	19	0.00000
Weissella_koreensis	165096	S	12	6	18	0.00000
Weissella_jogaejeotgali	1631871	S	10	6	16	0.00000
Ligilactobacillus_salivarius	1624	S	40	49	89	0.00001
Ligilactobacillus_ruminis	1623	S	36	9	45	0.00000
Ligilactobacillus_murinus	1622	S	20	16	36	0.00000
Ligilactobacillus_saerimneri	228229	S	20	16	36	0.00000
Ligilactobacillus_acidipiscis	89059	S	14	5	19	0.00000
Ligilactobacillus_agilis	1601	S	11	5	16	0.00000
Ligilactobacillus_animalis	1605	S	11	11	22	0.00000
Schleiferilactobacillus_harbinensis	304207	S	132	11	143	0.00001
Lentilactobacillus_buchneri	1581	S	32	11	43	0.00000
Lentilactobacillus_hilgardii	1588	S	20	3	23	0.00000
Lentilactobacillus_kefiri	33962	S	18	5	23	0.00000
Lentilactobacillus_parabuchneri	152331	S	18	4	22	0.00000
Lentilactobacillus_curieae	1138822	S	15	2	17	0.00000
Lentilactobacillus_sp._IM3328	2883998	S	11	2	13	0.00000
Companilactobacillus_zhachilii	2304606	S	19	3	22	0.00000
Companilactobacillus_futsaii	938155	S	17	9	26	0.00000
Companilactobacillus_heilongjiangensis	1074467	S	13	2	15	0.00000
Companilactobacillus_allii	1847728	S	13	1	14	0.00000
Companilactobacillus_ginsenosidimutans	1007676	S	12	1	13	0.00000
Latilactobacillus_sakei	1599	S	45	18	63	0.00001
Latilactobacillus_curvatus	28038	S	24	12	36	0.00000
Latilactobacillus_fuchuensis	164393	S	17	0	17	0.00000
Latilactobacillus_graminis	60519	S	15	4	19	0.00000
Pediococcus_pentosaceus	1255	S	19	8	27	0.00000
Pediococcus_acidilactici	1254	S	19	7	26	0.00000
Pediococcus_inopinatus	114090	S	18	11	29	0.00000
Pediococcus_damnosus	51663	S	14	8	22	0.00000
Pediococcus_claussenii	187452	S	13	4	17	0.00000
Loigolactobacillus_coryniformis	1610	S	29	23	52	0.00000
Loigolactobacillus_bifermentans	1607	S	28	7	35	0.00000
Loigolactobacillus_backii	375175	S	22	10	32	0.00000
Oenococcus_kitaharae	336988	S	27	1	28	0.00000
Oenococcus_oeni	1247	S	18	4	22	0.00000
Oenococcus_sp._UCMA_16435	2259623	S	14	4	18	0.00000
Oenococcus_sicerae	2203724	S	11	0	11	0.00000
Liquorilactobacillus_nagelii	82688	S	26	8	34	0.00000
Liquorilactobacillus_hordei	468911	S	23	12	35	0.00000
Liquorilactobacillus_mali	1618	S	18	8	26	0.00000
Secundilactobacillus_paracollinoides	240427	S	37	13	50	0.00000
Secundilactobacillus_malefermentans	176292	S	17	6	23	0.00000
Paucilactobacillus_oligofermentans	293371	S	16	5	21	0.00000
Paucilactobacillus_nenjiangensis	1296540	S	15	12	27	0.00000
Fructilactobacillus_sanfranciscensis	1625	S	18	13	31	0.00000
Fructilactobacillus_lindneri	53444	S	12	5	17	0.00000
Furfurilactobacillus_rossiae	231049	S	39	6	45	0.00000
Apilactobacillus_bombintestini	2419772	S	12	4	16	0.00000
Apilactobacillus_kunkeei	148814	S	11	3	14	0.00000
Amylolactobacillus_amylophilus	1603	S	21	15	36	0.00000
Periweissella_cryptocerci	2506420	S	18	1	19	0.00000
Lapidilactobacillus_dextrinicus	51664	S	14	2	16	0.00000
Bombilactobacillus_bombi	1303590	S	12	1	13	0.00000
Acetilactobacillus_jinshanensis	1720083	S	10	0	10	0.00000
Streptococcus_sp._HKU75	2781599	S	21	11	32	0.00000
Streptococcus_sp._zg-86	2664091	S	12	14	26	0.00000
Streptococcus_suis	1307	S	62	44	106	0.00001
Streptococcus_sanguinis	1305	S	51	15	66	0.00001
Streptococcus_equi	1336	S	29	6	35	0.00000
Streptococcus_dysgalactiae	1334	S	20	77	97	0.00001
Streptococcus_oralis	1303	S	44	78	122	0.00001
Streptococcus_intermedius	1338	S	17	16	33	0.00000
Streptococcus_anginosus	1328	S	12	85	97	0.00001
Streptococcus_pluranimalium	82348	S	28	12	40	0.00000
Streptococcus_porcinus	1340	S	28	13	41	0.00000
Streptococcus_cristatus	45634	S	24	28	52	0.00000
Streptococcus_pyogenes	1314	S	24	28	52	0.00000
Streptococcus_infantis	68892	S	24	13	37	0.00000
Streptococcus_pneumoniae	1313	S	22	25	47	0.00000
Streptococcus_pantholopis	1811193	S	21	2	23	0.00000
Streptococcus_sobrinus	1310	S	20	3	23	0.00000
Streptococcus_equinus	1335	S	19	18	37	0.00000
Streptococcus_mitis	28037	S	19	22	41	0.00000
Streptococcus_halotolerans	1814128	S	19	3	22	0.00000
Streptococcus_merionis	400065	S	18	1	19	0.00000
Streptococcus_pseudoporcinus	361101	S	18	15	33	0.00000
Streptococcus_thermophilus	1308	S	18	27	45	0.00000
Streptococcus_salivarius	1304	S	18	35	53	0.00000
Streptococcus_respiraculi	2021971	S	18	4	22	0.00000
Streptococcus_gordonii	1302	S	18	7	25	0.00000
Streptococcus_ratti	1341	S	17	2	19	0.00000
Streptococcus_ferus	1345	S	16	2	18	0.00000
Streptococcus_uberis	1349	S	15	4	19	0.00000
Streptococcus_iniae	1346	S	15	4	19	0.00000
Streptococcus_mutans	1309	S	14	5	19	0.00000
Streptococcus_canis	1329	S	14	10	24	0.00000
Streptococcus_chenjunshii	2173853	S	13	1	14	0.00000
Streptococcus_urinalis	149016	S	12	6	18	0.00000
Streptococcus_halichoeri	254785	S	12	12	24	0.00000
Streptococcus_himalayensis	1888195	S	12	3	15	0.00000
Streptococcus_parauberis	1348	S	12	22	34	0.00000
Streptococcus_australis	113107	S	11	28	39	0.00000
Streptococcus_gallolyticus	315405	S	10	37	47	0.00000
Streptococcus_troglodytae	1111760	S	10	4	14	0.00000
Streptococcus_lactarius	684066	S	10	8	18	0.00000
Lactococcus_lactis	1358	S	49	74	123	0.00001
Lactococcus_garvieae	1363	S	26	47	73	0.00001
Lactococcus_raffinolactis	1366	S	24	16	40	0.00000
Lactococcus_cremoris	1359	S	21	43	64	0.00001
Lactococcus_taiwanensis	1151742	S	18	5	23	0.00000
Lactococcus_protaetiae	2592653	S	18	5	23	0.00000
Lactococcus_allomyrinae	2419773	S	15	4	19	0.00000
Floricoccus_penangensis	1859475	S	23	4	27	0.00000
Enterococcus_faecalis	1351	S	70	101	171	0.00001
Enterococcus_avium	33945	S	59	26	85	0.00001
Enterococcus_cecorum	44008	S	56	35	91	0.00001
Enterococcus_durans	53345	S	53	49	102	0.00001
Enterococcus_mundtii	53346	S	47	15	62	0.00001
Enterococcus_raffinosus	71452	S	43	20	63	0.00001
Enterococcus_faecium	1352	S	41	455	496	0.00004
Enterococcus_wangshanyuanii	2005703	S	35	3	38	0.00000
Enterococcus_thailandicus	417368	S	33	12	45	0.00000
Enterococcus_casseliflavus	37734	S	30	69	99	0.00001
Enterococcus_gilvus	160453	S	29	12	41	0.00000
Enterococcus_hirae	1354	S	28	17	45	0.00000
Enterococcus_rotai	118060	S	27	1	28	0.00000
Enterococcus_saigonensis	1805431	S	18	24	42	0.00000
Vagococcus_fluvialis	2738	S	49	31	80	0.00001
Vagococcus_lutrae	81947	S	45	62	107	0.00001
Vagococcus_xieshaowenii	2562451	S	32	17	49	0.00000
Vagococcus_carniphilus	218144	S	27	11	38	0.00000
Vagococcus_penaei	633807	S	24	6	30	0.00000
Vagococcus_hydrophili	2714947	S	24	6	30	0.00000
Vagococcus_teuberi	519472	S	21	18	39	0.00000
Vagococcus_zengguangii	2571750	S	20	7	27	0.00000
Vagococcus_sp._CY52-2	2925838	S	18	17	35	0.00000
Vagococcus_coleopterorum	2714946	S	18	5	23	0.00000
Tetragenococcus_halophilus	51669	S	34	17	51	0.00000
Tetragenococcus_osmophilus	526944	S	17	11	28	0.00000
Tetragenococcus_koreensis	290335	S	15	6	21	0.00000
Melissococcus_plutonius	33970	S	34	25	59	0.00000
Carnobacterium_sp._17-4	208596	S	24	40	64	0.00001
Carnobacterium_divergens	2748	S	45	10	55	0.00000
Carnobacterium_maltaromaticum	2751	S	44	13	57	0.00000
Carnobacterium_inhibens	147709	S	34	27	61	0.00001
Carnobacterium_viridans	174587	S	15	13	28	0.00000
Jeotgalibaca_sp._MA1X17-3	2908211	S	29	5	34	0.00000
Jeotgalibaca_sp._PTS2502	1903686	S	18	27	45	0.00000
Jeotgalibaca_ciconiae	2496265	S	38	15	53	0.00000
Jeotgalibaca_porci	1868793	S	32	21	53	0.00000
Jeotgalibaca_dankookensis	708126	S	31	6	37	0.00000
Jeotgalibaca_arthritidis	1868794	S	22	33	55	0.00000
Dolosigranulum_pigrum	29394	S	60	13	73	0.00001
Granulicatella_adiacens	46124	S	30	12	42	0.00000
Granulicatella_elegans	137732	S	27	53	80	0.00001
Marinilactibacillus_sp._15R	1911586	S	26	10	36	0.00000
Aerococcus_sanguinicola	119206	S	41	6	47	0.00000
Aerococcus_urinae	1376	S	26	7	33	0.00000
Aerococcus_christensenii	87541	S	16	17	33	0.00000
Aerococcus_urinaeequi	51665	S	14	32	46	0.00000
Aerococcus_urinaehominis	128944	S	11	1	12	0.00000
Abiotrophia_defectiva	46125	S	29	6	35	0.00000
Suicoccus_acidiformans	2036206	S	28	15	43	0.00000
Ignavigranum_ruoffiae	89093	S	21	2	23	0.00000
Thermaerobacter_sp._FW80	2546351	S	2055	376	2431	0.00020
Thermaerobacter_sp._PB12/4term	2293838	S	1431	321	1752	0.00014
Thermaerobacter_marianensis	73919	S	1766	381	2147	0.00017
Intestinimonas_butyriciproducens	1297617	S	390	112	502	0.00004
Aminipila_luticellarii	2507160	S	52	5	57	0.00000
Aminipila_terrae	2697030	S	31	2	33	0.00000
Aminipila_butyrica	433296	S	25	2	27	0.00000
Emergencia_timonensis	1776384	S	106	28	134	0.00001
Mogibacterium_diversum	114527	S	13	21	34	0.00000
Flintibacter_sp._KGMB00164	2610895	S	206	22	228	0.00002
Massilistercora_timonensis	2086584	S	107	92	199	0.00002
Carboxydocella_thermautotrophica	178899	S	104	7	111	0.00001
Fenollaria_sp._EMRHCC_24	2811778	S	10	15	25	0.00000
Faecalibacterium_prausnitzii	853	S	1177	948	2125	0.00017
Dysosmobacter_sp._Marseille-Q4140	2830675	S	471	169	640	0.00005
Dysosmobacter_welbionis	2093857	S	372	239	611	0.00005
Flavonifractor_plautii	292800	S	744	166	910	0.00007
Vescimonas_coprocola	2714355	S	235	170	405	0.00003
Vescimonas_fastidiosa	2714353	S	188	231	419	0.00003
Ruthenibacterium_lactatiformans	1550024	S	414	97	511	0.00004
Ethanoligenens_harbinense	253239	S	391	19	410	0.00003
Caproiciproducens_sp._NJN-50	2507162	S	310	34	344	0.00003
Oscillibacter_sp._NSJ-62	2763056	S	289	78	367	0.00003
Anaerotruncus_colihominis	169435	S	273	133	406	0.00003
Caproicibacter_fermentans	2576756	S	234	12	246	0.00002
Acutalibacter_muris	1796620	S	195	9	204	0.00002
Ruminococcus_champanellensis	1161942	S	73	4	77	0.00001
Ruminococcus_albus	1264	S	39	0	39	0.00000
Ruminococcus_bicirculans	1160721	S	27	5	32	0.00000
Ruminococcus_bovis	2564099	S	16	1	17	0.00000
Acetivibrio_clariflavus	288965	S	52	29	81	0.00001
Acetivibrio_thermocellus	1515	S	47	8	55	0.00000
Acetivibrio_saccincola	1677857	S	37	20	57	0.00000
Pusillibacter_faecalis	2714358	S	141	73	214	0.00002
Solibaculum_mannosilyticum	2780922	S	130	102	232	0.00002
Caproicibacterium_amylolyticum	2766537	S	62	4	66	0.00001
Caproicibacterium_lactatifermentans	2666138	S	56	6	62	0.00001
Ruminiclostridium_herbifermentans	2488810	S	34	9	43	0.00000
Ruminiclostridium_cellulolyticum	1521	S	27	5	32	0.00000
Pseudoclostridium_thermosuccinogenes	84032	S	58	11	69	0.00001
Thermoclostridium_stercorarium	1510	S	52	4	56	0.00000
Monoglobus_pectinilyticus	1981510	S	33	12	45	0.00000
Mageeibacillus_indolicus	884684	S	31	28	59	0.00000
Fastidiosipila_sanguinis	236753	S	18	7	25	0.00000
Clostridium_sp._DL-VIII	641107	S	66	7	73	0.00001
Clostridium_sp._SY8519	1042156	S	66	15	81	0.00001
Clostridium_sp._M62/1	411486	S	59	61	120	0.00001
Clostridium_sp._C5S11	704125	S	57	4	61	0.00001
Clostridium_sp._JN-9	2507159	S	40	4	44	0.00000
Clostridium_sp._BNL1100	755731	S	34	3	37	0.00000
Clostridium_sp._JN-1	2483110	S	27	2	29	0.00000
Clostridium_sp._BJN0001	2930219	S	27	4	31	0.00000
Clostridium_sp._'deep_sea'	2779445	S	26	0	26	0.00000
Clostridium_sp._C1	1155388	S	22	15	37	0.00000
Clostridium_sp._MD294	97138	S	19	1	20	0.00000
Clostridium_sp._001	1970093	S	17	11	28	0.00000
Clostridium_sp._AWRP	2212991	S	17	7	24	0.00000
Clostridium_argentinense	29341	S	144	13	157	0.00001
Clostridium_botulinum	1491	S	144	163	307	0.00002
Clostridium_perfringens	1502	S	128	33	161	0.00001
Clostridium_beijerinckii	1520	S	91	128	219	0.00002
Clostridium_pasteurianum	1501	S	76	8	84	0.00001
Clostridium_kluyveri	1534	S	72	3	75	0.00001
Clostridium_saccharoperbutylacetonicum	36745	S	68	9	77	0.00001
Clostridium_tetani	1513	S	65	7	72	0.00001
Clostridium_intestinale	36845	S	57	4	61	0.00001
Clostridium_butyricum	1492	S	54	6	60	0.00000
Clostridium_cellulovorans	1493	S	53	5	58	0.00000
Clostridium_thermarum	1716543	S	50	21	71	0.00001
Clostridium_aceticum	84022	S	47	3	50	0.00000
Clostridium_saccharobutylicum	169679	S	45	5	50	0.00000
Clostridium_manihotivorum	2320868	S	44	3	47	0.00000
Clostridium_baratii	1561	S	44	8	52	0.00000
Clostridium_carboxidivorans	217159	S	43	8	51	0.00000
Clostridium_sporogenes	1509	S	39	169	208	0.00002
Clostridium_tyrobutyricum	1519	S	34	1	35	0.00000
Clostridium_formicaceticum	1497	S	34	4	38	0.00000
Clostridium_bornimense	1216932	S	33	9	42	0.00000
Clostridium_cadaveris	1529	S	32	5	37	0.00000
Clostridium_estertheticum	238834	S	29	3	32	0.00000
Clostridium_acetobutylicum	1488	S	28	35	63	0.00001
Clostridium_gasigenes	94869	S	28	3	31	0.00000
Clostridium_septicum	1504	S	26	4	30	0.00000
Clostridium_isatidis	182773	S	25	7	32	0.00000
Clostridium_taeniosporum	394958	S	24	2	26	0.00000
Clostridium_chauvoei	46867	S	18	3	21	0.00000
Clostridium_drakei	332101	S	17	9	26	0.00000
Clostridium_fermenticellae	2068654	S	17	1	18	0.00000
Clostridium_scatologenes	1548	S	17	11	28	0.00000
Clostridium_novyi	1542	S	16	76	92	0.00001
Clostridium_cochlearium	1494	S	12	2	14	0.00000
Alkaliphilus_sp._B6464	2731219	S	152	27	179	0.00001
Alkaliphilus_metalliredigens	208226	S	39	5	44	0.00000
Alkaliphilus_oremlandii	461876	S	34	6	40	0.00000
Hungatella_hathewayi	154046	S	125	3	128	0.00001
Crassaminicella_thermophila	2599308	S	31	7	38	0.00000
Crassaminicella_profunda	1286698	S	29	4	33	0.00000
Crassaminicella_sp._143-21	2855394	S	27	9	36	0.00000
Geosporobacter_ferrireducens	1424294	S	61	6	67	0.00001
Caloramator_sp._E03	2576307	S	44	2	46	0.00000
Serpentinicella_alkaliphila	1734049	S	38	4	42	0.00000
Paraclostridium_bifermentans	1490	S	28	6	34	0.00000
Hathewaya_histolytica	1498	S	24	4	28	0.00000
Sarcina_sp._JB2	2726954	S	21	5	26	0.00000
Candidatus_Arthromitus_sp._SFB-rat-Yit	1041504	S	10	10	20	0.00000
Symbiobacterium_thermophilum	2734	S	2479	156	2635	0.00021
[Clostridium]_hylemonae	89153	S	117	25	142	0.00001
[Clostridium]_scindens	29347	S	116	36	152	0.00001
Lachnoclostridium_phocaeense	1871021	S	102	72	174	0.00001
Lachnoclostridium_phytofermentans	66219	S	24	1	25	0.00000
Lachnoclostridium_sp._YL32	1834196	S	17	24	41	0.00000
Blautia_producta	33035	S	58	9	67	0.00001
Blautia_sp._NBRC_113351	2877527	S	41	34	75	0.00001
Blautia_sp._SC05B48	2479767	S	12	25	37	0.00000
Blautia_pseudococcoides	1796616	S	47	5	52	0.00000
Blautia_liquoris	2779518	S	28	1	29	0.00000
Blautia_obeum	40520	S	19	14	33	0.00000
Blautia_argi	1912897	S	18	12	30	0.00000
Blautia_hansenii	1322	S	14	8	22	0.00000
Blautia_massiliensis	1737424	S	14	22	36	0.00000
Lachnospiraceae_bacterium_NSJ-38	2763669	S	75	22	97	0.00001
Lachnospiraceae_bacterium_NSJ-29	2763667	S	71	15	86	0.00001
Lachnospiraceae_bacterium_sunii_NSJ-8	2763672	S	44	27	71	0.00001
Lachnospiraceae_bacterium_NSJ-4	2763670	S	38	32	70	0.00001
Anaerocolumna_cellulosilytica	433286	S	117	4	121	0.00001
Anaerocolumna_chitinilytica	1727145	S	49	1	50	0.00000
Anaerocolumna_sedimenticola	2696063	S	44	2	46	0.00000
Roseburia_hominis	301301	S	110	90	200	0.00002
Roseburia_intestinalis	166486	S	36	34	70	0.00001
Roseburia_sp._NSJ-69	2763062	S	15	3	18	0.00000
Coprococcus_comes	410072	S	42	37	79	0.00001
Coprococcus_catus	116085	S	37	16	53	0.00000
Coprococcus_eutactus	33043	S	23	23	46	0.00000
Anaerostipes_caccae	105841	S	43	11	54	0.00000
Anaerostipes_rhamnosivorans	1229621	S	36	16	52	0.00000
Anaerostipes_hadrus	649756	S	24	17	41	0.00000
Enterocloster_bolteae	208479	S	98	26	124	0.00001
Enterocloster_clostridioformis	1531	S	14	36	50	0.00000
Butyrivibrio_fibrisolvens	831	S	47	8	55	0.00000
Butyrivibrio_proteoclasticus	43305	S	32	3	35	0.00000
Butyrivibrio_hungatei	185008	S	20	1	21	0.00000
Lacrimispora_saccharolytica	84030	S	41	5	46	0.00000
Lacrimispora_sphenoides	29370	S	37	2	39	0.00000
Anaerotignum_propionicum	28446	S	56	4	60	0.00000
Sellimonas_intestinalis	1653434	S	50	20	70	0.00001
Cellulosilyticum_lentocellum	29360	S	15	27	42	0.00000
[Ruminococcus]_gnavus	33038	S	25	17	42	0.00000
[Ruminococcus]_torques	33039	S	17	12	29	0.00000
Anaerobutyricum_hallii	39488	S	40	11	51	0.00000
Novisyntrophococcus_fermenticellae	2068655	S	39	4	43	0.00000
Herbinix_luporum	1679721	S	29	15	44	0.00000
Dorea_longicatena	88431	S	22	18	40	0.00000
Lachnospira_eligens	39485	S	20	2	22	0.00000
Faecalicatena_sp._Marseille-Q4148	2823316	S	15	6	21	0.00000
Pseudobutyrivibrio_xylanivorans	185007	S	11	0	11	0.00000
Candidatus_Desulforudis_audaxviator	471827	S	620	28	648	0.00005
Desulforamulus_ruminis	1564	S	91	12	103	0.00001
Desulforamulus_ferrireducens	1833852	S	91	52	143	0.00001
Desulforamulus_reducens	59610	S	45	8	53	0.00000
Acididesulfobacillus_acetoxydans	1561005	S	241	7	248	0.00002
Candidatus_Formimonas_warabiya	1761012	S	161	9	170	0.00001
Thermanaerosceptrum_fracticalcis	1712410	S	97	11	108	0.00001
Desulfofarcimen_acetoxidans	58138	S	79	7	86	0.00001
Dehalobacterium_formicoaceticum	51515	S	50	8	58	0.00000
Desulfitobacterium_hafniense	49338	S	100	28	128	0.00001
Desulfitobacterium_metallireducens	142877	S	62	12	74	0.00001
Desulfitobacterium_dehalogenans	36854	S	51	14	65	0.00001
Desulfitobacterium_dichloroeliminans	233055	S	51	38	89	0.00001
Desulfosporosinus_orientis	1563	S	69	9	78	0.00001
Desulfosporosinus_youngiae	339862	S	69	13	82	0.00001
Desulfosporosinus_acidiphilus	885581	S	65	8	73	0.00001
Desulfosporosinus_meridiei	79209	S	53	12	65	0.00001
Dehalobacter_restrictus	55583	S	41	66	107	0.00001
Syntrophobotulus_glycolicus	51197	S	74	4	78	0.00001
Christensenella_sp._Marseille-P3954	2086585	S	564	189	753	0.00006
Christensenella_minuta	626937	S	159	37	196	0.00002
Heliomicrobium_modesticaldum	35701	S	626	284	910	0.00007
Heliorestis_convoluta	356322	S	65	3	68	0.00001
Eubacterium_limosum	1736	S	72	57	129	0.00001
Eubacterium_sp._MSJ-33	2841528	S	27	14	41	0.00000
Eubacterium_sp._c-25	2841037	S	26	10	36	0.00000
Eubacterium_sp._NSJ-61	2764325	S	10	11	21	0.00000
Eubacterium_callanderi	53442	S	41	26	67	0.00001
Eubacterium_maltosivorans	2041044	S	24	79	103	0.00001
Acetobacterium_wieringae	52694	S	52	30	82	0.00001
Acetobacterium_sp._KB-1	2184575	S	52	23	75	0.00001
Acetobacterium_woodii	33952	S	23	7	30	0.00000
Alkalibacter_sp._ES005	2815577	S	87	4	91	0.00001
Clostridioides_difficile	1496	S	41	957	998	0.00008
Peptoclostridium_acidaminophilum	1731	S	50	6	56	0.00000
Romboutsia_sp._CE17	2724150	S	16	7	23	0.00000
Romboutsia_hominis	1507512	S	15	6	21	0.00000
Acetoanaerobium_sticklandii	1511	S	30	2	32	0.00000
Paeniclostridium_sordellii	1505	S	28	5	33	0.00000
Tepidibacter_sp._8C15b	2925782	S	24	3	27	0.00000
Filifactor_alocis	143361	S	19	18	37	0.00000
Terrisporobacter_sp._MCA3	2813371	S	18	2	20	0.00000
Peptacetobacter_hiranonis	89152	S	13	2	15	0.00000
Syntrophothermus_lipocalidus	86170	S	99	7	106	0.00001
Candidatus_Contubernalis_alkalaceticum	338645	S	50	1	51	0.00000
Syntrophomonas_wolfei	863	S	39	6	45	0.00000
Candidatus_Syntrophocurvum_alkaliphilum	2293317	S	22	4	26	0.00000
Desulfoscipio_gibsoniae	102134	S	152	9	161	0.00001
Thermincola_potens	863643	S	82	6	88	0.00001
Vallitalea_guaymasensis	1185412	S	25	3	28	0.00000
Vallitalea_pronyensis	1348613	S	22	2	24	0.00000
Petrocella_atlantisensis	2173034	S	27	2	29	0.00000
Desulfotomaculum_nigrificans	1565	S	67	24	91	0.00001
Caloranaerobacter_azorensis	116090	S	61	6	67	0.00001
Alkalicella_caledoniensis	2731377	S	34	3	37	0.00000
Moorella_sp._Hama-1	2138101	S	328	70	398	0.00003
Moorella_thermoacetica	1525	S	310	55	365	0.00003
Moorella_glycerini	55779	S	259	26	285	0.00002
Ammonifex_degensii	42838	S	384	10	394	0.00003
Gelria_sp._Kuro-4	2796927	S	867	48	915	0.00007
Thermacetogenium_phaeum	85874	S	312	248	560	0.00005
Carboxydothermus_hydrogenoformans	129958	S	106	8	114	0.00001
Thermoanaerobacter_kivui	2325	S	14	21	35	0.00000
Thermoanaerobacter_mathranii	583357	S	14	63	77	0.00001
Thermanaeromonas_toyohensis	161154	S	99	2	101	0.00001
Caldanaerobacter_subterraneus	911092	S	34	66	100	0.00001
Caldicellulosiruptor_changbaiensis	1222016	S	22	56	78	0.00001
Caldicellulosiruptor_acetigenus	301953	S	14	22	36	0.00000
Thermoanaerobacterium_thermosaccharolyticum	1517	S	27	34	61	0.00000
Thermoanaerobacterium_sp._RBIITD	1550240	S	23	15	38	0.00000
Thermoanaerobacterium_xylanolyticum	29329	S	13	11	24	0.00000
Zhaonella_formicivorans	2528593	S	95	12	107	0.00001
Mahella_australiensis	252966	S	93	36	129	0.00001
Thermodesulfobium_narugense	184064	S	15	22	37	0.00000
Thermodesulfobium_acidiphilum	1794699	S	11	16	27	0.00000
Iocasia_fonsfrigidae	2682810	S	66	5	71	0.00001
Halanaerobium_praevalens	2331	S	27	13	40	0.00000
Halanaerobium_hydrogeniformans	656519	S	12	4	16	0.00000
Halothermothrix_orenii	31909	S	41	5	46	0.00000
Acetohalobium_arabaticum	28187	S	44	6	50	0.00000
Halobacteroides_halobius	42422	S	32	6	38	0.00000
Anoxybacter_fermentans	1323375	S	62	11	73	0.00001
Thermosediminibacter_oceani	291990	S	139	9	148	0.00001
Biomaibacter_acetigenes	2316383	S	87	7	94	0.00001
Tepidanaerobacter_acetatoxydans	499229	S	19	1	20	0.00000
Natranaerofaba_carboxydovora	2742683	S	78	3	81	0.00001
Natranaerobius_thermophilus	375929	S	33	4	37	0.00000
Koleobacter_methoxysyntrophicus	2751313	S	86	7	93	0.00001
Selenomonas_sp._oral_taxon_126	712528	S	439	110	549	0.00004
Selenomonas_sp._oral_taxon_920	1884263	S	272	55	327	0.00003
Selenomonas_sp._oral_taxon_478	712538	S	136	173	309	0.00003
Selenomonas_sp._oral_taxon_136	713030	S	113	134	247	0.00002
Selenomonas_sputigena	69823	S	753	42	795	0.00006
Selenomonas_timonae	2754044	S	287	125	412	0.00003
Selenomonas_ruminantium	971	S	123	7	130	0.00001
Megamonas_funiformis	437897	S	19	5	24	0.00000
Megamonas_hypermegale	158847	S	15	5	20	0.00000
Pectinatus_frisingensis	865	S	24	1	25	0.00000
Sporomusa_termitida	2377	S	168	16	184	0.00001
Methylomusa_anaerophila	1930071	S	117	5	122	0.00001
Pelosinus_sp._UFO1	484770	S	49	13	62	0.00001
Pelosinus_fermentans	365349	S	45	7	52	0.00000
Megasphaera_stantonii	2144175	S	256	107	363	0.00003
Megasphaera_elsdenii	907	S	253	101	354	0.00003
Megasphaera_massiliensis	1232428	S	102	28	130	0.00001
Dialister_pneumosintes	39950	S	20	77	97	0.00001
Veillonella_parvula	29466	S	24	18	42	0.00000
Veillonella_rodentium	248315	S	20	7	27	0.00000
Veillonella_atypica	39777	S	12	8	20	0.00000
Acidaminococcus_fermentans	905	S	152	22	174	0.00001
Acidaminococcus_intestini	187327	S	77	9	86	0.00001
Phascolarctobacterium_faecium	33025	S	72	5	77	0.00001
Phascolarctobacterium_sp._Marseille-Q4147	2823317	S	35	27	62	0.00001
Phascolarctobacterium_succinatutens	626940	S	24	46	70	0.00001
Limnochorda_pilosa	1555112	S	2436	70	2506	0.00020
Peptoniphilus_ivorii	54006	S	141	25	166	0.00001
Peptoniphilus_harei	54005	S	16	11	27	0.00000
Murdochiella_vaginalis	1852373	S	72	47	119	0.00001
Anaerococcus_mediterraneensis	1870984	S	30	34	64	0.00001
Anaerococcus_prevotii	33034	S	10	5	15	0.00000
Finegoldia_magna	1260	S	23	13	36	0.00000
Helcococcus_kunzii	40091	S	15	4	19	0.00000
Parvimonas_micra	33033	S	11	12	23	0.00000
Miniphocaeibacter_halophilus	2931922	S	10	0	10	0.00000
Schnuerera_ultunensis	45497	S	40	6	46	0.00000
Tissierella_sp._JN-28	2507161	S	38	5	43	0.00000
Keratinibaculum_paraultunense	1278232	S	34	11	45	0.00000
Gudongella_oleilytica	1582259	S	19	2	21	0.00000
Gottschalkia_acidurici	1556	S	77	6	83	0.00001
Ezakiella_coagulans	46507	S	55	95	150	0.00001
Ezakiella_massiliensis	1852374	S	15	7	22	0.00000
Sedimentibacter_sp._zth1	2816908	S	24	1	25	0.00000
Allobaculum_sp._Allo2	2853432	S	64	9	73	0.00001
Allobaculum_mucolyticum	2834459	S	39	7	46	0.00000
Faecalibaculum_rodentium	1702221	S	101	17	118	0.00001
Erysipelothrix_sp._HDW6A	2714928	S	18	8	26	0.00000
Erysipelothrix_sp._HDW6C	2714930	S	13	9	22	0.00000
Erysipelothrix_larvae	1514105	S	13	8	21	0.00000
[Clostridium]_innocuum	1522	S	46	27	73	0.00001
Erysipelatoclostridium_ramosum	1547	S	19	6	25	0.00000
Bulleidia_sp._zg-1006	2806552	S	26	6	32	0.00000
Intestinibaculum_porci	2487118	S	24	6	30	0.00000
Longicatena_caecimuris	1796635	S	18	20	38	0.00000
Amedibacterium_intestinale	2583452	S	17	22	39	0.00000
Faecalibacillus_intestinalis	1982626	S	16	13	29	0.00000
Erysipelotrichaceae_bacterium_BP52G	2899121	S	10	1	11	0.00000
Turicibacter_sp._H121	1712675	S	30	23	53	0.00000
Turicibacter_sp._TJ11	2806443	S	26	17	43	0.00000
Turicibacter_sanguinis	154288	S	25	5	30	0.00000
Ndongobacter_massiliensis	1871025	S	81	44	125	0.00001
endosymbiont_'TC1'_of_Trimyema_compressum	243899	S	43	1	44	0.00000
Nostoc_sp._MS1	2764711	S	962	110	1072	0.00009
Nostoc_sp._CENA543	1869241	S	769	56	825	0.00007
Nostoc_sp._PCC_7524	28072	S	412	34	446	0.00004
Nostoc_sp._UHCC_0870	2914041	S	396	36	432	0.00004
Nostoc_sp._TCL26-01	2576904	S	357	21	378	0.00003
Nostoc_sp._UHCC_0702	2814655	S	268	25	293	0.00002
Nostoc_sp._NIES-4103	2005458	S	266	26	292	0.00002
Nostoc_sp._NIES-2111	1973475	S	211	332	543	0.00004
Nostoc_sp._PCC_7107	317936	S	209	47	256	0.00002
Nostoc_sp._NIES-3756	1751286	S	195	397	592	0.00005
Nostoc_sp._C052	2576902	S	164	36	200	0.00002
Nostoc_sp._'Lobaria_pulmonaria_(5183)_cyanobiont'	1618022	S	118	25	143	0.00001
Nostoc_sp._'Peltigera_membranacea_cyanobiont'_N6	1261031	S	112	31	143	0.00001
Nostoc_sp._ATCC_53789	76335	S	94	142	236	0.00002
Nostoc_sp._TCL240-02	2572090	S	58	33	91	0.00001
Nostoc_sp._C057	2576903	S	55	81	136	0.00001
Nostoc_sp._PCC_7120_=_FACHB-418	103690	S	12	503	515	0.00004
Nostoc_piscinale	224012	S	285	31	316	0.00003
Nostoc_linckia	92942	S	203	23	226	0.00002
Nostoc_edaphicum	264686	S	141	44	185	0.00002
Nostoc_sphaeroides	446679	S	131	87	218	0.00002
Nostoc_flagelliforme	1306274	S	111	43	154	0.00001
Nostoc_punctiforme	272131	S	86	72	158	0.00001
Nostoc_commune	1178	S	85	27	112	0.00001
Anabaena_cylindrica	1165	S	766	74	840	0.00007
Anabaena_sp._WA102	1647413	S	172	145	317	0.00003
Anabaena_sp._90	46234	S	95	340	435	0.00004
Trichormus_azollae	1164	S	794	53	847	0.00007
Trichormus_variabilis	264691	S	12	189	201	0.00002
Richelia_sinica	1357545	S	378	28	406	0.00003
Cylindrospermum_stagnale	142864	S	238	16	254	0.00002
Sphaerospermopsis_torques-reginae	984207	S	2131	527	2658	0.00022
Sphaerospermopsis_kisseleviana	289435	S	1868	476	2344	0.00019
Dolichospermum_compactum	136073	S	168	100	268	0.00002
Dolichospermum_flos-aquae	1166	S	88	338	426	0.00003
Dolichospermum_sp._UHCC_0315A	1914871	S	86	279	365	0.00003
Nodularia_spumigena	70799	S	167	47	214	0.00002
Nodularia_sphaerocarpa	137816	S	133	21	154	0.00001
Anabaenopsis_circularis	109266	S	168	48	216	0.00002
Anabaenopsis_elenkinii	156213	S	89	8	97	0.00001
Cylindrospermopsis_curvispora	747548	S	34	18	52	0.00000
Cylindrospermopsis_raciborskii	77022	S	27	30	57	0.00000
Calothrix_sp._PCC_7716	2853227	S	188	93	281	0.00002
Calothrix_sp._PCC_7507	99598	S	174	25	199	0.00002
Calothrix_sp._NIES-2100	1954172	S	168	74	242	0.00002
Calothrix_sp._NIES-3974	2005462	S	165	9	174	0.00001
Calothrix_sp._NIES-2098	1954171	S	143	59	202	0.00002
Calothrix_sp._336/3	1337936	S	110	23	133	0.00001
Calothrix_sp._PCC_6303	1170562	S	85	17	102	0.00001
Calothrix_brevissima	938406	S	222	49	271	0.00002
Calothrix_parasitica	1973486	S	144	4	148	0.00001
Scytonema_sp._NIES-4073	2005464	S	155	52	207	0.00002
Scytonema_sp._HK-05	1137095	S	134	42	176	0.00001
Brasilonema_sennae	1397703	S	120	10	130	0.00001
Tolypothrix_sp._PCC_7910	2099387	S	166	36	202	0.00002
Tolypothrix_tenuis	457083	S	140	37	177	0.00001
Fischerella_sp._NIES-3754	1752063	S	162	23	185	0.00002
Fischerella_sp._NIES-4106	2005456	S	109	10	119	0.00001
Rivularia_sp._PCC_7116	373994	S	86	3	89	0.00001
Synechococcus_sp._CBW1004	1353136	S	799	177	976	0.00008
Synechococcus_sp._RSCCF101	2511069	S	619	104	723	0.00006
Synechococcus_sp._CBW1107	2789857	S	535	89	624	0.00005
Synechococcus_sp._JA-3-3Ab	321327	S	393	77	470	0.00004
Synechococcus_sp._CBW1108	1353147	S	382	46	428	0.00003
Synechococcus_sp._SynAce01	1916956	S	346	30	376	0.00003
Synechococcus_sp._CB0101	232348	S	345	63	408	0.00003
Synechococcus_sp._NB0720_10	2907159	S	283	60	343	0.00003
Synechococcus_sp._RS9909	221352	S	241	76	317	0.00003
Synechococcus_sp._LA31	2741953	S	240	45	285	0.00002
Synechococcus_sp._PCC_7336	195250	S	240	5	245	0.00002
Synechococcus_sp._LTW-R	2751170	S	211	43	254	0.00002
Synechococcus_sp._JA-2-3B'a(2-13)	321332	S	210	38	248	0.00002
Synechococcus_sp._WH_8101	59932	S	187	54	241	0.00002
Synechococcus_sp._HK01-R	2751171	S	175	25	200	0.00002
Synechococcus_sp._A10-1-5-1	2936507	S	175	33	208	0.00002
Synechococcus_sp._KORDI-100	1280380	S	156	9	165	0.00001
Synechococcus_sp._Minos11	221341	S	154	9	163	0.00001
Synechococcus_sp._NOUM97013	1442555	S	120	16	136	0.00001
Synechococcus_sp._BMK-MC-1	1442551	S	112	38	150	0.00001
Synechococcus_sp._KORDI-52	585425	S	105	28	133	0.00001
Synechococcus_sp._PROS-U-1	1400866	S	96	14	110	0.00001
Synechococcus_sp._KORDI-49	585423	S	92	77	169	0.00001
Synechococcus_sp._MEDNS5	1442554	S	87	25	112	0.00001
Synechococcus_sp._CC9902	316279	S	84	7	91	0.00001
Synechococcus_sp._PROS-7-1	1442556	S	83	31	114	0.00001
Synechococcus_sp._A15-127	1050624	S	82	69	151	0.00001
Synechococcus_sp._PCC_6312	195253	S	79	2	81	0.00001
Synechococcus_sp._CBW1006	1353138	S	77	478	555	0.00005
Synechococcus_sp._BIOS-E4-1	1400864	S	71	6	77	0.00001
Synechococcus_sp._A15-62	1050657	S	67	39	106	0.00001
Synechococcus_sp._PCC_7003	374981	S	65	15	80	0.00001
Synechococcus_sp._MIT_S9220	166309	S	65	8	73	0.00001
Synechococcus_sp._A15-44	1050646	S	62	91	153	0.00001
Synechococcus_sp._BIOS-U3-1	1400865	S	62	5	67	0.00001
Synechococcus_sp._CBW1002	1353134	S	60	425	485	0.00004
Synechococcus_sp._NIES-970	1827144	S	59	7	66	0.00001
Synechococcus_sp._ROS8604	1442557	S	50	10	60	0.00000
Synechococcus_sp._WH_8020	32052	S	45	7	52	0.00000
Synechococcus_sp._WH_8109	166314	S	43	27	70	0.00001
Synechococcus_sp._TAK9802	1442558	S	38	77	115	0.00001
Synechococcus_sp._RS9907	221350	S	37	71	108	0.00001
Synechococcus_sp._RS9902	221345	S	37	63	100	0.00001
Synechococcus_sp._PCC_7502	1173263	S	32	1	33	0.00000
Synechococcus_sp._M16.1	1442553	S	32	79	111	0.00001
Synechococcus_sp._PROS-9-1	1968775	S	29	6	35	0.00000
Synechococcus_sp._MVIR-18-1	1386941	S	25	36	61	0.00001
Synechococcus_sp._CC9311	64471	S	22	4	26	0.00000
Synechococcus_sp._A15-60	1050655	S	19	111	130	0.00001
Synechococcus_sp._SYN20	1050714	S	18	22	40	0.00000
Synechococcus_sp._A18-25c	1866938	S	16	97	113	0.00001
Synechococcus_sp._PCC_7002	32049	S	11	39	50	0.00000
Synechococcus_elongatus	32046	S	376	12	388	0.00003
Dactylococcopsis_salina	292566	S	137	36	173	0.00001
Cyanobium_sp._NIES-981	1851505	S	678	194	872	0.00007
Cyanobium_sp._NS01	261284	S	517	166	683	0.00006
Cyanobium_gracile	59930	S	847	151	998	0.00008
Prochlorococcus_marinus	1219	S	126	27	153	0.00001
Parasynechococcus_marenigrum	2881428	S	142	42	184	0.00001
Acaryochloris_marina	155978	S	93	26	119	0.00001
Acaryochloris_sp._'Moss_Beach'	2740837	S	27	45	72	0.00001
Chamaesiphon_minutus	1173032	S	173	6	179	0.00001
Synechocystis_sp._PCC_6714	1147	S	32	8	40	0.00000
Synechocystis_sp._CACIAM_05	1933929	S	16	94	110	0.00001
Leptolyngbya_sp._7M	2812896	S	1485	68	1553	0.00013
Leptolyngbya_sp._BL0902	1115757	S	297	13	310	0.00003
Leptolyngbya_sp._NIES-3755	1752064	S	111	5	116	0.00001
Leptolyngbya_sp._PCC_7376	111781	S	30	1	31	0.00000
Leptolyngbya_boryana	1184	S	183	193	376	0.00003
Kovacikia_minuta	2931930	S	435	30	465	0.00004
Leptodesmis_sichuanensis	2906798	S	241	27	268	0.00002
Leptothermofonsia_sichuanensis	2917832	S	228	21	249	0.00002
Thermoleptolyngbya_sp._PKUAC-SCTB121	2811482	S	17	454	471	0.00004
Halomicronema_hongdechloris	1209493	S	269	7	276	0.00002
Thermosynechococcus_sp._NK55a	1394889	S	46	21	67	0.00001
Thermosynechococcus_sp._TA-1	2813673	S	34	34	68	0.00001
Thermosynechococcus_sp._CL-1	2583530	S	14	14	28	0.00000
Thermosynechococcus_vestitus	146786	S	81	30	111	0.00001
Pseudanabaena_sp._PCC_7367	82654	S	90	3	93	0.00001
Pseudanabaena_sp._ABRG5-3	685565	S	54	3	57	0.00000
Geitlerinema_sp._PCC_7407	1173025	S	575	58	633	0.00005
Allocoleopsis_franciscana	2886352	S	135	9	144	0.00001
Moorena_producens	1155739	S	468	7	475	0.00004
Oscillatoria_nigro-viridis	482564	S	127	58	185	0.00002
Oscillatoria_acuminata	118323	S	99	4	103	0.00001
Oxynema_aestuarii	2874213	S	275	16	291	0.00002
Microcoleus_vaginatus	119532	S	167	54	221	0.00002
Planktothrix_rubescens	59512	S	29	10	39	0.00000
Planktothrix_agardhii	1160	S	20	10	30	0.00000
[Phormidium]_sp._ETS-05	222819	S	220	8	228	0.00002
Crinalium_epipsammum	241425	S	94	8	102	0.00001
Microcystis_aeruginosa	1126	S	264	257	521	0.00004
Microcystis_sp._MC19	1967666	S	49	20	69	0.00001
Gloeothece_citriformis	2546356	S	55	2	57	0.00000
Gloeothece_verrucosa	2546359	S	52	2	54	0.00000
Halothece_sp._PCC_7418	65093	S	69	16	85	0.00001
Euhalothece_natronophila	577489	S	35	3	38	0.00000
Crocosphaera_subtropica	2546360	S	77	7	84	0.00001
Rippkaea_orientalis	2546366	S	65	6	71	0.00001
Candidatus_Atelocyanobacterium_thalassa	713887	S	12	2	14	0.00000
Geminocystis_herdmanii	669359	S	69	8	77	0.00001
Geminocystis_sp._NIES-3709	1617448	S	21	5	26	0.00000
Geminocystis_sp._NIES-3708	1615909	S	18	4	22	0.00000
Gloeocapsa_sp._PCC_7428	1173026	S	77	5	82	0.00001
Chondrocystis_sp._NIES-4102	2005460	S	47	4	51	0.00000
Cyanobacterium_aponinum	379064	S	39	6	45	0.00000
Gloeobacter_kilaueensis	1416614	S	1131	24	1155	0.00009
Gloeobacter_morelensis	2907343	S	732	323	1055	0.00009
Gloeobacter_violaceus	33072	S	720	348	1068	0.00009
Anthocerotibacter_panamensis	2857077	S	281	6	287	0.00002
Chroococcidiopsis_sp._CCMEE_29	155894	S	189	22	211	0.00002
Chroococcidiopsis_sp._CCNUC1	2653189	S	66	90	156	0.00001
Chroococcidiopsis_thermalis	54299	S	43	65	108	0.00001
Stanieria_sp._NIES-3757	1807358	S	44	15	59	0.00000
Stanieria_cyanosphaera	102116	S	35	7	42	0.00000
Pleurocapsa_sp._PCC_7327	118163	S	76	6	82	0.00001
Gloeomargarita_lithophora	1188228	S	105	2	107	0.00001
Thermostichus_lividus	33070	S	48	4	52	0.00000
Deinococcus_sp._NW-56	2080419	S	1176	182	1358	0.00011
Deinococcus_sp._TS-293	2737050	S	1011	110	1121	0.00009
Deinococcus_sp._KNUC1210	2917691	S	908	35	943	0.00008
Deinococcus_sp._AJ005	2652443	S	698	64	762	0.00006
Deinococcus_sp._QL22	2939437	S	423	42	465	0.00004
Deinococcus_maricopensis	309887	S	1658	140	1798	0.00015
Deinococcus_metallilatus	1211322	S	1515	186	1701	0.00014
Deinococcus_gobiensis	502394	S	1475	201	1676	0.00014
Deinococcus_actinosclerus	1768108	S	1400	1067	2467	0.00020
Deinococcus_ficus	317577	S	1334	131	1465	0.00012
Deinococcus_irradiatisoli	2202254	S	1111	100	1211	0.00010
Deinococcus_peraridilitoris	432329	S	949	43	992	0.00008
Deinococcus_wulumuqiensis	980427	S	890	406	1296	0.00011
Deinococcus_radiopugnans	57497	S	812	107	919	0.00007
Deinococcus_geothermalis	68909	S	740	130	870	0.00007
Deinococcus_radiodurans	1299	S	738	314	1052	0.00009
Deinococcus_soli_(ex_Cha_et_al._2016)	1309411	S	572	695	1267	0.00010
Deinococcus_psychrotolerans	2489213	S	571	16	587	0.00005
Deinococcus_deserti	310783	S	490	36	526	0.00004
Deinococcus_proteolyticus	55148	S	462	122	584	0.00005
Deinococcus_puniceus	1182568	S	269	50	319	0.00003
Deinococcus_radiophilus	32062	S	257	64	321	0.00003
Thermus_thermophilus	274	S	796	903	1699	0.00014
Thermus_aquaticus	271	S	399	54	453	0.00004
Thermus_oshimai	56957	S	395	71	466	0.00004
Thermus_sp._CCB_US3_UF1	1111069	S	337	46	383	0.00003
Thermus_sp._NEB1569	2918899	S	52	90	142	0.00001
Thermus_brockianus	56956	S	338	62	400	0.00003
Thermus_caldilimi	2483360	S	182	44	226	0.00002
Thermus_scotoductus	37636	S	86	126	212	0.00002
Thermus_parvatiensis	456163	S	71	334	405	0.00003
Oceanithermus_profundus	187137	S	2218	202	2420	0.00020
Meiothermus_silvanus	52022	S	653	91	744	0.00006
Meiothermus_taiwanensis	172827	S	543	194	737	0.00006
Meiothermus_ruber	277	S	486	182	668	0.00005
Marinithermus_hydrothermalis	186192	S	1391	224	1615	0.00013
Truepera_radiovictrix	332249	S	2020	102	2122	0.00017
Sphaerobacter_thermophilus	2057	S	7869	512	8381	0.00068
Thermomicrobium_roseum	500	S	1704	42	1746	0.00014
Roseiflexus_sp._RS-1	357808	S	2773	585	3358	0.00027
Roseiflexus_castenholzii	120962	S	2544	558	3102	0.00025
Chloroflexus_aurantiacus	1108	S	820	106	926	0.00008
Chloroflexus_aggregans	152260	S	727	141	868	0.00007
Tepidiforma_bonchosmolovskayae	2601677	S	4825	164	4989	0.00040
Candidatus_Promineofilum_breve	1806508	S	3652	58	3710	0.00030
Caldilinea_aerophila	133453	S	1916	139	2055	0.00017
Anaerolinea_thermophila	167964	S	744	83	827	0.00007
Pelolinea_submarina	913107	S	600	31	631	0.00005
Brevefilum_fermentans	1986204	S	254	10	264	0.00002
Dehalogenimonas_formicexedens	1839801	S	404	122	526	0.00004
Dehalogenimonas_sp._GP	1536648	S	293	87	380	0.00003
Dehalococcoides_mccartyi	61435	S	95	277	372	0.00003
Ktedonosporobacter_rubrisoli	2509675	S	1044	35	1079	0.00009
Thermobaculum_terrenum	166501	S	868	108	976	0.00008
Phototrophicus_methaneseepsis	2710758	S	514	5	519	0.00004
Fimbriimonas_ginsengisoli	1005039	S	1974	7	1981	0.00016
Chthonomonas_calidirosea	454171	S	520	2	522	0.00004
Mycoplasma_sp._Pen4	640330	S	13	4	17	0.00000
Mycoplasma_pneumoniae	2104	S	13	0	13	0.00000
Mycoplasma_gallisepticum	2096	S	12	138	150	0.00001
Mycoplasma_phocoenae	754517	S	11	1	12	0.00000
Mesomycoplasma_neurolyticum	2120	S	10	2	12	0.00000
Mesoplasma_syrphidae	225999	S	12	23	35	0.00000
Candidatus_Phytoplasma_ziziphi	135727	S	11	16	27	0.00000
Alteracholeplasma_palmae	38986	S	36	5	41	0.00000
Haploplasma_axanthum	29552	S	17	5	22	0.00000
Paracholeplasma_brassicae	61635	S	14	5	19	0.00000
Candidatus_Izimaplasma_sp._HR1	1541959	S	10	0	10	0.00000
Bradyrhizobium_sp._200	2782665	S	12518	2899	15417	0.00125
Bradyrhizobium_sp._170	2782641	S	11415	3059	14474	0.00117
Bradyrhizobium_sp._CCBAU_051011	858422	S	11171	2195	13366	0.00108
Bradyrhizobium_sp._CCBAU_51753	1325100	S	7750	1719	9469	0.00077
Bradyrhizobium_sp._A19	2898149	S	6131	1080	7211	0.00059
Bradyrhizobium_sp._BTAi1	288000	S	5940	1110	7050	0.00057
Bradyrhizobium_sp._ORS_278	114615	S	5899	1375	7274	0.00059
Bradyrhizobium_sp._ORS_285	115808	S	5609	1291	6900	0.00056
Bradyrhizobium_sp._CCBAU_53351	1325114	S	5196	2664	7860	0.00064
Bradyrhizobium_sp._SK17	2057741	S	5164	1766	6930	0.00056
Bradyrhizobium_sp._186	2782654	S	4727	1317	6044	0.00049
Bradyrhizobium_sp._CCBAU_53338	1325111	S	4362	1812	6174	0.00050
Bradyrhizobium_sp._195	2782662	S	4115	1521	5636	0.00046
Bradyrhizobium_sp._CCBAU_53421	1325120	S	4103	1315	5418	0.00044
Bradyrhizobium_sp._CCBAU_53340	1325112	S	3877	1526	5403	0.00044
Bradyrhizobium_sp._1(2017)	1404888	S	3856	1222	5078	0.00041
Bradyrhizobium_sp._I71	2590772	S	3141	2873	6014	0.00049
Bradyrhizobium_sp._CCBAU_51765	1325102	S	3122	2973	6095	0.00049
Bradyrhizobium_sp._CCGE-LA001	1223566	S	3090	1175	4265	0.00035
Bradyrhizobium_sp._191	2782659	S	3081	3186	6267	0.00051
Bradyrhizobium_sp._S2-11-2	2840472	S	3061	2462	5523	0.00045
Bradyrhizobium_sp._6(2017)	1197460	S	2907	1450	4357	0.00035
Bradyrhizobium_sp._41S5	1404443	S	2543	1758	4301	0.00035
Bradyrhizobium_sp._S2-20-1	2840469	S	2418	2075	4493	0.00036
Bradyrhizobium_sp._S2-11-4	2840473	S	2382	2250	4632	0.00038
Bradyrhizobium_sp._C-145	574727	S	1521	1527	3048	0.00025
Bradyrhizobium_sp.	376	S	1117	3723	4840	0.00039
Bradyrhizobium_sp._40	2782674	S	904	2138	3042	0.00025
Bradyrhizobium_sp._4	2782678	S	848	2254	3102	0.00025
Bradyrhizobium_sp._144S4	2823807	S	790	1991	2781	0.00023
Bradyrhizobium_sp._323S2	1404649	S	784	2014	2798	0.00023
Bradyrhizobium_sp._192	2782660	S	736	1814	2550	0.00021
Bradyrhizobium_sp._LCT2	2493093	S	495	1400	1895	0.00015
Bradyrhizobium_sp._TM102	2599819	S	361	2510	2871	0.00023
Bradyrhizobium_sp._SG09	2599805	S	353	2565	2918	0.00024
Bradyrhizobium_sp._187	2782655	S	266	1332	1598	0.00013
Bradyrhizobium_sp._1S5	2816456	S	139	1594	1733	0.00014
Bradyrhizobium_sp._172	2782643	S	131	1623	1754	0.00014
Bradyrhizobium_sp._38S5	2819348	S	125	1555	1680	0.00014
Bradyrhizobium_sp._131	2782609	S	116	1929	2045	0.00017
Bradyrhizobium_sp._CW1	2782686	S	87	1372	1459	0.00012
Bradyrhizobium_sp._155	2782629	S	81	1485	1566	0.00013
Bradyrhizobium_sp._CCBAU_21365	1325083	S	20	981	1001	0.00008
Bradyrhizobium_erythrophlei	1437360	S	19477	1615	21092	0.00171
Bradyrhizobium_diazoefficiens	1355477	S	16231	28031	44262	0.00359
Bradyrhizobium_icense	1274631	S	11480	1667	13147	0.00107
Bradyrhizobium_paxllaeri	190148	S	10260	1959	12219	0.00099
Bradyrhizobium_lablabi	722472	S	6532	7660	14192	0.00115
Bradyrhizobium_canariense	255045	S	5959	9474	15433	0.00125
Bradyrhizobium_genosp._L	83637	S	5865	1199	7064	0.00057
Bradyrhizobium_oligotrophicum	44255	S	5264	935	6199	0.00050
Bradyrhizobium_japonicum	375	S	5086	7572	12658	0.00103
Bradyrhizobium_arachidis	858423	S	4511	1312	5823	0.00047
Bradyrhizobium_vignae	1549949	S	4491	1072	5563	0.00045
Bradyrhizobium_guangxiense	1325115	S	4447	1953	6400	0.00052
Bradyrhizobium_guangdongense	1325090	S	3984	1503	5487	0.00045
Bradyrhizobium_genosp._B	83627	S	3537	767	4304	0.00035
Bradyrhizobium_cosmicum	1404864	S	3462	1137	4599	0.00037
Bradyrhizobium_quebecense	2748629	S	3354	1923	5277	0.00043
Bradyrhizobium_guangzhouense	1325095	S	3268	1256	4524	0.00037
Bradyrhizobium_septentrionale	1404411	S	2768	1713	4481	0.00036
Bradyrhizobium_amphicarpaeae	1404768	S	2493	1048	3541	0.00029
Bradyrhizobium_daqingense	993502	S	2484	1359	3843	0.00031
Bradyrhizobium_betae	244734	S	2133	1228	3361	0.00027
Bradyrhizobium_symbiodeficiens	1404367	S	1988	3010	4998	0.00041
Bradyrhizobium_zhanjiangense	1325107	S	1404	1416	2820	0.00023
Bradyrhizobium_elkanii	29448	S	857	2851	3708	0.00030
Bradyrhizobium_ottawaense	931866	S	751	4725	5476	0.00044
Rhodopseudomonas_palustris	1076	S	19295	6405	25700	0.00209
Rhodopseudomonas_sp._SK50-23	340268	S	2604	550	3154	0.00026
Rhodopseudomonas_boonkerdii	475937	S	2581	711	3292	0.00027
Tardiphaga_sp._37S4	1404741	S	1346	1037	2383	0.00019
Tardiphaga_sp._vice154	2592814	S	97	1521	1618	0.00013
Tardiphaga_sp._vice278	2592815	S	60	1479	1539	0.00012
Tardiphaga_sp._vice304	2592817	S	49	942	991	0.00008
Tardiphaga_sp._vice352	2592816	S	17	522	539	0.00004
Tardiphaga_robiniae	943830	S	1320	910	2230	0.00018
Nitrobacter_hamburgensis	912	S	4277	747	5024	0.00041
Nitrobacter_winogradskyi	913	S	3115	550	3665	0.00030
Afipia_carboxidovorans	40137	S	3699	725	4424	0.00036
Afipia_sp._GAS231	1882747	S	2633	1927	4560	0.00037
Variibacter_gotjawalensis	1333996	S	5928	470	6398	0.00052
Mesorhizobium_sp._8	2584466	S	6683	1672	8355	0.00068
Mesorhizobium_sp._J8	2777475	S	6336	2139	8475	0.00069
Mesorhizobium_sp._B2-8-5	2589903	S	4029	1396	5425	0.00044
Mesorhizobium_sp._DCY119	2108445	S	3383	835	4218	0.00034
Mesorhizobium_sp._M1B.F.Ca.ET.045.04.1.1	2493673	S	3260	1302	4562	0.00037
Mesorhizobium_sp._B1-1-8	2589976	S	3018	801	3819	0.00031
Mesorhizobium_sp._Pch-S	2082387	S	2944	420	3364	0.00027
Mesorhizobium_sp._M3A.F.Ca.ET.080.04.2.1	2493676	S	2877	919	3796	0.00031
Mesorhizobium_sp._M1E.F.Ca.ET.045.02.1.1	2493672	S	2860	1492	4352	0.00035
Mesorhizobium_sp._M1A.F.Ca.IN.022.06.1.1	2493680	S	2797	945	3742	0.00030
Mesorhizobium_sp._B2-1-1	2589974	S	2783	659	3442	0.00028
Mesorhizobium_sp._M1D.F.Ca.ET.043.01.1.1	2493669	S	2760	1731	4491	0.00036
Mesorhizobium_sp._131-2-1	2744518	S	2446	1358	3804	0.00031
Mesorhizobium_sp._M4B.F.Ca.ET.058.02.1.1	2493675	S	2321	1027	3348	0.00027
Mesorhizobium_sp._INR15	2654248	S	2233	336	2569	0.00021
Mesorhizobium_sp._PAMC28654	2880934	S	2205	433	2638	0.00021
Mesorhizobium_sp._M9A.F.Ca.ET.002.03.1.2	2493668	S	1965	946	2911	0.00024
Mesorhizobium_sp._L-2-11	2744521	S	1950	792	2742	0.00022
Mesorhizobium_sp._B4-1-4	2589888	S	1900	481	2381	0.00019
Mesorhizobium_sp._M2A.F.Ca.ET.043.05.1.1	2493671	S	1893	1692	3585	0.00029
Mesorhizobium_sp._M6A.T.Cr.TU.016.01.1.1	2493677	S	1703	599	2302	0.00019
Mesorhizobium_sp._B2-1-8	2589967	S	1696	547	2243	0.00018
Mesorhizobium_sp._M7D.F.Ca.US.005.01.1.1	2493678	S	1587	575	2162	0.00018
Mesorhizobium_sp._M8A.F.Ca.ET.057.01.1.1	2493679	S	1473	595	2068	0.00017
Mesorhizobium_sp._NZP2077	2483404	S	1372	481	1853	0.00015
Mesorhizobium_sp._113-3-3	2744516	S	1309	765	2074	0.00017
Mesorhizobium_sp._M7A.F.Ce.TU.012.03.2.1	2493681	S	1269	496	1765	0.00014
Mesorhizobium_sp._L-8-3	2744522	S	1266	4308	5574	0.00045
Mesorhizobium_sp._L-8-10	2744523	S	1250	4142	5392	0.00044
Mesorhizobium_sp._113-1-2	2744515	S	1227	642	1869	0.00015
Mesorhizobium_sp._NBSH29	2654249	S	1126	82	1208	0.00010
Mesorhizobium_sp._M2A.F.Ca.ET.043.02.1.1	2493670	S	1037	2755	3792	0.00031
Mesorhizobium_sp._M2A.F.Ca.ET.046.03.2.1	2493674	S	1032	2883	3915	0.00032
Mesorhizobium_sp._NZP2298	2483403	S	997	630	1627	0.00013
Mesorhizobium_sp._113-3-9	2744517	S	991	785	1776	0.00014
Mesorhizobium_sp._AA22	1854057	S	810	547	1357	0.00011
Mesorhizobium_sp._WSM1497	278153	S	352	775	1127	0.00009
Mesorhizobium_sp._131-3-5	2744520	S	171	577	748	0.00006
Mesorhizobium_sp._NZP2234	2483402	S	163	637	800	0.00006
Mesorhizobium_sp._131-2-5	2744519	S	92	677	769	0.00006
Mesorhizobium_terrae	2725666	S	2983	1052	4035	0.00033
Mesorhizobium_opportunistum	593909	S	2507	1103	3610	0.00029
Mesorhizobium_amorphae	71433	S	2054	523	2577	0.00021
Mesorhizobium_loti	381	S	1486	13157	14643	0.00119
Mesorhizobium_australicum	536018	S	1357	453	1810	0.00015
Mesorhizobium_ciceri	39645	S	1347	3657	5004	0.00041
Mesorhizobium_huakuii	28104	S	1274	981	2255	0.00018
Mesorhizobium_erdmanii	1777866	S	1259	382	1641	0.00013
Mesorhizobium_japonicum	2066070	S	1081	868	1949	0.00016
Aquibium_microcysteis	675281	S	5059	1498	6557	0.00053
Aquibium_oceanicum	1670800	S	3838	959	4797	0.00039
Aminobacter_sp._MSH1	374606	S	2671	1715	4386	0.00036
Aminobacter_sp._SR38	2774562	S	500	2046	2546	0.00021
Aminobacter_sp._MDW-2	2666139	S	349	1757	2106	0.00017
Aminobacter_aminovorans	83263	S	363	1279	1642	0.00013
Nitratireductor_sp._SY7	2599600	S	3230	652	3882	0.00032
Nitratireductor_sp._OM-1	1756988	S	1711	311	2022	0.00016
Nitratireductor_kimnyeongensis	430679	S	1033	156	1189	0.00010
Phyllobacterium_sp._T1018	555316	S	1049	141	1190	0.00010
Phyllobacterium_sp._628	2718938	S	589	84	673	0.00005
Phyllobacterium_sp._T1293	555317	S	571	71	642	0.00005
Phyllobacterium_zundukense	1867719	S	1034	158	1192	0.00010
Roseitalea_porphyridii	1852022	S	2565	460	3025	0.00025
Hoeflea_sp._IMCC20628	1620421	S	1027	102	1129	0.00009
Hoeflea_phototrophica	244596	S	966	118	1084	0.00009
Oricola_thermophila	2742145	S	1954	280	2234	0.00018
Salaquimonas_pukyongi	2712698	S	742	33	775	0.00006
Lentilitoribacter_sp._Alg239-R112	2305987	S	42	0	42	0.00000
Rhizobium_sp._BG4	2613770	S	1702	327	2029	0.00016
Rhizobium_sp._WYJ-E13	2849093	S	1555	199	1754	0.00014
Rhizobium_sp._NXC24	2048897	S	1456	215	1671	0.00014
Rhizobium_sp._ACO-34A	1571470	S	1245	268	1513	0.00012
Rhizobium_sp._WL3	2603277	S	1216	239	1455	0.00012
Rhizobium_sp._AB2/73	2795216	S	1215	696	1911	0.00016
Rhizobium_sp._SL42	2806346	S	1093	197	1290	0.00010
Rhizobium_sp._11515TR	2028343	S	1044	263	1307	0.00011
Rhizobium_sp._NXC14	1981173	S	846	360	1206	0.00010
Rhizobium_sp._NZLR1	2731096	S	829	292	1121	0.00009
Rhizobium_sp._CIAT894	2020312	S	811	366	1177	0.00010
Rhizobium_sp._NLR16a	2731112	S	765	357	1122	0.00009
Rhizobium_sp._K102	2918527	S	697	489	1186	0.00010
Rhizobium_sp._C104	2917727	S	628	353	981	0.00008
Rhizobium_sp._L51/94	2819999	S	498	714	1212	0.00010
Rhizobium_sp._X9	2815360	S	315	678	993	0.00008
Rhizobium_sp._Kim5	2020311	S	307	714	1021	0.00008
Rhizobium_sp._007	2785056	S	255	459	714	0.00006
Rhizobium_sp._IE4771	1301032	S	246	525	771	0.00006
Rhizobium_sp._TAL182	2020313	S	180	539	719	0.00006
Rhizobium_sp._NIBRBAC000502774	2590777	S	106	496	602	0.00005
Rhizobium_sp._ZX09	2291939	S	92	404	496	0.00004
Rhizobium_sp._Y9	1914541	S	85	334	419	0.00003
Rhizobium_sp._CCGE531	2364271	S	46	1867	1913	0.00016
Rhizobium_sp._B230/85	2819994	S	42	518	560	0.00005
Rhizobium_sp._N324	1703969	S	39	922	961	0.00008
Rhizobium_sp._T136	555319	S	22	636	658	0.00005
Rhizobium_leguminosarum	384	S	7585	10112	17697	0.00144
Rhizobium_rhizoryzae	451876	S	3570	465	4035	0.00033
Rhizobium_binae	1138190	S	2351	896	3247	0.00026
Rhizobium_etli	29449	S	2267	2801	5068	0.00041
Rhizobium_jaguaris	1312183	S	1588	202	1790	0.00015
Rhizobium_pseudoryzae	379684	S	1561	332	1893	0.00015
Rhizobium_phaseoli	396	S	1509	3239	4748	0.00039
Rhizobium_gallicum	56730	S	1249	1646	2895	0.00023
Rhizobium_bangladeshense	1138189	S	1115	273	1388	0.00011
Rhizobium_tropici	398	S	980	265	1245	0.00010
Rhizobium_lentis	1138194	S	940	298	1238	0.00010
Rhizobium_rosettiformans	1368430	S	935	451	1386	0.00011
Rhizobium_daejeonense	240521	S	816	285	1101	0.00009
Rhizobium_indicum	2583231	S	602	545	1147	0.00009
Rhizobium_pusense	648995	S	522	2118	2640	0.00021
Rhizobium_acidisoli	1538158	S	474	401	875	0.00007
Rhizobium_oryzihabitans	2267833	S	269	380	649	0.00005
Rhizobium_hidalgonense	1538159	S	217	513	730	0.00006
Rhizobium_laguerreae	1076926	S	210	371	581	0.00005
Rhizobium_ruizarguesonis	2081791	S	160	1215	1375	0.00011
Rhizobium_favelukesii	348824	S	11	382	393	0.00003
Agrobacterium_tumefaciens	358	S	4189	4005	8194	0.00066
Agrobacterium_fabrum	1176649	S	402	522	924	0.00008
Agrobacterium_fabacearum	1183401	S	72	977	1049	0.00009
Agrobacterium_vitis	373	S	2159	258	2417	0.00020
Agrobacterium_sp._T29	2580515	S	310	247	557	0.00005
Agrobacterium_sp._MA01	2664893	S	223	496	719	0.00006
Agrobacterium_sp._RAC06	1842536	S	201	456	657	0.00005
Agrobacterium_sp._CGMCC_11546	2579248	S	109	228	337	0.00003
Agrobacterium_sp._S7/73	2820002	S	47	260	307	0.00002
Agrobacterium_vaccinii	2735528	S	781	107	888	0.00007
Agrobacterium_larrymoorei	160699	S	560	87	647	0.00005
Agrobacterium_rubi	28099	S	523	136	659	0.00005
Agrobacterium_salinitolerans	1183413	S	433	164	597	0.00005
Agrobacterium_rhizogenes	359	S	381	935	1316	0.00011
Neorhizobium_galegae	399	S	4416	1246	5662	0.00046
Neorhizobium_sp._SOG26	2060726	S	1299	269	1568	0.00013
Neorhizobium_sp._NCHU2750	1825976	S	1261	309	1570	0.00013
Pseudorhizobium_flavum	1335061	S	948	569	1517	0.00012
Pseudorhizobium_banfieldiae	1125847	S	842	453	1295	0.00011
Ensifer_adhaerens	106592	S	5941	3167	9108	0.00074
Ensifer_alkalisoli	1752398	S	4396	893	5289	0.00043
Ensifer_mexicanus	375549	S	2630	419	3049	0.00025
Ensifer_sojae	716925	S	2479	1009	3488	0.00028
Ensifer_sp._PDNC004	2811423	S	1661	702	2363	0.00019
Ensifer_sp._T173	555315	S	280	1156	1436	0.00012
Sinorhizobium_fredii	380	S	6146	8515	14661	0.00119
Sinorhizobium_meliloti	382	S	4668	2080	6748	0.00055
Sinorhizobium_americanum	194963	S	2137	834	2971	0.00024
Sinorhizobium_sp._BG8	2613773	S	1724	291	2015	0.00016
Sinorhizobium_sp._CCBAU_05631	794846	S	303	468	771	0.00006
Sinorhizobium_medicae	110321	S	1902	251	2153	0.00017
Shinella_sp._HZN7	879274	S	4875	4443	9318	0.00076
Shinella_sp._PSBB067	2715959	S	2520	2008	4528	0.00037
Shinella_sp._XGS7	2877941	S	1838	1638	3476	0.00028
Shinella_sp._H4-D48	2925841	S	1002	399	1401	0.00011
Shinella_zoogloeoides	352475	S	2695	3980	6675	0.00054
Shinella_oryzae	2871820	S	1385	619	2004	0.00016
Ciceribacter_thiooxidans	1969821	S	1825	382	2207	0.00018
Georhizobium_profundi	2341112	S	1729	402	2131	0.00017
Peteryoungia_desertarenae	1813451	S	579	109	688	0.00006
Candidatus_Liberibacter_africanus	34020	S	21	4	25	0.00000
Candidatus_Liberibacter_asiaticus	34021	S	18	3	21	0.00000
Liberibacter_crescens	1273132	S	16	41	57	0.00000
Candidatus_Liberibacter_americanus	309868	S	11	1	12	0.00000
Candidatus_Liberibacter_solanacearum	556287	S	11	1	12	0.00000
Methylobacterium_nodulans	114616	S	8257	1077	9334	0.00076
Methylobacterium_sp._17Sr1-1	2202826	S	3272	1632	4904	0.00040
Methylobacterium_sp._WL1	2603276	S	3085	654	3739	0.00030
Methylobacterium_sp._C1	1479019	S	384	3105	3489	0.00028
Methylobacterium_sp._XJLW	739141	S	178	2485	2663	0.00022
Methylobacterium_aquaticum	270351	S	6487	3021	9508	0.00077
Methylobacterium_durans	2202825	S	4941	750	5691	0.00046
Methylobacterium_radiodurans	2202828	S	4452	1126	5578	0.00045
Methylobacterium_currus	2051553	S	4299	1913	6212	0.00050
Methylobacterium_organophilum	410	S	3698	2228	5926	0.00048
Methylobacterium_tardum	374432	S	3500	1306	4806	0.00039
Methylobacterium_terrae	2202827	S	3474	1688	5162	0.00042
Methylobacterium_mesophilicum	39956	S	3378	759	4137	0.00034
Methylobacterium_brachiatum	269660	S	3126	1215	4341	0.00035
Methylobacterium_indicum	1775910	S	3036	1596	4632	0.00038
Methylobacterium_oryzae	334852	S	2558	3440	5998	0.00049
Methylobacterium_radiotolerans	31998	S	1100	6461	7561	0.00061
Methylobacterium_phyllosphaerae	418223	S	430	1672	2102	0.00017
Microvirga_sp._VF16	2807101	S	17788	3059	20847	0.00169
Microvirga_sp._17_mud_1-3	2082949	S	10500	2413	12913	0.00105
Microvirga_ossetica	1882682	S	16920	3255	20175	0.00164
Microvirga_thermotolerans	2651334	S	10225	2970	13195	0.00107
Methylorubrum_populi	223967	S	5438	2592	8030	0.00065
Methylorubrum_extorquens	408	S	4055	6902	10957	0.00089
Methylorubrum_sp._B1-46	2897334	S	1982	897	2879	0.00023
Methylorubrum_zatmanii	29429	S	110	593	703	0.00006
Pseudolabrys_taiwanensis	331696	S	17186	3223	20409	0.00166
Pseudolabrys_sp._FHR47	2562284	S	11352	2302	13654	0.00111
Xanthobacter_dioxanivorans	2528964	S	4721	1799	6520	0.00053
Xanthobacter_sp._YC-JY1	2419844	S	1600	1709	3309	0.00027
Xanthobacter_autotrophicus	280	S	1408	1627	3035	0.00025
Starkeya_sp._ORNL1	2709380	S	5326	1173	6499	0.00053
Starkeya_novella	921	S	4339	1804	6143	0.00050
Ancylobacter_sp._TS-1	1850374	S	3364	1533	4897	0.00040
Ancylobacter_polymorphus	223390	S	3156	1754	4910	0.00040
Ancylobacter_pratisalsi	1745854	S	2724	676	3400	0.00028
Labrys_sp._KNU-23	2789216	S	3560	388	3948	0.00032
Azorhizobium_caulinodans	7	S	3415	780	4195	0.00034
Rhodoplanes_sp._Z2-YC6860	674703	S	31198	3333	34531	0.00280
Hyphomicrobium_denitrificans	53399	S	5289	689	5978	0.00049
Hyphomicrobium_nitrativorans	1427356	S	3827	356	4183	0.00034
Hyphomicrobium_sp._MC1	717785	S	2737	239	2976	0.00024
Methyloceanibacter_sp._wino2	2170729	S	2542	643	3185	0.00026
Methyloceanibacter_caenitepidi	1384459	S	2486	588	3074	0.00025
Methyloligella_sp._GL2	2742204	S	3826	496	4322	0.00035
Aquabacter_sp._L1I39	2820278	S	3004	546	3550	0.00029
Rhodomicrobium_vannielii	1069	S	2359	163	2522	0.00020
Caenibius_sp._WL	2872646	S	768	133	901	0.00007
Caenibius_tardaugens	169176	S	490	440	930	0.00008
Candidatus_Filomicrobium_marinum	1608628	S	1116	33	1149	0.00009
Bosea_sp._Tri-49	1867715	S	5285	1338	6623	0.00054
Bosea_sp._RAC05	1842539	S	4447	1583	6030	0.00049
Bosea_sp._F3-2	2599640	S	4150	1473	5623	0.00046
Bosea_sp._ANAM02	2020412	S	3729	1556	5285	0.00043
Bosea_sp._AS-1	2015316	S	3637	1281	4918	0.00040
Bosea_sp._PAMC_26642	1792307	S	3436	805	4241	0.00034
Bosea_vaviloviae	1526658	S	3991	1043	5034	0.00041
Devosia_sp._A16	1736675	S	5272	645	5917	0.00048
Devosia_sp._JXJ_CY_41	2917991	S	1545	276	1821	0.00015
Devosia_sp._SL43	2806348	S	1431	258	1689	0.00014
Devosia_sp._1566	2499144	S	1426	151	1577	0.00013
Devosia_sp._I507	2083786	S	1040	306	1346	0.00011
Devosia_sp._MC521	2759954	S	536	81	617	0.00005
Devosia_ginsengisoli	400770	S	1642	299	1941	0.00016
Devosia_salina	2860336	S	1576	517	2093	0.00017
Devosia_beringensis	2657486	S	1497	221	1718	0.00014
Devosia_oryziradicis	2801335	S	1345	247	1592	0.00013
Devosia_rhizoryzae	2774137	S	1194	128	1322	0.00011
Youhaiella_tibetensis	1447062	S	2450	575	3025	0.00025
Paradevosia_shaoguanensis	1335043	S	2323	946	3269	0.00027
Pelagibacterium_halotolerans	531813	S	1206	140	1346	0.00011
Maritalea_myrionectae	454601	S	272	7	279	0.00002
Aureimonas_sp._SA4125	2826993	S	3040	592	3632	0.00029
Aureimonas_sp._AU20	1349819	S	2872	440	3312	0.00027
Aureimonas_sp._OT7	2816454	S	1400	1288	2688	0.00022
Aureimonas_populi	1701758	S	2460	506	2966	0.00024
Aureimonas_mangrovi	2758041	S	2270	498	2768	0.00022
Aureimonas_altamirensis	370622	S	1329	489	1818	0.00015
Martelella_sp._AD-3	686597	S	747	2245	2992	0.00024
Martelella_mediterranea	293089	S	1486	585	2071	0.00017
Martelella_endophytica	1486262	S	1361	316	1677	0.00014
Martelella_lutilitoris	2583532	S	791	693	1484	0.00012
Aurantimonas_sp._HBX-1	2906072	S	3906	1234	5140	0.00042
Methylocystis_bryophila	655015	S	2240	238	2478	0.00020
Methylocystis_parvus	134	S	2202	272	2474	0.00020
Methylocystis_heyeri	391905	S	2135	244	2379	0.00019
Methylocystis_sp._SC2	187303	S	1372	372	1744	0.00014
Methylocystis_sp._SB2	743836	S	525	816	1341	0.00011
Methylocystis_rosea	173366	S	1436	1076	2512	0.00020
Methylosinus_trichosporium	426	S	2887	640	3527	0.00029
Methylosinus_sp._C49	2699395	S	2454	526	2980	0.00024
Pseudorhodoplanes_sinuspersici	1235591	S	8256	664	8920	0.00072
Nordella_sp._HKS_07	2712222	S	6741	405	7146	0.00058
Terrihabitans_soli	708113	S	2730	338	3068	0.00025
Candidatus_Hodgkinia_cicadicola	573658	S	34	0	34	0.00000
Chelatococcus_sp._CO-6	1702325	S	9376	5168	14544	0.00118
Chelatococcus_daeguensis	444444	S	3879	2009	5888	0.00048
Phreatobacter_stygius	1940610	S	5628	914	6542	0.00053
Phreatobacter_cathodiphilus	1868589	S	5140	1624	6764	0.00055
Phreatobacter_sp._NMCR1094	2570229	S	3596	731	4327	0.00035
Stappia_indica	538381	S	3895	998	4893	0.00040
Stappia_sp._ES.058	1881061	S	2009	268	2277	0.00018
Roseibium_aggregatum	187304	S	2148	332	2480	0.00020
Roseibium_alexandrii	388408	S	582	57	639	0.00005
Pannonibacter_phragmitetus	121719	S	2630	2070	4700	0.00038
Labrenzia_sp._VG12	2021862	S	1093	141	1234	0.00010
Labrenzia_sp._PHM005	2590016	S	502	42	544	0.00004
Labrenzia_sp._THAF82	2587861	S	454	30	484	0.00004
Pseudovibrio_sp._FO-BEG1	911045	S	190	79	269	0.00002
Pseudovibrio_brasiliensis	1898042	S	158	65	223	0.00002
Kaustia_mangrovi	2593653	S	5420	560	5980	0.00049
Parvibaculum_lavamentivorans	256618	S	2412	1858	4270	0.00035
Pyruvatibacter_mobilis	1712261	S	1518	201	1719	0.00014
Candidatus_Phaeomarinobacter_ectocarpi	1458461	S	580	29	609	0.00005
Blastochloris_tepida	2233851	S	4593	1677	6270	0.00051
Blastochloris_viridis	1079	S	3917	1133	5050	0.00041
Methylocella_silvestris	199596	S	2255	265	2520	0.00020
Methylocella_tundrae	227605	S	1935	191	2126	0.00017
Methylovirgula_ligni	569860	S	1919	236	2155	0.00017
Methylovirgula_sp._HY1	2822761	S	1441	84	1525	0.00012
Beijerinckia_indica	533	S	981	77	1058	0.00009
Acuticoccus_sp._I52.16.1	2928472	S	5217	572	5789	0.00047
Kaistia_sp._32K	2795690	S	5129	1352	6481	0.00053
Brucella_anthropi	529	S	923	598	1521	0.00012
Brucella_intermedia	94625	S	770	134	904	0.00007
Brucella_sp._BTU1	2840456	S	122	17	139	0.00001
Brucella_sp._09RB8910	1844051	S	57	46	103	0.00001
Brucella_sp._6810	2769351	S	48	60	108	0.00001
Brucella_sp._10RB9215	1149953	S	39	33	72	0.00001
Brucella_sp._09RB8471	1149952	S	30	42	72	0.00001
Brucella_sp._BO2	693750	S	29	53	82	0.00001
Brucella_sp._2280	2592625	S	25	40	65	0.00001
Brucella_sp._BO3	2691913	S	25	31	56	0.00000
Brucella_sp._458	2821140	S	20	33	53	0.00000
[Ochrobactrum]_quorumnocens	271865	S	310	46	356	0.00003
Brucella_pseudogrignonensis	419475	S	210	50	260	0.00002
Brucella_pituitosa	571256	S	103	27	130	0.00001
Brucella_melitensis	29459	S	49	499	548	0.00004
Brucella_inopinata	1218315	S	21	14	35	0.00000
Brucella_abortus	235	S	19	792	811	0.00007
Brucella_suis	29461	S	18	10778	10796	0.00088
Brucella_ovis	236	S	11	20	31	0.00000
Pseudochrobactrum_sp._XF203	2879116	S	87	93	180	0.00001
Pseudochrobactrum_sp._Wa41.01b-1	2864102	S	64	73	137	0.00001
Pseudochrobactrum_algeriensis	2834768	S	76	88	164	0.00001
Hartmannibacter_diazotrophicus	1482074	S	3057	594	3651	0.00030
Lichenihabitans_psoromatis	2528642	S	1023	588	1611	0.00013
Lichenihabitans_sp._PAMC28606	2880932	S	890	595	1485	0.00012
Breoghania_sp._L-A4	2304600	S	2949	414	3363	0.00027
Cohaesibacter_sp._ES.047	1798205	S	576	21	597	0.00005
Bartonella_apis	1686310	S	207	11	218	0.00002
Bartonella_sp._HY038	2759660	S	56	10	66	0.00001
Bartonella_sp._46A	2893471	S	12	16	28	0.00000
Bartonella_australis	388640	S	22	2	24	0.00000
Bartonella_quintana	803	S	18	8	26	0.00000
Bartonella_vinsonii	33047	S	18	8	26	0.00000
Bartonella_henselae	38323	S	17	4	21	0.00000
Bartonella_tribocorum	85701	S	14	34	48	0.00000
Bartonella_birtlesii	111504	S	14	4	18	0.00000
Bartonella_ancashensis	1318743	S	12	1	13	0.00000
Bartonella_bacilliformis	774	S	12	1	13	0.00000
Sphingomonas_sp._DM2-R-LB4	2899123	S	6127	2050	8177	0.00066
Sphingomonas_sp._S8-45	2938948	S	3840	435	4275	0.00035
Sphingomonas_sp._HDW15A	2714942	S	3136	222	3358	0.00027
Sphingomonas_sp._CL5.1	2653203	S	3134	1040	4174	0.00034
Sphingomonas_sp._AK-PDB1-5	2872652	S	3029	456	3485	0.00028
Sphingomonas_sp._MM-1	745310	S	2696	3218	5914	0.00048
Sphingomonas_sp._Cra20	1327635	S	2683	385	3068	0.00025
Sphingomonas_sp._AP4-R1	2735134	S	2466	291	2757	0.00022
Sphingomonas_sp._LM7	1938607	S	2412	481	2893	0.00023
Sphingomonas_sp._AAP5	1523415	S	2242	556	2798	0.00023
Sphingomonas_sp._NBWT7	2596913	S	2122	644	2766	0.00022
Sphingomonas_sp._FARSPH	2219696	S	2085	1478	3563	0.00029
Sphingomonas_sp._S2-65	2903960	S	2059	369	2428	0.00020
Sphingomonas_sp._PAMC26645	2565555	S	1729	523	2252	0.00018
Sphingomonas_sp._HMP9	1517554	S	1720	689	2409	0.00020
Sphingomonas_sp._KC8	1030157	S	1410	164	1574	0.00013
Sphingomonas_sp._HMP6	1517551	S	1274	229	1503	0.00012
Sphingomonas_sp._LK11	1390395	S	1036	977	2013	0.00016
Sphingomonas_sp._NIC1	1961362	S	890	2639	3529	0.00029
Sphingomonas_sp._IC081	304378	S	290	1695	1985	0.00016
Sphingomonas_lutea	1045317	S	10166	1216	11382	0.00092
Sphingomonas_sediminicola	386874	S	7748	684	8432	0.00068
Sphingomonas_daechungensis	1176646	S	7245	650	7895	0.00064
Sphingomonas_sabuli	2764186	S	6513	755	7268	0.00059
Sphingomonas_ginsengisoli_An_et_al._2013	363835	S	5811	749	6560	0.00053
Sphingomonas_sinipercae	2714944	S	5796	716	6512	0.00053
Sphingomonas_piscis	2714943	S	4087	346	4433	0.00036
Sphingomonas_rhizophila	2071607	S	3892	912	4804	0.00039
Sphingomonas_profundi	2681549	S	3628	540	4168	0.00034
Sphingomonas_alpina	653931	S	3463	269	3732	0.00030
Sphingomonas_sanxanigenens	397260	S	3291	1519	4810	0.00039
Sphingomonas_xanthus	2594473	S	2741	546	3287	0.00027
Sphingomonas_taxi	1549858	S	2451	708	3159	0.00026
Sphingomonas_hengshuiensis	1609977	S	2425	294	2719	0.00022
Sphingomonas_panacis	1560345	S	2353	321	2674	0.00022
Sphingomonas_changnyeongensis	2698679	S	2289	411	2700	0.00022
Sphingomonas_koreensis	93064	S	2220	1578	3798	0.00031
Sphingomonas_panacisoli	1813879	S	1988	252	2240	0.00018
Sphingomonas_radiodurans	2890321	S	1815	218	2033	0.00016
Sphingomonas_suaedae	2599297	S	1675	204	1879	0.00015
Sphingomonas_insulae	424800	S	1593	417	2010	0.00016
Sphingomonas_aliaeris	2759526	S	1492	169	1661	0.00013
Sphingomonas_paucimobilis	13689	S	1428	876	2304	0.00019
Sphingomonas_sanguinis	33051	S	1115	919	2034	0.00017
Sphingomonas_melonis	152682	S	1046	3805	4851	0.00039
Sphingomonas_lacunae	2698828	S	696	71	767	0.00006
Sphingomonas_paeninsulae	2319844	S	607	21	628	0.00005
Sphingobium_sp._SYK-6	627192	S	1890	469	2359	0.00019
Sphingobium_sp._EP60837	1855519	S	1477	382	1859	0.00015
Sphingobium_sp._Cam5-1	2789327	S	1284	423	1707	0.00014
Sphingobium_sp._TKS	1315974	S	1127	1568	2695	0.00022
Sphingobium_sp._YG1	2082188	S	1007	398	1405	0.00011
Sphingobium_sp._CAP-1	2676077	S	984	574	1558	0.00013
Sphingobium_sp._SCG-1	2072936	S	945	57	1002	0.00008
Sphingobium_sp._RAC03	1843368	S	861	145	1006	0.00008
Sphingobium_sp._KCTC_72723	2733867	S	798	121	919	0.00007
Sphingobium_sp._MI1205	407020	S	740	1008	1748	0.00014
Sphingobium_sp._PAMC28499	2565554	S	249	444	693	0.00006
Sphingobium_sp._YBL2	484429	S	144	883	1027	0.00008
Sphingobium_sp._RSMS	520734	S	112	618	730	0.00006
Sphingobium_sp._LF-16	2185111	S	23	345	368	0.00003
Sphingobium_yanoikuyae	13690	S	1737	3047	4784	0.00039
Sphingobium_indicum	332055	S	1282	918	2200	0.00018
Sphingobium_phenoxybenzoativorans	1592790	S	1118	483	1601	0.00013
Sphingobium_amiense	135719	S	1107	1392	2499	0.00020
Sphingobium_cloacae	120107	S	1023	1477	2500	0.00020
Sphingobium_chlorophenolicum	46429	S	955	423	1378	0.00011
Sphingobium_xenophagum	121428	S	885	535	1420	0.00012
Sphingobium_herbicidovorans	76947	S	801	660	1461	0.00012
Sphingobium_baderi	1332080	S	800	809	1609	0.00013
Sphingobium_fuliginis	336203	S	457	1736	2193	0.00018
Sphingopyxis_sp._FD7	1914525	S	1943	779	2722	0.00022
Sphingopyxis_sp._YF1	2482763	S	1678	372	2050	0.00017
Sphingopyxis_sp._QXT-31	1357916	S	1640	446	2086	0.00017
Sphingopyxis_sp._113P3	292913	S	1552	608	2160	0.00018
Sphingopyxis_sp._OPL5	2486273	S	1536	284	1820	0.00015
Sphingopyxis_sp._BSN-002	2911495	S	1481	258	1739	0.00014
Sphingopyxis_sp._PAMC25046	2565556	S	1397	624	2021	0.00016
Sphingopyxis_sp._EG6	1874061	S	1141	544	1685	0.00014
Sphingopyxis_sp._MG	1866325	S	98	868	966	0.00008
Sphingopyxis_macrogoltabida	33050	S	2712	1327	4039	0.00033
Sphingopyxis_terrae	33052	S	1590	813	2403	0.00020
Sphingopyxis_lindanitolerans	2054227	S	1428	640	2068	0.00017
Sphingopyxis_granuli	267128	S	1257	3308	4565	0.00037
Sphingopyxis_fribergensis	1515612	S	1224	471	1695	0.00014
Sphingopyxis_alaskensis	117207	S	1152	251	1403	0.00011
Novosphingobium_sp._Gsoil_351	2675225	S	2061	154	2215	0.00018
Novosphingobium_sp._Sx8-5	2896849	S	2005	264	2269	0.00018
Novosphingobium_sp._EMRT-2	2571749	S	1700	938	2638	0.00021
Novosphingobium_sp._P6W	1609758	S	1376	187	1563	0.00013
Novosphingobium_sp._ES2-1	2780074	S	1075	509	1584	0.00013
Novosphingobium_sp._THN1	1016987	S	1069	357	1426	0.00012
Novosphingobium_sp._PP1Y	702113	S	671	789	1460	0.00012
Novosphingobium_sp._KA1	164608	S	410	1946	2356	0.00019
Novosphingobium_resinovorum	158500	S	1763	851	2614	0.00021
Novosphingobium_decolorationis	2698673	S	1699	866	2565	0.00021
Novosphingobium_aromaticivorans	48935	S	1465	614	2079	0.00017
Novosphingobium_ginsenosidimutans	1176536	S	1018	95	1113	0.00009
Novosphingobium_pentaromativorans	205844	S	581	1021	1602	0.00013
Rhizorhabdus_wittichii	160791	S	4114	2392	6506	0.00053
Rhizorhabdus_dicambivorans	1850238	S	2408	1996	4404	0.00036
Rhizorhabdus_phycosphaerae	2711156	S	1877	219	2096	0.00017
Sphingosinithalassobacter_sp._CS137	2762748	S	2075	412	2487	0.00020
Sphingosinithalassobacter_tenebrarum	2711215	S	1462	456	1918	0.00016
Allosphingosinicella_indica	941907	S	3340	385	3725	0.00030
Parasphingopyxis_algicola	2026624	S	1806	114	1920	0.00016
Parasphingopyxis_sp._CP4	2724527	S	477	19	496	0.00004
Sphingorhabdus_sp._YGSMI21	2077182	S	600	89	689	0.00006
Sphingorhabdus_sp._SMR4y	2584094	S	488	72	560	0.00005
Sphingorhabdus_sp._M41	1806885	S	424	45	469	0.00004
Sphingorhabdus_lacus	392610	S	362	12	374	0.00003
Sphingorhabdus_lutea	1913578	S	65	3	68	0.00001
Blastomonas_sp._RAC04	1842535	S	420	598	1018	0.00008
Blastomonas_fulva	1550728	S	382	716	1098	0.00009
Hankyongella_ginsenosidimutans	1763828	S	1727	331	2058	0.00017
Tardibacter_chloracetimidivorans	1921510	S	1401	1077	2478	0.00020
Citromicrobium_sp._JL477	1634516	S	1096	500	1596	0.00013
Novosphingopyxis_iocasae	2762729	S	1004	552	1556	0.00013
Parasphingorhabdus_halotolerans	2725558	S	227	7	234	0.00002
Parasphingorhabdus_sp._JHSY0214	2806553	S	208	12	220	0.00002
Parasphingorhabdus_litoris	394733	S	142	9	151	0.00001
Aquisediminimonas_profunda	1550733	S	519	16	535	0.00004
Erythrobacter_sp._HL-111	1798193	S	1501	262	1763	0.00014
Erythrobacter_sp._JK5	2829500	S	1019	284	1303	0.00011
Erythrobacter_sp._HKB08	2502843	S	1018	204	1222	0.00010
Erythrobacter_sp._SDW2	2907154	S	866	208	1074	0.00009
Erythrobacter_sp._THAF29	2587851	S	676	145	821	0.00007
Erythrobacter_sp._A30-3	2785907	S	522	386	908	0.00007
Erythrobacter_sp._LQ02-29	2920384	S	520	554	1074	0.00009
Erythrobacter_sp._3-20A1M	2653850	S	506	761	1267	0.00010
Erythrobacter_sp._KY5	2011159	S	477	32	509	0.00004
Erythrobacter_sp._SCSIO_43205	2779361	S	263	47	310	0.00003
Erythrobacter_litoralis	39960	S	1884	742	2626	0.00021
Erythrobacter_neustonensis	1112	S	872	174	1046	0.00008
Erythrobacter_mangrovi	2739433	S	762	253	1015	0.00008
Erythrobacter_aureus	2182384	S	601	93	694	0.00006
Porphyrobacter_sp._CACIAM_03H1	2003315	S	1711	461	2172	0.00018
Porphyrobacter_sp._HT-58-2	2023229	S	1386	298	1684	0.00014
Porphyrobacter_sp._LM_6	1896196	S	951	320	1271	0.00010
Porphyrobacter_sp._GA68	2883480	S	737	277	1014	0.00008
Qipengyuania_flava	192812	S	2062	1097	3159	0.00026
Qipengyuania_sediminis	1532023	S	1218	147	1365	0.00011
Qipengyuania_soli	2782568	S	844	138	982	0.00008
Qipengyuania_aurantiaca	2867233	S	732	217	949	0.00008
Qipengyuania_gelatinilytica	2867231	S	609	106	715	0.00006
Qipengyuania_seohaensis	266951	S	538	107	645	0.00005
Qipengyuania_xiapuensis	2867236	S	380	366	746	0.00006
Qipengyuania_aquimaris	255984	S	375	365	740	0.00006
Qipengyuania_psychrotolerans	2867238	S	369	38	407	0.00003
Altererythrobacter_sp._B11	2060312	S	1625	720	2345	0.00019
Altererythrobacter_sp._TH136	2067415	S	1210	207	1417	0.00012
Altererythrobacter_sp._BO-6	2604537	S	740	102	842	0.00007
Altererythrobacter_sp._ZODW24	2185142	S	317	12	329	0.00003
Altererythrobacter_epoxidivorans	361183	S	572	151	723	0.00006
Altererythrobacter_ishigakiensis	476157	S	229	14	243	0.00002
Tsuneonella_amylolytica	2338327	S	1498	399	1897	0.00015
Tsuneonella_dongtanensis	692370	S	1456	256	1712	0.00014
Tsuneonella_mangrovi	1982042	S	1054	143	1197	0.00010
Tsuneonella_flava	2055955	S	448	124	572	0.00005
Croceicoccus_sp._YJ47	2798724	S	980	508	1488	0.00012
Croceicoccus_sp._Ery5	1703340	S	340	366	706	0.00006
Croceicoccus_sp._Ery15	1703338	S	268	420	688	0.00006
Croceicoccus_marinus	450378	S	1741	869	2610	0.00021
Croceicoccus_naphthovorans	1348774	S	745	884	1629	0.00013
Aurantiacibacter_gangjinensis	502682	S	655	53	708	0.00006
Aurantiacibacter_atlanticus	1648404	S	310	95	405	0.00003
Pelagerythrobacter_marensis	543877	S	884	110	994	0.00008
Paraurantiacibacter_namhicola	645517	S	794	94	888	0.00007
Croceibacterium_atlanticum	1267766	S	633	247	880	0.00007
Sphingosinicella_sp._BN140058	1892855	S	3887	322	4209	0.00034
Sphingosinicella_microcystinivorans	335406	S	2146	269	2415	0.00020
Sphingosinicella_flava	2771430	S	1621	225	1846	0.00015
Polymorphobacter_sp._PAMC_29362	2835787	S	1234	810	2044	0.00017
Polymorphobacter_sp._PAMC_29334	2862331	S	1107	749	1856	0.00015
Sandaracinobacter_sp._M6	2759707	S	1582	102	1684	0.00014
Zymomonas_mobilis	542	S	144	73	217	0.00002
Roseomonas_sp._OT10	2897332	S	8870	2221	11091	0.00090
Roseomonas_sp._S08	1750527	S	8177	473	8650	0.00070
Roseomonas_sp._FDAARGOS_362	2018065	S	511	2795	3306	0.00027
Roseomonas_gilardii	257708	S	6122	2733	8855	0.00072
Roseomonas_marmotae	2768161	S	5471	536	6007	0.00049
Roseomonas_haemaphysalidis	2768162	S	5152	519	5671	0.00046
Roseomonas_mucosa	207340	S	445	2843	3288	0.00027
Rhodovastum_atsumiense	504468	S	6788	605	7393	0.00060
Roseococcus_microcysteis	2771361	S	5569	475	6044	0.00049
Komagataeibacter_xylinus	28448	S	1132	2220	3352	0.00027
Komagataeibacter_saccharivorans	265959	S	480	182	662	0.00005
Komagataeibacter_nataicola	265960	S	366	181	547	0.00004
Komagataeibacter_oboediens	65958	S	291	138	429	0.00003
Komagataeibacter_europaeus	33995	S	268	145	413	0.00003
Komagataeibacter_medellinensis	1177712	S	239	215	454	0.00004
Komagataeibacter_rhaeticus	215221	S	13	253	266	0.00002
Acidiphilium_multivorum	62140	S	832	3760	4592	0.00037
Acidiphilium_cryptum	524	S	191	1375	1566	0.00013
Sediminicoccus_rosea	1225128	S	4045	191	4236	0.00034
Acidibrevibacterium_fodinaquatile	1969806	S	2917	265	3182	0.00026
Lichenicola_cladoniae	1484109	S	2637	111	2748	0.00022
Acetobacter_aceti	435	S	935	372	1307	0.00011
Acetobacter_persici	1076596	S	235	33	268	0.00002
Acetobacter_sp._KACC_21233	2592655	S	224	47	271	0.00002
Acetobacter_ghanensis	431306	S	155	40	195	0.00002
Acetobacter_pasteurianus	438	S	72	188	260	0.00002
Acetobacter_ascendens	481146	S	66	98	164	0.00001
Acetobacter_senegalensis	446692	S	60	112	172	0.00001
Acetobacter_orientalis	146474	S	57	7	64	0.00001
Acetobacter_tropicalis	104102	S	53	96	149	0.00001
Acetobacter_oryzoeni	2500548	S	16	49	65	0.00001
Gluconacetobacter_diazotrophicus	33996	S	1789	379	2168	0.00018
Gluconobacter_oxydans	442	S	633	623	1256	0.00010
Gluconobacter_albidus	318683	S	265	43	308	0.00003
Gluconobacter_sphaericus	574987	S	188	42	230	0.00002
Gluconobacter_frateurii	38308	S	129	32	161	0.00001
Gluconobacter_thailandicus	257438	S	56	37	93	0.00001
Granulibacter_bethesdensis	364410	S	1228	94	1322	0.00011
Asaia_bogorensis	91915	S	701	103	804	0.00007
Neoasaia_chiangmaiensis	320497	S	666	139	805	0.00007
Kozakia_baliensis	153496	S	495	184	679	0.00006
Novacetimonas_hansenii	436	S	456	245	701	0.00006
Oecophyllibacter_saccharovorans	2558360	S	341	9	350	0.00003
Parasaccharibacter_apium	1510841	S	30	131	161	0.00001
Parasaccharibacter_sp._TMW_2.1888	2268025	S	13	58	71	0.00001
Swingsia_sp._F3b2	2558361	S	156	3	159	0.00001
Swingsia_samuiensis	1293412	S	40	5	45	0.00000
Neokomagataea_tanensis	661191	S	72	10	82	0.00001
Entomobacter_blattae	2762277	S	48	2	50	0.00000
Bombella_sp._KACC_21507	2697033	S	21	1	22	0.00000
Azospirillum_sp._B510	137722	S	2435	898	3333	0.00027
Azospirillum_sp._TSA2s	709810	S	2087	1586	3673	0.00030
Azospirillum_sp._TSH100	652764	S	2014	911	2925	0.00024
Azospirillum_sp._TSH58	664962	S	1585	2096	3681	0.00030
Azospirillum_brasilense	192	S	8275	7183	15458	0.00125
Azospirillum_thermophilum	2202148	S	6090	1314	7404	0.00060
Azospirillum_thiophilum	528244	S	3090	985	4075	0.00033
Azospirillum_ramasamyi	682998	S	1918	1082	3000	0.00024
Azospirillum_lipoferum	193	S	1572	1154	2726	0.00022
Azospirillum_humicireducens	1226968	S	1519	889	2408	0.00020
Azospirillum_oryzae	286727	S	1489	1283	2772	0.00022
Azospirillum_baldaniorum	1064539	S	937	1899	2836	0.00023
Skermanella_mucosa	1789672	S	2767	2060	4827	0.00039
Skermanella_sp._TT6	2775420	S	2597	2893	5490	0.00045
Skermanella_rosea	1817965	S	2500	2458	4958	0.00040
Skermanella_pratensis	2233999	S	2309	1354	3663	0.00030
Nitrospirillum_amazonense	28077	S	3534	388	3922	0.00032
Indioceanicola_profundi	2220096	S	2983	382	3365	0.00027
Niveispirillum_cyanobacteriorum	1612173	S	1275	137	1412	0.00011
Hypericibacter_adhaerens	2602016	S	10097	1836	11933	0.00097
Hypericibacter_terrae	2602015	S	7397	1051	8448	0.00069
Magnetospirillum_sp._XM-1	1663591	S	1720	589	2309	0.00019
Magnetospirillum_sp._ME-1	1639348	S	1581	589	2170	0.00018
Magnetospirillum_gryphiswaldense	55518	S	1979	152871	154850	0.01257
Magnetospirillum_magneticum	84159	S	1725	166	1891	0.00015
Rhodospirillum_centenum	34018	S	3953	515	4468	0.00036
Rhodospirillum_rubrum	1085	S	1897	126	2023	0.00016
Tistrella_mobilis	171437	S	3768	1783	5551	0.00045
Ferrovibrio_terrae	2594003	S	3309	210	3519	0.00029
Defluviicoccus_vanus	111831	S	2050	178	2228	0.00018
Pararhodospirillum_photometricum	1084	S	1187	75	1262	0.00010
Haematospirillum_jordaniae	1549855	S	177	11	188	0.00002
Candidatus_Endolissoclinum_faulkneri	1263979	S	86	0	86	0.00001
Stella_humosa	94	S	9063	617	9680	0.00079
Elioraea_tepida	2843330	S	4490	196	4686	0.00038
Thalassospira_sp._A40-3	2785908	S	215	76	291	0.00002
Thalassospira_sp._B30-1	2785911	S	129	177	306	0.00002
Thalassospira_marina	2048283	S	305	15	320	0.00003
Thalassospira_indica	1891279	S	217	117	334	0.00003
Thalassospira_xiamenensis	220697	S	122	157	279	0.00002
Magnetospira_sp._QH-2	1288970	S	756	20	776	0.00006
Terasakiella_sp._SH-1	2560057	S	87	1	88	0.00001
Paracoccus_sp._MC1862	2760307	S	1320	146	1466	0.00012
Paracoccus_sp._MA	2895796	S	1062	586	1648	0.00013
Paracoccus_sp._AK26	2589076	S	910	168	1078	0.00009
Paracoccus_sp._H4-D09	2812658	S	663	145	808	0.00007
Paracoccus_sp._S8-55	2903900	S	565	84	649	0.00005
Paracoccus_sp._Arc7-R13	2500532	S	400	417	817	0.00007
Paracoccus_sanguinis	1545044	S	2098	563	2661	0.00022
Paracoccus_yeei	147645	S	1416	2305	3721	0.00030
Paracoccus_liaowanqingii	2560053	S	1357	156	1513	0.00012
Paracoccus_denitrificans	266	S	1246	601	1847	0.00015
Paracoccus_zhejiangensis	1077935	S	1228	317	1545	0.00013
Paracoccus_pantotrophus	82367	S	1177	659	1836	0.00015
Paracoccus_suum	2259340	S	1119	217	1336	0.00011
Paracoccus_aminovorans	34004	S	1111	334	1445	0.00012
Paracoccus_jeotgali	2065379	S	1083	215	1298	0.00011
Paracoccus_contaminans	1945662	S	1080	253	1333	0.00011
Paracoccus_aminophilus	34003	S	900	90	990	0.00008
Paracoccus_kondratievae	135740	S	502	102	604	0.00005
Paracoccus_tegillarcae	1529068	S	486	29	515	0.00004
Paracoccus_marcusii	59779	S	422	387	809	0.00007
Paracoccus_mutanolyticus	1499308	S	180	608	788	0.00006
Cereibacter_sphaeroides	1063	S	4346	1796	6142	0.00050
Cereibacter_azotoformans	43057	S	431	1574	2005	0.00016
Rhodobacter_sp._CZR27	2033869	S	1691	556	2247	0.00018
Rhodobacter_sp._N10	2807096	S	1468	185	1653	0.00013
Rhodobacter_sp._LPB0142	1850250	S	1330	896	2226	0.00018
Rhodobacter_capsulatus	1061	S	1744	357	2101	0.00017
Rhodovulum_sp._P5	1564506	S	871	97	968	0.00008
Rhodovulum_sp._MB263	308754	S	802	301	1103	0.00009
Rhodovulum_sulfidophilum	35806	S	1314	794	2108	0.00017
Polymorphum_gilvum	991904	S	3139	832	3971	0.00032
Paroceanicella_profunda	2579971	S	2991	805	3796	0.00031
Pikeienuella_piscinae	2748098	S	2171	224	2395	0.00019
Thioclava_electrotropha	1549850	S	878	241	1119	0.00009
Thioclava_nitratireducens	1915078	S	786	291	1077	0.00009
Pontivivens_ytuae	2789856	S	1884	140	2024	0.00016
Silicimonas_algicola	1826607	S	1727	107	1834	0.00015
Pelagovum_pacificum	2588711	S	1691	221	1912	0.00016
Frigidibacter_mobilis	1335048	S	1320	602	1922	0.00016
Pukyongiella_litopenaei	2605946	S	1204	304	1508	0.00012
Brevirhabdus_pacifica	1267768	S	1181	579	1760	0.00014
Gymnodinialimonas_ceratoperidinii	2856823	S	964	94	1058	0.00009
Fuscovulum_blasticum	1075	S	954	126	1080	0.00009
Haematobacter_massiliensis	195105	S	922	405	1327	0.00011
Falsirhodobacter_sp._PG104	2692330	S	913	131	1044	0.00008
Gemmobacter_aquarius	2169400	S	831	162	993	0.00008
Pseudopuniceibacterium_antarcticum	2613965	S	765	62	827	0.00007
Tabrizicola_piscis	2494374	S	746	70	816	0.00007
Pacificitalea_manganoxidans	1411902	S	734	169	903	0.00007
Pseudooceanicola_algae	1537215	S	674	67	741	0.00006
Monaibacterium_sp._h42	2758038	S	656	158	814	0.00007
Roseicitreum_antarcticum	564137	S	633	33	666	0.00005
Tritonibacter_mobilis	379347	S	465	220	685	0.00006
Yoonia_vestfoldensis	245188	S	409	96	505	0.00004
Pseudohalocynthiibacter_aestuariivivens	1591409	S	398	84	482	0.00004
Qingshengfaniella_alkalisoli	2599296	S	389	21	410	0.00003
Rhodophyticola_sp._CCM32	2916397	S	363	11	374	0.00003
Rhodobaca_barguzinensis	441209	S	311	13	324	0.00003
Profundibacter_amoris	2171755	S	283	9	292	0.00002
Parasedimentitalea_marina	2483033	S	253	11	264	0.00002
Pseudorhodobacter_turbinis	2500533	S	233	14	247	0.00002
Aestuarium_zhoushanense	2820523	S	219	93	312	0.00003
Cognatishimia_activa	1715691	S	217	9	226	0.00002
Planktomarina_temperata	1284658	S	116	3	119	0.00001
Roseovarius_sp._SCSIO_43702	2823043	S	1321	105	1426	0.00012
Roseovarius_sp._THAF9	2587847	S	700	174	874	0.00007
Roseovarius_sp._THAF8	2587846	S	276	457	733	0.00006
Roseovarius_sp._THAF27	2587850	S	248	439	687	0.00006
Roseovarius_sp._TM1035	391613	S	107	215	322	0.00003
Roseovarius_indicus	540747	S	1645	528	2173	0.00018
Roseovarius_faecimaris	2494550	S	633	27	660	0.00005
Roseovarius_mucosus	215743	S	132	268	400	0.00003
Sulfitobacter_sp._JK7-1	2829501	S	672	36	708	0.00006
Sulfitobacter_sp._THAF37	2587855	S	669	285	954	0.00008
Sulfitobacter_sp._D7	1968541	S	332	124	456	0.00004
Sulfitobacter_sp._SK011	1389004	S	302	7	309	0.00003
Sulfitobacter_sp._JL08	2070369	S	302	6	308	0.00003
Sulfitobacter_sp._DSM_110093	2883127	S	195	56	251	0.00002
Sulfitobacter_sp._BSw21498	664426	S	192	29	221	0.00002
Sulfitobacter_sp._SK012	1389005	S	163	3	166	0.00001
Sulfitobacter_sp._SK025	1389011	S	70	143	213	0.00002
Sulfitobacter_sp._CB2047	1525218	S	61	167	228	0.00002
Sulfitobacter_sp._B30-2	2785912	S	55	116	171	0.00001
Sulfitobacter_alexandrii	1917485	S	985	504	1489	0.00012
Sulfitobacter_mediterraneus	83219	S	539	55	594	0.00005
Sulfitobacter_indolifex	225422	S	324	72	396	0.00003
Sulfitobacter_dubius	218673	S	237	104	341	0.00003
Sulfitobacter_pontiacus	60137	S	118	262	380	0.00003
Salipiger_profundus	1229727	S	1973	891	2864	0.00023
Salipiger_abyssi	1250539	S	1437	599	2036	0.00017
Salipiger_sp._CCB-MM3	1792508	S	1244	177	1421	0.00012
Roseivivax_sp._THAF30	2587852	S	980	209	1189	0.00010
Roseivivax_sp._THAF40	2587858	S	31	626	657	0.00005
Roseivivax_sp._THAF197b	2588299	S	24	374	398	0.00003
Roseivivax_marinus	1379903	S	1933	313	2246	0.00018
Celeribacter_indicus	1208324	S	1626	811	2437	0.00020
Celeribacter_ethanolicus	1758178	S	572	198	770	0.00006
Celeribacter_baekdonensis	875171	S	286	77	363	0.00003
Celeribacter_marinus	1397108	S	197	6	203	0.00002
Phaeobacter_gallaeciensis	60890	S	675	297	972	0.00008
Phaeobacter_inhibens	221822	S	540	217	757	0.00006
Phaeobacter_piscinae	1580596	S	222	191	413	0.00003
Phaeobacter_porticola	1844006	S	161	54	215	0.00002
Phaeobacter_sp._LSS9	681157	S	52	87	139	0.00001
Ruegeria_sp._TM1040	292414	S	330	55	385	0.00003
Ruegeria_sp._THAF33	2587853	S	245	69	314	0.00003
Ruegeria_sp._SCSIO_43209	2793010	S	234	47	281	0.00002
Ruegeria_sp._AD91A	2293862	S	214	26	240	0.00002
Ruegeria_pomeroyi	89184	S	864	150	1014	0.00008
Leisingera_aquaemixtae	1396826	S	802	157	959	0.00008
Leisingera_sp._NJS204	2508307	S	125	219	344	0.00003
Leisingera_sp._NJS201	2508306	S	124	206	330	0.00003
Leisingera_methylohalidivorans	133924	S	457	114	571	0.00005
Yangia_pacifica	311180	S	1722	286	2008	0.00016
Sagittula_sp._P11	2009329	S	1620	678	2298	0.00019
Sulfitobacter_pseudonitzschiae	1402135	S	1017	363	1380	0.00011
Pseudosulfitobacter_sp._DSM_107133	2883100	S	381	156	537	0.00004
Ponticoccus_alexandrii	1943633	S	1248	190	1438	0.00012
Dinoroseobacter_shibae	215813	S	1106	404	1510	0.00012
Mameliella_alba	561184	S	1086	203	1289	0.00010
Roseobacter_ponti	1891787	S	391	9	400	0.00003
Roseobacter_denitrificans	2434	S	297	47	344	0.00003
Roseobacter_litoralis	42443	S	223	25	248	0.00002
Ketogulonicigenium_robustum	92947	S	457	49	506	0.00004
Ketogulonicigenium_vulgare	92945	S	442	134	576	0.00005
Roseibacterium_elongatum	159346	S	909	76	985	0.00008
Octadecabacter_sp._SW4	2602067	S	338	50	388	0.00003
Octadecabacter_arcticus	53946	S	208	16	224	0.00002
Octadecabacter_antarcticus	1217908	S	192	12	204	0.00002
Octadecabacter_temperatus	1458307	S	124	2	126	0.00001
Actibacterium_sp._EMB200-NS6	1609966	S	857	425	1282	0.00010
Oceanicola_sp._D3	2587163	S	838	43	881	0.00007
Tateyamaria_omphalii	299262	S	619	20	639	0.00005
Maribius_sp._THAF1	2587842	S	582	29	611	0.00005
Jannaschia_sp._CCS1	290400	S	549	14	563	0.00005
Thalassococcus_sp._S3	2017482	S	546	14	560	0.00005
Antarctobacter_heliothermus	74033	S	513	26	539	0.00004
Thalassobius_gelatinovorus	53501	S	328	17	345	0.00003
Falsihalocynthiibacter_arcticus	1579316	S	141	4	145	0.00001
Caulobacter_sp._S6	2823693	S	4366	455	4821	0.00039
Caulobacter_sp._FWC26	69665	S	1459	657	2116	0.00017
Caulobacter_segnis	88688	S	4931	1611	6542	0.00053
Caulobacter_mirabilis	69666	S	3667	652	4319	0.00035
Caulobacter_vibrioides	155892	S	3059	1270	4329	0.00035
Caulobacter_flavus	1679497	S	2993	819	3812	0.00031
Caulobacter_rhizosphaerae	2010972	S	2591	754	3345	0.00027
Caulobacter_soli	2708539	S	2398	766	3164	0.00026
Caulobacter_henricii	69395	S	1239	208	1447	0.00012
Brevundimonas_sp._PAMC22021	2861285	S	1242	251	1493	0.00012
Brevundimonas_sp._LM2	1938605	S	1143	178	1321	0.00011
Brevundimonas_sp._M20	2591463	S	1131	163	1294	0.00011
Brevundimonas_sp._MF30-B	2561924	S	1092	162	1254	0.00010
Brevundimonas_sp._AJA228-03	2752515	S	897	110	1007	0.00008
Brevundimonas_sp._CS1	2813778	S	317	292	609	0.00005
Brevundimonas_sp._SGAir0440	2579977	S	309	277	586	0.00005
Brevundimonas_sp._DS20	1532555	S	272	634	906	0.00007
Brevundimonas_sp._Bb-A	2560058	S	265	506	771	0.00006
Brevundimonas_sp._GW460-12-10-14-LB2	1827469	S	254	416	670	0.00005
Brevundimonas_sp._'scallop'	2562582	S	204	337	541	0.00004
Brevundimonas_naejangsanensis	588932	S	2113	668	2781	0.00023
Brevundimonas_goettingensis	2774190	S	1315	189	1504	0.00012
Brevundimonas_albigilva	1312364	S	1310	708	2018	0.00016
Brevundimonas_subvibrioides	74313	S	1102	183	1285	0.00010
Brevundimonas_diminuta	293	S	867	1544	2411	0.00020
Brevundimonas_vitisensis	2800818	S	861	98	959	0.00008
Brevundimonas_mediterranea	74329	S	784	281	1065	0.00009
Brevundimonas_pondensis	2774189	S	771	226	997	0.00008
Brevundimonas_nasdae	172043	S	720	400	1120	0.00009
Brevundimonas_vancanneytii	1325724	S	254	922	1176	0.00010
Brevundimonas_vesicularis	41276	S	245	516	761	0.00006
Phenylobacterium_zucineum	284016	S	10033	1980	12013	0.00097
Phenylobacterium_parvum	2201350	S	2469	255	2724	0.00022
Terricaulis_silvestris	2686094	S	2550	88	2638	0.00021
Asticcacaulis_excentricus	78587	S	965	146	1111	0.00009
Asticcacaulis_sp._AND118	2840468	S	828	122	950	0.00008
Marinicauda_algicola	2029849	S	2200	384	2584	0.00021
Maricaulis_maris	74318	S	709	42	751	0.00006
Glycocaulis_alkaliphilus	1434191	S	690	35	725	0.00006
Hyphobacterium_sp._CCMP332	2749086	S	512	16	528	0.00004
Hyphomonas_sp._CACIAM_19H1	1873716	S	747	107	854	0.00007
Hyphomonas_sp._KY3	2016196	S	414	49	463	0.00004
Hyphomonas_sp._Mor2	1906738	S	402	7	409	0.00003
Hyphomonas_neptunium	81032	S	661	77	738	0.00006
Candidatus_Viadribacter_manganicus	1759059	S	1496	39	1535	0.00012
Hirschia_baltica	2724	S	37	0	37	0.00000
Aquisalinus_flavus	1526572	S	819	37	856	0.00007
Parvularcula_bermudensis	208216	S	351	45	396	0.00003
Anaplasma_ovis	142058	S	63	14	77	0.00001
Anaplasma_platys	949	S	25	5	30	0.00000
Anaplasma_phagocytophilum	948	S	22	6	28	0.00000
Anaplasma_marginale	770	S	18	17	35	0.00000
Anaplasma_centrale	769	S	10	13	23	0.00000
Wolbachia_pipientis	955	S	10	36	46	0.00000
Ehrlichia_ruminantium	779	S	21	10	31	0.00000
Rickettsia_tillamookensis	2761623	S	25	72	97	0.00001
Rickettsia_endosymbiont_of_Oedothorax_gibbosus	931099	S	12	13	25	0.00000
Orientia_tsutsugamushi	784	S	21	3	24	0.00000
Candidatus_Phycorickettsia_trachydisci	2115978	S	31	5	36	0.00000
Candidatus_Midichloria_mitochondrii	234827	S	36	8	44	0.00000
Candidatus_Fokinia_solitaria	1802984	S	16	0	16	0.00000
Rickettsiales_endosymbiont_of_Stachyamoeba_lipophora	2486578	S	16	4	20	0.00000
Candidatus_Deianiraea_vastatrix	2163644	S	11	0	11	0.00000
Luteithermobacter_gelatinilyticus	2582913	S	330	39	369	0.00003
Paremcibacter_congregatus	2043170	S	291	7	298	0.00002
Micavibrio_aeruginosavorus	349221	S	484	5	489	0.00004
Candidatus_Puniceispirillum_marinum	767892	S	82	2	84	0.00001
Candidatus_Hydrogenosomobacter_endosymbioticus	2558174	S	40	0	40	0.00000
endosymbiont_of_Acanthamoeba_sp._UWC8	86106	S	27	0	27	0.00000
Candidatus_Cytomitobacter_indipagum	2601575	S	16	6	22	0.00000
Candidatus_Gromoviella_agglomerans	2806609	S	24	0	24	0.00000
Candidatus_Nesciobacter_abundans	2601668	S	13	2	15	0.00000
Candidatus_Paracaedibacter_acanthamoebae	91604	S	65	4	69	0.00001
Candidatus_Nucleicultrix_amoebiphila	1509244	S	46	2	48	0.00000
Magnetococcus_marinus	1124597	S	172	3	175	0.00001
Candidatus_Pelagibacter_sp._IMCC9063	1002672	S	15	1	16	0.00000
Candidatus_Pelagibacter_sp._RS40	1977865	S	14	12	26	0.00000
Candidatus_Fonsibacter_ubiquis	1925548	S	29	1	30	0.00000
Kordiimonas_pumila	2161677	S	57	0	57	0.00000
Burkholderia_multivorans	87883	S	5133	2010	7143	0.00058
Burkholderia_ubonensis	101571	S	4786	2520	7306	0.00059
Burkholderia_cenocepacia	95486	S	3646	8032	11678	0.00095
Burkholderia_cepacia	292	S	3086	5827	8913	0.00072
Burkholderia_pyrrocinia	60550	S	1971	831	2802	0.00023
Burkholderia_ambifaria	152480	S	1661	1043	2704	0.00022
Burkholderia_contaminans	488447	S	1637	900	2537	0.00021
Burkholderia_stagnalis	1503054	S	1636	486	2122	0.00017
Burkholderia_dolosa	152500	S	1489	408	1897	0.00015
Burkholderia_anthina	179879	S	1431	1041	2472	0.00020
Burkholderia_stabilis	95485	S	1393	875	2268	0.00018
Burkholderia_lata	482957	S	1312	1039	2351	0.00019
Burkholderia_territorii	1503055	S	1182	450	1632	0.00013
Burkholderia_seminalis	488731	S	936	352	1288	0.00010
Burkholderia_vietnamiensis	60552	S	881	40618	41499	0.00337
Burkholderia_metallica	488729	S	726	284	1010	0.00008
Burkholderia_diffusa	488732	S	513	199	712	0.00006
Burkholderia_pseudomultivorans	1207504	S	448	419	867	0.00007
Burkholderia_latens	488446	S	251	456	707	0.00006
Burkholderia_aenigmatica	2015348	S	209	420	629	0.00005
Burkholderia_pseudomallei	28450	S	2229	34061	36290	0.00294
Burkholderia_mayonis	1385591	S	1661	303	1964	0.00016
Burkholderia_thailandensis	57975	S	1620	9038	10658	0.00086
Burkholderia_oklahomensis	342113	S	1088	594	1682	0.00014
Burkholderia_savannae	1637837	S	260	206	466	0.00004
Burkholderia_sp._MSMB617WGS	1637831	S	103	161	264	0.00002
Burkholderia_sp._MSMB1588	1636423	S	89	127	216	0.00002
Burkholderia_mallei	13373	S	70	661	731	0.00006
Burkholderia_sp._DHOD12	2571746	S	2560	256	2816	0.00023
Burkholderia_sp._Bp7605	1740163	S	1588	202	1790	0.00015
Burkholderia_sp._LA-2-3-30-S1-D2	1637862	S	586	238	824	0.00007
Burkholderia_sp._NRF60-BP8	1637853	S	560	214	774	0.00006
Burkholderia_sp._MSMB0856	1637869	S	478	209	687	0.00006
Burkholderia_sp._JP2-270	2217913	S	470	205	675	0.00005
Burkholderia_sp._PAMC_26561	1795043	S	362	296	658	0.00005
Burkholderia_sp._MS455	2811788	S	338	164	502	0.00004
Burkholderia_sp._PAMC_28687	1795874	S	249	312	561	0.00005
Burkholderia_sp._IDO3	1705310	S	216	217	433	0.00004
Burkholderia_sp._KBS0801	1179675	S	106	140	246	0.00002
Burkholderia_sp._LAS2	2813843	S	86	267	353	0.00003
Burkholderia_sp._MBR-1	2732364	S	62	183	245	0.00002
Burkholderia_sp._MS389	2811789	S	42	209	251	0.00002
Burkholderia_sp._KJ006	416344	S	35	155	190	0.00002
Burkholderia_sp._B21-007	2890407	S	16	420	436	0.00004
Burkholderia_sp._B21-005	2890406	S	14	435	449	0.00004
Burkholderia_gladioli	28095	S	6034	1808	7842	0.00064
Burkholderia_glumae	337	S	2269	9934	12203	0.00099
Burkholderia_plantarii	41899	S	1640	477	2117	0.00017
Burkholderia_perseverans	2615214	S	1327	414	1741	0.00014
Cupriavidus_taiwanensis	164546	S	13013	10410	23423	0.00190
Cupriavidus_pauculus	82633	S	7845	3183	11028	0.00089
Cupriavidus_oxalaticus	96344	S	3993	1684	5677	0.00046
Cupriavidus_sp._EM10	2839983	S	1789	1013	2802	0.00023
Cupriavidus_sp._MP-37	2884455	S	927	864	1791	0.00015
Cupriavidus_sp._ISTL7	2771360	S	326	1888	2214	0.00018
Cupriavidus_sp._KK10	1478019	S	293	780	1073	0.00009
Cupriavidus_sp._USMAA2-4	876364	S	235	1511	1746	0.00014
Cupriavidus_sp._USMAHM13	1389192	S	173	1081	1254	0.00010
Cupriavidus_necator	106590	S	3877	3214	7091	0.00058
Cupriavidus_basilensis	68895	S	3819	2096	5915	0.00048
Cupriavidus_campinensis	151783	S	3125	1025	4150	0.00034
Cupriavidus_metallidurans	119219	S	2448	14049	16497	0.00134
Cupriavidus_pinatubonensis	248026	S	2221	355	2576	0.00021
Cupriavidus_gilardii	82541	S	1161	5537	6698	0.00054
Cupriavidus_nantongensis	1796606	S	980	2554	3534	0.00029
Cupriavidus_neocaledonicus	1040979	S	716	796	1512	0.00012
Cupriavidus_malaysiensis	367825	S	195	1147	1342	0.00011
Paraburkholderia_sp._SOS3	1926494	S	2100	306	2406	0.00020
Paraburkholderia_sp._PGU16	2735433	S	964	566	1530	0.00012
Paraburkholderia_sp._PGU19	2735434	S	736	676	1412	0.00011
Paraburkholderia_pallida	2547399	S	2916	519	3435	0.00028
Paraburkholderia_aromaticivorans	2026199	S	2440	1116	3556	0.00029
Paraburkholderia_acidisoli	2571748	S	2382	423	2805	0.00023
Paraburkholderia_caribensis	75105	S	2159	1685	3844	0.00031
Paraburkholderia_tropica	92647	S	2127	467	2594	0.00021
Paraburkholderia_acidiphila	2571747	S	2069	394	2463	0.00020
Paraburkholderia_edwinii	2861782	S	1907	260	2167	0.00018
Paraburkholderia_phytofirmans	261302	S	1783	776	2559	0.00021
Paraburkholderia_terricola	169427	S	1698	497	2195	0.00018
Paraburkholderia_atlantica	2654982	S	1654	405	2059	0.00017
Paraburkholderia_sprentiae	948107	S	1558	341	1899	0.00015
Paraburkholderia_phymatum	148447	S	1539	402	1941	0.00016
Paraburkholderia_phenoliruptrix	252970	S	1512	448	1960	0.00016
Paraburkholderia_fungorum	134537	S	1438	346	1784	0.00014
Paraburkholderia_graminis	60548	S	1423	355	1778	0.00014
Paraburkholderia_megapolitana	420953	S	1352	125	1477	0.00012
Paraburkholderia_terrae	311230	S	1291	1581	2872	0.00023
Paraburkholderia_ginsengisoli	311231	S	1260	389	1649	0.00013
Paraburkholderia_caledonica	134536	S	1143	208	1351	0.00011
Paraburkholderia_dokdonella	2211211	S	1020	272	1292	0.00010
Paraburkholderia_xenovorans	36873	S	1002	1246	2248	0.00018
Paraburkholderia_caffeinilytica	1761016	S	1001	269	1270	0.00010
Paraburkholderia_hospita	169430	S	993	1201	2194	0.00018
Paraburkholderia_dioscoreae	2604047	S	676	480	1156	0.00009
Ralstonia_solanacearum	305	S	5019	10165	15184	0.00123
Ralstonia_insidiosa	190721	S	1435	1035	2470	0.00020
Ralstonia_mannitolilytica	105219	S	1248	1529	2777	0.00023
Ralstonia_pickettii	329	S	1171	548	1719	0.00014
Ralstonia_sp._56D2	2842456	S	960	147	1107	0.00009
Ralstonia_syzygii	28097	S	73	237	310	0.00003
Ralstonia_pseudosolanacearum	1310165	S	39	1088	1127	0.00009
Pandoraea_pnomenusa	93220	S	2087	969	3056	0.00025
Pandoraea_pulmonicola	93221	S	1763	396	2159	0.00018
Pandoraea_thiooxydans	445709	S	1695	133	1828	0.00015
Pandoraea_sp._XY-2	2518599	S	1189	602	1791	0.00015
Pandoraea_faecigallinarum	656179	S	1169	330	1499	0.00012
Pandoraea_norimbergensis	93219	S	1122	181	1303	0.00011
Pandoraea_vervacti	656178	S	1086	331	1417	0.00012
Pandoraea_fibrosis	1891094	S	945	331	1276	0.00010
Pandoraea_apista	93218	S	928	553	1481	0.00012
Pandoraea_oxalativorans	573737	S	898	452	1350	0.00011
Pandoraea_sputorum	93222	S	738	349	1087	0.00009
Caballeronia_sp._Lep1P3	2878150	S	1825	441	2266	0.00018
Caballeronia_sp._TF1N1	2878153	S	1398	161	1559	0.00013
Caballeronia_sp._SL2Y3	2878151	S	867	533	1400	0.00011
Caballeronia_sp._Sq4a	2878152	S	813	649	1462	0.00012
Caballeronia_sp._M1242	2814653	S	756	588	1344	0.00011
Caballeronia_sp._SBC2	2705547	S	69	667	736	0.00006
Caballeronia_sp._SBC1	2705548	S	55	743	798	0.00006
Caballeronia_zhejiangensis	871203	S	2144	516	2660	0.00022
Caballeronia_insecticola	758793	S	1883	406	2289	0.00019
Caballeronia_grimmiae	1071679	S	1628	814	2442	0.00020
Polynucleobacter_sp._MWH-UH24A	2689110	S	65	3	68	0.00001
Polynucleobacter_sp._AP-Nino-20-G2	2576917	S	35	8	43	0.00000
Polynucleobacter_sp._LimPoW16	1743162	S	34	1	35	0.00000
Polynucleobacter_sp._MWH-UH35A	1855619	S	33	5	38	0.00000
Polynucleobacter_sp._MWH-P3-07-1	1743173	S	31	4	35	0.00000
Polynucleobacter_sp._MWH-CaK5	2689107	S	31	1	32	0.00000
Polynucleobacter_sp._AP-Titi-500A-B4	2576923	S	30	6	36	0.00000
Polynucleobacter_sp._MWH-Braz-FAM2G	1855883	S	30	3	33	0.00000
Polynucleobacter_sp._AP-Ainpum-60-G11	2576926	S	29	7	36	0.00000
Polynucleobacter_sp._MWH-Svant-W18	1855909	S	29	5	34	0.00000
Polynucleobacter_sp._TSB-Sco08W16	1758374	S	28	4	32	0.00000
Polynucleobacter_sp._VK25	1758398	S	27	7	34	0.00000
Polynucleobacter_sp._MWH-Aus1W21	1855880	S	27	6	33	0.00000
Polynucleobacter_sp._MWH-UH2A	1855617	S	24	5	29	0.00000
Polynucleobacter_sp._MWH-UH21B	1743174	S	23	4	27	0.00000
Polynucleobacter_sp._AP-Sving-400A-A2	2081049	S	23	14	37	0.00000
Polynucleobacter_sp._MG-6-Vaara-E2	2576932	S	22	4	26	0.00000
Polynucleobacter_sp._AP-Jannik-300A-C4	2576928	S	21	25	46	0.00000
Polynucleobacter_sp._AP-Kolm-20A-A1	2081041	S	21	11	32	0.00000
Polynucleobacter_sp._MWH-S4W17	1855910	S	19	11	30	0.00000
Polynucleobacter_sp._MWH-Spelu-300-X4	2689109	S	19	1	20	0.00000
Polynucleobacter_sp._MG-Unter2-18	2081052	S	18	13	31	0.00000
Polynucleobacter_sp._es-MAR-2	1819725	S	18	4	22	0.00000
Polynucleobacter_sp._AP-Elch-400A-B2	2576930	S	18	9	27	0.00000
Polynucleobacter_sp._JS-Mosq-20-D10	2576922	S	17	7	24	0.00000
Polynucleobacter_sp._AP-Melu-1000-A1	2081042	S	17	8	25	0.00000
Polynucleobacter_sp._JS-JIR-II-50	2576919	S	16	8	24	0.00000
Polynucleobacter_sp._MWH-UH25E	1855616	S	15	3	18	0.00000
Polynucleobacter_sp._es-EL-1	1855652	S	15	2	17	0.00000
Polynucleobacter_sp._JS-JIR-II-b4	1758390	S	13	8	21	0.00000
Polynucleobacter_necessarius	576610	S	154	24	178	0.00001
Polynucleobacter_difficilis	556054	S	85	6	91	0.00001
Polynucleobacter_asymbioticus	576611	S	76	9	85	0.00001
Polynucleobacter_acidiphobus	556053	S	57	3	60	0.00000
Polynucleobacter_paneuropaeus	2527775	S	28	2	30	0.00000
Polynucleobacter_wuianus	1743168	S	23	6	29	0.00000
Polynucleobacter_duraquae	1835254	S	18	10	28	0.00000
Lautropia_mirabilis	47671	S	1323	240	1563	0.00013
Chitinimonas_arctica	2594795	S	1072	85	1157	0.00009
Mycetohabitans_rhizoxinica	412963	S	907	56	963	0.00008
Mycoavidus_sp._HKI	2840467	S	100	7	107	0.00001
Mycoavidus_sp._B2-EB	2651972	S	60	10	70	0.00001
Mycoavidus_cysteinexigens	1553431	S	65	7	72	0.00001
Candidatus_Vallotia_cooleyia	1177211	S	44	4	48	0.00000
Candidatus_Vallotia_sp._(ex_Adelges_kitamiensis)	2864217	S	40	13	53	0.00000
Candidatus_Vallotia_lariciata	2018052	S	34	11	45	0.00000
Candidatus_Vallotia_tarda	1177213	S	25	3	28	0.00000
Limnobacter_sp._SAORIC-580	2732163	S	151	6	157	0.00001
Ephemeroptericola_cinctiostellae	2268024	S	84	5	89	0.00001
Variovorax_sp._HW608	1034889	S	5841	1056	6897	0.00056
Variovorax_sp._PBS-H4	434008	S	3223	1806	5029	0.00041
Variovorax_sp._PBL-H6	434009	S	3011	2726	5737	0.00047
Variovorax_sp._WDL1	207745	S	2744	4392	7136	0.00058
Variovorax_sp._RA8	662548	S	2671	1941	4612	0.00037
Variovorax_sp._PAMC_28711	1795631	S	2501	450	2951	0.00024
Variovorax_sp._RKNM96	2681552	S	2281	931	3212	0.00026
Variovorax_sp._PAMC26660	2762322	S	1954	529	2483	0.00020
Variovorax_sp._PAMC28562	2762323	S	1914	172	2086	0.00017
Variovorax_sp._SRS16	282217	S	1483	3349	4832	0.00039
Variovorax_sp._38R	2774875	S	1453	1730	3183	0.00026
Variovorax_sp._PBL-E5	434014	S	1343	3519	4862	0.00039
Variovorax_sp._PDNC026	2811425	S	39	1548	1587	0.00013
Variovorax_sp._PMC12	2126319	S	23	1173	1196	0.00010
Variovorax_paradoxus	34073	S	11748	11231	22979	0.00186
Variovorax_boronicumulans	436515	S	1689	1323	3012	0.00024
Hydrogenophaga_sp._BA0156	2716225	S	3694	2685	6379	0.00052
Hydrogenophaga_sp._YM1	2806262	S	3336	1835	5171	0.00042
Hydrogenophaga_sp._PBC	795665	S	2808	3135	5943	0.00048
Hydrogenophaga_sp._BPS33	2651974	S	2748	1742	4490	0.00036
Hydrogenophaga_sp._SL48	2806347	S	2185	571	2756	0.00022
Hydrogenophaga_sp._PBL-H3	434010	S	1696	1503	3199	0.00026
Hydrogenophaga_sp._RAC07	1842537	S	1672	601	2273	0.00018
Hydrogenophaga_sp._PAMC20947	2565558	S	880	63	943	0.00008
Hydrogenophaga_sp._NH-16	2184519	S	825	1954	2779	0.00023
Hydrogenophaga_taeniospiralis	65656	S	1840	616	2456	0.00020
Hydrogenophaga_pseudoflava	47421	S	821	1555	2376	0.00019
Hydrogenophaga_crassostreae	1763535	S	792	53	845	0.00007
Acidovorax_sp._YS12	2738413	S	1760	1715	3475	0.00028
Acidovorax_sp._KKS102	358220	S	1409	1144	2553	0.00021
Acidovorax_sp._RAC01	1842533	S	1137	920	2057	0.00017
Acidovorax_sp._JMULE5	2518343	S	1029	314	1343	0.00011
Acidovorax_sp._HDW3	2714923	S	1028	813	1841	0.00015
Acidovorax_sp._1608163	2478662	S	846	195	1041	0.00008
Acidovorax_sp._T1	1858609	S	594	2244	2838	0.00023
Acidovorax_avenae	80867	S	3662	2639	6301	0.00051
Acidovorax_monticola	1926868	S	2107	927	3034	0.00025
Acidovorax_antarcticus	2743470	S	1831	1560	3391	0.00028
Acidovorax_carolinensis	553814	S	1203	1055	2258	0.00018
Acidovorax_citrulli	80869	S	972	1028	2000	0.00016
Acidovorax_cattleyae	80868	S	872	700	1572	0.00013
Acidovorax_radicis	758826	S	770	174	944	0.00008
Ramlibacter_tataouinensis	94132	S	13998	5859	19857	0.00161
Comamonas_sp._NLF-7-7	2597701	S	1349	1130	2479	0.00020
Comamonas_sp._NLF-1-9	2853163	S	1178	701	1879	0.00015
Comamonas_sp._B21-038	2918299	S	674	179	853	0.00007
Comamonas_sp._Y33R10-2	2853257	S	222	42	264	0.00002
Comamonas_serinivorans	1082851	S	1691	524	2215	0.00018
Comamonas_aquatica	225991	S	1519	1488	3007	0.00024
Comamonas_testosteroni	285	S	991	1473	2464	0.00020
Comamonas_koreensis	160825	S	641	348	989	0.00008
Comamonas_odontotermitis	379895	S	636	137	773	0.00006
Comamonas_piscis	1562974	S	548	115	663	0.00005
Comamonas_thiooxydans	363952	S	482	1110	1592	0.00013
Comamonas_kerstersii	225992	S	370	192	562	0.00005
Comamonas_fluminis	2796366	S	359	160	519	0.00004
Rhodoferax_sp._BAB1	2741720	S	1850	555	2405	0.00020
Rhodoferax_sp._AJA081-3	2752316	S	687	52	739	0.00006
Rhodoferax_sp._PAMC_29310	2822760	S	474	54	528	0.00004
Rhodoferax_sp._MIZ03	2798804	S	374	42	416	0.00003
Rhodoferax_koreense	1842727	S	2958	1658	4616	0.00037
Rhodoferax_sediminis	2509614	S	2355	394	2749	0.00022
Rhodoferax_ferrireducens	192843	S	940	67	1007	0.00008
Rhodoferax_saidenbachensis	1484693	S	686	81	767	0.00006
Rhodoferax_antarcticus	81479	S	426	33	459	0.00004
Rhodoferax_aquaticus	2527691	S	306	32	338	0.00003
Schlegelella_thermodepolymerans	215580	S	5302	2744	8046	0.00065
Schlegelella_brevitalea	413882	S	4307	663	4970	0.00040
Diaphorobacter_sp._HDW4A	2714924	S	1152	1041	2193	0.00018
Diaphorobacter_sp._HDW4B	2714925	S	1071	146	1217	0.00010
Diaphorobacter_sp._JS3051	2792224	S	127	2074	2201	0.00018
Diaphorobacter_sp._MNS-0	2866628	S	124	1099	1223	0.00010
Diaphorobacter_sp._JS3050	2735554	S	102	1130	1232	0.00010
Diaphorobacter_ruginosibacter	1715720	S	1413	279	1692	0.00014
Diaphorobacter_aerolatus	1288495	S	1069	1780	2849	0.00023
[Acidovorax]_ebreus	721785	S	231	1444	1675	0.00014
Diaphorobacter_nitroreducens	164759	S	148	418	566	0.00005
Delftia_tsuruhatensis	180282	S	1319	3666	4985	0.00040
Delftia_acidovorans	80866	S	1146	2030	3176	0.00026
Delftia_lacustris	558537	S	898	5011	5909	0.00048
Delftia_sp._Cs1-4	742013	S	156	340	496	0.00004
Delftia_sp._HK171	1920191	S	104	260	364	0.00003
Kinneretia_sp._DAIF2	2714952	S	4211	1651	5862	0.00048
Kinneretia_sp._XES5	2877940	S	1417	2022	3439	0.00028
Polaromonas_sp._JS666	296591	S	1795	1758	3553	0.00029
Polaromonas_naphthalenivorans	216465	S	1489	252	1741	0.00014
Polaromonas_vacuolata	37448	S	177	18	195	0.00002
Ottowia_sp._27C	2816950	S	1788	374	2162	0.00018
Ottowia_sp._oral_taxon_894	1658672	S	733	111	844	0.00007
Ottowia_oryzae	2109914	S	1407	330	1737	0.00014
Alicycliphilus_denitrificans	179636	S	3574	6272	9846	0.00080
Melaminivora_sp._SC2-9	2109913	S	1637	1889	3526	0.00029
Melaminivora_jejuensis	1267217	S	1329	1028	2357	0.00019
Serpentinimonas_maccroryi	1458426	S	1126	361	1487	0.00012
Serpentinimonas_raichei	1458425	S	1026	367	1393	0.00011
Verminephrobacter_eiseniae	364317	S	1655	218	1873	0.00015
Hylemonella_gracilis	80880	S	1468	228	1696	0.00014
Pulveribacter_suum	2116657	S	1406	798	2204	0.00018
Simplicispira_suum	2109915	S	1097	391	1488	0.00012
Limnohabitans_sp._63ED37-2	1678128	S	489	56	545	0.00004
Limnohabitans_sp._103DPR2	1678129	S	195	15	210	0.00002
Curvibacter_sp._AEP1-3	1844971	S	500	37	537	0.00004
Candidatus_Symbiobacter_mobilis	1436290	S	448	15	463	0.00004
Massilia_sp._WG5	1707785	S	5506	2430	7936	0.00064
Massilia_sp._LPB0304	2769491	S	3106	790	3896	0.00032
Massilia_sp._HC52	2852099	S	2707	766	3473	0.00028
Massilia_sp._DM-R-R2A-13	2899220	S	2353	530	2883	0.00023
Massilia_sp._YMA4	1593482	S	2130	1087	3217	0.00026
Massilia_sp._NP310	2861282	S	2120	1386	3506	0.00028
Massilia_sp._PAMC28688	2861283	S	1615	247	1862	0.00015
Massilia_sp._MB5	2919578	S	321	1170	1491	0.00012
Massilia_sp._NR_4-1	1678028	S	301	1060	1361	0.00011
Massilia_sp._Se16.2.3	2709303	S	42	1584	1626	0.00013
Massilia_sp._Dwa41.01b	2709302	S	38	1419	1457	0.00012
Massilia_putida	1141883	S	11969	3789	15758	0.00128
Massilia_violaceinigra	2045208	S	3727	1032	4759	0.00039
Massilia_flava	871742	S	3507	848	4355	0.00035
Massilia_lutea	321985	S	2287	686	2973	0.00024
Massilia_albidiflava	321983	S	2192	859	3051	0.00025
Massilia_umbonata	864828	S	2168	854	3022	0.00025
Massilia_plicata	321984	S	1986	519	2505	0.00020
Massilia_armeniaca	2072590	S	1958	1012	2970	0.00024
Massilia_oculi	945844	S	1801	1122	2923	0.00024
Massilia_antarctica	2765360	S	1625	591	2216	0.00018
Duganella_sp._GN2-R2	2728020	S	3462	1382	4844	0.00039
Duganella_sp._AF9R3	2728021	S	1666	346	2012	0.00016
Herbaspirillum_robiniae	2014887	S	1878	746	2624	0.00021
Herbaspirillum_seropedicae	964	S	1382	552	1934	0.00016
Herbaspirillum_hiltneri	341045	S	1364	251	1615	0.00013
Herbaspirillum_frisingense	92645	S	1312	453	1765	0.00014
Herbaspirillum_rubrisubalbicans	80842	S	1185	571	1756	0.00014
Herbaspirillum_huttiense	863372	S	922	398	1320	0.00011
Herbaspirillum_sp._meg3	2025949	S	730	89	819	0.00007
Janthinobacterium_sp._17J80-10	2497863	S	1227	188	1415	0.00011
Janthinobacterium_sp._1_2014MBL_MicDiv	1644131	S	1055	401	1456	0.00012
Janthinobacterium_sp._LM6	1938606	S	545	355	900	0.00007
Janthinobacterium_sp._PAMC25594	2861284	S	407	263	670	0.00005
Janthinobacterium_sp._Marseille	375286	S	372	102	474	0.00004
Janthinobacterium_sp._HH102	1537274	S	215	356	571	0.00005
Janthinobacterium_sp._B9-8	1236179	S	104	31	135	0.00001
Janthinobacterium_agaricidamnosum	55508	S	1533	2516	4049	0.00033
Janthinobacterium_tructae	2590869	S	391	208	599	0.00005
Janthinobacterium_lividum	29581	S	379	397	776	0.00006
Janthinobacterium_svalbardensis	368607	S	305	158	463	0.00004
Collimonas_fungivorans	158899	S	1529	442	1971	0.00016
Collimonas_arenae	279058	S	1229	164	1393	0.00011
Collimonas_pratensis	279113	S	1094	238	1332	0.00011
Noviherbaspirillum_sp._UKPF54	2601898	S	3681	651	4332	0.00035
Undibacterium_sp._KW1	2058624	S	183	73	256	0.00002
Undibacterium_sp._YM2	2058625	S	141	56	197	0.00002
Undibacterium_parvum	401471	S	183	23	206	0.00002
Glaciimonas_sp._PAMC28666	2807626	S	229	13	242	0.00002
Herminiimonas_arsenitoxidans	1809410	S	227	37	264	0.00002
Oxalobacter_formigenes	847	S	169	16	185	0.00002
Achromobacter_xylosoxidans	85698	S	5371	9871	15242	0.00124
Achromobacter_sp._AONIH1	1758194	S	1807	2633	4440	0.00036
Achromobacter_sp._MFA1_R4	1881016	S	1649	542	2191	0.00018
Achromobacter_sp._77	2756133	S	277	750	1027	0.00008
Achromobacter_sp._B7	2282475	S	213	542	755	0.00006
Achromobacter_sp._ES-001	2860286	S	210	744	954	0.00008
Achromobacter_spanius	217203	S	2814	1295	4109	0.00033
Achromobacter_denitrificans	32002	S	2782	2224	5006	0.00041
Achromobacter_deleyi	1353891	S	1936	1507	3443	0.00028
Achromobacter_insolitus	217204	S	1305	395	1700	0.00014
Achromobacter_pestifer	1353889	S	1036	756	1792	0.00015
Achromobacter_mucicolens	1389922	S	437	731	1168	0.00009
Achromobacter_ruhlandii	72557	S	21	1039	1060	0.00009
Bordetella_sp._H567	1697043	S	1995	256	2251	0.00018
Bordetella_sp._N	1746199	S	1734	220	1954	0.00016
Bordetella_bronchialis	463025	S	2919	428	3347	0.00027
Bordetella_genomosp._13	463040	S	2381	1941	4322	0.00035
Bordetella_genomosp._8	1416806	S	2183	284	2467	0.00020
Bordetella_genomosp._9	1416803	S	2128	612	2740	0.00022
Bordetella_flabilis	463014	S	2027	185	2212	0.00018
Bordetella_hinzii	103855	S	1725	855	2580	0.00021
Bordetella_petrii	94624	S	1684	2571	4255	0.00035
Bordetella_trematum	123899	S	1222	558	1780	0.00014
Bordetella_pseudohinzii	1331258	S	931	479	1410	0.00011
Bordetella_bronchiseptica	518	S	920	4412	5332	0.00043
Bordetella_holmesii	35814	S	592	170	762	0.00006
Bordetella_avium	521	S	582	107	689	0.00006
Bordetella_genomosp._6	463024	S	282	614	896	0.00007
Bordetella_pertussis	520	S	185	1719	1904	0.00015
Bordetella_parapertussis	519	S	111	1492	1603	0.00013
Pigmentiphaga_sp._H8	2488560	S	3570	495	4065	0.00033
Pigmentiphaga_aceris	1940612	S	928	67	995	0.00008
Castellaniella_defragrans	75697	S	2222	1716	3938	0.00032
Orrella_dioscoreae	1851544	S	1866	755	2621	0.00021
Orrella_marina	2163011	S	232	39	271	0.00002
Orrella_sp._f23	2782176	S	112	7	119	0.00001
Alcaligenes_faecalis	511	S	433	397	830	0.00007
Alcaligenes_sp._SORT26	2813780	S	116	23	139	0.00001
Alcaligenes_sp._DN25	1367435	S	37	89	126	0.00001
Alcaligenes_aquatilis	323284	S	75	283	358	0.00003
Pusillimonas_thiosulfatoxidans	2028345	S	486	113	599	0.00005
Pusillimonas_sp._T7-7	1007105	S	304	53	357	0.00003
Pusillimonas_sp._DMV24BSW_D	2716226	S	151	10	161	0.00001
Paralcaligenes_sp._KSB-10	2901142	S	616	26	642	0.00005
Kerstersia_gyiorum	206506	S	583	138	721	0.00006
Advenella_kashmirensis	310575	S	254	13	267	0.00002
Advenella_mimigardefordensis	302406	S	239	12	251	0.00002
Oligella_ureolytica	90244	S	56	28	84	0.00001
Oligella_urethralis	90245	S	53	4	57	0.00000
Paenalcaligenes_hominis	643674	S	57	3	60	0.00000
Pelistega_ratti	2652177	S	20	2	22	0.00000
Basilea_psittacipulmonis	1472345	S	19	1	20	0.00000
Taylorella_asinigenitalis	84590	S	10	1	11	0.00000
Rhizobacter_sp._AJA081-3	2753607	S	6818	2018	8836	0.00072
Rhizobacter_gummiphilus	946333	S	5569	1237	6806	0.00055
Sphaerotilus_sp._FB-5	2914710	S	3830	2738	6568	0.00053
Sphaerotilus_natans	34103	S	3308	1463	4771	0.00039
Rubrivivax_gelatinosus	28068	S	6414	2271	8685	0.00070
Methylibium_sp._Pch-M	2082386	S	2161	2165	4326	0.00035
Methylibium_petroleiphilum	105560	S	1978	2170	4148	0.00034
Aquincola_tertiaricarbonis	391953	S	5122	2048	7170	0.00058
Thiomonas_sp._X19	1050370	S	1718	681	2399	0.00019
Thiomonas_intermedia	926	S	1149	173	1322	0.00011
Thiomonas_arsenitoxydans	426114	S	396	749	1145	0.00009
Leptothrix_cholodnii	34029	S	4125	1522	5647	0.00046
Mitsuaria_sp._7	1658665	S	4058	924	4982	0.00040
Ideonella_dechloratans	36863	S	2690	1873	4563	0.00037
Xylophilus_rhododendri	2697032	S	2618	864	3482	0.00028
Tepidimonas_taiwanensis	307486	S	2334	939	3273	0.00027
Aquabacterium_olei	1296669	S	1911	573	2484	0.00020
Roseateles_depolymerans	76731	S	1905	420	2325	0.00019
Inhella_inkyongensis	392593	S	1354	241	1595	0.00013
Paucibacter_sp._KCTC_42545	1768242	S	1028	196	1224	0.00010
Candidatus_Ichthyocystis_hellenicum	1561003	S	28	0	28	0.00000
Sutterella_megalosphaeroides	2494234	S	630	102	732	0.00006
Sutterella_faecalis	2584944	S	545	76	621	0.00005
Sutterella_wadsworthensis	40545	S	231	27	258	0.00002
Turicimonas_muris	1796652	S	82	5	87	0.00001
Thauera_sp._MZ1T	85643	S	3221	3506	6727	0.00055
Thauera_sp._K11	2005884	S	2982	1802	4784	0.00039
Thauera_humireducens	1134435	S	1885	1084	2969	0.00024
Thauera_chlorobenzoica	96773	S	1460	1399	2859	0.00023
Thauera_aromatica	59405	S	1309	1868	3177	0.00026
Thauera_hydrothermalis	2184083	S	843	263	1106	0.00009
Azoarcus_sp._KH32C	748247	S	3761	718	4479	0.00036
Azoarcus_sp._DD4	2027405	S	2198	1567	3765	0.00031
Azoarcus_olearius	418699	S	2821	1115	3936	0.00032
Azoarcus_communis	41977	S	2048	855	2903	0.00024
Nitrogeniibacter_mangrovi	2016596	S	2374	511	2885	0.00023
Nitrogeniibacter_aestuarii	2815343	S	1035	114	1149	0.00009
Aromatoleum_petrolei	76116	S	3018	800	3818	0.00031
Aromatoleum_aromaticum	551760	S	2386	1775	4161	0.00034
Aromatoleum_bremense	76115	S	2122	1303	3425	0.00028
Aromatoleum_pumilum	2067960	S	1982	726	2708	0.00022
Azospira_restricta	404405	S	5326	2954	8280	0.00067
Azospira_inquinata	2785627	S	495	42	537	0.00004
Azospira_sp._I09	1765049	S	342	1059	1401	0.00011
Azospira_oryzae	146939	S	325	814	1139	0.00009
Niveibacterium_microcysteis	2811415	S	1872	261	2133	0.00017
Oryzomicrobium_terrae	1735038	S	1291	355	1646	0.00013
Rugosibacter_aromaticivorans	1565605	S	377	70	447	0.00004
Dechloromonas_denitrificans	281362	S	1872	485	2357	0.00019
Dechloromonas_sp._HYN0024	2231055	S	535	110	645	0.00005
Dechloromonas_sp._TW-R-39-2	2654218	S	301	144	445	0.00004
Ferribacterium_limneticum	76259	S	2590	451	3041	0.00025
Quatrionicoccus_australiensis	138118	S	1117	345	1462	0.00012
Fluviibacter_phosphoraccumulans	1751046	S	148	41	189	0.00002
Usitatibacter_rugosus	2732067	S	11238	1356	12594	0.00102
Usitatibacter_palustris	2732487	S	8729	1125	9854	0.00080
Nitrosomonas_communis	44574	S	6092	114	6206	0.00050
Nitrosomonas_ureae	44577	S	290	8	298	0.00002
Nitrosomonas_europaea	915	S	147	21	168	0.00001
Nitrosomonas_eutropha	916	S	101	50	151	0.00001
Nitrosomonas_stercoris	1444684	S	46	25	71	0.00001
Nitrosospira_multiformis	1231	S	4962	149	5111	0.00041
Nitrosospira_lacus	1288494	S	528	17	545	0.00004
Nitrosospira_sp._NRS527	155925	S	248	158	406	0.00003
Nitrosospira_briensis	35799	S	226	154	380	0.00003
Denitratisoma_sp._DHT3	1981880	S	1772	1460	3232	0.00026
Denitratisoma_oestradiolicum	311182	S	895	158	1053	0.00009
Sulfuritalea_hydrogenivorans	748811	S	2201	346	2547	0.00021
Methyloversatilis_sp._RAC08	1842540	S	1831	258	2089	0.00017
Sterolibacterium_denitrificans	157592	S	1409	437	1846	0.00015
Ferrigenium_kumadai	1682490	S	2483	511	2994	0.00024
Sideroxydans_sp._MIZ01	2764705	S	1230	265	1495	0.00012
Sideroxydans_lithotrophicus	63745	S	921	144	1065	0.00009
Ferriphaselus_amnicola	1188319	S	502	64	566	0.00005
Candidatus_Nitrotoga_arctica	453162	S	167	43	210	0.00002
Candidatus_Nitrotoga_sp._AM1P	2559597	S	121	34	155	0.00001
Gallionella_capsiferriformans	370405	S	271	23	294	0.00002
Thiobacillus_denitrificans	36861	S	2860	583	3443	0.00028
Sulfuritortus_calidifontis	1914471	S	1956	909	2865	0.00023
Sulfurimicrobium_lacus	2715678	S	1444	188	1632	0.00013
Sulfuriferula_plumbiphila	171865	S	827	153	980	0.00008
Sulfuriferula_sp._AH1	1985873	S	359	76	435	0.00004
Sulfuriferula_nivalis	2675298	S	60	4	64	0.00001
Sulfuricella_denitrificans	649841	S	619	55	674	0.00005
Methylovorus_sp._MP688	887061	S	101	98	199	0.00002
Methylovorus_glucosotrophus	266009	S	100	88	188	0.00002
Methylobacillus_flagellatus	405	S	344	93	437	0.00004
Methylophilus_sp._TWE2	1662285	S	78	5	83	0.00001
Methylophilus_medardicus	2588534	S	69	6	75	0.00001
Candidatus_Methylopumilus_turicensis	1581680	S	34	5	39	0.00000
Candidatus_Methylopumilus_universalis	2588536	S	28	9	37	0.00000
Candidatus_Methylopumilus_planktonicus	1581557	S	24	8	32	0.00000
Candidatus_Methylopumilus_rimovensis	2588535	S	16	2	18	0.00000
Methylotenera_mobilis	359408	S	69	7	76	0.00001
Methylotenera_versatilis	1055487	S	34	4	38	0.00000
Methyloradius_palustris	2778876	S	64	5	69	0.00001
Chromobacterium_sp._ATCC_53434	2059672	S	1370	484	1854	0.00015
Chromobacterium_sp._Rain0013	2292447	S	212	257	469	0.00004
Chromobacterium_sp._Beijing	2735795	S	188	524	712	0.00006
Chromobacterium_violaceum	536	S	1256	777	2033	0.00017
Chromobacterium_vaccinii	1108595	S	1176	518	1694	0.00014
Chromobacterium_phragmitis	2202141	S	779	348	1127	0.00009
Chromobacterium_paludis	2605945	S	736	297	1033	0.00008
Chromobacterium_rhizoryzae	1778675	S	213	1106	1319	0.00011
Chromobacterium_haemolyticum	394935	S	141	910	1051	0.00009
Iodobacter_fluviatilis	537	S	90	28	118	0.00001
Iodobacter_ciconiae	2496266	S	59	16	75	0.00001
Jeongeupia_sp._USM3	1906741	S	2007	565	2572	0.00021
Jeongeupia_sp._HS-3	1009682	S	813	170	983	0.00008
Paludibacterium_paludis	1225769	S	939	182	1121	0.00009
Paludibacterium_yongneupense	400061	S	830	116	946	0.00008
Paludibacterium_sp._B53371	2806263	S	583	117	700	0.00006
Pseudogulbenkiania_sp._NH8B	748280	S	1769	619	2388	0.00019
Vogesella_sp._LIG4	1192162	S	1116	316	1432	0.00012
Vogesella_sp._XCS3	2877939	S	508	138	646	0.00005
Aquitalea_aquatilis	1537400	S	350	109	459	0.00004
Aquitalea_sp._USM4	1590041	S	245	130	375	0.00003
Aquitalea_magnusonii	332411	S	229	127	356	0.00003
Aquitalea_denitrificans	519081	S	228	113	341	0.00003
Microvirgula_aerodenitrificans	57480	S	1240	245	1485	0.00012
Laribacter_hongkongensis	168471	S	856	719	1575	0.00013
Aquaspirillum_sp._LM1	1938604	S	631	96	727	0.00006
Chitinibacter_fontanus	1737446	S	110	16	126	0.00001
Chitinibacter_bivalviorum	2739434	S	103	73	176	0.00001
Deefgea_sp._D25	2865840	S	79	10	89	0.00001
Deefgea_sp._D17	2739061	S	61	18	79	0.00001
Deefgea_sp._D13	2864875	S	51	12	63	0.00001
Neisseria_sp._KEM232	655307	S	222	31	253	0.00002
Neisseria_sp._oral_taxon_014	641148	S	105	44	149	0.00001
Neisseria_sp._ZJ785	2709396	S	53	6	59	0.00000
Neisseria_sp._Dent_CA1/247	2912675	S	46	20	66	0.00001
Neisseria_bacilliformis	267212	S	293	69	362	0.00003
Neisseria_shayeganii	607712	S	230	31	261	0.00002
Neisseria_chenwenguii	1853278	S	187	20	207	0.00002
Neisseria_elongata	495	S	180	83	263	0.00002
Neisseria_meningitidis	487	S	169	489	658	0.00005
Neisseria_musculi	1815583	S	166	14	180	0.00001
Neisseria_dentiae	194197	S	164	18	182	0.00001
Neisseria_gonorrhoeae	485	S	126	394	520	0.00004
Neisseria_lactamica	486	S	83	91	174	0.00001
Neisseria_animalis	492	S	76	10	86	0.00001
Neisseria_weaveri	28091	S	76	25	101	0.00001
Neisseria_sicca	490	S	59	118	177	0.00001
Neisseria_weixii	1853276	S	58	6	64	0.00001
Neisseria_animaloris	326522	S	57	11	68	0.00001
Neisseria_brasiliensis	2666100	S	54	44	98	0.00001
Neisseria_zalophi	640030	S	49	4	53	0.00000
Neisseria_canis	493	S	49	11	60	0.00000
Neisseria_mucosa	488	S	49	101	150	0.00001
Neisseria_dumasiana	1931275	S	39	14	53	0.00000
Neisseria_wadsworthii	607711	S	38	7	45	0.00000
Neisseria_macacae	496	S	27	57	84	0.00001
Neisseria_arctica	1470200	S	25	2	27	0.00000
Neisseria_zoodegmatis	326523	S	24	14	38	0.00000
Neisseria_subflava	28449	S	16	11	27	0.00000
Neisseria_flavescens	484	S	16	11	27	0.00000
Neisseria_cinerea	483	S	16	9	25	0.00000
Crenobacter_cavernae	2290923	S	2350	786	3136	0.00025
Chitinolyticbacter_meiyuanensis	682798	S	1406	181	1587	0.00013
Vitreoscilla_filiformis	63	S	617	124	741	0.00006
Vitreoscilla_massiliensis	1689272	S	75	38	113	0.00001
Kingella_potus	265175	S	193	24	217	0.00002
Kingella_denitrificans	502	S	137	80	217	0.00002
Kingella_oralis	505	S	121	19	140	0.00001
Kingella_kingae	504	S	33	5	38	0.00000
Eikenella_corrodens	539	S	241	146	387	0.00003
Eikenella_exigua	2528037	S	71	46	117	0.00001
Uruburuella_suis	252130	S	234	35	269	0.00002
Uruburuella_testudinis	1282863	S	148	27	175	0.00001
Paralysiella_testudinis	2809020	S	123	26	149	0.00001
Alysiella_filiformis	194196	S	39	13	52	0.00000
Alysiella_crassa	153491	S	34	11	45	0.00000
Aquella_oligotrophica	2067065	S	65	2	67	0.00001
Neisseriaceae_bacterium_CCUG_44465	2917790	S	64	9	73	0.00001
Conchiformibius_steedae	153493	S	58	9	67	0.00001
Snodgrassella_alvi	1196083	S	29	7	36	0.00000
Morococcus_cerebrosus	1056807	S	20	106	126	0.00001
Simonsiella_muelleri	72	S	13	2	15	0.00000
Casimicrobium_huifangae	2591109	S	1565	830	2395	0.00019
Candidatus_Kinetoplastibacterium_sorsogonicusi	1576550	S	13	5	18	0.00000
Archangium_violaceum	83451	S	180392	16223	196615	0.01596
Archangium_gephyra	48	S	24735	2393	27128	0.00220
Cystobacter_fuscus	43	S	14273	1762	16035	0.00130
Stigmatella_aurantiaca	41	S	8588	509	9097	0.00074
Melittangium_boletus	83453	S	7854	914	8768	0.00071
Pyxidicoccus_sp._SCPEA002	2813578	S	31656	1295	32951	0.00267
Myxococcus_xanthus	34	S	9651	25771	35422	0.00287
Myxococcus_hansupus	1297742	S	5649	456	6105	0.00050
Myxococcus_stipitatus	83455	S	4364	544	4908	0.00040
Myxococcus_sp._SCHIC003	2813577	S	3677	456	4133	0.00034
Corallococcus_coralloides	184914	S	10336	3687	14023	0.00114
Corallococcus_macrosporus	35	S	6519	1121	7640	0.00062
Corallococcus_sp._EGB	1521117	S	6008	1977	7985	0.00065
Anaeromyxobacter_sp._Red232	2918170	S	14874	1468	16342	0.00133
Anaeromyxobacter_sp._Fw109-5	404589	S	11354	1346	12700	0.00103
Anaeromyxobacter_sp._Red630	2918171	S	10826	1228	12054	0.00098
Anaeromyxobacter_sp._K	447217	S	2521	5204	7725	0.00063
Anaeromyxobacter_dehalogenans	161493	S	8200	5901	14101	0.00114
Vulgatibacter_incomptus	1391653	S	6620	395	7015	0.00057
Sorangium_cellulosum	56	S	112779	10706	123485	0.01002
Polyangium_aurulentum	2567896	S	20078	1512	21590	0.00175
Chondromyces_crocatus	52	S	9822	352	10174	0.00083
Pajaroellobacter_abortibovis	1882918	S	146	3	149	0.00001
Sandaracinus_amylolyticus	927083	S	27647	1165	28812	0.00234
Labilithrix_luteola	1391654	S	15281	565	15846	0.00129
Haliangium_ochraceum	80816	S	12218	550	12768	0.00104
Geomonas_sp._RF6	2897342	S	3121	356	3477	0.00028
Geomonas_paludis	2740185	S	2118	1051	3169	0.00026
Geomonas_nitrogeniifigens	2847991	S	1947	982	2929	0.00024
Geomonas_subterranea	2847989	S	1656	753	2409	0.00020
Geomonas_oryzisoli	2847992	S	1625	877	2502	0.00020
Geobacter_sp._FeAm09	2597769	S	1646	216	1862	0.00015
Geobacter_sp._SVR	2495594	S	1180	175	1355	0.00011
Geobacter_sp._DSM_9736	1277350	S	748	48	796	0.00006
Geobacter_pickeringii	345632	S	1772	434	2206	0.00018
Geobacter_sulfurreducens	35554	S	1763	352	2115	0.00017
Geobacter_metallireducens	28232	S	1108	255	1363	0.00011
Geobacter_benzoatilyticus	2815309	S	704	152	856	0.00007
Citrifermentans_bremense	60035	S	1815	696	2511	0.00020
Citrifermentans_bemidjiense	225194	S	1579	556	2135	0.00017
Geotalea_uraniireducens	351604	S	847	57	904	0.00007
Geotalea_daltonii	1203471	S	530	38	568	0.00005
Geoalkalibacter_subterraneus	483547	S	674	598	1272	0.00010
Trichlorobacter_lovleyi	313985	S	402	53	455	0.00004
Desulfuromonas_versatilis	2802975	S	2383	402	2785	0.00023
Desulfuromonas_sp._DDH964	1823759	S	1750	316	2066	0.00017
Desulfuromonas_sp._AOP6	1566351	S	532	58	590	0.00005
Desulfuromonas_soudanensis	1603606	S	1484	161	1645	0.00013
Pelobacter_propionicus	29543	S	1004	357	1361	0.00011
Syntrophotalea_acetylenica	29542	S	471	82	553	0.00004
Syntrophotalea_carbinolica	19	S	401	28	429	0.00003
Syntrophotalea_acetylenivorans	1842532	S	255	33	288	0.00002
Desulfovibrio_sp._IOR2	2583823	S	720	144	864	0.00007
Desulfovibrio_sp._86	2666132	S	267	64	331	0.00003
Desulfovibrio_sp._G11	631220	S	221	168	389	0.00003
Desulfovibrio_vulgaris	881	S	968	28	996	0.00008
Desulfovibrio_sulfodismutans	63561	S	824	234	1058	0.00009
Desulfovibrio_desulfuricans	876	S	684	138	822	0.00007
Desulfovibrio_piger	901	S	577	108	685	0.00006
Desulfovibrio_fairfieldensis	44742	S	540	48	588	0.00005
Desulfovibrio_ferrophilus	241368	S	304	23	327	0.00003
Candidatus_Desulfovibrio_trichonymphae	1725232	S	126	10	136	0.00001
Pseudodesulfovibrio_indicus	1716143	S	1092	239	1331	0.00011
Pseudodesulfovibrio_mercurii	641491	S	1087	263	1350	0.00011
Pseudodesulfovibrio_aespoeensis	182210	S	757	554	1311	0.00011
Pseudodesulfovibrio_cashew	2678688	S	623	119	742	0.00006
Pseudodesulfovibrio_sp._SF6	2810563	S	315	28	343	0.00003
Pseudodesulfovibrio_sp._zrk46	2725288	S	228	35	263	0.00002
Pseudodesulfovibrio_tunisiensis	463192	S	523	51	574	0.00005
Pseudodesulfovibrio_profundus	57320	S	148	150	298	0.00002
Pseudodesulfovibrio_piezophilus	879567	S	98	12	110	0.00001
Solidesulfovibrio_carbinoliphilus	345370	S	1549	196	1745	0.00014
Solidesulfovibrio_magneticus	184917	S	671	401	1072	0.00009
Solidesulfovibrio_carbinolicus	296842	S	586	474	1060	0.00009
Oceanidesulfovibrio_marinus	370038	S	1515	96	1611	0.00013
Desulfocurvibacter_africanus	873	S	1071	75	1146	0.00009
Desulfolutivibrio_sulfoxidireducens	2773299	S	949	291	1240	0.00010
Megalodesulfovibrio_gigas	879	S	826	43	869	0.00007
Oleidesulfovibrio_alaskensis	58180	S	250	357	607	0.00005
Maridesulfovibrio_salexigens	880	S	81	11	92	0.00001
Maridesulfovibrio_hydrothermalis	191026	S	50	7	57	0.00000
Paradesulfovibrio_bizertensis	376490	S	131	12	143	0.00001
Lawsonia_intracellularis	29546	S	25	0	25	0.00000
Desulfomicrobium_baculatum	899	S	687	57	744	0.00006
Desulfomicrobium_orale	132132	S	376	100	476	0.00004
Desulfohalobium_retbaense	45663	S	294	13	307	0.00002
Desulfosarcina_ovata	83564	S	900	42	942	0.00008
Desulfosarcina_alkanivorans	571177	S	787	340	1127	0.00009
Desulfosarcina_widdelii	947919	S	647	75	722	0.00006
Desulfococcus_multivorans	897	S	577	108	685	0.00006
Desulfatibacillum_aliphaticivorans	218208	S	494	16	510	0.00004
Desulfoluna_sp._ASN36	2810562	S	441	21	462	0.00004
Desulfonema_magnum	45655	S	159	3	162	0.00001
Desulfonema_limicola	45656	S	58	3	61	0.00001
Desulfobacter_hydrogenophilus	2291	S	90	16	106	0.00001
Desulfobacter_postgatei	2293	S	79	12	91	0.00001
Desulforapulum_autotrophicum	2296	S	161	18	179	0.00001
Desulfobacula_toluolica	28223	S	59	4	63	0.00001
Desulfobulbus_propionicus	894	S	781	41	822	0.00007
Desulfobulbus_oralis	1986146	S	543	118	661	0.00005
Desulfobulbus_oligotrophicus	1909699	S	161	137	298	0.00002
Desulfurivibrio_alkaliphilus	427923	S	580	24	604	0.00005
Desulfomarina_profundi	2772557	S	79	6	85	0.00001
Desulfosudis_oleivorans	181663	S	567	34	601	0.00005
Desulfosediminicola_ganghwensis	2569540	S	122	13	135	0.00001
Desulfosediminicola_flagellatus	2569541	S	77	7	84	0.00001
Desulfotalea_psychrophila	84980	S	71	11	82	0.00001
Desulfocapsa_sulfexigens	65555	S	32	1	33	0.00000
Persicimonas_caeni	2292766	S	4042	113	4155	0.00034
Bradymonas_sediminis	1548548	S	1330	85	1415	0.00011
Bradymonadales_bacterium_V1718	2600177	S	489	22	511	0.00004
Syntrophobacter_fumaroxidans	119484	S	1010	416	1426	0.00012
Desulfoglaeba_alkanexedens	361111	S	882	36	918	0.00007
Desulfarculus_baarsii	453230	S	1666	961	2627	0.00021
Desulfobacca_acetoxidans	60893	S	347	7	354	0.00003
Syntrophus_aciditrophicus	316277	S	306	14	320	0.00003
Desulfomonile_tiedjei	2358	S	278	2	280	0.00002
Dissulfurimicrobium_hydrothermale	1750598	S	196	9	205	0.00002
Candidatus_Desulfofervidus_auxilii	1621989	S	114	1	115	0.00001
Hippea_maritima	84405	S	47	1	48	0.00000
Campylobacter_gracilis	824	S	114	8	122	0.00001
Campylobacter_showae	204	S	97	25	122	0.00001
Campylobacter_curvus	200	S	87	9	96	0.00001
Campylobacter_sp._19-13652	2840180	S	19	4	23	0.00000
Campylobacter_sp._RM6914	1032243	S	15	3	18	0.00000
Campylobacter_concisus	199	S	80	10	90	0.00001
Campylobacter_rectus	203	S	63	19	82	0.00001
Campylobacter_coli	195	S	19	53	72	0.00001
Candidatus_Campylobacter_infans	2561898	S	14	1	15	0.00000
Campylobacter_fetus	196	S	13	17	30	0.00000
Campylobacter_hyointestinalis	198	S	12	7	19	0.00000
Campylobacter_hominis	76517	S	12	4	16	0.00000
Campylobacter_sputorum	206	S	10	1	11	0.00000
Campylobacter_pinnipediorum	1965231	S	10	0	10	0.00000
Campylobacter_helveticus	28898	S	10	7	17	0.00000
Sulfurimonas_sp._HSL-3221	2894755	S	454	36	490	0.00004
Sulfurimonas_sp._B2	2590551	S	10	3	13	0.00000
Sulfurimonas_paralvinellae	317658	S	14	8	22	0.00000
Sulfurimonas_lithotrophica	2590022	S	13	4	17	0.00000
Sulfuricurvum_kujiense	148813	S	50	1	51	0.00000
Helicobacter_pylori	210	S	136	232	368	0.00003
Helicobacter_sp._NHP19-0012	2849642	S	24	3	27	0.00000
Helicobacter_sp._NHP19-0003	2849641	S	21	2	23	0.00000
Helicobacter_bizzozeronii	56877	S	22	0	22	0.00000
Helicobacter_cinaedi	213	S	18	1	19	0.00000
Helicobacter_heilmannii	35817	S	18	1	19	0.00000
Helicobacter_cetorum	138563	S	14	0	14	0.00000
Helicobacter_himalayensis	1591088	S	13	0	13	0.00000
Helicobacter_suis	104628	S	13	0	13	0.00000
Helicobacter_mustelae	217	S	12	0	12	0.00000
Helicobacter_bilis	37372	S	10	1	11	0.00000
Wolinella_succinogenes	844	S	43	3	46	0.00000
Nitratifractor_salsuginis	269261	S	242	10	252	0.00002
Sulfurovum_sp._NBC37-1	387093	S	33	13	46	0.00000
Sulfurovum_sp._HSL1-3	2893889	S	25	4	29	0.00000
Sulfurovum_sp._XGS-02	2925411	S	16	1	17	0.00000
Sulfurovum_lithotrophicum	206403	S	31	15	46	0.00000
Sulfurovum_indicum	2779528	S	22	1	23	0.00000
Hydrogenimonas_urashimensis	2740515	S	263	15	278	0.00002
Aliarcobacter_cryaerophilus	28198	S	14	15	29	0.00000
Arcobacter_sp._FWKO_B	2593672	S	12	8	20	0.00000
Malaciobacter_molluscorum	1032072	S	11	6	17	0.00000
Pseudoarcobacter_acticola	1849015	S	16	17	33	0.00000
Halarcobacter_bivalviorum	663364	S	11	4	15	0.00000
Poseidonibacter_lekithochrous	1904463	S	13	6	19	0.00000
Sulfurospirillum_cavolei	366522	S	46	3	49	0.00000
Sulfurospirillum_sp._UCH001	1581011	S	12	16	28	0.00000
Sulfurospirillum_multivorans	66821	S	21	18	39	0.00000
Sulfurospirillum_halorespirans	194424	S	16	13	29	0.00000
Sulfurospirillum_deleyianum	65553	S	12	1	13	0.00000
Sulfurospirillum_barnesii	44674	S	10	0	10	0.00000
Nitrosophilus_alvini	2714855	S	66	18	84	0.00001
Nitrosophilus_labii	2706014	S	27	15	42	0.00000
Nitratiruptor_sp._YY09-18	2724901	S	22	18	40	0.00000
Nitratiruptor_sp._SB155-2	387092	S	17	21	38	0.00000
Caminibacter_mediatlanticus	291048	S	31	16	47	0.00000
Caminibacter_pacificus	1424653	S	16	7	23	0.00000
Nautilia_profundicola	244787	S	15	11	26	0.00000
Nautilia_sp._PV-1	2579250	S	13	8	21	0.00000
Lysobacter_sp._TY2-98	2290922	S	3033	473	3506	0.00028
Lysobacter_sp._KIS68-7	2904252	S	2569	497	3066	0.00025
Lysobacter_sp._5GHs7-4	2904253	S	1941	594	2535	0.00021
Lysobacter_sp._CECT_30171	2822368	S	1741	417	2158	0.00018
Lysobacter_sp._S4-A87	2925843	S	1590	523	2113	0.00017
Lysobacter_sp._K5869	2820808	S	1497	709	2206	0.00018
Lysobacter_sp._CW239	2762611	S	1304	732	2036	0.00017
Lysobacter_sp._H21R4	2781021	S	438	782	1220	0.00010
Lysobacter_sp._CJ11	2764185	S	360	26	386	0.00003
Lysobacter_sp._H23M47	2781024	S	233	1068	1301	0.00011
Lysobacter_sp._HDW10	2714936	S	232	53	285	0.00002
Lysobacter_lycopersici	1324796	S	5935	1307	7242	0.00059
Lysobacter_enzymogenes	69	S	5923	2170	8093	0.00066
Lysobacter_solisilvae_(ex_Woo_and_Kim_2022)	2865112	S	4017	1220	5237	0.00043
Lysobacter_soli	453783	S	3927	846	4773	0.00039
Lysobacter_capsici	435897	S	3623	3689	7312	0.00059
Lysobacter_solisilvae_(ex_Kim_et_al._2021)	2763317	S	2486	504	2990	0.00024
Lysobacter_antibioticus	84531	S	2087	440	2527	0.00021
Lysobacter_maris	1605891	S	2067	511	2578	0.00021
Lysobacter_arenosi	2795387	S	1582	516	2098	0.00017
Lysobacter_oculi	2698682	S	1459	427	1886	0.00015
Lysobacter_alkalisoli	2591633	S	1449	266	1715	0.00014
Lysobacter_ciconiae	2781022	S	358	621	979	0.00008
Lysobacter_gummosus	262324	S	302	2387	2689	0.00022
Lysobacter_avium	2781023	S	207	889	1096	0.00009
Xanthomonas_translucens	343	S	2602	3486	6088	0.00049
Xanthomonas_campestris	339	S	1889	3885	5774	0.00047
Xanthomonas_sacchari	56458	S	1510	568	2078	0.00017
Xanthomonas_sp._GW	2724121	S	262	390	652	0.00005
Xanthomonas_sp._SS	2724122	S	225	388	613	0.00005
Xanthomonas_sp._SI	2724123	S	210	364	574	0.00005
Xanthomonas_sp._MLO165	2081477	S	62	110	172	0.00001
Xanthomonas_arboricola	56448	S	1116	1378	2494	0.00020
Xanthomonas_theicola	56464	S	967	346	1313	0.00011
Xanthomonas_oryzae	347	S	895	541	1436	0.00012
Xanthomonas_citri	346	S	733	4947	5680	0.00046
Xanthomonas_hyacinthi	56455	S	653	443	1096	0.00009
Xanthomonas_albilineans	29447	S	577	85	662	0.00005
Xanthomonas_hortorum	56454	S	558	526	1084	0.00009
Xanthomonas_vesicatoria	56460	S	545	303	848	0.00007
Xanthomonas_fragariae	48664	S	515	111	626	0.00005
Xanthomonas_cucurbitae	56453	S	473	95	568	0.00005
Xanthomonas_cassavae	56450	S	416	124	540	0.00004
Xanthomonas_vasicola	56459	S	412	164	576	0.00005
Xanthomonas_euroxanthea	2259622	S	331	467	798	0.00006
Xanthomonas_hydrangeae	2775159	S	261	107	368	0.00003
Xanthomonas_axonopodis	53413	S	259	452	711	0.00006
Xanthomonas_phaseoli	1985254	S	191	543	734	0.00006
Xanthomonas_euvesicatoria	456327	S	131	700	831	0.00007
Xanthomonas_perforans	442694	S	20	128	148	0.00001
Stenotrophomonas_maltophilia	40324	S	6137	8877	15014	0.00122
Stenotrophomonas_sp._ESTM1D_MKCIP4_1	2072414	S	404	170	574	0.00005
Stenotrophomonas_sp._SAU14A_NAIMI4_5	2072413	S	378	244	622	0.00005
Stenotrophomonas_sp._ZAC14D2_NAIMI4_7	2072405	S	197	218	415	0.00003
Stenotrophomonas_sp._ZAC14A_NAIMI4_1	2072412	S	155	297	452	0.00004
Stenotrophomonas_sp._YAU14D1_LEIMI4_1	2072407	S	147	259	406	0.00003
Stenotrophomonas_sp._ZAC14D2_NAIMI4_6	2072406	S	101	202	303	0.00002
Stenotrophomonas_sp._SAU14A_NAIMI4_8	2072409	S	54	314	368	0.00003
Stenotrophomonas_sp._YAU14A_MKIMI4_1	2072408	S	39	227	266	0.00002
Stenotrophomonas_sp._LM091	1904944	S	813	328	1141	0.00009
Stenotrophomonas_sp._169	2770322	S	722	117	839	0.00007
Stenotrophomonas_sp._364	2691571	S	522	210	732	0.00006
Stenotrophomonas_sp._NA06056	2742129	S	277	136	413	0.00003
Stenotrophomonas_sp._WZN-1	2005046	S	134	161	295	0.00002
Stenotrophomonas_sp._DR822	2871174	S	97	168	265	0.00002
Stenotrophomonas_sp._Pemsol	2040586	S	88	285	373	0.00003
Stenotrophomonas_sp._pho	2211160	S	62	305	367	0.00003
Stenotrophomonas_sp._MYb57	1827305	S	51	230	281	0.00002
Stenotrophomonas_sp._ASS1	2282124	S	46	217	263	0.00002
Stenotrophomonas_sp._CW117	2775920	S	44	1043	1087	0.00009
Stenotrophomonas_sp._NY11291	2939415	S	35	377	412	0.00003
Stenotrophomonas_sp._G4	2303750	S	35	163	198	0.00002
Stenotrophomonas_sp._SI-NJAU-1	2886359	S	27	129	156	0.00001
Stenotrophomonas_sp._SXG-1	2682487	S	16	176	192	0.00002
Stenotrophomonas_rhizophila	216778	S	2301	711	3012	0.00024
Stenotrophomonas_acidaminiphila	128780	S	1414	3396	4810	0.00039
Stenotrophomonas_indicatrix	2045451	S	78	321	399	0.00003
Luteimonas_sp._MC1750	2799326	S	1698	635	2333	0.00019
Luteimonas_sp._S4-F44	2925842	S	1642	329	1971	0.00016
Luteimonas_sp._D4P002	2901869	S	1520	424	1944	0.00016
Luteimonas_sp._YGD11-2	2508168	S	1441	646	2087	0.00017
Luteimonas_sp._JM171	1896164	S	1423	298	1721	0.00014
Luteimonas_sp._MC1572	2799325	S	1408	681	2089	0.00017
Luteimonas_sp._MC1825	2761107	S	1357	673	2030	0.00016
Luteimonas_granuli	1176533	S	1804	652	2456	0.00020
Luteimonas_chenhongjianii	2006110	S	1407	319	1726	0.00014
Luteimonas_yindakuii	2565782	S	1312	532	1844	0.00015
Pseudoxanthomonas_mexicana	128785	S	4037	4208	8245	0.00067
Pseudoxanthomonas_suwonensis	314722	S	3425	1801	5226	0.00042
Pseudoxanthomonas_sp._X-1	2571115	S	1788	1750	3538	0.00029
Pseudoxanthomonas_sp._F37	2932492	S	15	630	645	0.00005
Pseudoxanthomonas_daejeonensis	266062	S	1413	375	1788	0.00015
Pseudoxanthomonas_spadix	415229	S	1020	403	1423	0.00012
Thermomonas_sp._XSG	2771436	S	1313	602	1915	0.00016
Thermomonas_sp._HDW16	2714945	S	877	247	1124	0.00009
Thermomonas_brevis	215691	S	1944	815	2759	0.00022
Thermomonas_aquatica	2202149	S	1614	819	2433	0.00020
Thermomonas_carbonis	1463158	S	1325	292	1617	0.00013
Arenimonas_daejeonensis	370777	S	2525	537	3062	0.00025
Pseudolysobacter_antarcticus	2511995	S	1507	40	1547	0.00013
Xylella_fastidiosa	2371	S	175	54	229	0.00002
Xylella_taiwanensis	1444770	S	100	4	104	0.00001
Luteibacter_sp._321	2911537	S	1672	514	2186	0.00018
Luteibacter_sp._EIF3	2780091	S	1331	218	1549	0.00013
Luteibacter_sp._335	2911538	S	1097	245	1342	0.00011
Luteibacter_sp._353	2911539	S	1041	326	1367	0.00011
Luteibacter_rhizovicinus	242606	S	1359	204	1563	0.00013
Luteibacter_pinisoli	2589080	S	1329	377	1706	0.00014
Luteibacter_anthropi	564369	S	1037	205	1242	0.00010
Rhodanobacter_denitrificans	666685	S	2564	1155	3719	0.00030
Rhodanobacter_sp._FDAARGOS_1247	2778082	S	1664	597	2261	0.00018
Rhodanobacter_thiooxydans	416169	S	1522	826	2348	0.00019
Rhodanobacter_glycinis	582702	S	1187	242	1429	0.00012
Dyella_thiooxydans	445710	S	2135	735	2870	0.00023
Dyella_japonica	231455	S	1181	415	1596	0.00013
Dyella_telluris	2763498	S	1054	328	1382	0.00011
Dyella_terrae	522259	S	798	129	927	0.00008
Dyella_caseinilytica	1849581	S	719	60	779	0.00006
Dyella_sp._M7H15-1	2501295	S	448	50	498	0.00004
Frateuria_sp._5GH9-34	2898793	S	2834	1004	3838	0.00031
Frateuria_sp._5GH9-11	1542730	S	2746	1239	3985	0.00032
Frateuria_aurantia	81475	S	614	82	696	0.00006
Dokdonella_koreensis	323415	S	4708	871	5579	0.00045
Aerosticca_soli	2010829	S	2005	2916	4921	0.00040
Ahniella_affigens	2021234	S	950	23	973	0.00008
Pseudomonas_sp._LPB0260	2614442	S	1099	209	1308	0.00011
Pseudomonas_sp._CC6-YY-74	1930532	S	885	99	984	0.00008
Pseudomonas_sp._B11D7D	2735906	S	869	151	1020	0.00008
Pseudomonas_sp._ATCC_13867	1294143	S	850	287	1137	0.00009
Pseudomonas_sp._SCB32	2653853	S	834	163	997	0.00008
Pseudomonas_sp._TCU-HL1	1856685	S	787	104	891	0.00007
Pseudomonas_sp._PDNC002	2811422	S	758	157	915	0.00007
Pseudomonas_sp._KNUC1026	2893890	S	728	66	794	0.00006
Pseudomonas_sp._MSPm1	2726956	S	674	131	805	0.00007
Pseudomonas_sp._DY-1	1755504	S	659	78	737	0.00006
Pseudomonas_sp._Ost2	2678260	S	643	86	729	0.00006
Pseudomonas_sp._ABC1	2748080	S	515	71	586	0.00005
Pseudomonas_sp._MTM4	2705472	S	505	86	591	0.00005
Pseudomonas_sp._StFLB209	1028989	S	495	119	614	0.00005
Pseudomonas_sp._MM211	2866808	S	491	42	533	0.00004
Pseudomonas_sp._Pc102	2678261	S	491	229	720	0.00006
Pseudomonas_sp._L5B5	2883205	S	442	73	515	0.00004
Pseudomonas_sp._7SR1	1881017	S	429	74	503	0.00004
Pseudomonas_sp._p1(2021b)	2874628	S	424	225	649	0.00005
Pseudomonas_sp._OIL-1	2706126	S	409	75	484	0.00004
Pseudomonas_sp._CMR5c	658630	S	360	94	454	0.00004
Pseudomonas_sp._HN2-3	2886360	S	348	71	419	0.00003
Pseudomonas_sp._MPC6	2498848	S	332	64	396	0.00003
Pseudomonas_sp._gcc21	2726989	S	328	134	462	0.00004
Pseudomonas_sp._LAB-08	143813	S	305	51	356	0.00003
Pseudomonas_sp._LPH1	1898684	S	292	231	523	0.00004
Pseudomonas_sp._Marseille-Q3773	2866592	S	291	87	378	0.00003
Pseudomonas_sp._HLS-6	2049589	S	279	75	354	0.00003
Pseudomonas_sp._URMO17WK12:I11	1283291	S	260	153	413	0.00003
Pseudomonas_sp._15A4	2804761	S	247	55	302	0.00002
Pseudomonas_sp._Leaf58	1736226	S	243	42	285	0.00002
Pseudomonas_sp._RtIB026	2749999	S	242	130	372	0.00003
Pseudomonas_sp._DG56-2	2320270	S	238	24	262	0.00002
Pseudomonas_sp._2hn	2866626	S	227	140	367	0.00003
Pseudomonas_sp._ADAK13	2730847	S	226	47	273	0.00002
Pseudomonas_sp._Tri1	2823875	S	225	47	272	0.00002
Pseudomonas_sp._S34	1573718	S	222	48	270	0.00002
Pseudomonas_sp._S09G_359	2054919	S	220	48	268	0.00002
Pseudomonas_sp._DTU12.3	2073078	S	218	50	268	0.00002
Pseudomonas_sp._MM213	2866807	S	212	41	253	0.00002
Pseudomonas_sp._S35	1573719	S	210	52	262	0.00002
Pseudomonas_sp._Seg1	2678259	S	209	43	252	0.00002
Pseudomonas_sp._NIBR-H-19	2901380	S	207	41	248	0.00002
Pseudomonas_sp._ADPe	2774873	S	204	468	672	0.00005
Pseudomonas_sp._phDV1	253237	S	201	686	887	0.00007
Pseudomonas_sp._DR48	2871095	S	201	101	302	0.00002
Pseudomonas_sp._31-12	2201356	S	200	46	246	0.00002
Pseudomonas_sp._R5-89-07	658644	S	200	58	258	0.00002
Pseudomonas_sp._M1	95619	S	189	419	608	0.00005
Pseudomonas_sp._HS6	2850559	S	187	44	231	0.00002
Pseudomonas_sp._OE_28.3	2745519	S	174	37	211	0.00002
Pseudomonas_sp._RC3H12	2834406	S	163	91	254	0.00002
Pseudomonas_sp._DNDY-54	2870860	S	162	69	231	0.00002
Pseudomonas_sp._R2A2	2213057	S	162	169	331	0.00003
Pseudomonas_sp._PP3	2815936	S	161	51	212	0.00002
Pseudomonas_sp._NS1(2017)	2025658	S	158	36	194	0.00002
Pseudomonas_sp._LG1E9	2219057	S	157	42	199	0.00002
Pseudomonas_sp._LS.1a	2920387	S	156	60	216	0.00002
Pseudomonas_sp._ACM7	2052956	S	155	24	179	0.00001
Pseudomonas_sp._M30-35	1981174	S	153	8	161	0.00001
Pseudomonas_sp._ADAK18	2730848	S	152	23	175	0.00001
Pseudomonas_sp._SK3(2021)	2841064	S	146	82	228	0.00002
Pseudomonas_sp._CCOS_191	1649877	S	145	110	255	0.00002
Pseudomonas_sp._HN11	1344094	S	144	29	173	0.00001
Pseudomonas_sp._UW4	1207075	S	132	76	208	0.00002
Pseudomonas_sp._SDM007	2812000	S	131	79	210	0.00002
Pseudomonas_sp._HS-18	2879114	S	129	235	364	0.00003
Pseudomonas_sp._St316	2678257	S	125	36	161	0.00001
Pseudomonas_sp._NIBRBAC000502773	2590776	S	125	55	180	0.00001
Pseudomonas_sp._R84	1573712	S	124	54	178	0.00001
Pseudomonas_sp._14181154	2662033	S	123	127	250	0.00002
Pseudomonas_sp._MRSN12121	1611770	S	116	148	264	0.00002
Pseudomonas_sp._SCA2728.1_7	2825975	S	114	58	172	0.00001
Pseudomonas_sp._FIT81	2837969	S	109	56	165	0.00001
Pseudomonas_sp._IzPS59	2774459	S	108	45	153	0.00001
Pseudomonas_sp._CYM-20-01	2870750	S	107	46	153	0.00001
Pseudomonas_sp._SK	2729423	S	105	79	184	0.00002
Pseudomonas_sp._BIGb0427	2724470	S	99	226	325	0.00003
Pseudomonas_sp._AO-1	2855434	S	96	91	187	0.00002
Pseudomonas_sp._R76	1573711	S	93	40	133	0.00001
Pseudomonas_sp._02C_26	2054914	S	92	208	300	0.00002
Pseudomonas_sp._Z003-0.4C(8344-21)	1855380	S	90	55	145	0.00001
Pseudomonas_sp._SORT22	2813842	S	87	211	298	0.00002
Pseudomonas_sp._RBPA9	2746321	S	86	159	245	0.00002
Pseudomonas_sp._3-2	2867408	S	83	101	184	0.00002
Pseudomonas_sp._LTJR-52	2479392	S	83	24	107	0.00001
Pseudomonas_sp._FGI182	1259844	S	82	80	162	0.00001
Pseudomonas_sp._B10	118613	S	78	49	127	0.00001
Pseudomonas_sp._S07E_245	2866278	S	75	180	255	0.00002
Pseudomonas_sp._Cab53	2678258	S	71	96	167	0.00001
Pseudomonas_sp._BIOMIG1BAC	1758730	S	71	215	286	0.00002
Pseudomonas_sp._J380	2605424	S	70	84	154	0.00001
Pseudomonas_sp._LBUM920	2126069	S	69	174	243	0.00002
Pseudomonas_sp._MPFS	2795724	S	69	105	174	0.00001
Pseudomonas_sp._THAF7b	2587845	S	68	126	194	0.00002
Pseudomonas_sp._FDAARGOS_380	2018067	S	65	45	110	0.00001
Pseudomonas_sp._09C_129	2054915	S	65	68	133	0.00001
Pseudomonas_sp._Y5-11	2749808	S	64	201	265	0.00002
Pseudomonas_sp._HN2	2884805	S	59	44	103	0.00001
Pseudomonas_sp._DR_5-09	1534110	S	58	74	132	0.00001
Pseudomonas_sp._PONIH3	1636610	S	55	309	364	0.00003
Pseudomonas_sp._GR_6-02	1659194	S	55	132	187	0.00002
Pseudomonas_sp._AN-B15	2697023	S	53	149	202	0.00002
Pseudomonas_sp._ArH3a	2862945	S	53	133	186	0.00002
Pseudomonas_sp._SC3(2021)	2871493	S	52	48	100	0.00001
Pseudomonas_sp._MYb193	1827300	S	49	50	99	0.00001
Pseudomonas_sp._C27(2019)	2604941	S	48	7	55	0.00000
Pseudomonas_sp._ATCC_43928	676210	S	47	114	161	0.00001
Pseudomonas_sp._RU47	2005388	S	46	118	164	0.00001
Pseudomonas_sp._S150	2559074	S	45	60	105	0.00001
Pseudomonas_sp._ADAK22	2730851	S	44	112	156	0.00001
Pseudomonas_sp._R3-18-08	1173283	S	39	114	153	0.00001
Pseudomonas_sp._St29	1500687	S	38	154	192	0.00002
Pseudomonas_sp._S49	1573720	S	37	95	132	0.00001
Pseudomonas_sp._7-41	2898483	S	35	132	167	0.00001
Pseudomonas_sp._Os17	1500686	S	34	168	202	0.00002
Pseudomonas_sp._SWI44	2083053	S	33	281	314	0.00003
Pseudomonas_sp._R4-39-08	1173288	S	32	188	220	0.00002
Pseudomonas_sp._SXM-1	2169583	S	31	83	114	0.00001
Pseudomonas_sp._A2	107445	S	31	170	201	0.00002
Pseudomonas_sp._BC42	2933816	S	31	153	184	0.00001
Pseudomonas_sp._R2-37-08W	1173273	S	30	142	172	0.00001
Pseudomonas_sp._LG1D9	2083054	S	30	112	142	0.00001
Pseudomonas_sp._CFSAN084952	2664899	S	28	70	98	0.00001
Pseudomonas_sp._Colony2	2861799	S	27	99	126	0.00001
Pseudomonas_sp._CFA	2651048	S	27	117	144	0.00001
Pseudomonas_sp._IAC-BECa141	2793103	S	27	47	74	0.00001
Pseudomonas_sp._DTU12.1	2654238	S	26	103	129	0.00001
Pseudomonas_sp._DR208	2870840	S	26	53	79	0.00001
Pseudomonas_sp._Y39-6	2749807	S	26	71	97	0.00001
Pseudomonas_sp._BJP69	2597770	S	24	126	150	0.00001
Pseudomonas_sp._XWY-1	2069256	S	24	125	149	0.00001
Pseudomonas_sp._R4-35-07	658643	S	23	155	178	0.00001
Pseudomonas_sp._R32	1573704	S	23	50	73	0.00001
Pseudomonas_sp._NC02	2067572	S	21	60	81	0.00001
Pseudomonas_sp._R4-34-07	658642	S	21	121	142	0.00001
Pseudomonas_sp._R11-23-07	658632	S	21	188	209	0.00002
Pseudomonas_sp._CIP-10	2892442	S	21	163	184	0.00001
Pseudomonas_sp._SWI36	2083052	S	20	49	69	0.00001
Pseudomonas_sp._HN8-3	2886361	S	20	33	53	0.00000
Pseudomonas_sp._R1-43-08	1173270	S	20	118	138	0.00001
Pseudomonas_sp._PS1(2021)	2866282	S	20	582	602	0.00005
Pseudomonas_sp._IB20	1702250	S	20	116	136	0.00001
Pseudomonas_sp._MPDS	2762896	S	19	68	87	0.00001
Pseudomonas_sp._LH1G9	2083055	S	19	55	74	0.00001
Pseudomonas_sp._R3-52-08	1173284	S	19	115	134	0.00001
Pseudomonas_sp._BYT-1	2816906	S	19	141	160	0.00001
Pseudomonas_sp._TKP	1415630	S	18	52	70	0.00001
Pseudomonas_sp._B14-6	2738843	S	17	39	56	0.00000
Pseudomonas_sp._A214	1855331	S	17	44	61	0.00000
Pseudomonas_sp._Eqa60	2799184	S	17	81	98	0.00001
Pseudomonas_sp._R2-60-08W	1173280	S	16	112	128	0.00001
Pseudomonas_sp._I3-I5	2926671	S	15	50	65	0.00001
Pseudomonas_sp._St290	1602166	S	15	48	63	0.00001
Pseudomonas_sp._So3.2b	2864101	S	15	40	55	0.00000
Pseudomonas_sp._R2-7-07	658641	S	14	132	146	0.00001
Pseudomonas_sp._SW-3	147212	S	14	44	58	0.00000
Pseudomonas_sp._SWI7	2587597	S	13	71	84	0.00001
Pseudomonas_sp._KBS0802	2578115	S	12	3775	3787	0.00031
Pseudomonas_sp._VLB120	69328	S	12	170	182	0.00001
Pseudomonas_sp._St386	2678256	S	12	82	94	0.00001
Pseudomonas_sp._OST1909	2777367	S	11	28	39	0.00000
Pseudomonas_sp._SWI6	2083051	S	11	185	196	0.00002
Pseudomonas_sp._JY-Q	1338689	S	10	65	75	0.00001
Pseudomonas_sp._SK2	2841063	S	10	182	192	0.00002
Pseudomonas_furukawaii	1149133	S	11726	3421	15147	0.00123
Pseudomonas_oleovorans	301	S	485	1582	2067	0.00017
Pseudomonas_mendocina	300	S	7635	2521	10156	0.00082
Pseudomonas_aeruginosa	287	S	5208	61555	66763	0.00542
Pseudomonas_alcaligenes	43263	S	2639	1680	4319	0.00035
Pseudomonas_resinovorans	53412	S	1228	248	1476	0.00012
Pseudomonas_multiresinivorans	95301	S	499	139	638	0.00005
Pseudomonas_nitroreducens	46680	S	134	258	392	0.00003
Pseudomonas_citronellolis	53408	S	523	658	1181	0.00010
Pseudomonas_fluorescens	294	S	4340	2968	7308	0.00059
Pseudomonas_protegens	380021	S	1058	4681	5739	0.00047
Pseudomonas_orientalis	76758	S	758	178	936	0.00008
Pseudomonas_azotoformans	47878	S	573	188	761	0.00006
Pseudomonas_synxantha	47883	S	502	294	796	0.00006
Pseudomonas_poae	200451	S	395	171	566	0.00005
Pseudomonas_rhodesiae	76760	S	372	137	509	0.00004
Pseudomonas_mediterranea	183795	S	331	74	405	0.00003
Pseudomonas_trivialis	200450	S	325	100	425	0.00003
Pseudomonas_tolaasii	29442	S	323	52	375	0.00003
Pseudomonas_corrugata	47879	S	279	53	332	0.00003
Pseudomonas_cedrina	651740	S	259	58	317	0.00003
Pseudomonas_migulae	78543	S	243	102	345	0.00003
Pseudomonas_mucidolens	46679	S	198	25	223	0.00002
Pseudomonas_congelans	200452	S	187	45	232	0.00002
Pseudomonas_veronii	76761	S	139	304	443	0.00004
Pseudomonas_brenneri	129817	S	139	41	180	0.00001
Pseudomonas_libanensis	75588	S	117	112	229	0.00002
Pseudomonas_mandelii	75612	S	97	209	306	0.00002
Pseudomonas_ogarae	1114970	S	87	52	139	0.00001
Pseudomonas_extremorientalis	169669	S	20	37	57	0.00000
Pseudomonas_putida	303	S	5663	6024	11687	0.00095
Pseudomonas_oryzihabitans	47885	S	1819	346	2165	0.00018
Pseudomonas_fulva	47880	S	1187	2552	3739	0.00030
Pseudomonas_plecoglossicida	70775	S	362	257	619	0.00005
Pseudomonas_mosselii	78327	S	211	370	581	0.00005
Pseudomonas_monteilii	76759	S	210	494	704	0.00006
Pseudomonas_sp._SGAir0191	2217867	S	104	53	157	0.00001
Pseudomonas_stutzeri	316	S	7343	4400	11743	0.00095
Pseudomonas_chloritidismutans	203192	S	92	110	202	0.00002
Pseudomonas_balearica	74829	S	1292	1625	2917	0.00024
Pseudomonas_xanthomarina	271420	S	393	57	450	0.00004
Pseudomonas_luteola	47886	S	96	37	133	0.00001
Pseudomonas_syringae	317	S	1330	1295	2625	0.00021
Pseudomonas_viridiflava	33069	S	874	93	967	0.00008
Pseudomonas_cichorii	36746	S	509	41	550	0.00004
Pseudomonas_asturiensis	1190415	S	311	27	338	0.00003
Pseudomonas_amygdali	47877	S	125	467	592	0.00005
Pseudomonas_savastanoi	29438	S	71	341	412	0.00003
Pseudomonas_syringae_group_genomosp._7	251699	S	255	21	276	0.00002
Pseudomonas_avellanae	46257	S	194	156	350	0.00003
Pseudomonas_fuscovaginae	50340	S	156	73	229	0.00002
Pseudomonas_syringae_group_genomosp._3	251701	S	44	1240	1284	0.00010
Pseudomonas_coronafaciens	53409	S	41	57	98	0.00001
Pseudomonas_sp._Lz4W	1206777	S	33	46	79	0.00001
Pseudomonas_tremae	200454	S	15	18	33	0.00000
Pseudomonas_chlororaphis	587753	S	2621	2107	4728	0.00038
Pseudomonas_lundensis	86185	S	306	35	341	0.00003
Pseudomonas_fragi	296	S	179	120	299	0.00002
Pseudomonas_otitidis	319939	S	1794	378	2172	0.00018
Pseudomonas_oryzae	1392877	S	1683	513	2196	0.00018
Pseudomonas_knackmussii	65741	S	1668	1431	3099	0.00025
Pseudomonas_psychrotolerans	237610	S	1622	321	1943	0.00016
Pseudomonas_cavernae	2320867	S	1251	188	1439	0.00012
Pseudomonas_entomophila	312306	S	1174	429	1603	0.00013
Pseudomonas_lalkuanensis	2604832	S	1115	192	1307	0.00011
Pseudomonas_guangdongensis	1245526	S	1070	330	1400	0.00011
Pseudomonas_campi	2731681	S	926	122	1048	0.00009
Pseudomonas_qingdaonensis	2056231	S	670	128	798	0.00006
Pseudomonas_vanderleydeniana	2745495	S	658	81	739	0.00006
Pseudomonas_wenzhouensis	2906062	S	636	221	857	0.00007
Pseudomonas_parafulva	157782	S	621	150	771	0.00006
Pseudomonas_eucalypticola	2599595	S	606	72	678	0.00006
Pseudomonas_nanhaiensis	2830842	S	563	61	624	0.00005
Pseudomonas_argentinensis	289370	S	553	111	664	0.00005
Pseudomonas_cremoricolorata	157783	S	504	69	573	0.00005
Pseudomonas_rhizosphaerae	216142	S	482	55	537	0.00004
Pseudomonas_frederiksbergensis	104087	S	481	115	596	0.00005
Pseudomonas_sediminis	1691904	S	474	113	587	0.00005
Pseudomonas_alkylphenolica	237609	S	468	85	553	0.00004
Pseudomonas_tohonis	2725477	S	463	314	777	0.00006
Pseudomonas_brassicacearum	930166	S	451	636	1087	0.00009
Pseudomonas_alcaliphila	101564	S	447	426	873	0.00007
Pseudomonas_pohangensis	364197	S	425	29	454	0.00004
Pseudomonas_saudiphocaensis	1499686	S	419	73	492	0.00004
Pseudomonas_toyotomiensis	554344	S	416	308	724	0.00006
Pseudomonas_yamanorum	515393	S	414	74	488	0.00004
Pseudomonas_muyukensis	2842357	S	402	102	504	0.00004
Pseudomonas_palleroniana	191390	S	396	52	448	0.00004
Pseudomonas_umsongensis	198618	S	395	54	449	0.00004
Pseudomonas_zhaodongensis	1176257	S	389	152	541	0.00004
Pseudomonas_khazarica	2502979	S	373	366	739	0.00006
Pseudomonas_alvandae	2842348	S	370	49	419	0.00003
Pseudomonas_xantholysinigenes	2745490	S	369	86	455	0.00004
Pseudomonas_phragmitis	1931241	S	365	27	392	0.00003
Pseudomonas_chengduensis	489632	S	359	657	1016	0.00008
Pseudomonas_antarctica	219572	S	333	68	401	0.00003
Pseudomonas_koreensis	198620	S	326	102	428	0.00003
Pseudomonas_vancouverensis	95300	S	313	42	355	0.00003
Pseudomonas_xanthosomae	2842356	S	298	79	377	0.00003
Pseudomonas_tructae	2518644	S	288	44	332	0.00003
Pseudomonas_extremaustralis	359110	S	285	52	337	0.00003
Pseudomonas_marincola	437900	S	281	40	321	0.00003
Pseudomonas_fakonensis	2842355	S	281	74	355	0.00003
Pseudomonas_prosekii	1148509	S	277	38	315	0.00003
Pseudomonas_arsenicoxydans	702115	S	272	45	317	0.00003
Pseudomonas_granadensis	1421430	S	272	102	374	0.00003
Pseudomonas_silesiensis	1853130	S	268	47	315	0.00003
Pseudomonas_sihuiensis	1274359	S	266	294	560	0.00005
Pseudomonas_hamedanensis	2745504	S	262	39	301	0.00002
Pseudomonas_promysalinigenes	485898	S	258	35	293	0.00002
Pseudomonas_thivervalensis	86265	S	256	43	299	0.00002
Pseudomonas_agarici	46677	S	254	10	264	0.00002
Pseudomonas_asgharzadehiana	2842349	S	240	46	286	0.00002
Pseudomonas_graminis	158627	S	220	49	269	0.00002
Pseudomonas_lurida	244566	S	219	40	259	0.00002
Pseudomonas_simiae	321846	S	217	44	261	0.00002
Pseudomonas_viciae	2505979	S	195	38	233	0.00002
Pseudomonas_taetrolens	47884	S	193	21	214	0.00002
Pseudomonas_lini	163011	S	188	30	218	0.00002
Pseudomonas_reinekei	395598	S	183	42	225	0.00002
Pseudomonas_maumuensis	2842354	S	183	72	255	0.00002
Pseudomonas_allokribbensis	2774460	S	180	56	236	0.00002
Pseudomonas_versuta	1788301	S	176	24	200	0.00002
Pseudomonas_kribbensis	1628086	S	163	121	284	0.00002
Pseudomonas_oryziphila	2894079	S	156	99	255	0.00002
Pseudomonas_asplenii	53407	S	152	74	226	0.00002
Pseudomonas_psychrophila	122355	S	150	18	168	0.00001
Pseudomonas_tritici	2745518	S	122	30	152	0.00001
Pseudomonas_gozinkensis	2774461	S	119	44	163	0.00001
Pseudomonas_moraviensis	321662	S	115	140	255	0.00002
Pseudomonas_zeae	2745510	S	112	44	156	0.00001
Pseudomonas_kunmingensis	1211807	S	103	129	232	0.00002
Pseudomonas_tensinigenes	2745511	S	101	45	146	0.00001
Pseudomonas_iranensis	2745503	S	97	57	154	0.00001
Pseudomonas_germanica	2815720	S	96	41	137	0.00001
Pseudomonas_anuradhapurensis	485870	S	93	66	159	0.00001
Pseudomonas_azerbaijanoriens	2842350	S	85	44	129	0.00001
Pseudomonas_atacamensis	2565368	S	84	63	147	0.00001
Pseudomonas_zarinae	2745498	S	77	45	122	0.00001
Pseudomonas_juntendi	2666183	S	57	463	520	0.00004
Pseudomonas_monsensis	2745509	S	55	45	100	0.00001
Pseudomonas_salmasensis	2745514	S	53	27	80	0.00001
Pseudomonas_soli	1306993	S	49	168	217	0.00002
Pseudomonas_lactis	1615674	S	48	27	75	0.00001
Pseudomonas_asiatica	2219225	S	48	208	256	0.00002
Pseudomonas_sessilinigenes	658629	S	43	84	127	0.00001
Pseudomonas_donghuensis	1163398	S	40	87	127	0.00001
Pseudomonas_bijieensis	2681983	S	35	100	135	0.00001
Pseudomonas_glycinae	1785145	S	31	42	73	0.00001
Pseudomonas_cerasi	1583341	S	27	43	70	0.00001
Candidatus_Pseudomonas_adelgestsugas	1302376	S	17	0	17	0.00000
Pseudomonas_rhizophila	2045200	S	16	31	47	0.00000
Pseudomonas_taiwanensis	470150	S	12	114	126	0.00001
Pseudomonas_shahriarae	2745512	S	11	32	43	0.00000
Azotobacter_chroococcum	353	S	1371	866	2237	0.00018
Azotobacter_vinelandii	354	S	956	0	956	0.00008
Azotobacter_salinestris	69964	S	787	430	1217	0.00010
Halopseudomonas_xinjiangensis	487184	S	426	40	466	0.00004
Halopseudomonas_aestusnigri	857252	S	364	249	613	0.00005
Halopseudomonas_sp._RR6	2918528	S	346	50	396	0.00003
Halopseudomonas_sabulinigri	472181	S	339	29	368	0.00003
Halopseudomonas_litoralis	797277	S	275	66	341	0.00003
Halopseudomonas_salegens	1434072	S	219	15	234	0.00002
Permianibacter_aggregans	1510150	S	408	10	418	0.00003
Thiopseudomonas_alkaliphila	1697053	S	47	9	56	0.00000
Entomomonas_sp._F2A	2785331	S	22	1	23	0.00000
Entomomonas_moraniae	2213226	S	14	0	14	0.00000
Marinobacter_sp._CA1	2817656	S	454	34	488	0.00004
Marinobacter_sp._Arc7-DN-1	2304594	S	293	42	335	0.00003
Marinobacter_sp._NP-4(2019)	2488665	S	260	51	311	0.00003
Marinobacter_sp._LPB0319	2769486	S	256	16	272	0.00002
Marinobacter_sp._LV10R510-11A	1415568	S	143	6	149	0.00001
Marinobacter_sp._LQ44	1749259	S	130	205	335	0.00003
Marinobacter_sp._CP1	1671721	S	94	191	285	0.00002
Marinobacter_sp._JH2	2547598	S	93	25	118	0.00001
Marinobacter_sp._es.042	1761794	S	92	95	187	0.00002
Marinobacter_sp._BSs20148	490759	S	79	52	131	0.00001
Marinobacter_fonticola	2603215	S	394	20	414	0.00003
Marinobacter_salarius	1420917	S	327	45	372	0.00003
Marinobacter_nauticus	2743	S	305	98	403	0.00003
Marinobacter_salsuginis	418719	S	241	36	277	0.00002
Marinobacter_similis	1420916	S	241	21	262	0.00002
Marinobacter_salinus	1874317	S	217	14	231	0.00002
Marinobacter_adhaerens	1033846	S	75	146	221	0.00002
Marinobacter_psychrophilus	330734	S	41	27	68	0.00001
Klebsiella_pneumoniae	573	S	659	26806	27465	0.00223
Klebsiella_quasipneumoniae	1463165	S	453	1515	1968	0.00016
Klebsiella_oxytoca	571	S	293	174	467	0.00004
Klebsiella_aerogenes	548	S	268	134	402	0.00003
Klebsiella_sp._A52	2834819	S	20	241	261	0.00002
Klebsiella_michiganensis	1134687	S	163	576	739	0.00006
Klebsiella_variicola	244366	S	150	466	616	0.00005
Klebsiella_quasivariicola	2026240	S	84	84	168	0.00001
Klebsiella_huaxiensis	2153354	S	71	55	126	0.00001
Klebsiella_africana	2489010	S	51	27	78	0.00001
Klebsiella_grimontii	2058152	S	48	283	331	0.00003
Raoultella_sp._HC6	2923366	S	190	131	321	0.00003
Raoultella_planticola	575	S	144	142	286	0.00002
Raoultella_ornithinolytica	54291	S	87	723	810	0.00007
Raoultella_terrigena	577	S	54	121	175	0.00001
Raoultella_electrica	1259973	S	26	69	95	0.00001
Enterobacter_cloacae	550	S	690	1035	1725	0.00014
Enterobacter_hormaechei	158836	S	221	3413	3634	0.00029
Enterobacter_cancerogenus	69218	S	214	67	281	0.00002
Enterobacter_asburiae	61645	S	185	815	1000	0.00008
Enterobacter_roggenkampii	1812935	S	127	507	634	0.00005
Enterobacter_chengduensis	2494701	S	97	63	160	0.00001
Enterobacter_ludwigii	299767	S	77	189	266	0.00002
Enterobacter_chuandaensis	2497875	S	67	41	108	0.00001
Enterobacter_sp._BIDMC_29	1329841	S	18	64	82	0.00001
Enterobacter_cloacae_complex_sp.	2027919	S	15	373	388	0.00003
Enterobacter_kobei	208224	S	44	457	501	0.00004
Enterobacter_sichuanensis	2071710	S	40	38	78	0.00001
Enterobacter_sp._SA187	1914861	S	196	34	230	0.00002
Enterobacter_sp._JUb54	2724468	S	184	35	219	0.00002
Enterobacter_sp._E76	2596949	S	90	183	273	0.00002
Enterobacter_sp._RHBSTW-00994	2742676	S	76	17	93	0.00001
Enterobacter_sp._Colony194	2866201	S	64	86	150	0.00001
Enterobacter_sp._RHBSTW-00175	2742639	S	53	48	101	0.00001
Enterobacter_sp._JBIWA008	2831892	S	35	22	57	0.00000
Enterobacter_sp._SGAir0187	2836161	S	25	29	54	0.00000
Enterobacter_sp._JBIWA003	2831890	S	23	31	54	0.00000
Enterobacter_sp._SES19	2705458	S	18	19	37	0.00000
Enterobacter_sp._JBIWA005	2831891	S	16	31	47	0.00000
Enterobacter_huaxiensis	2494702	S	125	34	159	0.00001
Enterobacter_bugandensis	881260	S	79	137	216	0.00002
Enterobacter_oligotrophicus	2478464	S	78	22	100	0.00001
Enterobacter_mori	539813	S	72	91	163	0.00001
Enterobacter_soli	885040	S	51	12	63	0.00001
Citrobacter_freundii	546	S	204	914	1118	0.00009
Citrobacter_braakii	57706	S	34	291	325	0.00003
Citrobacter_werkmanii	67827	S	31	74	105	0.00001
Citrobacter_sedlakii	67826	S	30	88	118	0.00001
Citrobacter_portucalensis	1639133	S	30	306	336	0.00003
Citrobacter_freundii_complex_sp._CFNIH2	2066049	S	23	27	50	0.00000
Citrobacter_sp._R56	1573676	S	81	23	104	0.00001
Citrobacter_sp._RHB25-C09	2742624	S	76	21	97	0.00001
Citrobacter_sp._BDA59-3	2781952	S	21	9	30	0.00000
Citrobacter_sp._MGH_55	1439319	S	10	53	63	0.00001
Citrobacter_rodentium	67825	S	191	0	191	0.00002
Citrobacter_farmeri	67824	S	126	57	183	0.00001
Citrobacter_amalonaticus	35703	S	93	467	560	0.00005
Citrobacter_koseri	545	S	61	85	146	0.00001
Citrobacter_tructae	2562449	S	51	20	71	0.00001
Citrobacter_pasteurii	1563222	S	39	34	73	0.00001
Citrobacter_arsenatis	2546350	S	26	9	35	0.00000
Citrobacter_cronae	1748967	S	17	143	160	0.00001
Cronobacter_sakazakii	28141	S	272	278	550	0.00004
Cronobacter_dublinensis	413497	S	226	82	308	0.00003
Cronobacter_condimenti	1163710	S	168	47	215	0.00002
Cronobacter_universalis	535744	S	135	100	235	0.00002
Cronobacter_malonaticus	413503	S	80	119	199	0.00002
Cronobacter_sp._JZ38	1906275	S	46	141	187	0.00002
Cronobacter_muytjensii	413501	S	30	120	150	0.00001
Leclercia_adecarboxylata	83655	S	411	750	1161	0.00009
Leclercia_sp._29361	2714951	S	117	46	163	0.00001
Leclercia_sp._J807	2681307	S	26	45	71	0.00001
Leclercia_sp._G3L	2898725	S	23	108	131	0.00001
Leclercia_sp._W6	2282310	S	17	36	53	0.00000
Leclercia_sp._W17	2282309	S	16	49	65	0.00001
Leclercia_sp._119287	2681308	S	13	41	54	0.00000
Leclercia_pneumoniae	2815358	S	121	44	165	0.00001
Kosakonia_sp._SMBL-WEM22	2725560	S	99	43	142	0.00001
Kosakonia_sp._CCTCC_M2018092	2492396	S	67	65	132	0.00001
Kosakonia_sp._MUSA4	2067958	S	60	32	92	0.00001
Kosakonia_cowanii	208223	S	225	166	391	0.00003
Kosakonia_sacchari	1158459	S	183	89	272	0.00002
Kosakonia_pseudosacchari	1646340	S	77	41	118	0.00001
Kosakonia_oryzae	497725	S	74	54	128	0.00001
Kosakonia_arachidis	551989	S	63	17	80	0.00001
Kosakonia_radicincitans	283686	S	59	41	100	0.00001
Salmonella_enterica	28901	S	771	27451	28222	0.00229
Salmonella_bongori	54736	S	75	39	114	0.00001
Pluralibacter_gergoviae	61647	S	582	145	727	0.00006
[Enterobacter]_lignolyticus	1334193	S	307	74	381	0.00003
Cedecea_neteri	158822	S	467	97	564	0.00005
Cedecea_lapagei	158823	S	119	31	150	0.00001
Cedecea_sp._FDAARGOS_727	2545798	S	95	19	114	0.00001
Escherichia_coli	562	S	459	12939	13398	0.00109
Escherichia_albertii	208962	S	72	47	119	0.00001
Escherichia_marmotae	1499973	S	43	19	62	0.00001
Escherichia_fergusonii	564	S	41	50	91	0.00001
Escherichia_sp._E4742	2044467	S	19	10	29	0.00000
Lelliottia_amnigena	61646	S	311	82	393	0.00003
Lelliottia_sp._WB101	2153385	S	61	70	131	0.00001
Lelliottia_sp._AC1	2067959	S	40	39	79	0.00001
Kluyvera_ascorbata	51288	S	118	90	208	0.00002
Kluyvera_intermedia	61648	S	75	45	120	0.00001
Kluyvera_genomosp._3	2774055	S	18	43	61	0.00000
Kluyvera_sp._CRP	2873269	S	16	40	56	0.00000
Candidatus_Symbiopectobacterium_sp._SyEd1	2871826	S	109	12	121	0.00001
Candidatus_Hamiltonella_defensa	138072	S	37	2	39	0.00000
secondary_endosymbiont_of_Ctenarytaina_eucalypti	1199245	S	28	0	28	0.00000
Blochmannia_endosymbiont_of_Colobopsis_nipponica	2681987	S	11	11	22	0.00000
Candidatus_Doolittlea_endobia	1778262	S	28	1	29	0.00000
Candidatus_Hoaglandella_endobia	1778263	S	12	0	12	0.00000
Candidatus_Mikella_endobia	1778264	S	11	0	11	0.00000
Jejubacter_calystegiae	2579935	S	281	29	310	0.00003
Pseudescherichia_vulneris	566	S	206	12	218	0.00002
Plesiomonas_shigelloides	703	S	180	50	230	0.00002
Buttiauxella_agrestis	82977	S	47	8	55	0.00000
Buttiauxella_ferragutiae	82989	S	14	44	58	0.00000
Buttiauxella_sp._3AFRM03	2479367	S	13	38	51	0.00000
Shimwellia_blattae	563	S	140	24	164	0.00001
Atlantibacter_hermannii	565	S	131	25	156	0.00001
Yokenella_regensburgei	158877	S	124	42	166	0.00001
Scandinavium_goeteborgense	1851514	S	120	20	140	0.00001
Phytobacter_ursingii	1972431	S	91	107	198	0.00002
Pseudocitrobacter_sp._G163CM	2891570	S	108	24	132	0.00001
Shigella_flexneri	623	S	20	744	764	0.00006
Shigella_boydii	621	S	13	175	188	0.00002
Candidatus_Moranella_endobia	1048758	S	13	0	13	0.00000
Candidatus_Ishikawaella_capsulata	168169	S	13	0	13	0.00000
Candidatus_Schneideria_nysicola	1081631	S	12	0	12	0.00000
Serratia_marcescens	615	S	1105	2473	3578	0.00029
Serratia_plymuthica	82996	S	490	257	747	0.00006
Serratia_sp._FDAARGOS_506	2420306	S	87	95	182	0.00001
Serratia_sp._ATCC_39006	104623	S	74	7	81	0.00001
Serratia_sp._FGI94	671990	S	58	71	129	0.00001
Serratia_sp._1D1416	2447890	S	37	142	179	0.00001
Serratia_sp._FS14	1327989	S	22	124	146	0.00001
Serratia_sp._3ACOL1	2448483	S	20	33	53	0.00000
Serratia_sp._P2ACOL2	2482769	S	16	57	73	0.00001
Serratia_sp._MYb239	2033438	S	16	162	178	0.00001
Serratia_sp._Tan611	2773264	S	12	94	106	0.00001
Serratia_entomophila	42906	S	301	79	380	0.00003
Serratia_rubidaea	61652	S	283	365	648	0.00005
Serratia_proteamaculans	28151	S	196	50	246	0.00002
Serratia_odorifera	618	S	190	33	223	0.00002
Serratia_fonticola	47917	S	154	154	308	0.00002
Serratia_quinivorans	137545	S	108	45	153	0.00001
Serratia_symbiotica	138074	S	105	16	121	0.00001
Serratia_surfactantfaciens	2741499	S	105	68	173	0.00001
Serratia_liquefaciens	614	S	86	131	217	0.00002
Serratia_inhibens	2338073	S	81	49	130	0.00001
Serratia_grimesii	82995	S	64	8	72	0.00001
Serratia_rhizosphaerae	2597702	S	60	63	123	0.00001
Serratia_ureilytica	300181	S	46	691	737	0.00006
Serratia_ficaria	61651	S	21	110	131	0.00001
Yersinia_similis	367190	S	26	5	31	0.00000
Yersinia_pseudotuberculosis	633	S	19	122	141	0.00001
Yersinia_enterocolitica	630	S	86	94	180	0.00001
Yersinia_ruckeri	29486	S	52	9	61	0.00000
Yersinia_mollaretii	33060	S	47	10	57	0.00000
Yersinia_entomophaga	935293	S	46	8	54	0.00000
Yersinia_rohdei	29485	S	38	7	45	0.00000
Yersinia_aleksiciae	263819	S	33	8	41	0.00000
Yersinia_canariae	2607663	S	28	9	37	0.00000
Yersinia_kristensenii	28152	S	27	85	112	0.00001
Yersinia_aldovae	29483	S	25	5	30	0.00000
Yersinia_frederiksenii	29484	S	25	24	49	0.00000
Yersinia_intermedia	631	S	17	61	78	0.00001
Rahnella_aquatilis	34038	S	217	260	477	0.00004
Rahnella_victoriana	1510570	S	123	18	141	0.00001
Rahnella_sp._ERMR1:05	1805933	S	119	16	135	0.00001
Rahnella_inusitata	58169	S	112	27	139	0.00001
Nissabacter_sp._SGAir0207	2126321	S	513	73	586	0.00005
Gibbsiella_quercinecans	929813	S	311	42	353	0.00003
Ewingella_americana	41202	S	172	24	196	0.00002
Rouxiella_badensis	1646377	S	168	15	183	0.00001
Chania_multitudinisentens	1639108	S	89	10	99	0.00001
Candidatus_Fukatsuia_symbiotica	1878942	S	24	1	25	0.00000
Pantoea_sp._Z09	2886821	S	402	133	535	0.00004
Pantoea_sp._SO10	2575375	S	164	32	196	0.00002
Pantoea_sp._At-9b	592316	S	145	31	176	0.00001
Pantoea_sp._MSR2	2052056	S	125	17	142	0.00001
Pantoea_sp._CCBC3-3-1	2490851	S	98	19	117	0.00001
Pantoea_agglomerans	549	S	841	301	1142	0.00009
Pantoea_dispersa	59814	S	690	184	874	0.00007
Pantoea_deleyi	470932	S	279	72	351	0.00003
Pantoea_vagans	470934	S	232	486	718	0.00006
Pantoea_ananatis	553	S	211	71	282	0.00002
Pantoea_alhagi	1891675	S	163	52	215	0.00002
Pantoea_stewartii	66269	S	124	30	154	0.00001
Pantoea_cypripedii	55209	S	119	9	128	0.00001
Pantoea_rwandensis	1076550	S	98	22	120	0.00001
Erwinia_sp._E602	2675378	S	448	75	523	0.00004
Erwinia_sp._J780	2681984	S	103	18	121	0.00001
Erwinia_sp._QL-Z3	2547962	S	23	75	98	0.00001
Erwinia_sp._Ejp617	215689	S	15	29	44	0.00000
Erwinia_gerundensis	1619313	S	230	40	270	0.00002
Erwinia_persicina	55211	S	145	29	174	0.00001
Erwinia_rhapontici	55212	S	137	25	162	0.00001
Erwinia_tasmaniensis	338565	S	108	21	129	0.00001
Erwinia_amylovora	552	S	93	41	134	0.00001
Erwinia_billingiae	182337	S	85	172	257	0.00002
Erwinia_tracheiphila	65700	S	80	10	90	0.00001
Candidatus_Erwinia_haradaeae	1922217	S	74	1	75	0.00001
[Pantoea]_beijingensis	1324864	S	69	12	81	0.00001
Erwinia_pyrifoliae	79967	S	13	24	37	0.00000
Mixta_gaviniae	665914	S	311	120	431	0.00003
Mixta_calida	665913	S	237	117	354	0.00003
Mixta_theicola	1458355	S	205	65	270	0.00002
Mixta_sp._X22927	2872648	S	125	60	185	0.00002
Mixta_intestinalis	1615494	S	110	31	141	0.00001
Buchnera_aphidicola	9	S	193	21	214	0.00002
Tatumella_ptyseos	82987	S	65	10	75	0.00001
Tatumella_citrea	53336	S	50	6	56	0.00000
Wigglesworthia_glossinidia	51229	S	20	1	21	0.00000
Dickeya_dadantii	204038	S	285	187	472	0.00004
Dickeya_zeae	204042	S	206	228	434	0.00004
Dickeya_dianthicola	204039	S	202	166	368	0.00003
Dickeya_chrysanthemi	556	S	201	126	327	0.00003
Dickeya_fangzhongdai	1778540	S	120	526	646	0.00005
Dickeya_sp._NCPPB_3274	568766	S	77	55	132	0.00001
Dickeya_poaceiphila	568768	S	78	13	91	0.00001
Dickeya_solani	1089444	S	64	34	98	0.00001
Dickeya_oryzae	1240404	S	10	22	32	0.00000
Pectobacterium_brasiliense	180957	S	117	140	257	0.00002
Pectobacterium_carotovorum	554	S	115	271	386	0.00003
Pectobacterium_parmentieri	1905730	S	88	33	121	0.00001
Pectobacterium_sp._LJ1	2878098	S	51	14	65	0.00001
Pectobacterium_sp._PL64	2738983	S	23	15	38	0.00000
Pectobacterium_atrosepticum	29471	S	59	23	82	0.00001
Pectobacterium_punjabense	2108399	S	58	14	72	0.00001
Pectobacterium_polaris	2042057	S	44	32	76	0.00001
Pectobacterium_versatile	2488639	S	32	74	106	0.00001
Pectobacterium_wasabiae	55208	S	29	8	37	0.00000
Pectobacterium_odoriferum	78398	S	26	19	45	0.00000
Pectobacterium_quasiaquaticum	2774015	S	25	24	49	0.00000
Pectobacterium_aroidearum	1201031	S	23	36	59	0.00000
Pectobacterium_parvum	2778550	S	13	16	29	0.00000
Brenneria_goodwinii	1109412	S	203	230	433	0.00004
Brenneria_izadpanahii	2722756	S	185	217	402	0.00003
Brenneria_rubrifaciens	55213	S	119	48	167	0.00001
Lonsdalea_populi	1172565	S	222	58	280	0.00002
Lonsdalea_britannica	1082704	S	169	41	210	0.00002
Musicola_paradisiaca	69223	S	230	25	255	0.00002
Edwardsiella_tarda	636	S	318	790	1108	0.00009
Edwardsiella_hoshinae	93378	S	147	29	176	0.00001
Edwardsiella_ictaluri	67780	S	105	47	152	0.00001
Edwardsiella_piscicida	1263550	S	37	306	343	0.00003
Hafnia_alvei	569	S	65	75	140	0.00001
Hafnia_paralvei	546367	S	32	12	44	0.00000
Obesumbacterium_proteus	82983	S	34	23	57	0.00000
Morganella_morganii	582	S	295	258	553	0.00004
Xenorhabdus_bovienii	40576	S	69	10	79	0.00001
Xenorhabdus_doucetiae	351671	S	66	7	73	0.00001
Xenorhabdus_poinarii	40577	S	45	6	51	0.00000
Xenorhabdus_nematophila	628	S	40	593	633	0.00005
Xenorhabdus_budapestensis	290110	S	33	3	36	0.00000
Xenorhabdus_hominickii	351679	S	21	2	23	0.00000
Providencia_rettgeri	587	S	59	112	171	0.00001
Providencia_alcalifaciens	126385	S	51	18	69	0.00001
Providencia_heimbachae	333962	S	20	6	26	0.00000
Providencia_sp._R33	2828763	S	19	3	22	0.00000
Providencia_rustigianii	158850	S	15	4	19	0.00000
Providencia_sneebia	516075	S	13	1	14	0.00000
Proteus_mirabilis	584	S	108	167	275	0.00002
Proteus_vulgaris	585	S	25	61	86	0.00001
Proteus_hauseri	183417	S	23	4	27	0.00000
Photorhabdus_thracensis	230089	S	49	9	58	0.00000
Photorhabdus_asymbiotica	291112	S	23	2	25	0.00000
Photorhabdus_akhurstii	171438	S	22	4	26	0.00000
Photorhabdus_laumondii	2218628	S	21	5	26	0.00000
Arsenophonus_endosymbiont_of_Apis_mellifera	1541805	S	11	3	14	0.00000
Arsenophonus_nasoniae	638	S	12	2	14	0.00000
Moellerella_wisconsensis	158849	S	21	12	33	0.00000
Sodalis_sp._dw_23	2697027	S	365	22	387	0.00003
Sodalis_endosymbiont_of_Henestaris_halophilus	1929246	S	11	0	11	0.00000
Sodalis_praecaptivus	1239307	S	194	107	301	0.00002
Sodalis_glossinidius	63612	S	139	17	156	0.00001
Candidatus_Sodalis_pierantonius	1486991	S	90	52	142	0.00001
Leminorella_richardii	158841	S	111	13	124	0.00001
Pragia_fontium	82985	S	32	4	36	0.00000
Jinshanibacter_zhutongyuii	2498113	S	28	4	32	0.00000
Limnobaculum_parvum	2172103	S	27	4	31	0.00000
Thioalkalivibrio_sulfidiphilus	1033854	S	1471	883	2354	0.00019
Thioalkalivibrio_paradoxus	108010	S	1382	435	1817	0.00015
Thioalkalivibrio_nitratireducens	186931	S	1369	391	1760	0.00014
Thioalkalivibrio_versutus	106634	S	1046	139	1185	0.00010
Thioalkalivibrio_sp._K90mix	396595	S	1011	129	1140	0.00009
Spiribacter_sp._E85	2182432	S	2827	259	3086	0.00025
Spiribacter_sp._2438	2666185	S	561	54	615	0.00005
Spiribacter_curvatus	1335757	S	661	35	696	0.00006
Spiribacter_salinus	1335746	S	423	32	455	0.00004
Acidihalobacter_aeolianus	2792603	S	1237	181	1418	0.00012
Acidihalobacter_ferrooxydans	1765967	S	995	109	1104	0.00009
Acidihalobacter_yilgarnensis	2819280	S	718	51	769	0.00006
Halorhodospira_halophila	1053	S	1253	144	1397	0.00011
Halorhodospira_halochloris	1052	S	212	10	222	0.00002
Alkalilimnicola_ehrlichii	351052	S	1305	158	1463	0.00012
Aquisalimonas_sp._2447	2740807	S	1246	85	1331	0.00011
Ectothiorhodospira_haloalkaliphila	421628	S	445	162	607	0.00005
Ectothiorhodospira_sp._BSL-9	1442136	S	395	142	537	0.00004
Ectothiorhodosinus_mongolicus	233100	S	185	11	196	0.00002
Allochromatium_tepidum	553982	S	1041	516	1557	0.00013
Allochromatium_vinosum	1049	S	1024	413	1437	0.00012
Candidatus_Thiodictyon_syntrophicum	1166950	S	2360	126	2486	0.00020
Thioflavicoccus_mobilis	80679	S	2204	195	2399	0.00019
Marichromatium_purpuratum	37487	S	2009	383	2392	0.00019
Thiocapsa_bogorovii	521689	S	1626	87	1713	0.00014
Thiocystis_violascens	73141	S	1186	100	1286	0.00010
Thermochromatium_tepidum	1050	S	818	200	1018	0.00008
Nitrosococcus_halophilus	133539	S	157	20	177	0.00001
Nitrosococcus_wardiae	1814290	S	141	17	158	0.00001
Nitrosococcus_watsonii	473531	S	119	29	148	0.00001
Nitrosococcus_oceani	1229	S	110	25	135	0.00001
Caldichromatium_japonicum	2699430	S	581	59	640	0.00005
Rheinheimera_sp._F8	1763998	S	87	3	90	0.00001
Rheinheimera_sp._D18	2545632	S	15	10	25	0.00000
Rheinheimera_mangrovi	2498451	S	45	2	47	0.00000
Candidatus_Nitrosacidococcus_tergens	553981	S	34	1	35	0.00000
Candidatus_Nitrosoglobus_terrae	1630141	S	23	1	24	0.00000
Wenzhouxiangella_marina	1579979	S	1315	82	1397	0.00011
Wenzhouxiangella_sp._AB-CW3	2771012	S	785	33	818	0.00007
Thiohalobacter_thiocyanaticus	585455	S	284	743	1027	0.00008
Thiohalobacter_sp._COW1	2795687	S	266	563	829	0.00007
Guyparkeria_halophila	47960	S	1333	273	1606	0.00013
Sulfurivermis_fontis	1972068	S	1290	529	1819	0.00015
Halothiobacillus_sp._LS2	1860122	S	543	46	589	0.00005
Halothiobacillus_neapolitanus	927	S	222	23	245	0.00002
Woeseia_oceani	1548547	S	593	9	602	0.00005
Sulfuriflexus_mobilis	1811807	S	279	8	287	0.00002
Granulosicoccus_antarcticus	437505	S	254	4	258	0.00002
Halomonas_sp._THAF5a	2587844	S	1108	394	1502	0.00012
Halomonas_sp._JS92-SW72	2306583	S	924	989	1913	0.00016
Halomonas_sp._1513	1883416	S	866	192	1058	0.00009
Halomonas_sp._HG01	1609967	S	825	343	1168	0.00009
Halomonas_sp._THAF12	2587849	S	793	466	1259	0.00010
Halomonas_sp._MCCC_1A13316	2733487	S	725	96	821	0.00007
Halomonas_sp._YLGW01	2773308	S	710	117	827	0.00007
Halomonas_sp._PGE1	2730360	S	526	685	1211	0.00010
Halomonas_sp._Y2R2	2562282	S	269	15	284	0.00002
Halomonas_sp._A40-4	2785909	S	206	51	257	0.00002
Halomonas_sp._SH5A2	2749040	S	196	35	231	0.00002
Halomonas_sp._KO116	1504981	S	132	51	183	0.00001
Halomonas_sp._18071143	2855441	S	130	283	413	0.00003
Halomonas_sp._R57-5	1610576	S	126	52	178	0.00001
Halomonas_sp._SS10-MC5	2854257	S	125	1080	1205	0.00010
Halomonas_sp._FeN2	2832500	S	112	48	160	0.00001
Halomonas_sp._GFAJ-1	1118153	S	78	15	93	0.00001
Halomonas_sp._SF2003	2136172	S	71	358	429	0.00003
Halomonas_sp._NyZ770	2883106	S	62	252	314	0.00003
Halomonas_sp._TD01	999141	S	59	30	89	0.00001
Halomonas_sp._HL-93	1666906	S	49	299	348	0.00003
Halomonas_sp._hl-4	1761789	S	42	248	290	0.00002
Halomonas_sp._N3-2A	2014541	S	25	29	54	0.00000
Halomonas_sp._GT	1971364	S	25	17	42	0.00000
Halomonas_sp._A3H3	1346287	S	14	361	375	0.00003
Halomonas_beimenensis	475662	S	1215	236	1451	0.00012
Halomonas_aestuarii	1897729	S	924	191	1115	0.00009
Halomonas_socia	1081866	S	842	160	1002	0.00008
Halomonas_sulfidivorans	2733488	S	754	149	903	0.00007
Halomonas_tianxiuensis	2497861	S	736	161	897	0.00007
Halomonas_elongata	2746	S	675	70	745	0.00006
Halomonas_chromatireducens	507626	S	582	47	629	0.00005
Halomonas_subglaciescola	29571	S	363	41	404	0.00003
Halomonas_meridiana	29570	S	358	288	646	0.00005
Halomonas_huangheensis	1178482	S	324	19	343	0.00003
Halomonas_piezotolerans	2609667	S	204	109	313	0.00003
Halomonas_profundi	2852117	S	104	15	119	0.00001
Halomonas_sulfidoxydans	2733484	S	95	807	902	0.00007
Halomonas_hydrothermalis	115561	S	90	254	344	0.00003
Halomonas_titanicae	664683	S	87	426	513	0.00004
Halomonas_venusta	44935	S	53	66	119	0.00001
Halomonas_campaniensis	213554	S	12	55	67	0.00001
Halomonas_alkaliphila	272774	S	10	49	59	0.00000
Halotalea_alkalilenta	376489	S	1244	254	1498	0.00012
Cobetia_sp._L2A1	2686360	S	235	29	264	0.00002
Cobetia_sp._cqz5-12	2609415	S	162	232	394	0.00003
Cobetia_sp._4B	2758724	S	63	282	345	0.00003
Cobetia_sp._AM6	2661553	S	49	287	336	0.00003
Cobetia_pacifica	1055101	S	85	225	310	0.00003
Cobetia_amphilecti	1055104	S	47	293	340	0.00003
Cobetia_marina	28258	S	13	147	160	0.00001
Salinicola_tamaricis	1771309	S	1112	128	1240	0.00010
Kushneria_phosphatilytica	657387	S	273	10	283	0.00002
Kushneria_marisflavi	157779	S	270	55	325	0.00003
Kushneria_konosiri	698828	S	259	54	313	0.00003
Chromohalobacter_salexigens	158080	S	790	86	876	0.00007
Pistricoccus_aurantiacus	1883414	S	543	37	580	0.00005
Zymobacter_palmae	33074	S	153	20	173	0.00001
Candidatus_Portiera_aleyrodidarum	91844	S	26	2	28	0.00000
Candidatus_Carsonella_ruddii	114186	S	16	8	24	0.00000
Alcanivorax_sp._N3-2A	2014542	S	948	728	1676	0.00014
Alcanivorax_pacificus	1306787	S	706	237	943	0.00008
Alcanivorax_dieselolei	285091	S	419	211	630	0.00005
Alcanivorax_xenomutans	1094342	S	382	253	635	0.00005
Ketobacter_alkanivorans	1917421	S	136	9	145	0.00001
Marinobacterium_aestuarii	1821621	S	455	33	488	0.00004
Marinobacterium_georgiense	48076	S	170	48	218	0.00002
Marinobacterium_sediminicola	518898	S	168	22	190	0.00002
Marinobacterium_sp._LSUCC0821	2668067	S	38	2	40	0.00000
Marinomonas_sp._FW-1	2071621	S	31	7	38	0.00000
Marinomonas_sp._A3A	2065312	S	23	3	26	0.00000
Marinomonas_sp._CT5	2066133	S	21	1	22	0.00000
Marinomonas_profundi	2726122	S	36	10	46	0.00000
Marinomonas_primoryensis	178399	S	32	4	36	0.00000
Marinomonas_posidonica	936476	S	30	4	34	0.00000
Marinomonas_algicola	2773454	S	29	5	34	0.00000
Marinomonas_arctica	383750	S	27	6	33	0.00000
Marinomonas_mediterranea	119864	S	22	1	23	0.00000
Marinomonas_foliarum	491950	S	21	7	28	0.00000
Thalassolituus_sp._C2-1	2597518	S	109	6	115	0.00001
Thalassolituus_oleivorans	187493	S	51	11	62	0.00001
Venatorbacter_cucullus	2661630	S	133	26	159	0.00001
Bacterioplanes_sanyensis	1249553	S	122	6	128	0.00001
Neptunomonas_concharum	1031538	S	40	4	44	0.00000
Neptunomonas_japonica	417574	S	27	2	29	0.00000
Neptunomonas_phycophila	1572645	S	25	2	27	0.00000
Nitrincola_iocasae	2614693	S	61	10	71	0.00001
Amphritea_japonica	452627	S	43	3	46	0.00000
Bermanella_marisrubri	207949	S	35	1	36	0.00000
Saccharospirillum_mangrovi	2161747	S	353	19	372	0.00003
Reinekea_forsetii	1336806	S	159	7	166	0.00001
Gynuella_sunshinyii	1445505	S	100	2	102	0.00001
Hahella_chejuensis	158327	S	301	47	348	0.00003
Hahella_sp._KA22	1628392	S	239	42	281	0.00002
Litoricola_lipolytica	418701	S	198	9	207	0.00002
Oleiphilus_messinensis	141451	S	86	6	92	0.00001
Endozoicomonas_montiporae	1027273	S	79	4	83	0.00001
Spartinivicinus_ruber	2683272	S	27	0	27	0.00000
Methylococcus_sp._EFPC2	2812648	S	1107	74	1181	0.00010
Methylococcus_sp._Mc7	2860258	S	1068	346	1414	0.00011
Methylococcus_capsulatus	414	S	989	256	1245	0.00010
Methylococcus_geothermalis	2681310	S	886	248	1134	0.00009
Methylomonas_sp._LL1	2785785	S	339	14	353	0.00003
Methylomonas_sp._DH-1	1727196	S	144	271	415	0.00003
Methylomonas_sp._EFPC1	2812647	S	137	93	230	0.00002
Methylomonas_sp._LW13	107637	S	129	82	211	0.00002
Methylomonas_koyamae	702114	S	342	346	688	0.00006
Methylomonas_rhizoryzae	2608981	S	301	10	311	0.00003
Methylomonas_methanica	421	S	264	12	276	0.00002
Methylomonas_denitrificans	1538553	S	264	17	281	0.00002
Methylomonas_paludis	1173101	S	79	3	82	0.00001
Methylomicrobium_album	39775	S	1103	40	1143	0.00009
Methylomicrobium_sp._wino1	2049332	S	220	177	397	0.00003
Methylomagnum_ishizawai	1760988	S	1315	54	1369	0.00011
Methylocaldum_marinum	1432792	S	1228	72	1300	0.00011
Methylogaea_oryzae	1295382	S	1171	88	1259	0.00010
Candidatus_Methylospira_mobilis	1808979	S	364	14	378	0.00003
Methylotuvimicrobium_buryatense	95641	S	117	124	241	0.00002
Methylotuvimicrobium_alcaliphilum	271065	S	100	125	225	0.00002
Methylovulum_psychrotolerans	1704499	S	183	4	187	0.00002
Methylobacter_sp._S3L5C	2839024	S	71	3	74	0.00001
Aeromonas_sp._FDAARGOS_1415	2778064	S	214	121	335	0.00003
Aeromonas_sp._CA23	2033032	S	183	81	264	0.00002
Aeromonas_sp._FDAARGOS_1409	2778058	S	111	171	282	0.00002
Aeromonas_sp._CU5	2033033	S	87	37	124	0.00001
Aeromonas_sp._FDAARGOS_1403	2778052	S	37	123	160	0.00001
Aeromonas_sp._FDAARGOS_1407	2778056	S	31	96	127	0.00001
Aeromonas_sp._ASNIH4	1636609	S	28	142	170	0.00001
Aeromonas_sp._1805	2560028	S	27	83	110	0.00001
Aeromonas_sp._FDAARGOS_1410	2778059	S	25	61	86	0.00001
Aeromonas_sp._FDAARGOS_1405	2778054	S	25	44	69	0.00001
Aeromonas_sp._FDAARGOS_1408	2778057	S	21	127	148	0.00001
Aeromonas_sp._2692-1	2560029	S	19	101	120	0.00001
Aeromonas_sp._FDAARGOS_1416	2778065	S	17	54	71	0.00001
Aeromonas_sp._FDAARGOS_1417	2778066	S	15	45	60	0.00000
Aeromonas_sp._ASNIH1	1636606	S	15	298	313	0.00003
Aeromonas_sp._ASNIH2	1636607	S	14	190	204	0.00002
Aeromonas_sp._FDAARGOS_1406	2778055	S	13	131	144	0.00001
Aeromonas_sp._ASNIH3	1636608	S	13	618	631	0.00005
Aeromonas_sp._FDAARGOS_1411	2778060	S	12	41	53	0.00000
Aeromonas_sp._FDAARGOS_1414	2778063	S	11	38	49	0.00000
Aeromonas_sp._FDAARGOS_1404	2778053	S	10	37	47	0.00000
Aeromonas_sp._ASNIH5	1758179	S	10	175	185	0.00002
Aeromonas_hydrophila	644	S	980	2273	3253	0.00026
Aeromonas_veronii	654	S	684	1560	2244	0.00018
Aeromonas_schubertii	652	S	496	143	639	0.00005
Aeromonas_media	651	S	472	851	1323	0.00011
Aeromonas_encheleia	73010	S	443	155	598	0.00005
Aeromonas_salmonicida	645	S	395	424	819	0.00007
Aeromonas_simiae	218936	S	362	294	656	0.00005
Aeromonas_caviae	648	S	304	2491	2795	0.00023
Aeromonas_rivuli	648794	S	266	73	339	0.00003
Aeromonas_enteropelogenes	29489	S	238	206	444	0.00004
Aeromonas_jandaei	650	S	209	231	440	0.00004
Aeromonas_dhakensis	196024	S	192	418	610	0.00005
Aeromonas_sanarellii	633415	S	59	305	364	0.00003
Aeromonas_allosaccharophila	656	S	44	74	118	0.00001
Aeromonas_rivipollensis	948519	S	29	49	78	0.00001
Zobellella_denitrificans	347534	S	787	188	975	0.00008
Oceanimonas_sp._GK1	511062	S	432	95	527	0.00004
Dongshaea_marina	2047966	S	125	10	135	0.00001
Oceanisphaera_profunda	1416627	S	60	7	67	0.00001
Oceanisphaera_avium	1903694	S	34	4	38	0.00000
Tolumonas_auensis	43948	S	77	34	111	0.00001
Succinivibrio_dextrinosolvens	83771	S	27	1	28	0.00000
Solimonas_sp._K1W22B-7	2303331	S	5490	562	6052	0.00049
Flagellatimonas_centrodinii	2806210	S	1466	103	1569	0.00013
Sinimarinibacterium_sp._NLF-5-8	2698684	S	724	410	1134	0.00009
Steroidobacter_denitrificans	465721	S	2878	879	3757	0.00030
Sulfurifustis_variabilis	1675686	S	5364	325	5689	0.00046
Sulfuricaulis_limicola	1620215	S	2120	162	2282	0.00019
Acidiferrobacter_sp._SPIII_3	1281578	S	693	198	891	0.00007
Acidiferrobacter_thiooxydans	163359	S	581	167	748	0.00006
Microbulbifer_sp._YPW16	2904242	S	478	42	520	0.00004
Microbulbifer_sp._SH-1	2681547	S	432	64	496	0.00004
Microbulbifer_sp._YPW1	2745199	S	259	44	303	0.00002
Microbulbifer_sp._ALW1	1516059	S	213	34	247	0.00002
Microbulbifer_sp._GL-2	2591606	S	103	17	120	0.00001
Microbulbifer_sp._THAF38	2587856	S	97	31	128	0.00001
Microbulbifer_sp._A4B17	359370	S	79	18	97	0.00001
Microbulbifer_aggregans	1769779	S	306	34	340	0.00003
Microbulbifer_thermotolerans	252514	S	276	15	291	0.00002
Microbulbifer_celer	435905	S	269	30	299	0.00002
Microbulbifer_hydrolyticus	48074	S	266	44	310	0.00003
Microbulbifer_elongatus	86173	S	254	37	291	0.00002
Microbulbifer_agarilyticus	260552	S	153	15	168	0.00001
Microbulbifer_variabilis	266805	S	80	26	106	0.00001
Kineobactrum_salinum	2708301	S	717	27	744	0.00006
Halioglobus_japonicus	930805	S	237	10	247	0.00002
Halioglobus_maricola	2601894	S	235	8	243	0.00002
Congregibacter_litoralis	393662	S	290	113	403	0.00003
Aequoribacter_fuscus	2518989	S	88	10	98	0.00001
Cellvibrio_sp._PSBB006	1987723	S	180	5	185	0.00002
Cellvibrio_sp._PSBB023	1945512	S	98	7	105	0.00001
Cellvibrio_sp._KY-YJ-3	454662	S	91	10	101	0.00001
Cellvibrio_sp._KY-GH-1	2303332	S	87	5	92	0.00001
Cellvibrio_japonicus	155077	S	138	9	147	0.00001
Simiduia_agarivorans	447471	S	243	11	254	0.00002
Teredinibacter_turnerae	2426	S	123	4	127	0.00001
Teredinibacter_haidensis	2731755	S	64	3	67	0.00001
Teredinibacter_purpureus	2731756	S	41	1	42	0.00000
Agarilytica_rhodophyticola	1737490	S	42	0	42	0.00000
Marinagarivorans_sp._GE09	2721545	S	40	3	43	0.00000
Saccharophagus_degradans	86304	S	37	1	38	0.00000
Spongiibacter_taiwanensis	1748242	S	212	8	220	0.00002
Spongiibacter_nanhainus	2794344	S	189	20	209	0.00002
Spongiibacter_sp._IMCC21906	1620392	S	62	14	76	0.00001
Zhongshania_aliphaticivorans	1470434	S	86	5	91	0.00001
Oceanicoccus_sagamiensis	716816	S	55	1	56	0.00000
Shewanella_sp._FJAT-53555	2864204	S	48	37	85	0.00001
Shewanella_sp._FJAT-54031	2864209	S	45	60	105	0.00001
Shewanella_sp._FJAT-53681	2864205	S	41	59	100	0.00001
Shewanella_sp._FJAT-53764	2864207	S	39	54	93	0.00001
Shewanella_sp._FJAT-52072	2864213	S	36	43	79	0.00001
Shewanella_sp._FJAT-52076	2864202	S	34	43	77	0.00001
Shewanella_sp._SNU_WT4	2590015	S	31	7	38	0.00000
Shewanella_sp._FJAT-51860	2864212	S	31	4	35	0.00000
Shewanella_sp._FJAT-53749	2864206	S	29	5	34	0.00000
Shewanella_sp._KX20019	2803864	S	29	3	32	0.00000
Shewanella_sp._FJAT-53532	2864203	S	27	41	68	0.00001
Shewanella_sp._Scap07	2589987	S	25	2	27	0.00000
Shewanella_sp._WE21	2029986	S	25	11	36	0.00000
Shewanella_sp._FJAT-53870	2864208	S	19	2	21	0.00000
Shewanella_sp._MR-4	60480	S	18	17	35	0.00000
Shewanella_sp._ANA-3	94122	S	18	44	62	0.00001
Shewanella_sp._FJAT-51754	2864211	S	15	19	34	0.00000
Shewanella_sp._OM3-2	2908650	S	15	2	17	0.00000
Shewanella_sp._Arc9-LZ	2698686	S	14	5	19	0.00000
Shewanella_sp._FJAT-51649	2864210	S	14	19	33	0.00000
Shewanella_sp._LZH-2	2806008	S	12	49	61	0.00000
Shewanella_algae	38313	S	147	114	261	0.00002
Shewanella_khirikhana	1965282	S	126	18	144	0.00001
Shewanella_cyperi	2814292	S	118	57	175	0.00001
Shewanella_litorisediminis	1173586	S	106	23	129	0.00001
Shewanella_putrefaciens	24	S	87	258	345	0.00003
Shewanella_marisflavi	260364	S	81	14	95	0.00001
Shewanella_amazonensis	60478	S	67	15	82	0.00001
Shewanella_sedimentimangrovi	2814293	S	63	42	105	0.00001
Shewanella_baltica	62322	S	58	62	120	0.00001
Shewanella_dokdonensis	712036	S	56	4	60	0.00000
Shewanella_sediminis	271097	S	55	6	61	0.00000
Shewanella_avicenniae	2814294	S	43	6	49	0.00000
Shewanella_denitrificans	192073	S	43	6	49	0.00000
Shewanella_yunxiaonensis	2829809	S	39	5	44	0.00000
Shewanella_benthica	43661	S	38	7	45	0.00000
Shewanella_violacea	60217	S	38	6	44	0.00000
Shewanella_loihica	359303	S	34	52	86	0.00001
Shewanella_maritima	2520507	S	31	2	33	0.00000
Shewanella_psychropiezotolerans	2593655	S	29	4	33	0.00000
Shewanella_oneidensis	70863	S	28	7	35	0.00000
Shewanella_pealeana	70864	S	28	4	32	0.00000
Shewanella_carassii	1987584	S	27	27	54	0.00000
Shewanella_vesiculosa	518738	S	27	6	33	0.00000
Shewanella_halifaxensis	271098	S	26	3	29	0.00000
Shewanella_decolorationis	256839	S	23	24	47	0.00000
Shewanella_psychrophila	225848	S	22	2	24	0.00000
Shewanella_inventionis	1738770	S	22	9	31	0.00000
Shewanella_piezotolerans	404011	S	22	2	24	0.00000
Shewanella_chilikensis	558541	S	20	56	76	0.00001
Shewanella_psychromarinicola	2487742	S	20	2	22	0.00000
Shewanella_xiamenensis	332186	S	20	92	112	0.00001
Shewanella_donghaensis	238836	S	17	1	18	0.00000
Shewanella_indica	768528	S	17	21	38	0.00000
Shewanella_woodyi	60961	S	17	1	18	0.00000
Shewanella_glacialimarina	2590884	S	17	2	19	0.00000
Shewanella_livingstonensis	150120	S	13	2	15	0.00000
Shewanella_aestuarii	1028752	S	12	3	15	0.00000
Parashewanella_tropica	2547970	S	19	2	21	0.00000
Parashewanella_spongiae	342950	S	16	1	17	0.00000
Alteromonas_sp._RKMC-009	2267264	S	66	6	72	0.00001
Alteromonas_sp._RW2A1	1917158	S	14	70	84	0.00001
Alteromonas_sp._76-1	2358187	S	14	5	19	0.00000
Alteromonas_macleodii	28108	S	80	28	108	0.00001
Alteromonas_pelagimontana	1858656	S	66	7	73	0.00001
Alteromonas_mediterranea	314275	S	47	13	60	0.00000
Alteromonas_australica	589873	S	16	30	46	0.00000
Alteromonas_stellipolaris	233316	S	11	44	55	0.00000
Alteromonas_naphthalenivorans	715451	S	11	6	17	0.00000
Salinimonas_lutimaris	914153	S	74	11	85	0.00001
Salinimonas_marina	2785918	S	59	5	64	0.00001
Salinimonas_iocasae	2572577	S	49	8	57	0.00000
Salinimonas_sediminis	2303538	S	34	6	40	0.00000
Hydrocarboniclastica_marina	2259620	S	309	38	347	0.00003
Agarivorans_sp._TSD2052	2937286	S	34	4	38	0.00000
Agarivorans_gilvus	680279	S	31	3	34	0.00000
Agarivorans_aestuarii	1563703	S	17	7	24	0.00000
Agarivorans_albus	182262	S	12	12	24	0.00000
Lacimicrobium_alkaliphilum	1526571	S	104	6	110	0.00001
Paraglaciecola_sp._L1A13	2686359	S	22	3	25	0.00000
Paraglaciecola_sp._L3A3	2686358	S	20	1	21	0.00000
Paraglaciecola_psychrophila	326544	S	29	2	31	0.00000
Paraglaciecola_mesophila	197222	S	23	3	26	0.00000
Saliniradius_amylolyticus	2183582	S	89	7	96	0.00001
Paraneptunicella_aestuarii	2831148	S	37	1	38	0.00000
Catenovulum_sediminis	1740262	S	29	1	30	0.00000
Glaciecola_nitratireducens	300231	S	28	1	29	0.00000
Saccharobesus_litoralis	2172099	S	18	1	19	0.00000
Pseudoalteromonas_sp._R3	1709477	S	40	8	48	0.00000
Pseudoalteromonas_sp._A25	116092	S	28	9	37	0.00000
Pseudoalteromonas_rubra	43658	S	117	11	128	0.00001
Pseudoalteromonas_viridis	339617	S	79	20	99	0.00001
Pseudoalteromonas_luteoviolacea	43657	S	68	8	76	0.00001
Pseudoalteromonas_donghaensis	621376	S	40	195	235	0.00002
Pseudoalteromonas_piscicida	43662	S	35	20	55	0.00000
Pseudoalteromonas_xiamenensis	882626	S	31	3	34	0.00000
Pseudoalteromonas_ulvae	107327	S	25	1	26	0.00000
Pseudoalteromonas_spongiae	298657	S	25	3	28	0.00000
Pseudoalteromonas_shioyasakiensis	1190813	S	21	7	28	0.00000
Pseudoalteromonas_prydzensis	182141	S	18	2	20	0.00000
Pseudoalteromonas_agarivorans	176102	S	18	33	51	0.00000
Pseudoalteromonas_mariniglutinosa	206042	S	16	17	33	0.00000
Pseudoalteromonas_tunicata	314281	S	15	1	16	0.00000
Pseudoalteromonas_phenolica	161398	S	14	1	15	0.00000
Pseudoalteromonas_translucida	166935	S	13	27	40	0.00000
Pseudoalteromonas_aliena	247523	S	12	3	15	0.00000
Pseudoalteromonas_espejiana	28107	S	11	1	12	0.00000
Pseudoalteromonas_piratica	1348114	S	10	1	11	0.00000
Pseudoalteromonas_ruthenica	151081	S	10	6	16	0.00000
Psychrosphaera_ytuae	2820710	S	15	3	18	0.00000
Flocculibacter_collagenilyticus	2744479	S	11	0	11	0.00000
Ferrimonas_balearica	44012	S	352	42	394	0.00003
Ferrimonas_lipolytica	2724191	S	70	9	79	0.00001
Thalassotalea_sp._HSM_43	2552945	S	36	5	41	0.00000
Thalassotalea_sp._LPB0316	2769490	S	24	7	31	0.00000
Thalassotalea_sp._PS06	2594005	S	20	2	22	0.00000
Thalassotalea_crassostreae	1763536	S	19	1	20	0.00000
Colwellia_sp._PAMC_20917	1816218	S	25	1	26	0.00000
Colwellia_sp._Arc7-D	2161872	S	16	3	19	0.00000
Colwellia_sp._20A7	2689569	S	13	1	14	0.00000
Colwellia_sp._MT41	58049	S	10	1	11	0.00000
Colwellia_sp._Arc7-635	2497879	S	10	1	11	0.00000
Colwellia_psychrerythraea	28229	S	14	1	15	0.00000
Litorilituus_sediminis	718192	S	17	1	18	0.00000
Cognaticolwellia_beringensis	1967665	S	14	3	17	0.00000
Idiomarina_sp._OT37-5b	2100422	S	66	12	78	0.00001
Idiomarina_sp._X4	2055892	S	14	4	18	0.00000
Idiomarina_abyssalis	86102	S	31	3	34	0.00000
Idiomarina_loihiensis	135577	S	30	0	30	0.00000
Idiomarina_piscisalsi	1096243	S	20	6	26	0.00000
Moritella_sp._24	2746230	S	12	3	15	0.00000
Moritella_sp._5	2746231	S	10	24	34	0.00000
Moritella_yayanosii	69539	S	23	7	30	0.00000
Moritella_marina	90736	S	20	5	25	0.00000
Psychromonas_ingrahamii	357794	S	42	7	49	0.00000
Psychromonas_sp._CNPT3	314282	S	13	3	16	0.00000
Aquicella_siphonis	254247	S	3334	101	3435	0.00028
Aquicella_lusitana	254246	S	131	4	135	0.00001
Coxiella_burnetii	777	S	117	34	151	0.00001
Coxiella_endosymbiont_of_Amblyomma_nuttalli	2749996	S	32	2	34	0.00000
Coxiella_endosymbiont_of_Amblyomma_sculptum	2487929	S	20	4	24	0.00000
Candidatus_Coxiella_mudrowiae	2054173	S	34	2	36	0.00000
Candidatus_Rickettsiella_viridis	676208	S	10	9	19	0.00000
Rickettsiella_endosymbiont_of_Dermanyssus_gallinae	2856608	S	10	8	18	0.00000
Legionella_pneumophila	446	S	691	158	849	0.00007
Legionella_sp._MW5194	2662448	S	70	8	78	0.00001
Legionella_sp._PC1000	2746060	S	38	5	43	0.00000
Legionella_sp._PC997	2755562	S	25	4	29	0.00000
Legionella_waltersii	66969	S	124	12	136	0.00001
Legionella_geestiana	45065	S	121	7	128	0.00001
Legionella_spiritensis	452	S	74	5	79	0.00001
Legionella_fallonii	96230	S	48	2	50	0.00000
Legionella_sainthelensi	28087	S	48	5	53	0.00000
Legionella_longbeachae	450	S	38	4	42	0.00000
Legionella_israelensis	454	S	37	1	38	0.00000
Legionella_antarctica	2708020	S	33	1	34	0.00000
Legionella_oakridgensis	29423	S	31	1	32	0.00000
Legionella_cherrii	28084	S	31	1	32	0.00000
Legionella_clemsonensis	1867846	S	29	2	31	0.00000
Legionella_jordanis	456	S	29	2	31	0.00000
Legionella_lansingensis	45067	S	28	1	29	0.00000
Legionella_adelaidensis	45056	S	27	1	28	0.00000
Legionella_anisa	28082	S	27	4	31	0.00000
Legionella_hackeliae	449	S	25	2	27	0.00000
Legionella_endosymbiont_of_Polyplax_serrata	2005262	S	10	0	10	0.00000
Tatlockia_micdadei	451	S	34	1	35	0.00000
Fluoribacter_dumoffii	463	S	25	9	34	0.00000
Vibrio_parahaemolyticus	670	S	120	39	159	0.00001
Vibrio_harveyi	669	S	41	12	53	0.00000
Vibrio_campbellii	680	S	32	28	60	0.00000
Vibrio_alginolyticus	663	S	31	44	75	0.00001
Vibrio_owensii	696485	S	30	16	46	0.00000
Vibrio_diabolicus	50719	S	23	19	42	0.00000
Vibrio_rotiferianus	190895	S	22	8	30	0.00000
Vibrio_azureus	512649	S	21	2	23	0.00000
Vibrio_natriegens	691	S	19	19	38	0.00000
Vibrio_jasicida	766224	S	14	13	27	0.00000
Vibrio_sp._OG9-811	2841925	S	96	15	111	0.00001
Vibrio_sp._VB16	2785746	S	32	2	34	0.00000
Vibrio_sp._B1FLJ16	2751178	S	32	7	39	0.00000
Vibrio_sp._SCSIO_43132	2779363	S	27	9	36	0.00000
Vibrio_sp._SS-MA-C1-2	2908646	S	21	3	24	0.00000
Vibrio_sp._THAF190c	2587865	S	21	2	23	0.00000
Vibrio_sp._HDW18	2714948	S	21	3	24	0.00000
Vibrio_sp._Scap24	2589990	S	14	7	21	0.00000
Vibrio_sp._ED004	2785124	S	11	5	16	0.00000
Vibrio_fluvialis	676	S	180	32	212	0.00002
Vibrio_furnissii	29494	S	169	54	223	0.00002
Vibrio_vulnificus	672	S	150	30	180	0.00001
Vibrio_sinaloensis	379097	S	38	5	43	0.00000
Vibrio_tubiashii	29498	S	31	13	44	0.00000
Vibrio_europaeus	300876	S	20	6	26	0.00000
Vibrio_cholerae	666	S	90	1144	1234	0.00010
Vibrio_anguillarum	55601	S	86	16	102	0.00001
Vibrio_navarrensis	29495	S	57	15	72	0.00001
Vibrio_cyclitrophicus	47951	S	54	13	67	0.00001
Vibrio_maritimus	990268	S	50	5	55	0.00000
Vibrio_mimicus	674	S	48	11	59	0.00000
Vibrio_coralliilyticus	190893	S	45	13	58	0.00000
Vibrio_gazogenes	687	S	40	4	44	0.00000
Vibrio_nigripulchritudo	28173	S	38	7	45	0.00000
Vibrio_tritonius	1435069	S	36	4	40	0.00000
Vibrio_alfacsensis	1074311	S	35	15	50	0.00000
Vibrio_taketomensis	2572923	S	35	4	39	0.00000
Vibrio_spartinae	1918945	S	34	3	37	0.00000
Vibrio_zhugei	2479546	S	34	8	42	0.00000
Vibrio_astriarenae	1481923	S	34	4	38	0.00000
Vibrio_tapetis	52443	S	34	2	36	0.00000
Vibrio_metschnikovii	28172	S	33	6	39	0.00000
Vibrio_ponticus	265668	S	31	2	33	0.00000
Vibrio_mediterranei	689	S	31	3	34	0.00000
Vibrio_penaeicida	104609	S	30	3	33	0.00000
Vibrio_panuliri	1381081	S	30	4	34	0.00000
Vibrio_algicola	2662262	S	28	4	32	0.00000
Vibrio_cincinnatiensis	675	S	26	5	31	0.00000
Vibrio_neptunius	170651	S	25	3	28	0.00000
Vibrio_rumoiensis	76258	S	25	15	40	0.00000
Vibrio_splendidus	29497	S	23	6	29	0.00000
Vibrio_metoecus	1481663	S	23	7	30	0.00000
Vibrio_crassostreae	246167	S	22	7	29	0.00000
Vibrio_scophthalmi	45658	S	22	4	26	0.00000
Vibrio_cidicii	1763883	S	22	7	29	0.00000
Vibrio_breoganii	553239	S	21	2	23	0.00000
Vibrio_chagasii	170679	S	20	3	23	0.00000
Vibrio_gigantis	296199	S	17	4	21	0.00000
Vibrio_kanaloae	170673	S	17	4	21	0.00000
Vibrio_aquimaris	2587862	S	16	1	17	0.00000
Vibrio_bathopelagicus	2777577	S	14	3	17	0.00000
Vibrio_casei	673372	S	13	3	16	0.00000
Vibrio_ziniensis	2711221	S	13	1	14	0.00000
Vibrio_atlanticus	693153	S	12	2	14	0.00000
Vibrio_aphrogenes	1891186	S	10	1	11	0.00000
Photobacterium_sp._GJ3	2829502	S	102	14	116	0.00001
Photobacterium_sp._TLY01	2907534	S	72	13	85	0.00001
Photobacterium_gaetbulicola	1295392	S	119	12	131	0.00001
Photobacterium_damselae	38293	S	102	49	151	0.00001
Photobacterium_ganghwense	320778	S	97	23	120	0.00001
Photobacterium_profundum	74109	S	19	2	21	0.00000
Salinivibrio_kushneri	1908198	S	53	8	61	0.00000
Salinivibrio_sp._YCSC6	2003370	S	11	19	30	0.00000
Salinivibrio_costicola	51367	S	10	18	28	0.00000
Grimontia_hollisae	673	S	76	9	85	0.00001
Thaumasiovibrio_subtropicus	1891207	S	44	5	49	0.00000
Aliivibrio_fischeri	668	S	20	3	23	0.00000
Aliivibrio_salmonicida	40269	S	10	3	13	0.00000
Candidatus_Enterovibrio_luxaltus	1927128	S	16	0	16	0.00000
Immundisolibacter_cernigliae	1810504	S	3099	587	3686	0.00030
Acinetobacter_sp._WCHAc010034	1879049	S	126	57	183	0.00001
Acinetobacter_sp._10FS3-1	2563897	S	22	14	36	0.00000
Acinetobacter_sp._TGL-Y2	1407071	S	18	1	19	0.00000
Acinetobacter_sp._TTH0-4	1646498	S	17	3	20	0.00000
Acinetobacter_sp._Marseille-Q1620	2714110	S	16	1	17	0.00000
Acinetobacter_sp._ASP199	2773709	S	15	7	22	0.00000
Acinetobacter_sp._LoGeW2-3	1808001	S	14	3	17	0.00000
Acinetobacter_sp._CS-2	2798861	S	13	7	20	0.00000
Acinetobacter_baumannii	470	S	112	565	677	0.00005
Acinetobacter_pittii	48296	S	30	54	84	0.00001
Acinetobacter_calcoaceticus	471	S	29	4	33	0.00000
Acinetobacter_seifertii	1530123	S	28	12	40	0.00000
Acinetobacter_nosocomialis	106654	S	13	6	19	0.00000
Acinetobacter_indicus	756892	S	74	52	126	0.00001
Acinetobacter_johnsonii	40214	S	57	64	121	0.00001
Acinetobacter_soli	487316	S	33	3	36	0.00000
Acinetobacter_lwoffii	28090	S	32	52	84	0.00001
Acinetobacter_schindleri	108981	S	31	25	56	0.00000
Acinetobacter_radioresistens	40216	S	28	5	33	0.00000
Acinetobacter_haemolyticus	29430	S	25	15	40	0.00000
Acinetobacter_wuhouensis	1879050	S	23	11	34	0.00000
Acinetobacter_equi	1324350	S	21	2	23	0.00000
Acinetobacter_tandoii	202954	S	21	2	23	0.00000
Acinetobacter_junii	40215	S	19	7	26	0.00000
Acinetobacter_larvae	1789224	S	18	1	19	0.00000
Acinetobacter_baylyi	202950	S	17	1	18	0.00000
Acinetobacter_variabilis	70346	S	17	24	41	0.00000
Acinetobacter_bouvetii	202951	S	16	3	19	0.00000
Acinetobacter_piscicola	2006115	S	16	8	24	0.00000
Acinetobacter_defluvii	1871111	S	15	10	25	0.00000
Acinetobacter_gyllenbergii	134534	S	15	1	16	0.00000
Acinetobacter_towneri	202956	S	14	30	44	0.00000
Acinetobacter_portensis	1839785	S	13	12	25	0.00000
Acinetobacter_shaoyimingii	2715164	S	11	1	12	0.00000
Psychrobacter_sp._DAB_AL43B	1028416	S	23	11	34	0.00000
Psychrobacter_sp._28M-43	2772254	S	16	15	31	0.00000
Psychrobacter_sp._P11F6	1699621	S	15	21	36	0.00000
Psychrobacter_sp._P11G5	1699624	S	15	46	61	0.00000
Psychrobacter_sp._KCTC_72983	2733866	S	15	52	67	0.00001
Psychrobacter_sp._WY6	2708350	S	10	13	23	0.00000
Psychrobacter_arenosus	256326	S	37	5	42	0.00000
Psychrobacter_urativorans	45610	S	19	8	27	0.00000
Psychrobacter_arcticus	334543	S	13	17	30	0.00000
Moraxella_osloensis	34062	S	96	15	111	0.00001
Moraxella_bovoculi	386891	S	28	31	59	0.00000
Moraxella_bovis	476	S	22	4	26	0.00000
Moraxella_catarrhalis	480	S	21	3	24	0.00000
Moraxella_sp._ZY201115	2904121	S	21	1	22	0.00000
Moraxella_cuniculi	34061	S	18	1	19	0.00000
Moraxella_nonliquefaciens	478	S	10	1	11	0.00000
Aquirhabdus_parva	2283318	S	58	2	60	0.00000
Candidatus_Endoriftia_persephone	393765	S	692	33	725	0.00006
Candidatus_Ruthia_magnifica	386487	S	11	3	14	0.00000
Bathymodiolus_thermophilus_thioautotrophic_gill_symbiont	2360	S	16	1	17	0.00000
Bathymodiolus_septemdierum_thioautotrophic_gill_symbiont	113267	S	14	2	16	0.00000
Sedimenticola_thiotaurini	1543721	S	391	16	407	0.00003
Candidatus_Reidiella_endopervernicosa	2738883	S	300	5	305	0.00002
Thiolapillus_brandeum	1076588	S	243	5	248	0.00002
Pseudohongiella_spirulinae	1249552	S	138	3	141	0.00001
Gallaecimonas_mangrovi	2291597	S	95	7	102	0.00001
Celerinatantimonas_diazotrophica	412034	S	41	3	44	0.00000
Ignatzschineria_sp._HR5S32	2923279	S	30	2	32	0.00000
Candidatus_Pseudothioglobus_singularis	1427364	S	24	7	31	0.00000
Candidatus_Thioglobus_autotrophicus	1705394	S	15	1	16	0.00000
Candidatus_Azoamicus_ciliaticola	2652803	S	13	1	14	0.00000
Thiomicrorhabdus_xiamenensis	2739063	S	76	4	80	0.00001
Thiomicrorhabdus_aquaedulcis	2211106	S	36	1	37	0.00000
Thiomicrorhabdus_sediminis	2580412	S	35	1	36	0.00000
Thiomicrorhabdus_sp._Am19	2791037	S	32	1	33	0.00000
Thiomicrorhabdus_indica	2267253	S	17	0	17	0.00000
Methylophaga_frappieri	754477	S	58	32	90	0.00001
Methylophaga_nitratireducenticrescens	754476	S	54	10	64	0.00001
Methylophaga_sp._TMB456	2881052	S	46	16	62	0.00001
Thiomicrospira_sp._S5	1803865	S	54	36	90	0.00001
Thiomicrospira_cyclica	147268	S	41	4	45	0.00000
Thiomicrospira_aerophila	92245	S	32	7	39	0.00000
Thiomicrospira_microaerophila	406020	S	30	7	37	0.00000
Hydrogenovibrio_thermophilus	265883	S	62	41	103	0.00001
Hydrogenovibrio_marinus	28885	S	41	1	42	0.00000
Hydrogenovibrio_crunogenus	39765	S	16	0	16	0.00000
Thiosulfatimonas_sediminis	2675054	S	43	2	45	0.00000
Piscirickettsia_salmonis	1238	S	39	2	41	0.00000
Thiosulfativibrio_zosterae	2675053	S	26	1	27	0.00000
Thiothrix_litoralis	2891210	S	154	10	164	0.00001
Thiothrix_subterranea	2735563	S	110	27	137	0.00001
Thiothrix_sp._CT3	96472	S	102	30	132	0.00001
Thiothrix_unzii	111769	S	80	38	118	0.00001
Candidatus_Thiothrix_anitrata	2823902	S	49	26	75	0.00001
Beggiatoa_leptomitoformis	288004	S	54	0	54	0.00000
Francisella_tularensis	263	S	20	72	92	0.00001
Francisella_philomiragia	28110	S	14	8	22	0.00000
Francisella_frigiditurris	1542390	S	12	0	12	0.00000
Francisella_halioticida	549298	S	11	0	11	0.00000
Salinisphaera_sp._LB1	2183911	S	1453	54	1507	0.00012
endosymbiont_of_unidentified_scaly_snail_isolate_Monju	1248727	S	1162	96	1258	0.00010
Pasteurella_multocida	747	S	163	373	536	0.00004
Pasteurella_canis	753	S	10	2	12	0.00000
Haemophilus_parainfluenzae	729	S	59	22	81	0.00001
Haemophilus_influenzae	727	S	38	32	70	0.00001
[Haemophilus]_ducreyi	730	S	20	8	28	0.00000
Haemophilus_haemolyticus	726	S	18	8	26	0.00000
Haemophilus_parahaemolyticus	735	S	16	3	19	0.00000
Haemophilus_pittmaniae	249188	S	13	2	15	0.00000
Aggregatibacter_actinomycetemcomitans	714	S	64	9	73	0.00001
Aggregatibacter_aphrophilus	732	S	38	19	57	0.00000
Aggregatibacter_sp._Marseille-P9115	2866570	S	13	12	25	0.00000
Aggregatibacter_sp._oral_taxon_513	712150	S	10	9	19	0.00000
Aggregatibacter_sp._2125159857	2820817	S	10	4	14	0.00000
Actinobacillus_sp._GY-402	2774188	S	48	21	69	0.00001
Actinobacillus_pleuropneumoniae	715	S	21	21	42	0.00000
Actinobacillus_porcitonsillarum	189834	S	11	4	15	0.00000
Mannheimia_granulomatis	85402	S	33	6	39	0.00000
Mannheimia_varigena	85404	S	26	15	41	0.00000
Mannheimia_haemolytica	75985	S	25	9	34	0.00000
Avibacterium_paragallinarum	728	S	27	6	33	0.00000
Avibacterium_volantium	762	S	11	2	13	0.00000
Glaesserella_parasuis	738	S	25	21	46	0.00000
Glaesserella_sp._15-184	2030797	S	24	7	31	0.00000
Rodentibacter_heylii	1906744	S	27	2	29	0.00000
Rodentibacter_haemolyticus	2778911	S	12	1	13	0.00000
Gallibacterium_anatis	750	S	21	5	26	0.00000
Histophilus_somni	731	S	18	4	22	0.00000
Bibersteinia_trehalosi	47735	S	14	7	21	0.00000
Vespertiliibacter_pulmonis	1443036	S	13	2	15	0.00000
Bisgaardia_hudsonensis	109472	S	12	1	13	0.00000
Frederiksenia_canicola	123824	S	11	2	13	0.00000
Cardiobacterium_hominis	2718	S	420	89	509	0.00004
Cardiobacterium_sp._Marseille-Q4385	2866573	S	289	53	342	0.00003
Suttonella_sp._R2A3	2908648	S	42	2	44	0.00000
Dichelobacter_nodosus	870	S	27	6	33	0.00000
Kangiella_koreensis	261964	S	44	5	49	0.00000
Kangiella_profundi	1561924	S	39	6	45	0.00000
Kangiella_geojedonensis	914150	S	23	1	24	0.00000
Kangiella_sediminilitoris	1144748	S	23	1	24	0.00000
Gilliamella_sp._ESL0441	2704654	S	16	11	27	0.00000
Gilliamella_sp._ESL0405	2704653	S	11	3	14	0.00000
Gilliamella_apicola	1196095	S	12	4	16	0.00000
Zophobihabitans_entericus	1635327	S	21	1	22	0.00000
Acidithiobacillus_caldus	33059	S	451	68	519	0.00004
Acidithiobacillus_ferrivorans	160808	S	251	42	293	0.00002
Acidithiobacillus_ferrooxidans	920	S	202	161	363	0.00003
Acidithiobacillus_thiooxidans	930	S	119	5	124	0.00001
Acidithiobacillus_ferriphilus	1689834	S	116	20	136	0.00001
Acidithiobacillus_ferridurans	1232575	S	20	146	166	0.00001
Acidithiobacillus_sp._'AMD_consortium'	2614801	S	12	138	150	0.00001
Bdellovibrio_bacteriovorus	959	S	338	40	378	0.00003
Bdellovibrio_sp._LBG001	2835041	S	75	8	83	0.00001
Bdellovibrio_sp._NC01	2220073	S	62	7	69	0.00001
Bdellovibrio_sp._ZAP7	2231053	S	53	24	77	0.00001
Bdellovibrio_sp._KM01	2748865	S	43	20	63	0.00001
Pseudobdellovibrio_exovorus	453816	S	49	2	51	0.00000
Bacteriovorax_stolpii	960	S	50	12	62	0.00001
Halobacteriovorax_marinus	97084	S	15	6	21	0.00000
Halobacteriovorax_sp._BALOs_7	2109558	S	13	4	17	0.00000
Fluviispira_sanaruensis	2493639	S	28	7	35	0.00000
Silvanigrella_aquatica	1915309	S	22	5	27	0.00000
Hydrogenophilus_thermoluteolus	297	S	604	88	692	0.00006
Mariprofundus_ferrinatatus	1921087	S	173	23	196	0.00002
Mariprofundus_aestuarium	1921086	S	110	16	126	0.00001
Gemmata_obscuriglobus	114	S	18531	2885	21416	0.00174
Gemmata_massiliana	1210884	S	7187	3076	10263	0.00083
Gemmata_sp._SH-PL17	1630693	S	6717	3242	9959	0.00081
Urbifossiella_limnaea	2528023	S	32949	2590	35539	0.00288
Frigoriglobus_tundricola	2774151	S	21536	3318	24854	0.00202
Limnoglobus_roseus	2598579	S	15489	678	16167	0.00131
Tuwongella_immobilis	692036	S	1590	61	1651	0.00013
Telmatocola_sphagniphila	1123043	S	1459	12	1471	0.00012
Tautonia_plasticadhaerens	2527974	S	32229	2438	34667	0.00281
Aquisphaera_giovannonii	406548	S	23915	3632	27547	0.00224
Paludisphaera_borealis	1387353	S	15500	3125	18625	0.00151
Singulisphaera_acidiphila	466153	S	10551	1424	11975	0.00097
Isosphaera_pallida	128	S	2088	140	2228	0.00018
Planctomyces_sp._SH-PL62	1636152	S	14145	4364	18509	0.00150
Planctomyces_sp._SH-PL14	1632864	S	5824	355	6179	0.00050
Gimesia_panareensis	2527978	S	1200	147	1347	0.00011
Gimesia_chilikensis	2605989	S	718	454	1172	0.00010
Gimesia_maris	122	S	467	75	542	0.00004
Gimesia_algae	2527971	S	300	78	378	0.00003
Gimesia_alba	2527973	S	297	54	351	0.00003
Gimesia_fumaroli	2527976	S	254	53	307	0.00002
Gimesia_benthica	2608982	S	191	281	472	0.00004
Gimesia_aquarii	2527964	S	184	12	196	0.00002
Caulifigura_coniformis	2527983	S	4439	284	4723	0.00038
Maioricimonas_rarisocia	2528026	S	4058	526	4584	0.00037
Alienimonas_californiensis	2527989	S	3622	255	3877	0.00031
Symmachiella_dynata	2527995	S	1548	94	1642	0.00013
Planctopirus_ephydatiae	2528019	S	308	139	447	0.00004
Planctopirus_limnophila	120	S	285	121	406	0.00003
Rubinisphaera_brasiliensis	119	S	795	79	874	0.00007
Fuerstiella_marisgermanici	1891926	S	788	14	802	0.00007
Calycomorphotria_hydatis	2528027	S	743	28	771	0.00006
Crateriforma_conspicua	2527996	S	699	125	824	0.00007
Thalassoglobus_polymorphus	2527994	S	334	17	351	0.00003
Polystyrenella_longa	2528007	S	287	25	312	0.00003
Lacipirellula_parvula	2650471	S	4409	542	4951	0.00040
Lacipirellula_limnantheis	2528024	S	4141	602	4743	0.00038
Pirellulimonas_nuda	2528009	S	4935	558	5493	0.00045
Botrimarina_mediterranea	2528022	S	4204	410	4614	0.00037
Aeoliella_mucimassa	2527972	S	1510	136	1646	0.00013
Adhaeretor_mobilis	1930276	S	837	88	925	0.00008
Bythopirellula_goksoeyrii	1400387	S	706	56	762	0.00006
Lignipirellula_cremea	2528010	S	3257	370	3627	0.00029
Stieleria_neptunia	2527979	S	1413	163	1576	0.00013
Stieleria_maiorica	2795974	S	1399	274	1673	0.00014
Rosistilla_oblonga	2527990	S	795	382	1177	0.00010
Rosistilla_ulvae	1930277	S	542	323	865	0.00007
Rosistilla_carotiformis	2528017	S	538	230	768	0.00006
Anatilimnocola_aggregata	2528021	S	2463	262	2725	0.00022
Bremerella_volcania	2527984	S	1921	135	2056	0.00017
Pirellula_staleyi	125	S	1308	48	1356	0.00011
Pirellula_sp._SH-Sr6A	1632865	S	449	12	461	0.00004
Roseimaritima_ulvae	980254	S	1246	78	1324	0.00011
Roseimaritima_multifibrata	1930274	S	362	39	401	0.00003
Rubripirellula_lacrimiformis	1930273	S	678	124	802	0.00007
Mariniblastus_fucicola	980251	S	508	9	517	0.00004
Aureliella_helgolandensis	2527968	S	454	36	490	0.00004
Rhodopirellula_baltica	265606	S	449	29	478	0.00004
Thermogutta_terrifontis	1331910	S	656	20	676	0.00005
Humisphaera_borealis	2807512	S	6137	128	6265	0.00051
Phycisphaera_mikurensis	547188	S	2818	197	3015	0.00024
Mucisphaera_calidilacus	2527982	S	1307	72	1379	0.00011
Poriferisphaera_corsica	2528020	S	181	1	182	0.00001
Anaerohalosphaera_lusitana	1936003	S	252	6	258	0.00002
Limihaloglobus_sulfuriphilus	1851148	S	118	6	124	0.00001
Sedimentisphaera_salicampi	1941349	S	46	13	59	0.00000
Sedimentisphaera_cyanobacteriorum	1940790	S	41	51	92	0.00001
Candidatus_Kuenenia_stuttgartiensis	174633	S	142	0	142	0.00001
Candidatus_Uabimicrobium_amorphum	2596890	S	82	1	83	0.00001
Opitutus_terrae	107709	S	4135	184	4319	0.00035
Opitutus_sp._GAS368	1882749	S	3853	569	4422	0.00036
Lacunisphaera_limnophila	1838286	S	3039	448	3487	0.00028
Oleiharenicola_sp._KSB-15	2862869	S	2062	110	2172	0.00018
Nibricoccus_aquaticus	2576891	S	1643	77	1720	0.00014
Ereboglobus_luteus	1796921	S	1330	66	1396	0.00011
Ruficoccus_sp._ZRK36	2866311	S	616	62	678	0.00006
Coraliomargarita_akajimensis	395922	S	161	3	164	0.00001
Verrucomicrobium_sp._GAS474	1882831	S	2144	218	2362	0.00019
Verrucomicrobium_spinosum	2736	S	1074	75	1149	0.00009
Luteolibacter_ambystomatis	2824561	S	1229	93	1322	0.00011
Luteolibacter_luteus	2728835	S	995	53	1048	0.00009
Roseimicrobium_sp._ORNL1	2711231	S	1344	56	1400	0.00011
Sulfuriroseicoccus_oceanibius	2707525	S	366	46	412	0.00003
Akkermansia_muciniphila	239935	S	826	85	911	0.00007
Akkermansia_glycaniphila	1679444	S	315	23	338	0.00003
Methylacidimicrobium_sp._AP8	2730359	S	601	94	695	0.00006
Methylacidimicrobium_sp._B4	2796139	S	540	124	664	0.00005
Candidatus_Xiphinematobacter_sp._Idaho_Grape	1704307	S	193	16	209	0.00002
Methylacidiphilum_sp._IT6	2795386	S	27	2	29	0.00000
Methylacidiphilum_sp._IT5	2795384	S	13	29	42	0.00000
Methylacidiphilum_kamchatkense	431057	S	33	2	35	0.00000
Methylacidiphilum_infernorum	511746	S	10	21	31	0.00000
Kiritimatiella_glycovorans	1307763	S	769	831	1600	0.00013
Tichowtungia_aerotolerans	2697043	S	274	8	282	0.00002
Candidatus_Protochlamydia_naegleriophila	389348	S	83	57	140	0.00001
Candidatus_Protochlamydia_amoebophila	362787	S	62	41	103	0.00001
Parachlamydia_acanthamoebae	83552	S	80	21	101	0.00001
Neochlamydia_sp._S13	1353976	S	50	8	58	0.00000
Candidatus_Rhabdochlamydia_oedothoracis	2720720	S	23	25	48	0.00000
Candidatus_Rhabdochlamydia_porcellionis	225148	S	16	23	39	0.00000
Waddlia_chondrophila	71667	S	48	9	57	0.00000
Simkania_negevensis	83561	S	43	4	47	0.00000
Chlamydia_pneumoniae	83558	S	15	46	61	0.00000
Candidatus_Velamenicoccus_archaeovorus	1930593	S	286	0	286	0.00002
Gemmatirosa_kalamazoonesis	861299	S	77053	5024	82077	0.00666
Gemmatimonas_groenlandica	2732249	S	6953	762	7715	0.00063
Gemmatimonas_aurantiaca	173480	S	5127	501	5628	0.00046
Gemmatimonas_phototrophica	1379270	S	4314	583	4897	0.00040
Hymenobacter_sp._5317J-9	2932250	S	743	174	917	0.00007
Hymenobacter_sp._PAMC_26554	1484116	S	721	69	790	0.00006
Hymenobacter_sp._PAMC_26628	1484118	S	711	173	884	0.00007
Hymenobacter_sp._APR13	1356852	S	598	246	844	0.00007
Hymenobacter_sp._BRD128	2675878	S	568	75	643	0.00005
Hymenobacter_sp._5116S-3	2932248	S	401	62	463	0.00004
Hymenobacter_sp._5116S-27	2932249	S	393	62	455	0.00004
Hymenobacter_sp._BT18	2835648	S	356	46	402	0.00003
Hymenobacter_sp._DG01	2584940	S	318	88	406	0.00003
Hymenobacter_sp._S2-20-2	2761579	S	313	48	361	0.00003
Hymenobacter_sp._5420S-77	2932254	S	286	39	325	0.00003
Hymenobacter_sp._BRD67	2675877	S	281	276	557	0.00005
Hymenobacter_sp._NBH84	2596915	S	280	42	322	0.00003
Hymenobacter_sp._DG25B	1385664	S	264	100	364	0.00003
Hymenobacter_sp._5413J-13	2932251	S	259	38	297	0.00002
Hymenobacter_sp._DG25A	1385663	S	214	83	297	0.00002
Hymenobacter_sp._HDW8	2714932	S	119	393	512	0.00004
Hymenobacter_sp._5516S-25	2933777	S	72	308	380	0.00003
Hymenobacter_sp._5516J-16	2932253	S	71	322	393	0.00003
Hymenobacter_monticola	1705399	S	678	124	802	0.00007
Hymenobacter_busanensis	2607656	S	678	72	750	0.00006
Hymenobacter_sedentarius	1411621	S	658	97	755	0.00006
Hymenobacter_nivis	1850093	S	508	130	638	0.00005
Hymenobacter_oligotrophus	2319843	S	459	47	506	0.00004
Hymenobacter_jejuensis	2502781	S	409	30	439	0.00004
Hymenobacter_swuensis	1446467	S	304	67	371	0.00003
Hymenobacter_baengnokdamensis	2615203	S	282	309	591	0.00005
Hymenobacter_tibetensis	497967	S	267	41	308	0.00003
Hymenobacter_qilianensis	1385715	S	256	46	302	0.00002
Hymenobacter_radiodurans	2496028	S	103	355	458	0.00004
Pontibacter_russatus	2694929	S	656	65	721	0.00006
Pontibacter_actiniarum	323450	S	377	88	465	0.00004
Pontibacter_akesuensis	388950	S	202	30	232	0.00002
Pontibacter_sp._SGAir0037	2571030	S	104	17	121	0.00001
Pontibacter_korlensis	400092	S	93	13	106	0.00001
Pontibacter_pudoricolor	2694930	S	92	10	102	0.00001
Rufibacter_radiotolerans	1379910	S	176	23	199	0.00002
Rufibacter_tibetensis	512763	S	135	25	160	0.00001
Rufibacter_sp._DG15C	1379909	S	110	70	180	0.00001
Adhaeribacter_swui	2086471	S	100	11	111	0.00001
Adhaeribacter_radiodurans	2745197	S	83	8	91	0.00001
Nibribacter_ruber	2698458	S	122	77	199	0.00002
Spirosoma_sp._CJU-R4	2728024	S	377	26	403	0.00003
Spirosoma_sp._KUDC1026	2745947	S	214	17	231	0.00002
Spirosoma_sp._RHs26	2898794	S	154	10	164	0.00001
Spirosoma_sp._KCTC_42546	2520506	S	148	17	165	0.00001
Spirosoma_sp._KCTC_72228	2710596	S	119	13	132	0.00001
Spirosoma_rigui	564064	S	281	18	299	0.00002
Spirosoma_taeanense	2735870	S	261	21	282	0.00002
Spirosoma_montaniterrae	1178516	S	213	11	224	0.00002
Spirosoma_pollinicola	2057025	S	159	13	172	0.00001
Spirosoma_endbachense	2666025	S	155	72	227	0.00002
Spirosoma_radiotolerans	1379870	S	152	10	162	0.00001
Spirosoma_aerolatum	1211326	S	139	6	145	0.00001
Spirosoma_aureum	2692134	S	107	60	167	0.00001
Rhodocytophaga_rosea	2704465	S	109	3	112	0.00001
Aquirufa_sp._9H-EGSE	2696560	S	33	11	44	0.00000
Cytophaga_hutchinsonii	985	S	42	3	45	0.00000
Dyadobacter_fermentans	94254	S	508	37	545	0.00004
Dyadobacter_sp._LJ419	2906456	S	109	6	115	0.00001
Dyadobacter_sp._NIV53	2861765	S	52	2	54	0.00000
Dyadobacter_sandarakinus	2747268	S	151	11	162	0.00001
Fibrella_aestuarina	651143	S	537	48	585	0.00005
Fibrella_sp._ES10-3-2-2	1834519	S	206	16	222	0.00002
Runella_slithyformis	106	S	162	8	170	0.00001
Runella_rosea	2259595	S	117	7	124	0.00001
Runella_sp._SP2	2268026	S	103	5	108	0.00001
Larkinella_sp._IE-0392	2907205	S	138	8	146	0.00001
Leadbetterella_byssophila	316068	S	33	15	48	0.00000
Arcticibacterium_luteifluviistationis	1784714	S	21	1	22	0.00000
Chryseolinea_soli	2321403	S	737	17	754	0.00006
Fulvivirga_sp._SS9-22	2904245	S	28	3	31	0.00000
Fulvivirga_sp._W9P-11	2904246	S	26	13	39	0.00000
Fulvivirga_sp._SW1-E11	2904247	S	25	17	42	0.00000
Fulvivirga_lutea	2810512	S	29	4	33	0.00000
Echinicola_strongylocentroti	1795355	S	59	8	67	0.00001
Echinicola_sp._20G	2781961	S	30	2	32	0.00000
Echinicola_sp._SCS_3-6	2859768	S	27	8	35	0.00000
Echinicola_soli	2591634	S	49	3	52	0.00000
Echinicola_rosea	1807691	S	47	16	63	0.00001
Echinicola_vietnamensis	390884	S	45	18	63	0.00001
Algoriphagus_sp._Y33	2772483	S	50	4	54	0.00000
Algoriphagus_sp._NBT04N3	2705473	S	19	4	23	0.00000
Algoriphagus_sanaruensis	1727163	S	41	4	45	0.00000
Algoriphagus_machipongonensis	388413	S	21	1	22	0.00000
Cyclobacterium_amurskyense	320787	S	28	2	30	0.00000
Cyclobacterium_marinum	104	S	17	3	20	0.00000
Aquiflexum_balticum	280473	S	44	4	48	0.00000
Mongoliitalea_daihaiensis	2782006	S	33	2	35	0.00000
Belliella_baltica	232259	S	17	6	23	0.00000
Flammeovirga_kamogawensis	373891	S	15	3	18	0.00000
Flammeovirga_pectinis	2494373	S	15	3	18	0.00000
Flammeovirga_yaeyamensis	367791	S	10	12	22	0.00000
Flammeovirga_sp._MY04	1191459	S	10	12	22	0.00000
Candidatus_Amoebophilus_asiaticus	281120	S	35	0	35	0.00000
Marivirga_tractuosa	1006	S	41	13	54	0.00000
Mangrovivirga_cuniculi	2715131	S	31	1	32	0.00000
Bernardetia_litoralis	999	S	20	1	21	0.00000
Niastella_koreensis	354356	S	3360	254	3614	0.00029
Chitinophaga_sp._XS-30	2604421	S	306	101	407	0.00003
Chitinophaga_sp._KRA15-503	2829818	S	185	89	274	0.00002
Chitinophaga_oryzae	2725414	S	398	43	441	0.00004
Chitinophaga_filiformis	104663	S	225	26	251	0.00002
Chitinophaga_alhagiae	2203219	S	170	2	172	0.00001
Chitinophaga_agri	2703787	S	141	26	167	0.00001
Chitinophaga_pinensis	79329	S	135	20	155	0.00001
Chitinophaga_caeni	2029983	S	96	13	109	0.00001
Flavisolibacter_ginsenosidimutans	661481	S	670	33	703	0.00006
Flavisolibacter_tropicus	1492898	S	508	62	570	0.00005
Panacibacter_ginsenosidivorans	1813871	S	1151	39	1190	0.00010
Paraflavitalea_soli	2315862	S	576	31	607	0.00005
Pseudocnuella_soli	2502779	S	565	50	615	0.00005
Pseudobacter_ginsenosidimutans	661488	S	499	31	530	0.00004
Flavihumibacter_sp._IMCC34838	2838156	S	254	16	270	0.00002
Flavihumibacter_sp._IMCC34837	2838157	S	196	9	205	0.00002
Niabella_ginsenosidivorans	1176587	S	200	15	215	0.00002
Niabella_soli	446683	S	198	18	216	0.00002
Arachidicoccus_sp._BS20	1850526	S	98	30	128	0.00001
Arachidicoccus_sp._5GH13-10	2875539	S	85	9	94	0.00001
Arachidicoccus_sp._B3-10	2545455	S	60	4	64	0.00001
Arachidicoccus_soli	2341117	S	71	5	76	0.00001
Arachidicoccus_ginsenosidivorans	496057	S	61	5	66	0.00001
Ferruginibacter_sp._KIS38-8	2875540	S	176	12	188	0.00002
Ferruginibacter_lapsinanis	563172	S	142	9	151	0.00001
Lacibacter_sp._S13-6-6	2760713	S	306	10	316	0.00003
Phnomibacter_ginsenosidimutans	2676868	S	244	21	265	0.00002
Filimonas_lacunae	477680	S	170	14	184	0.00001
Rhodocaloribacter_litoris	2558931	S	3607	278	3885	0.00032
Rhodothermus_marinus	29549	S	3488	139	3627	0.00029
Salinibacter_ruber	146919	S	2236	25	2261	0.00018
Alistipes_dispar	2585119	S	506	54	560	0.00005
Alistipes_onderdonkii	328813	S	481	540	1021	0.00008
Alistipes_communis	2585118	S	465	319	784	0.00006
Alistipes_finegoldii	214856	S	387	340	727	0.00006
Alistipes_senegalensis	1288121	S	379	83	462	0.00004
Alistipes_megaguti	2364787	S	331	32	363	0.00003
Alistipes_shahii	328814	S	330	187	517	0.00004
Alistipes_sp._dk3624	2662363	S	324	62	386	0.00003
Alistipes_indistinctus	626932	S	252	47	299	0.00002
Prevotella_sp._Rep29	2691580	S	71	8	79	0.00001
Prevotella_sp._E13-17	2913616	S	44	1	45	0.00000
Prevotella_sp._oral_taxon_475	712471	S	42	3	45	0.00000
Prevotella_sp._E15-22	2937774	S	34	2	36	0.00000
Prevotella_sp._E9-3	2913621	S	25	4	29	0.00000
Prevotella_sp._E2-28	2913620	S	17	1	18	0.00000
Prevotella_sp._E13-3	2913617	S	10	40	50	0.00000
Prevotella_sp._E2-25	2913619	S	10	37	47	0.00000
Prevotella_dentalis	52227	S	249	39	288	0.00002
Prevotella_multiformis	282402	S	80	30	110	0.00001
Prevotella_denticola	28129	S	76	22	98	0.00001
Prevotella_melaninogenica	28132	S	67	20	87	0.00001
Prevotella_copri	165179	S	54	22	76	0.00001
Prevotella_intermedia	28131	S	51	21	72	0.00001
Prevotella_ruminicola	839	S	46	1	47	0.00000
Prevotella_buccalis	28127	S	33	32	65	0.00001
Prevotella_enoeca	76123	S	22	3	25	0.00000
Prevotella_oris	28135	S	21	2	23	0.00000
Prevotella_jejuni	1177574	S	17	6	23	0.00000
Prevotella_bryantii	77095	S	14	1	15	0.00000
Prevotella_veroralis	28137	S	14	2	16	0.00000
Prevotella_herbatica	2801997	S	14	0	14	0.00000
Prevotella_nigrescens	28133	S	12	7	19	0.00000
Paraprevotella_xylaniphila	454155	S	46	37	83	0.00001
Pseudoprevotella_muciniphila	2133944	S	43	7	50	0.00000
Bacteroides_sp._CBA7301	2715212	S	41	29	70	0.00001
Bacteroides_fragilis	817	S	65	108	173	0.00001
Bacteroides_eggerthii	28111	S	65	64	129	0.00001
Bacteroides_cellulosilyticus	246787	S	59	19	78	0.00001
Bacteroides_thetaiotaomicron	818	S	56	33	89	0.00001
Bacteroides_heparinolyticus	28113	S	54	13	67	0.00001
Bacteroides_zoogleoformans	28119	S	48	12	60	0.00000
Bacteroides_stercoris	46506	S	47	42	89	0.00001
Bacteroides_uniformis	820	S	33	100	133	0.00001
Bacteroides_intestinalis	329854	S	29	5	34	0.00000
Bacteroides_faecis	674529	S	29	22	51	0.00000
Bacteroides_salyersiae	291644	S	26	22	48	0.00000
Bacteroides_zhangwenhongii	2650157	S	24	14	38	0.00000
Bacteroides_helcogenes	290053	S	21	0	21	0.00000
Bacteroides_nordii	291645	S	21	14	35	0.00000
Bacteroides_caccae	47678	S	20	2	22	0.00000
Bacteroides_coprosuis	151276	S	18	1	19	0.00000
Bacteroides_xylanisolvens	371601	S	17	38	55	0.00000
Bacteroides_luhongzhouii	2650158	S	15	7	22	0.00000
Bacteroides_caecimuris	1796613	S	10	12	22	0.00000
Phocaeicola_salanitronis	376805	S	80	31	111	0.00001
Phocaeicola_coprophilus	387090	S	39	18	57	0.00000
Phocaeicola_vulgatus	821	S	22	26	48	0.00000
Phocaeicola_dorei	357276	S	13	31	44	0.00000
Tannerella_serpentiformis	712710	S	263	12	275	0.00002
Tannerella_forsythia	28112	S	110	8	118	0.00001
Parabacteroides_goldsteinii	328812	S	66	14	80	0.00001
Parabacteroides_merdae	46503	S	60	59	119	0.00001
Parabacteroides_distasonis	823	S	50	124	174	0.00001
Parabacteroides_johnsonii	387661	S	37	26	63	0.00001
Sodaliphilus_pleomorphus	2606626	S	216	96	312	0.00003
Duncaniella_dubosii	2518971	S	55	11	66	0.00001
Muribaculum_gordoncarteri	2530390	S	92	8	100	0.00001
Muribaculum_intestinale	1796646	S	80	6	86	0.00001
Porphyromonas_sp._oral_taxon_275	712435	S	200	15	215	0.00002
Porphyromonas_gingivalis	837	S	67	8	75	0.00001
Porphyromonas_asaccharolytica	28123	S	67	3	70	0.00001
Porphyromonas_somerae	322095	S	49	10	59	0.00000
Porphyromonas_cangingivalis	36874	S	36	3	39	0.00000
Porphyromonas_crevioricanis	393921	S	18	3	21	0.00000
Porphyromonas_endodontalis	28124	S	17	1	18	0.00000
Proteiniphilum_saccharofermentans	1642647	S	72	5	77	0.00001
Proteiniphilum_sp._JNU-WLY501	2829812	S	20	0	20	0.00000
Petrimonas_mucosa	1642646	S	81	3	84	0.00001
Barnesiella_viscericola	397865	S	115	134	249	0.00002
Butyricimonas_faecalis	2093856	S	29	27	56	0.00000
Butyricimonas_virosa	544645	S	21	5	26	0.00000
Odoribacter_splanchnicus	28118	S	32	3	35	0.00000
Paludibacter_propionicigenes	185300	S	29	0	29	0.00000
Salinivirga_cyanobacteriivorans	1307839	S	28	0	28	0.00000
Tenuifilum_thalassicum	2590900	S	19	0	19	0.00000
Draconibacterium_orientale	1168034	S	47	2	49	0.00000
Draconibacterium_halophilum	2706887	S	25	1	26	0.00000
Maribellus_comscasis	2681766	S	52	1	53	0.00000
Alkalitalea_saponilacus	889453	S	35	2	37	0.00000
Labilibaculum_antarcticum	1717717	S	25	1	26	0.00000
Flavobacterium_sp._HJ-32-4	1160795	S	159	9	168	0.00001
Flavobacterium_sp._KSM-R2A25	2895947	S	126	32	158	0.00001
Flavobacterium_sp._KSM-R2A30	2897181	S	102	33	135	0.00001
Flavobacterium_sp._CLA17	2724135	S	39	6	45	0.00000
Flavobacterium_sp._IGB_4-14	1871076	S	35	2	37	0.00000
Flavobacterium_sp._MDT1-60	1979344	S	33	6	39	0.00000
Flavobacterium_sp._CJ74	2294119	S	33	2	35	0.00000
Flavobacterium_sp._M31R6	2739062	S	27	3	30	0.00000
Flavobacterium_sp._F-323	2893885	S	25	5	30	0.00000
Flavobacterium_sp._SLB02	2665645	S	25	4	29	0.00000
Flavobacterium_sp._KBS0721	1179672	S	20	5	25	0.00000
Flavobacterium_sp._F-340	2893886	S	20	6	26	0.00000
Flavobacterium_sp._B183	907046	S	19	3	22	0.00000
Flavobacterium_sp._F-70	2893884	S	18	3	21	0.00000
Flavobacterium_sp._F-29	2893883	S	17	3	20	0.00000
Flavobacterium_sp._Sr18	935222	S	16	2	18	0.00000
Flavobacterium_sp._I3-2	2748319	S	15	23	38	0.00000
Flavobacterium_sp._WSW3-B6	2856519	S	15	1	16	0.00000
Flavobacterium_sp._GENT5	1751095	S	15	3	18	0.00000
Flavobacterium_sp._MMS21-Er5	2937442	S	15	6	21	0.00000
Flavobacterium_sp._K5-23	2746225	S	14	3	17	0.00000
Flavobacterium_sp._CS20	2775246	S	14	5	19	0.00000
Flavobacterium_sp._KK2020170	2830782	S	14	4	18	0.00000
Flavobacterium_sp._LPB0248	2614441	S	14	7	21	0.00000
Flavobacterium_sp._140616W15	2478552	S	14	2	16	0.00000
Flavobacterium_sp._CHNK8	2871165	S	11	10	21	0.00000
Flavobacterium_sp._xlx-214	2654325	S	11	2	13	0.00000
Flavobacterium_magnum	2162713	S	78	7	85	0.00001
Flavobacterium_album	2175091	S	64	4	68	0.00001
Flavobacterium_pallidum	2172098	S	61	5	66	0.00001
Flavobacterium_nackdongense	2547394	S	47	3	50	0.00000
Flavobacterium_anhuiense	459526	S	41	15	56	0.00000
Flavobacterium_johnsoniae	986	S	41	17	58	0.00000
Flavobacterium_endoglycinae	2816357	S	34	7	41	0.00000
Flavobacterium_commune	1306519	S	34	5	39	0.00000
Flavobacterium_inviolabile	2748320	S	29	4	33	0.00000
Flavobacterium_crocinum	2183896	S	28	8	36	0.00000
Flavobacterium_kingsejongi	1678728	S	28	3	31	0.00000
Flavobacterium_sangjuense	2518177	S	27	2	29	0.00000
Flavobacterium_gilvum	1492737	S	20	2	22	0.00000
Flavobacterium_enshiense	1341165	S	20	2	22	0.00000
Flavobacterium_nitrogenifigens	1617283	S	19	9	28	0.00000
Flavobacterium_faecale	1355330	S	18	2	20	0.00000
Flavobacterium_jumunjinense	998845	S	18	2	20	0.00000
Flavobacterium_haoranii	683124	S	17	6	23	0.00000
Flavobacterium_sediminis	2201181	S	17	18	35	0.00000
Flavobacterium_branchiophilum	55197	S	16	1	17	0.00000
Flavobacterium_fluviale	2249356	S	16	5	21	0.00000
Flavobacterium_crassostreae	1763534	S	14	3	17	0.00000
Flavobacterium_davisii	2906077	S	13	4	17	0.00000
Flavobacterium_sediminilitoris	2024526	S	13	1	14	0.00000
Flavobacterium_psychrophilum	96345	S	13	2	15	0.00000
Flavobacterium_columnare	996	S	13	32	45	0.00000
Flavobacterium_indicum	312277	S	11	1	12	0.00000
Flavobacterium_alkalisoli	2602769	S	11	0	11	0.00000
Capnocytophaga_sp._oral_taxon_902	2748316	S	17	31	48	0.00000
Capnocytophaga_sp._FDAARGOS_737	2545799	S	13	7	20	0.00000
Capnocytophaga_sp._oral_taxon_878	1316596	S	11	4	15	0.00000
Capnocytophaga_haemolytica	45243	S	47	3	50	0.00000
Capnocytophaga_gingivalis	1017	S	45	5	50	0.00000
Capnocytophaga_canimorsus	28188	S	33	9	42	0.00000
Capnocytophaga_sputigena	1019	S	29	9	38	0.00000
Capnocytophaga_stomatis	1848904	S	22	5	27	0.00000
Capnocytophaga_ochracea	1018	S	15	19	34	0.00000
Capnocytophaga_leadbetteri	327575	S	12	6	18	0.00000
Capnocytophaga_endodontalis	2708117	S	11	5	16	0.00000
Muricauda_sp._SCSIO_65647	2908843	S	34	1	35	0.00000
Muricauda_sp._SCSIO_64092	2908842	S	33	0	33	0.00000
Muricauda_oceani	2698672	S	60	30	90	0.00001
Muricauda_ruestringensis	111501	S	37	2	39	0.00000
Muricauda_aquimarina	254955	S	37	18	55	0.00000
Muricauda_lutaonensis	516051	S	29	7	36	0.00000
Muricauda_aurantiaca	1383885	S	15	1	16	0.00000
Polaribacter_sp._SM13	2818493	S	15	4	19	0.00000
Polaribacter_sp._Q13	2806551	S	13	10	23	0.00000
Polaribacter_sp._NJDZ03	2855841	S	11	15	26	0.00000
Polaribacter_sp._MED152	313598	S	10	1	11	0.00000
Polaribacter_sp._Hel1_33_78	1336804	S	10	2	12	0.00000
Polaribacter_sp._G4M1	2808900	S	10	2	12	0.00000
Polaribacter_vadi	1774273	S	21	3	24	0.00000
Polaribacter_litorisediminis	1908341	S	18	2	20	0.00000
Polaribacter_reichenbachii	996801	S	15	2	17	0.00000
Polaribacter_haliotis	1888915	S	11	5	16	0.00000
Gramella_sp._GC03-9	2920386	S	35	10	45	0.00000
Gramella_sp._MAR_2010_147	1250205	S	14	1	15	0.00000
Gramella_sp._MT6	2705471	S	14	1	15	0.00000
Gramella_forsetii	411153	S	40	10	50	0.00000
Gramella_flava	1486245	S	39	13	52	0.00000
Gramella_fulva	2126553	S	28	2	30	0.00000
Gramella_echinicola	279359	S	17	2	19	0.00000
Gramella_salexigens	1913577	S	13	1	14	0.00000
Robiginitalea_biformata	252307	S	187	10	197	0.00002
Nonlabens_sp._Hel1_33_55	1336802	S	24	4	28	0.00000
Nonlabens_sp._Ci31	2608253	S	16	4	20	0.00000
Nonlabens_sp._MB-3u-79	2058134	S	12	3	15	0.00000
Nonlabens_spongiae	331648	S	35	17	52	0.00000
Nonlabens_ponticola	2496866	S	22	2	24	0.00000
Nonlabens_marinus	930802	S	18	6	24	0.00000
Winogradskyella_sp._PG-2	754409	S	23	3	26	0.00000
Winogradskyella_sp._J14-2	1936080	S	14	3	17	0.00000
Winogradskyella_sp._PC-19	754417	S	13	4	17	0.00000
Winogradskyella_sp._MH6	2929510	S	10	2	12	0.00000
Winogradskyella_forsetii	2686077	S	35	13	48	0.00000
Winogradskyella_helgolandensis	2697010	S	13	3	16	0.00000
Winogradskyella_sediminis	1382466	S	10	3	13	0.00000
Aequorivita_sublithincola	101385	S	37	29	66	0.00001
Aequorivita_sp._H23M31	2494375	S	36	12	48	0.00000
Antarcticibacterium_flavum	2058175	S	46	9	55	0.00000
Antarcticibacterium_arcticum	2585771	S	37	4	41	0.00000
Antarcticibacterium_sp._1MA-6-2	2908210	S	24	3	27	0.00000
Tenacibaculum_sp._SZ-18	754423	S	17	12	29	0.00000
Tenacibaculum_dicentrarchi	669041	S	15	6	21	0.00000
Tenacibaculum_singaporense	2358479	S	11	7	18	0.00000
Tenacibaculum_jejuense	584609	S	10	0	10	0.00000
Sinomicrobium_sp._HD2P242	2900738	S	90	3	93	0.00001
Maribacter_sp._HTCC2170	313603	S	15	0	15	0.00000
Maribacter_sp._MJ134	2496865	S	12	1	13	0.00000
Maribacter_cobaltidurans	1178778	S	17	15	32	0.00000
Maribacter_hydrothermalis	1836467	S	14	1	15	0.00000
Maribacter_dokdonensis	320912	S	13	11	24	0.00000
Cellulophaga_sp._L1A9	2686362	S	12	9	21	0.00000
Cellulophaga_sp._HaHaR_3_176	1942464	S	10	2	12	0.00000
Cellulophaga_lytica	979	S	19	9	28	0.00000
Cellulophaga_algicola	59600	S	10	3	13	0.00000
Kordia_antarctica	1218801	S	33	2	35	0.00000
Kordia_sp._SMS9	2282170	S	31	1	32	0.00000
Salegentibacter_salegens	143223	S	21	3	24	0.00000
Salegentibacter_sp._T436	1729720	S	19	20	39	0.00000
Salegentibacter_mishustinae	270918	S	18	17	35	0.00000
Formosa_sp._Hel1_33_131	1336794	S	19	1	20	0.00000
Formosa_sp._L2A11	2686363	S	10	6	16	0.00000
Aquimarina_sp._TRL1	2736252	S	29	2	31	0.00000
Aquimarina_sp._BL5	1714860	S	13	1	14	0.00000
Aquimarina_sp._AD1	1714848	S	11	1	12	0.00000
Myroides_odoratus	256	S	17	11	28	0.00000
Myroides_fluvii	2572594	S	10	8	18	0.00000
Leeuwenhoekiella_sp._ZYFB001	2719912	S	23	13	36	0.00000
Leeuwenhoekiella_palythoae	573501	S	14	11	25	0.00000
Lacinutrix_sp._Bg11-31	2057808	S	17	5	22	0.00000
Lacinutrix_sp._WUR7	2653681	S	10	2	12	0.00000
Aggregatimonas_sangjinii	2583587	S	42	1	43	0.00000
Psychroflexus_sp._ALD_RP9	2777186	S	20	1	21	0.00000
Psychroflexus_torquis	57029	S	16	0	16	0.00000
Algibacter_alginicilyticus	1736674	S	16	4	20	0.00000
Flagellimonas_sp._HMM57	2905121	S	18	1	19	0.00000
Flagellimonas_sp._CMM7	2654676	S	17	1	18	0.00000
Lutibacter_sp._A80	2918453	S	10	2	12	0.00000
Lutibacter_sp._A64	2918526	S	10	2	12	0.00000
Lutibacter_profundi	1622118	S	12	2	14	0.00000
Zunongwangia_profunda	398743	S	17	14	31	0.00000
Zunongwangia_sp._SCSIO_43204	2779359	S	15	11	26	0.00000
Tamlana_carrageenivorans	2069432	S	16	3	19	0.00000
Tamlana_sp._s12	1630406	S	14	2	16	0.00000
Galbibacter_sp._BG1	1170699	S	29	3	32	0.00000
Euzebyella_marina	1761453	S	27	15	42	0.00000
Zobellia_galactanivorans	63186	S	25	1	26	0.00000
Gilvibacter_sp._SZ-19	754429	S	24	3	27	0.00000
Constantimarinum_furrinae	2562285	S	24	2	26	0.00000
Croceibacter_atlanticus	313588	S	23	4	27	0.00000
Changchengzhania_lutea	2049305	S	22	2	24	0.00000
Mariniflexile_sp._TRM1-10	2027857	S	22	2	24	0.00000
Muriicola_soli	2507538	S	21	1	22	0.00000
Pukyongia_salina	2094025	S	20	1	21	0.00000
Costertonia_aggregata	343403	S	19	4	23	0.00000
Seonamhaeicola_sp._S2-3	1936081	S	14	3	17	0.00000
Arenibacter_algicola	616991	S	18	6	24	0.00000
Aegicerativicinus_sediminis	2893202	S	17	1	18	0.00000
Bizionia_sp._M204	2675331	S	17	3	20	0.00000
Zhouia_spongiae	2202721	S	16	3	19	0.00000
Sediminicola_sp._YIK13	1453352	S	15	1	16	0.00000
Wenyingzhuangia_fucanilytica	1790137	S	14	2	16	0.00000
Flavobacteriaceae_bacterium_10Alg115	2584122	S	14	0	14	0.00000
Urechidicola_croceus	1850246	S	14	7	21	0.00000
Oceanihabitans_sp._IOP_32	2529032	S	13	5	18	0.00000
Gillisia_sp._Hel1_33_143	1336796	S	13	4	17	0.00000
Amniculibacterium_sp._G2-70	2767188	S	11	15	26	0.00000
Marixanthomonas_sp._SCSIO_43207	2779360	S	11	3	14	0.00000
Sabulilitoribacter_sp._BrNp1-15	2916754	S	10	2	12	0.00000
Chryseobacterium_sp.	1871047	S	47	21	68	0.00001
Chryseobacterium_sp._SC2-2	2929800	S	42	24	66	0.00001
Chryseobacterium_sp._6424	2039166	S	34	10	44	0.00000
Chryseobacterium_sp._cx-624	2758037	S	31	6	37	0.00000
Chryseobacterium_sp._F4	2852098	S	28	2	30	0.00000
Chryseobacterium_sp._MEBOG06	2879938	S	24	6	30	0.00000
Chryseobacterium_sp._ZHDP1	2838877	S	24	24	48	0.00000
Chryseobacterium_sp._ADR-1	2929799	S	21	9	30	0.00000
Chryseobacterium_sp._DH-B6	2759528	S	18	10	28	0.00000
Chryseobacterium_sp._Y16C	2920939	S	18	15	33	0.00000
Chryseobacterium_sp._T16E-39	2015076	S	18	2	20	0.00000
Chryseobacterium_sp._LJ668	2864040	S	17	3	20	0.00000
Chryseobacterium_sp._IHB_B_17019	1721091	S	17	3	20	0.00000
Chryseobacterium_sp._POL2	2713414	S	14	10	24	0.00000
Chryseobacterium_sp._PCH239	2825845	S	13	13	26	0.00000
Chryseobacterium_sp._G0186	2487064	S	13	11	24	0.00000
Chryseobacterium_sp._StRB126	878220	S	12	4	16	0.00000
Chryseobacterium_sp._MEBOG07	2879939	S	12	4	16	0.00000
Chryseobacterium_sp._G0201	2487065	S	10	3	13	0.00000
Chryseobacterium_sp._G0162	2487063	S	10	14	24	0.00000
Chryseobacterium_sp._C-17	2898076	S	10	5	15	0.00000
Chryseobacterium_taklimakanense	536441	S	78	50	128	0.00001
Chryseobacterium_indologenes	253	S	47	27	74	0.00001
Chryseobacterium_indoltheticum	254	S	37	11	48	0.00000
Chryseobacterium_camelliae	1265445	S	37	25	62	0.00001
Chryseobacterium_arthrosphaerae	651561	S	33	21	54	0.00000
Chryseobacterium_shandongense	1493872	S	32	24	56	0.00000
Chryseobacterium_carnipullorum	1124835	S	30	13	43	0.00000
Chryseobacterium_nepalense	1854498	S	29	5	34	0.00000
Chryseobacterium_gallinarum	1324352	S	25	10	35	0.00000
Chryseobacterium_daecheongense	192389	S	24	5	29	0.00000
Chryseobacterium_piperi	558152	S	20	2	22	0.00000
Chryseobacterium_salivictor	2547600	S	20	3	23	0.00000
Chryseobacterium_gleum	250	S	19	30	49	0.00000
Chryseobacterium_lactis	1241981	S	17	21	38	0.00000
Chryseobacterium_aureum	2497456	S	17	5	22	0.00000
Chryseobacterium_cucumeris	1813611	S	15	12	27	0.00000
Chryseobacterium_balustinum	246	S	15	6	21	0.00000
Chryseobacterium_manosquense	2754694	S	14	13	27	0.00000
Chryseobacterium_nakagawai	1241982	S	10	20	30	0.00000
Kaistella_sp._97-N-M2	2908645	S	38	4	42	0.00000
Kaistella_sp._GW4-15	2878534	S	21	2	23	0.00000
Kaistella_daneshvariae	2487074	S	48	5	53	0.00000
Kaistella_jeonii	266749	S	21	1	22	0.00000
Candidatus_Kaistella_beijingensis	2820270	S	20	9	29	0.00000
Kaistella_flava_(ex_Peng_et_al._2021)	2038776	S	19	3	22	0.00000
Kaistella_antarctica	266748	S	17	1	18	0.00000
Kaistella_carnis	1241979	S	16	5	21	0.00000
Epilithonimonas_vandammei	2487072	S	26	49	75	0.00001
Epilithonimonas_zeae	1416779	S	18	2	20	0.00000
Elizabethkingia_anophelis	1117645	S	41	61	102	0.00001
Elizabethkingia_meningoseptica	238	S	34	3	37	0.00000
Elizabethkingia_sp._JS20170427COW	2583851	S	13	2	15	0.00000
Elizabethkingia_miricola	172045	S	11	9	20	0.00000
Cruoricaptor_ignavus	1118202	S	71	11	82	0.00001
Apibacter_raozihei	2500547	S	13	15	28	0.00000
Empedobacter_falsenii	343874	S	18	15	33	0.00000
Empedobacter_stercoris	1628248	S	15	5	20	0.00000
Empedobacter_brevis	247	S	14	6	20	0.00000
Cloacibacterium_caeni	2004710	S	17	23	40	0.00000
Ornithobacterium_rhinotracheale	28251	S	30	23	53	0.00000
Riemerella_anatipestifer	34085	S	28	11	39	0.00000
Bergeyella_cardium	1585976	S	23	5	28	0.00000
Faecalibacter_bovis	2898187	S	10	1	11	0.00000
Blattabacterium_cuenoti	1653831	S	120	31	151	0.00001
Fluviicola_taffensis	191579	S	81	5	86	0.00001
Crocinitomix_sp._GM2_3_6_6	2862509	S	25	0	25	0.00000
Croceimicrobium_hydrocarbonivorans	2761580	S	37	8	45	0.00000
Owenweeksia_hongkongensis	253245	S	34	3	37	0.00000
Candidatus_Sulcia_muelleri	336810	S	28	6	34	0.00000
Candidatus_Walczuchella_monophlebidarum	1415657	S	17	1	18	0.00000
Mucilaginibacter_sp._14171R-50	2703789	S	104	6	110	0.00001
Mucilaginibacter_sp._SMC90	2929803	S	91	5	96	0.00001
Mucilaginibacter_sp._21P	2778902	S	77	4	81	0.00001
Mucilaginibacter_sp._F39-2	2728022	S	65	4	69	0.00001
Mucilaginibacter_mali	2740462	S	164	6	170	0.00001
Mucilaginibacter_daejeonensis	398049	S	138	7	145	0.00001
Mucilaginibacter_gotjawali	1550579	S	131	3	134	0.00001
Mucilaginibacter_ginsenosidivorans	398053	S	116	3	119	0.00001
Mucilaginibacter_ginsenosidivorax	862126	S	99	4	103	0.00001
Mucilaginibacter_celer	2305508	S	96	3	99	0.00001
Mucilaginibacter_paludis	423351	S	91	4	95	0.00001
Mucilaginibacter_xinganensis	1234841	S	89	4	93	0.00001
Mucilaginibacter_rubeus	2027860	S	75	184	259	0.00002
Mucilaginibacter_mallensis	652787	S	68	2	70	0.00001
Mucilaginibacter_ginkgonis	2682091	S	58	2	60	0.00000
Mucilaginibacter_gossypii	551996	S	33	24	57	0.00000
Pedobacter_sp._SW-16	2766984	S	50	10	60	0.00000
Pedobacter_sp._HDW13	2714940	S	43	5	48	0.00000
Pedobacter_sp._KBS0701	2578106	S	42	15	57	0.00000
Pedobacter_sp._PACM_27299	1727164	S	37	5	42	0.00000
Pedobacter_sp._D749	2856523	S	37	14	51	0.00000
Pedobacter_sp._G11	2482728	S	32	4	36	0.00000
Pedobacter_sp._Q8-18	2895286	S	29	2	31	0.00000
Pedobacter_aquae	2605747	S	120	11	131	0.00001
Pedobacter_endophyticus	2789740	S	58	5	63	0.00001
Pedobacter_heparinus	984	S	52	4	56	0.00000
Pedobacter_suwonensis	332999	S	48	11	59	0.00000
Pedobacter_steynii	430522	S	44	4	48	0.00000
Pedobacter_schmidteae	2201271	S	43	4	47	0.00000
Pedobacter_cryoconitis	188932	S	42	4	46	0.00000
Pedobacter_roseus	336820	S	42	13	55	0.00000
Pedobacter_ginsengisoli	363852	S	34	4	38	0.00000
Sphingobacterium_sp._DR205	2713573	S	43	5	48	0.00000
Sphingobacterium_sp._UDSM-2020	2795738	S	24	7	31	0.00000
Sphingobacterium_sp._SRCM116780	2907623	S	24	3	27	0.00000
Sphingobacterium_sp._ML3W	1538644	S	18	6	24	0.00000
Sphingobacterium_sp._CZ-2	2557994	S	18	5	23	0.00000
Sphingobacterium_sp._PCS056	2931400	S	13	2	15	0.00000
Sphingobacterium_sp._dk4302	2662364	S	11	1	12	0.00000
Sphingobacterium_spiritivorum	258	S	73	52	125	0.00001
Sphingobacterium_thalpophilum	259	S	58	65	123	0.00001
Sphingobacterium_hotanense	649196	S	39	12	51	0.00000
Sphingobacterium_lactis	797291	S	34	29	63	0.00001
Sphingobacterium_multivorum	28454	S	28	82	110	0.00001
Sphingobacterium_mizutaii	1010	S	22	3	25	0.00000
Sphingobacterium_daejeonense	371142	S	19	5	24	0.00000
Sphingobacterium_psychroaquaticum	561061	S	16	3	19	0.00000
Sphingobacterium_paramultivorum	2886510	S	13	24	37	0.00000
Anseongella_ginsenosidimutans	496056	S	136	4	140	0.00001
Solitalea_canadensis	995	S	55	6	61	0.00001
Solitalea_sp._S2-8	2911172	S	43	7	50	0.00000
Olivibacter_sp._LS-1	2592345	S	51	2	53	0.00000
Olivibacter_sp._SDN3	2764720	S	47	6	53	0.00000
Pseudopedobacter_saltans	151895	S	43	35	78	0.00001
Haliscomenobacter_hydrossis	2350	S	194	2	196	0.00002
Saprospira_grandis	1008	S	40	0	40	0.00000
Candidatus_Sulfidibacterium_hydrothermale	2875962	S	60	1	61	0.00001
Chlorobaculum_limnaeum	274537	S	815	122	937	0.00008
Chlorobaculum_parvum	274539	S	402	72	474	0.00004
Chlorobaculum_tepidum	1097	S	378	95	473	0.00004
Pelodictyon_luteolum	1100	S	334	50	384	0.00003
Pelodictyon_phaeoclathratiforme	34090	S	74	4	78	0.00001
Chlorobium_limicola	1092	S	159	12	171	0.00001
Chlorobium_phaeobacteroides	1096	S	88	11	99	0.00001
Chlorobium_phaeovibrioides	1094	S	82	15	97	0.00001
Prosthecochloris_sp._GSB1	281093	S	326	23	349	0.00003
Prosthecochloris_sp._HL-130-GSB	1974213	S	107	23	130	0.00001
Prosthecochloris_sp._CIB_2401	1868325	S	103	28	131	0.00001
Prosthecochloris_aestuarii	1102	S	111	14	125	0.00001
Chloroherpeton_thalassium	100716	S	156	2	158	0.00001
Candidatus_Cyclonatronum_proteinivorum	1457365	S	249	25	274	0.00002
Melioribacter_roseus	1134405	S	113	15	128	0.00001
Ignavibacterium_album	591197	S	78	13	91	0.00001
Fibrobacter_succinogenes	833	S	117	1	118	0.00001
Candidatus_Cloacimonas_acidaminovorans	456827	S	40	0	40	0.00000
Luteitalea_sp._TBR-22	2802971	S	20338	3440	23778	0.00193
Luteitalea_pratensis	1855912	S	15288	1682	16970	0.00138
Granulicella_sp._WH15	2602070	S	2659	490	3149	0.00026
Granulicella_sp._5B5	1617967	S	2097	354	2451	0.00020
Granulicella_mallensis	940614	S	1892	233	2125	0.00017
Granulicella_tundricola	940615	S	1425	194	1619	0.00013
Terriglobus_roseus	392734	S	2472	552	3024	0.00025
Terriglobus_albidus	1592106	S	1803	180	1983	0.00016
Terriglobus_saanensis	870903	S	1162	165	1327	0.00011
Acidobacterium_capsulatum	33075	S	2504	334	2838	0.00023
Acidobacterium_sp._4Y35	2763107	S	2161	171	2332	0.00019
Candidatus_Koribacter_versatilis	658062	S	4650	162	4812	0.00039
Edaphobacter_sp._12200R-103	2703788	S	1470	272	1742	0.00014
Edaphobacter_sp._4G125	2763071	S	831	132	963	0.00008
Acidisarcina_polymorpha	2211140	S	1558	122	1680	0.00014
Paludibaculum_fermentans	1473598	S	6998	191	7189	0.00058
Chloracidobacterium_aggregatum	2851959	S	1055	586	1641	0.00013
Chloracidobacterium_validum	2821543	S	827	14	841	0.00007
Chloracidobacterium_sp._D	2821536	S	92	429	521	0.00004
Chloracidobacterium_thermophilum	458033	S	66	282	348	0.00003
Sulfidibacter_corallicola	2818388	S	1610	29	1639	0.00013
Thermotomaculum_hydrothermale	981385	S	68	2	70	0.00001
Nitrospira_moscoviensis	42253	S	7295	549	7844	0.00064
Nitrospira_japonica	1325564	S	2914	312	3226	0.00026
Candidatus_Nitrospira_inopinata	1715989	S	2103	159	2262	0.00018
Nitrospira_sp._KM1	1936990	S	2009	171	2180	0.00018
Leptospirillum_ferrooxidans	180	S	85	1	86	0.00001
Leptospirillum_ferriphilum	178606	S	43	100	143	0.00001
Leptospirillum_sp._Group_II_'CF-1'	1660083	S	27	50	77	0.00001
Dissulfurispira_thermophila	2715679	S	100	8	108	0.00001
Thermodesulfovibrio_yellowstonii	28262	S	80	2	82	0.00001
Treponema_brennaborense	81028	S	156	36	192	0.00002
Treponema_primitia	88058	S	95	5	100	0.00001
Treponema_azotonutricium	150829	S	93	3	96	0.00001
Treponema_socranskii	53419	S	88	32	120	0.00001
Treponema_sp._Marseille-Q4132	2766701	S	53	19	72	0.00001
Treponema_sp._OMZ_838	1539298	S	17	13	30	0.00000
Treponema_caldarium	215591	S	64	8	72	0.00001
Treponema_vincentii	69710	S	50	39	89	0.00001
Treponema_parvum	138851	S	44	1	45	0.00000
Treponema_succinifaciens	167	S	41	20	61	0.00000
Treponema_medium	58231	S	31	30	61	0.00000
Treponema_denticola	158	S	28	5	33	0.00000
Treponema_phagedenis	162	S	20	5	25	0.00000
Treponema_pedis	409322	S	20	3	23	0.00000
Spirochaeta_thermophila	154	S	516	10	526	0.00004
Spirochaeta_africana	46355	S	184	9	193	0.00002
Salinispira_pacifica	1307761	S	99	3	102	0.00001
Sediminispirochaeta_smaragdinae	55206	S	69	2	71	0.00001
Oceanispirochaeta_crateris	2518645	S	30	1	31	0.00000
Thiospirochaeta_perfilievii	252967	S	17	1	18	0.00000
Sphaerochaeta_associata	1129264	S	99	18	117	0.00001
Sphaerochaeta_coccoides	273376	S	59	2	61	0.00001
Sphaerochaeta_globosa	1131703	S	37	7	44	0.00000
Sphaerochaeta_pleomorpha	1131707	S	22	2	24	0.00000
Breznakiella_homolactica	2798577	S	137	12	149	0.00001
Leptospira_santarosai	28183	S	69	0	69	0.00001
Leptospira_kmetyi	408139	S	68	0	68	0.00001
Leptospira_tipperaryensis	2564040	S	37	0	37	0.00000
Leptospira_weilii	28184	S	26	0	26	0.00000
Leptospira_kobayashii	1917830	S	23	0	23	0.00000
Leptospira_biflexa	172	S	21	0	21	0.00000
Leptospira_noguchii	28182	S	21	0	21	0.00000
Leptospira_borgpetersenii	174	S	15	0	15	0.00000
Leptospira_interrogans	173	S	11	121	132	0.00001
Leptospira_mayottensis	1137606	S	11	0	11	0.00000
Turneriella_parva	29510	S	239	1	240	0.00002
Brachyspira_pilosicoli	52584	S	13	21	34	0.00000
Pyramidobacter_piscolens	638849	S	545	24	569	0.00005
Fretibacterium_fastidiosum	651822	S	527	5	532	0.00004
Aminomonas_paucivorans	81412	S	486	41	527	0.00004
Cloacibacillus_porcorum	1197717	S	393	52	445	0.00004
Thermanaerovibrio_acidaminovorans	81462	S	196	54	250	0.00002
Thermanaerovibrio_velox	108007	S	136	26	162	0.00001
Jonquetella_anthropi	428712	S	302	30	332	0.00003
Acetomicrobium_mobile	97477	S	77	1	78	0.00001
Thermovirga_lienii	336261	S	58	30	88	0.00001
Aminobacterium_colombiense	81468	S	54	2	56	0.00000
Candidatus_Bipolaricaulis_anaerobius	2026885	S	651	17	668	0.00005
Candidatus_Nanosynbacter_featherlites	2572088	S	38	14	52	0.00000
Candidatus_Nanosynbacter_lyticus	2093824	S	24	46	70	0.00001
Nanosynbacter_sp._HMT-352	2899133	S	16	35	51	0.00000
Candidatus_Nanosynbacter_sp._HMT352	2902423	S	10	31	41	0.00000
Candidatus_Saccharimonas_aalborgensis	1332188	S	71	0	71	0.00001
Candidatus_Minimicrobia_vallesae	2841264	S	12	64	76	0.00001
Candidatus_Babela_massiliensis	673862	S	110	1	111	0.00001
Candidatus_Chazhemtobacterium_aquaticus	2715735	S	46	0	46	0.00000
Candidatus_Absconditicoccus_praedator	2735562	S	33	0	33	0.00000
Thermotoga_caldifontis	1508419	S	92	120	212	0.00002
Thermotoga_profunda	1508420	S	15	6	21	0.00000
Pseudothermotoga_hypogea	57487	S	34	21	55	0.00000
Thermosipho_ferrireducens	2571116	S	23	16	39	0.00000
Fervidobacterium_pennivorans	93466	S	22	49	71	0.00001
Fervidobacterium_nodosum	2424	S	10	6	16	0.00000
Mesotoga_infera	1236046	S	50	7	57	0.00000
Mesotoga_prima	1184387	S	27	4	31	0.00000
Kosmotoga_olearia	651457	S	27	8	35	0.00000
Kosmotoga_pacifica	1330330	S	19	6	25	0.00000
Tepiditoga_spiralis	2108365	S	15	6	21	0.00000
Defluviitoga_tunisiensis	1006576	S	11	16	27	0.00000
Athalassotoga_saccharophila	1441386	S	30	1	31	0.00000
Thermocrinis_minervae	381751	S	93	15	108	0.00001
Thermocrinis_ruber	75906	S	20	3	23	0.00000
Thermocrinis_albus	136094	S	16	2	18	0.00000
Hydrogenobacter_thermophilus	940	S	20	8	28	0.00000
Hydrogenobacter_sp._T-8	1632019	S	17	5	22	0.00000
Aquifex_aeolicus	63363	S	36	2	38	0.00000
Sulfurihydrogenibium_azorense	309806	S	57	6	63	0.00001
Persephonella_marina	309805	S	55	3	58	0.00000
Thermosulfidibacter_takaii	412593	S	99	2	101	0.00001
Thermovibrio_ammonificans	228745	S	72	14	86	0.00001
Desulfurobacterium_thermolithotrophum	64160	S	19	3	22	0.00000
Thermosulfurimonas_marina	2047767	S	156	32	188	0.00002
Thermosulfuriphilus_ammonigenes	1936021	S	88	4	92	0.00001
Thermodesulfatator_indicus	171695	S	58	11	69	0.00001
Thermodesulfobacterium_sp._TA1	2234087	S	12	11	23	0.00000
Thermodesulfobacterium_geofontis	1295609	S	10	8	18	0.00000
Caldimicrobium_thiodismutans	1653476	S	31	9	40	0.00000
Fusobacterium_nucleatum	851	S	23	54	77	0.00001
Fusobacterium_ulcerans	861	S	19	3	22	0.00000
Fusobacterium_necrophorum	859	S	14	3	17	0.00000
Fusobacterium_sp._NSJ-57	2764326	S	13	12	25	0.00000
Cetobacterium_somerae	188913	S	14	1	15	0.00000
Leptotrichia_sp._oral_taxon_212	712357	S	19	12	31	0.00000
Leptotrichia_trevisanii	109328	S	10	20	30	0.00000
Sebaldella_termitidis	826	S	41	2	43	0.00000
Streptobacillus_moniliformis	34105	S	11	5	16	0.00000
Geovibrio_thiophilus	139438	S	85	17	102	0.00001
Mucispirillum_schaedleri	248039	S	38	3	41	0.00000
Denitrovibrio_acetiphilus	118000	S	37	5	42	0.00000
Flexistipes_sinusarabici	2352	S	32	3	35	0.00000
Calditerrivibrio_nitroreducens	477976	S	31	4	35	0.00000
Deferribacter_desulfuricans	197162	S	26	4	30	0.00000
Caldithrix_abyssi	187145	S	270	1	271	0.00002
Desulfurispirillum_indicum	936456	S	230	66	296	0.00002
Endomicrobium_proavitum	1408281	S	50	12	62	0.00001
Candidatus_Endomicrobium_trichonymphae	1408204	S	31	7	38	0.00000
Elusimicrobium_minutum	423605	S	84	0	84	0.00001
Coprothermobacter_proteolyticus	35786	S	93	12	105	0.00001
Caldisericum_exile	693075	S	91	0	91	0.00001
Dictyoglomus_thermophilum	14	S	17	27	44	0.00000
Dictyoglomus_turgidum	513050	S	15	24	39	0.00000
Atribacter_laminatus	2847778	S	37	0	37	0.00000
Fusarium_acuminatum	5515	S	13071	973	14044	0.00114
Fusarium_avenaceum	40199	S	114	5	119	0.00001
Fusarium_sambucinum	5128	S	184	46	230	0.00002
Fusarium_pseudograminearum	101028	S	108	20	128	0.00001
Fusarium_poae	36050	S	104	37	141	0.00001
Fusarium_sporotrichioides	5514	S	94	6	100	0.00001
Fusarium_longipes	694270	S	86	4	90	0.00001
Fusarium_venenatum	56646	S	66	140	206	0.00002
Fusarium_graminearum	5518	S	63	363	426	0.00003
Fusarium_culmorum	5516	S	49	20	69	0.00001
Fusarium_decemcellulare	57161	S	449	14	463	0.00004
Fusarium_nygamai	42673	S	114	46	160	0.00001
Fusarium_pseudonygamai	47755	S	106	34	140	0.00001
Fusarium_fujikuroi	5127	S	85	12	97	0.00001
Fusarium_thapsinum	120644	S	69	19	88	0.00001
Fusarium_verticillioides	117187	S	34	77	111	0.00001
Fusarium_dimerum	57145	S	339	15	354	0.00003
Fusarium_graminum	86546	S	118	29	147	0.00001
Fusarium_heterosporum	42747	S	107	25	132	0.00001
Fusarium_oxysporum	5507	S	259	138	397	0.00003
Fusarium_lateritium	5523	S	245	10	255	0.00002
Fusarium_chlamydosporum	86545	S	91	27	118	0.00001
Fusarium_nelsonii	77846	S	88	26	114	0.00001
Fusarium_equiseti	61235	S	83	26	109	0.00001
Fusarium_scirpi	2211609	S	74	21	95	0.00001
Fusarium_musae	1042133	S	39	86	125	0.00001
Trichoderma_reesei	51453	S	337	37	374	0.00003
Trichoderma_citrinoviride	58853	S	316	38	354	0.00003
Trichoderma_pleuroti	500994	S	215	24	239	0.00002
Trichoderma_asperellum	101201	S	178	14	192	0.00002
Trichoderma_erinaceum	202914	S	164	26	190	0.00002
Trichoderma_atroviride	63577	S	161	44	205	0.00002
Trichoderma_afroharzianum	1567482	S	153	31	184	0.00001
Trichoderma_hamatum	49224	S	147	13	160	0.00001
Trichoderma_koningiopsis	337941	S	145	23	168	0.00001
Trichoderma_gamsii	398673	S	110	15	125	0.00001
Trichoderma_harzianum	5544	S	108	21	129	0.00001
Trichoderma_longibrachiatum	5548	S	63	570	633	0.00005
Trichoderma_virens	29875	S	32	288	320	0.00003
Trichoderma_koningii	97093	S	21	177	198	0.00002
Trichoderma_viride	5547	S	15	175	190	0.00002
Metarhizium_album	92629	S	513	21	534	0.00004
Metarhizium_guizhouense	169041	S	508	276	784	0.00006
Metarhizium_rileyi	1649241	S	342	58	400	0.00003
Metarhizium_acridum	92637	S	195	181	376	0.00003
Metarhizium_anisopliae	5530	S	109	184	293	0.00002
Metarhizium_humberi	2596975	S	84	50	134	0.00001
Metarhizium_majus	1650735	S	81	37	118	0.00001
Metarhizium_brunneum	500148	S	80	65	145	0.00001
Metarhizium_robertsii	568076	S	48	33	81	0.00001
Ustilaginoidea_virens	1159556	S	721	52	773	0.00006
Pochonia_chlamydosporia	280754	S	191	20	211	0.00002
Beauveria_felina	37994	S	597	48	645	0.00005
Beauveria_pseudobassiana	931006	S	324	57	381	0.00003
Beauveria_brongniartii	118266	S	222	66	288	0.00002
Beauveria_rudraprayagi	1481906	S	154	217	371	0.00003
Beauveria_bassiana	176275	S	100	148	248	0.00002
Cordyceps_fumosorosea	114497	S	829	83	912	0.00007
Purpureocillium_lilacinum	33203	S	1087	120	1207	0.00010
Drechmeria_coniospora	98403	S	810	59	869	0.00007
Clonostachys_rosea	29856	S	378	39	417	0.00003
Colletotrichum_higginsianum	80884	S	1041	336	1377	0.00011
Thermothielavioides_terrestris	2587410	S	2755	342	3097	0.00025
Thermothelomyces_thermophilus	78579	S	2719	246	2965	0.00024
Neurospora_crassa	5141	S	768	69	837	0.00007
Pyricularia_pennisetigena	1578925	S	350	62	412	0.00003
Pyricularia_oryzae	318829	S	348	104	452	0.00004
Pyricularia_grisea	148305	S	273	47	320	0.00003
Neopestalotiopsis_clavispora	289240	S	202	206	408	0.00003
Neopestalotiopsis_rosae	1562205	S	169	159	328	0.00003
Botrytis_cinerea	40559	S	227	1	228	0.00002
Aspergillus_chevalieri	182096	S	14534	1261	15795	0.00128
Aspergillus_luchuensis	1069201	S	5586	356	5942	0.00048
Aspergillus_oryzae	5062	S	501	1272	1773	0.00014
Aspergillus_flavus	5059	S	192	528	720	0.00006
Aspergillus_puulaauensis	1220207	S	1662	57	1719	0.00014
Aspergillus_fumigatus	746128	S	377	17	394	0.00003
Penicillium_citrinum	5077	S	329	36	365	0.00003
Penicillium_chrysogenum	5076	S	223	48	271	0.00002
Penicillium_aurantiogriseum	36655	S	162	62	224	0.00002
Penicillium_expansum	27334	S	136	67	203	0.00002
Penicillium_italicum	40296	S	124	55	179	0.00001
Penicillium_digitatum	36651	S	119	28	147	0.00001
Paecilomyces_niveus	5093	S	318	14	332	0.00003
Paecilomyces_variotii	264951	S	217	20	237	0.00002
Talaromyces_rugulosus	121627	S	242	13	255	0.00002
Paraphaeosphaeria_minitans	565426	S	434	150	584	0.00005
Ampelomyces_quisqualis	50730	S	370	39	409	0.00003
Zymoseptoria_tritici	1047171	S	215	5	220	0.00002
Cercospora_beticola	122368	S	176	1	177	0.00001
Eremothecium_gossypii	33169	S	128	136	264	0.00002
Eremothecium_cymbalariae	45285	S	12	0	12	0.00000
Eremothecium_sinecaudum	45286	S	11	8	19	0.00000
Naumovozyma_castellii	27288	S	52	4	56	0.00000
Naumovozyma_dairenensis	27289	S	46	2	48	0.00000
Tetrapisispora_blattae	1071379	S	57	3	60	0.00000
Tetrapisispora_phaffii	113608	S	26	1	27	0.00000
Kluyveromyces_marxianus	4911	S	39	9	48	0.00000
Kluyveromyces_lactis	28985	S	11	1	12	0.00000
[Candida]_glabrata	5478	S	51	2	53	0.00000
Saccharomyces_eubayanus	1080349	S	24	1	25	0.00000
Saccharomyces_cerevisiae	4932	S	18	3	21	0.00000
Lachancea_thermotolerans	381046	S	47	3	50	0.00000
Kazachstania_naganishii	588726	S	41	2	43	0.00000
Torulaspora_globosa	48254	S	20	1	21	0.00000
Torulaspora_delbrueckii	4950	S	12	1	13	0.00000
Zygosaccharomyces_rouxii	4956	S	31	1	32	0.00000
Zygotorulaspora_mrakii	42260	S	22	3	25	0.00000
Candida_dubliniensis	42374	S	80	3	83	0.00001
Candida_orthopsilosis	273371	S	47	1	48	0.00000
Candida_albicans	5476	S	37	1	38	0.00000
Scheffersomyces_stipitis	4924	S	25	1	26	0.00000
Debaryomyces_hansenii	4959	S	12	0	12	0.00000
Brettanomyces_bruxellensis	5007	S	30	3	33	0.00000
Brettanomyces_nanus	13502	S	29	7	36	0.00000
Ogataea_parapolymorpha	1005962	S	53	2	55	0.00000
Pichia_kudriavzevii	4909	S	24	1	25	0.00000
Yarrowia_lipolytica	4952	S	96	1	97	0.00001
Sugiyamaella_lignohabitans	796027	S	62	5	67	0.00001
Saccharomycodes_ludwigii	36035	S	31	5	36	0.00000
Komagataella_phaffii	460519	S	14	0	14	0.00000
Schizosaccharomyces_pombe	4896	S	38	1	39	0.00000
Pseudozyma_flocculosa	84751	S	1122	11	1133	0.00009
Ustilago_maydis	5270	S	281	10	291	0.00002
Sporisorium_graminicola	280036	S	274	55	329	0.00003
Malassezia_restricta	76775	S	195	33	228	0.00002
Phlebiopsis_gigantea	82310	S	389	3	392	0.00003
Rhizoctonia_solani	456999	S	65	2	67	0.00001
Marasmius_oreades	181124	S	62	2	64	0.00001
Cryptococcus_neoformans	5207	S	77	5	82	0.00001
Cryptococcus_gattii_VGI	37769	S	31	23	54	0.00000
Phytophthora_cinnamomi	4785	S	719	127	846	0.00007
Phytophthora_fragariae	53985	S	619	93	712	0.00006
Phytophthora_cryptogea	4786	S	366	31	397	0.00003
Phytophthora_infestans	4787	S	323	585	908	0.00007
Phytophthora_boehmeriae	109152	S	199	26	225	0.00002
Phytophthora_cactorum	29920	S	186	29	215	0.00002
Phytophthora_parasitica	4792	S	150	21	171	0.00001
Pythium_aphanidermatum	65070	S	274	9	283	0.00002
