name	taxonomy_id	taxonomy_lvl	kraken_assigned_reads	added_reads	new_est_reads	fraction_total_reads
Bradyrhizobium_sp._200	2782665	S	15454	3508	18962	0.00090
Bradyrhizobium_sp._170	2782641	S	12393	3254	15647	0.00074
Bradyrhizobium_sp._CCBAU_051011	858422	S	10342	2049	12391	0.00059
Bradyrhizobium_sp._CCBAU_51753	1325100	S	9737	2186	11923	0.00057
Bradyrhizobium_sp._BTAi1	288000	S	8484	1594	10078	0.00048
Bradyrhizobium_sp._ORS_278	114615	S	8209	1925	10134	0.00048
Bradyrhizobium_sp._A19	2898149	S	8103	1453	9556	0.00045
Bradyrhizobium_sp._ORS_285	115808	S	8001	1852	9853	0.00047
Bradyrhizobium_sp._SK17	2057741	S	6869	2308	9177	0.00044
Bradyrhizobium_sp._186	2782654	S	5830	1601	7431	0.00035
Bradyrhizobium_sp._CCBAU_53421	1325120	S	5530	1780	7310	0.00035
Bradyrhizobium_sp._1(2017)	1404888	S	4637	1483	6120	0.00029
Bradyrhizobium_sp._CCBAU_53338	1325111	S	4607	1947	6554	0.00031
Bradyrhizobium_sp._195	2782662	S	4415	1620	6035	0.00029
Bradyrhizobium_sp._CCBAU_53340	1325112	S	4401	1764	6165	0.00029
Bradyrhizobium_sp._CCGE-LA001	1223566	S	4268	1639	5907	0.00028
Bradyrhizobium_sp._CCBAU_53351	1325114	S	4261	2219	6480	0.00031
Bradyrhizobium_sp._6(2017)	1197460	S	3897	1975	5872	0.00028
Bradyrhizobium_sp._191	2782659	S	3809	3777	7586	0.00036
Bradyrhizobium_sp._S2-11-2	2840472	S	3626	2782	6408	0.00030
Bradyrhizobium_sp._CCBAU_51765	1325102	S	3300	3034	6334	0.00030
Bradyrhizobium_sp._I71	2590772	S	3179	2795	5974	0.00028
Bradyrhizobium_sp._S2-20-1	2840469	S	3159	2575	5734	0.00027
Bradyrhizobium_sp._41S5	1404443	S	3122	2186	5308	0.00025
Bradyrhizobium_sp._S2-11-4	2840473	S	2829	2535	5364	0.00025
Bradyrhizobium_sp._C-145	574727	S	1892	1944	3836	0.00018
Bradyrhizobium_sp.	376	S	1490	5069	6559	0.00031
Bradyrhizobium_sp._40	2782674	S	1148	2591	3739	0.00018
Bradyrhizobium_sp._4	2782678	S	1049	2653	3702	0.00018
Bradyrhizobium_sp._323S2	1404649	S	1041	2694	3735	0.00018
Bradyrhizobium_sp._144S4	2823807	S	1025	2596	3621	0.00017
Bradyrhizobium_sp._192	2782660	S	906	2255	3161	0.00015
Bradyrhizobium_sp._LCT2	2493093	S	663	1922	2585	0.00012
Bradyrhizobium_sp._SG09	2599805	S	398	2914	3312	0.00016
Bradyrhizobium_sp._187	2782655	S	362	1786	2148	0.00010
Bradyrhizobium_sp._TM102	2599819	S	342	2389	2731	0.00013
Bradyrhizobium_sp._CW1	2782686	S	256	3929	4185	0.00020
Bradyrhizobium_sp._38S5	2819348	S	227	2751	2978	0.00014
Bradyrhizobium_sp._1S5	2816456	S	212	2365	2577	0.00012
Bradyrhizobium_sp._172	2782643	S	199	2403	2602	0.00012
Bradyrhizobium_sp._131	2782609	S	184	2982	3166	0.00015
Bradyrhizobium_sp._155	2782629	S	128	2287	2415	0.00011
Bradyrhizobium_sp._CCBAU_21365	1325083	S	15	756	771	0.00004
Bradyrhizobium_erythrophlei	1437360	S	25041	2142	27183	0.00129
Bradyrhizobium_diazoefficiens	1355477	S	19628	38301	57929	0.00275
Bradyrhizobium_icense	1274631	S	11359	1697	13056	0.00062
Bradyrhizobium_paxllaeri	190148	S	9407	1839	11246	0.00053
Bradyrhizobium_lablabi	722472	S	8241	9924	18165	0.00086
Bradyrhizobium_genosp._L	83637	S	7670	1616	9286	0.00044
Bradyrhizobium_canariense	255045	S	7512	12282	19794	0.00094
Bradyrhizobium_oligotrophicum	44255	S	7405	1354	8759	0.00042
Bradyrhizobium_japonicum	375	S	7196	10706	17902	0.00085
Bradyrhizobium_arachidis	858423	S	5671	1694	7365	0.00035
Bradyrhizobium_guangdongense	1325090	S	4815	1862	6677	0.00032
Bradyrhizobium_vignae	1549949	S	4690	1151	5841	0.00028
Bradyrhizobium_quebecense	2748629	S	4504	2653	7157	0.00034
Bradyrhizobium_genosp._B	83627	S	4431	987	5418	0.00026
Bradyrhizobium_cosmicum	1404864	S	4347	1471	5818	0.00028
Bradyrhizobium_guangxiense	1325115	S	4224	1909	6133	0.00029
Bradyrhizobium_guangzhouense	1325095	S	4048	1600	5648	0.00027
Bradyrhizobium_septentrionale	1404411	S	3772	2398	6170	0.00029
Bradyrhizobium_daqingense	993502	S	3381	1902	5283	0.00025
Bradyrhizobium_betae	244734	S	2906	1714	4620	0.00022
Bradyrhizobium_amphicarpaeae	1404768	S	2870	1241	4111	0.00020
Bradyrhizobium_symbiodeficiens	1404367	S	2500	3894	6394	0.00030
Bradyrhizobium_zhanjiangense	1325107	S	1847	1917	3764	0.00018
Bradyrhizobium_elkanii	29448	S	1283	4824	6107	0.00029
Bradyrhizobium_ottawaense	931866	S	950	6143	7093	0.00034
Rhodopseudomonas_palustris	1076	S	27064	10004	37068	0.00176
Rhodopseudomonas_sp._SK50-23	340268	S	3707	788	4495	0.00021
Rhodopseudomonas_boonkerdii	475937	S	3572	986	4558	0.00022
Tardiphaga_sp._37S4	1404741	S	1988	1478	3466	0.00016
Tardiphaga_sp._vice154	2592814	S	145	2193	2338	0.00011
Tardiphaga_sp._vice278	2592815	S	89	2115	2204	0.00010
Tardiphaga_sp._vice304	2592817	S	57	1056	1113	0.00005
Tardiphaga_sp._vice352	2592816	S	32	947	979	0.00005
Tardiphaga_robiniae	943830	S	2035	1349	3384	0.00016
Afipia_carboxidovorans	40137	S	5268	2359	7627	0.00036
Afipia_sp._GAS231	1882747	S	3677	2748	6425	0.00030
Nitrobacter_hamburgensis	912	S	4233	769	5002	0.00024
Nitrobacter_winogradskyi	913	S	3368	605	3973	0.00019
Variibacter_gotjawalensis	1333996	S	7407	612	8019	0.00038
Rhizobium_sp._BG4	2613770	S	2922	574	3496	0.00017
Rhizobium_sp._NXC24	2048897	S	2655	394	3049	0.00014
Rhizobium_sp._WYJ-E13	2849093	S	2609	341	2950	0.00014
Rhizobium_sp._ACO-34A	1571470	S	2100	457	2557	0.00012
Rhizobium_sp._SL42	2806346	S	1999	371	2370	0.00011
Rhizobium_sp._AB2/73	2795216	S	1923	1066	2989	0.00014
Rhizobium_sp._WL3	2603277	S	1869	371	2240	0.00011
Rhizobium_sp._11515TR	2028343	S	1642	391	2033	0.00010
Rhizobium_sp._NZLR1	2731096	S	1392	479	1871	0.00009
Rhizobium_sp._CIAT894	2020312	S	1357	594	1951	0.00009
Rhizobium_sp._NXC14	1981173	S	1341	549	1890	0.00009
Rhizobium_sp._NLR16a	2731112	S	1319	585	1904	0.00009
Rhizobium_sp._C104	2917727	S	1206	652	1858	0.00009
Rhizobium_sp._K102	2918527	S	1109	748	1857	0.00009
Rhizobium_sp._L51/94	2819999	S	865	1092	1957	0.00009
Rhizobium_sp._007	2785056	S	603	1056	1659	0.00008
Rhizobium_sp._X9	2815360	S	577	1246	1823	0.00009
Rhizobium_sp._IE4771	1301032	S	376	755	1131	0.00005
Rhizobium_sp._Kim5	2020311	S	345	754	1099	0.00005
Rhizobium_sp._TAL182	2020313	S	287	814	1101	0.00005
Rhizobium_sp._NIBRBAC000502774	2590777	S	181	844	1025	0.00005
Rhizobium_sp._ZX09	2291939	S	115	499	614	0.00003
Rhizobium_sp._Y9	1914541	S	106	404	510	0.00002
Rhizobium_sp._B230/85	2819994	S	86	921	1007	0.00005
Rhizobium_sp._T136	555319	S	68	1887	1955	0.00009
Rhizobium_sp._N324	1703969	S	51	1058	1109	0.00005
Rhizobium_sp._CCGE531	2364271	S	50	1766	1816	0.00009
Rhizobium_sp._B21/90	2819993	S	38	1327	1365	0.00006
Rhizobium_sp._CCGE532	2364272	S	18	1345	1363	0.00006
Rhizobium_sp._BG6	2613771	S	10	1721	1731	0.00008
Rhizobium_leguminosarum	384	S	13210	17612	30822	0.00146
Rhizobium_etli	29449	S	3909	4548	8457	0.00040
Rhizobium_jaguaris	1312183	S	2722	354	3076	0.00015
Rhizobium_gallicum	56730	S	2713	3506	6219	0.00030
Rhizobium_pseudoryzae	379684	S	2713	594	3307	0.00016
Rhizobium_phaseoli	396	S	2332	4762	7094	0.00034
Rhizobium_bangladeshense	1138189	S	2144	524	2668	0.00013
Rhizobium_tropici	398	S	1623	437	2060	0.00010
Rhizobium_lentis	1138194	S	1606	506	2112	0.00010
Rhizobium_binae	1138190	S	1458	548	2006	0.00010
Rhizobium_rosettiformans	1368430	S	1412	681	2093	0.00010
Rhizobium_daejeonense	240521	S	1354	458	1812	0.00009
Rhizobium_rhizoryzae	451876	S	1270	177	1447	0.00007
Rhizobium_indicum	2583231	S	1063	938	2001	0.00009
Rhizobium_pusense	648995	S	753	2964	3717	0.00018
Rhizobium_acidisoli	1538158	S	747	617	1364	0.00006
Rhizobium_oryzihabitans	2267833	S	485	670	1155	0.00005
Rhizobium_laguerreae	1076926	S	386	662	1048	0.00005
Rhizobium_hidalgonense	1538159	S	344	789	1133	0.00005
Rhizobium_ruizarguesonis	2081791	S	240	1762	2002	0.00010
Rhizobium_favelukesii	348824	S	27	903	930	0.00004
Agrobacterium_tumefaciens	358	S	6413	6404	12817	0.00061
Agrobacterium_fabrum	1176649	S	739	961	1700	0.00008
Agrobacterium_fabacearum	1183401	S	134	1801	1935	0.00009
Agrobacterium_vitis	373	S	3591	449	4040	0.00019
Agrobacterium_sp._T29	2580515	S	538	424	962	0.00005
Agrobacterium_sp._RAC06	1842536	S	405	804	1209	0.00006
Agrobacterium_sp._MA01	2664893	S	384	747	1131	0.00005
Agrobacterium_sp._CGMCC_11546	2579248	S	219	450	669	0.00003
Agrobacterium_sp._S7/73	2820002	S	94	516	610	0.00003
Agrobacterium_vaccinii	2735528	S	1452	205	1657	0.00008
Agrobacterium_larrymoorei	160699	S	1093	190	1283	0.00006
Agrobacterium_rubi	28099	S	914	265	1179	0.00006
Agrobacterium_salinitolerans	1183413	S	798	303	1101	0.00005
Agrobacterium_rhizogenes	359	S	606	1454	2060	0.00010
Neorhizobium_galegae	399	S	10751	3139	13890	0.00066
Neorhizobium_sp._SOG26	2060726	S	3163	675	3838	0.00018
Neorhizobium_sp._NCHU2750	1825976	S	2481	616	3097	0.00015
Pseudorhizobium_flavum	1335061	S	1679	1097	2776	0.00013
Pseudorhizobium_banfieldiae	1125847	S	1509	888	2397	0.00011
Sinorhizobium_meliloti	382	S	16626	12336	28962	0.00137
Sinorhizobium_fredii	380	S	12789	16656	29445	0.00140
Sinorhizobium_americanum	194963	S	4269	1629	5898	0.00028
Sinorhizobium_medicae	110321	S	3694	436	4130	0.00020
Sinorhizobium_sp._BG8	2613773	S	2937	509	3446	0.00016
Sinorhizobium_sp._CCBAU_05631	794846	S	695	979	1674	0.00008
Ensifer_adhaerens	106592	S	7449	4291	11740	0.00056
Ensifer_mexicanus	375549	S	5136	821	5957	0.00028
Ensifer_alkalisoli	1752398	S	3647	740	4387	0.00021
Ensifer_sojae	716925	S	3489	1321	4810	0.00023
Ensifer_sp._PDNC004	2811423	S	2524	1087	3611	0.00017
Ensifer_sp._T173	555315	S	550	2351	2901	0.00014
Shinella_sp._HZN7	879274	S	4658	4120	8778	0.00042
Shinella_sp._PSBB067	2715959	S	3700	2890	6590	0.00031
Shinella_sp._XGS7	2877941	S	3237	3031	6268	0.00030
Shinella_sp._H4-D48	2925841	S	1533	637	2170	0.00010
Shinella_zoogloeoides	352475	S	3576	5227	8803	0.00042
Shinella_oryzae	2871820	S	2066	956	3022	0.00014
Ciceribacter_thiooxidans	1969821	S	3137	660	3797	0.00018
Georhizobium_profundi	2341112	S	2641	617	3258	0.00015
Peteryoungia_desertarenae	1813451	S	1002	188	1190	0.00006
Candidatus_Liberibacter_africanus	34020	S	84	19	103	0.00000
Liberibacter_crescens	1273132	S	35	28	63	0.00000
Candidatus_Liberibacter_asiaticus	34021	S	23	51	74	0.00000
Candidatus_Liberibacter_solanacearum	556287	S	23	2	25	0.00000
Candidatus_Liberibacter_americanus	309868	S	19	2	21	0.00000
Methylobacterium_nodulans	114616	S	11979	1662	13641	0.00065
Methylobacterium_sp._17Sr1-1	2202826	S	5305	2694	7999	0.00038
Methylobacterium_sp._WL1	2603276	S	4969	1082	6051	0.00029
Methylobacterium_sp._C1	1479019	S	615	4739	5354	0.00025
Methylobacterium_sp._XJLW	739141	S	359	4749	5108	0.00024
Methylobacterium_aquaticum	270351	S	10314	4860	15174	0.00072
Methylobacterium_durans	2202825	S	7463	1175	8638	0.00041
Methylobacterium_radiodurans	2202828	S	6806	1810	8616	0.00041
Methylobacterium_currus	2051553	S	6657	2985	9642	0.00046
Methylobacterium_organophilum	410	S	5725	3418	9143	0.00043
Methylobacterium_terrae	2202827	S	5664	2802	8466	0.00040
Methylobacterium_mesophilicum	39956	S	5081	1137	6218	0.00030
Methylobacterium_tardum	374432	S	5052	1877	6929	0.00033
Methylobacterium_brachiatum	269660	S	4940	1908	6848	0.00033
Methylobacterium_indicum	1775910	S	4602	2445	7047	0.00033
Methylobacterium_oryzae	334852	S	3848	4990	8838	0.00042
Methylobacterium_radiotolerans	31998	S	1853	10264	12117	0.00058
Methylobacterium_phyllosphaerae	418223	S	732	2721	3453	0.00016
Microvirga_sp._VF16	2807101	S	29548	5005	34553	0.00164
Microvirga_sp._17_mud_1-3	2082949	S	10089	2309	12398	0.00059
Microvirga_ossetica	1882682	S	25195	4792	29987	0.00142
Microvirga_thermotolerans	2651334	S	11977	3526	15503	0.00074
Methylorubrum_populi	223967	S	8828	4234	13062	0.00062
Methylorubrum_extorquens	408	S	6816	11329	18145	0.00086
Methylorubrum_sp._B1-46	2897334	S	3197	1439	4636	0.00022
Methylorubrum_zatmanii	29429	S	204	1047	1251	0.00006
Mesorhizobium_sp._8	2584466	S	6863	1749	8612	0.00041
Mesorhizobium_sp._M1A.F.Ca.IN.022.06.1.1	2493680	S	5097	1733	6830	0.00032
Mesorhizobium_sp._J8	2777475	S	4965	1700	6665	0.00032
Mesorhizobium_sp._DCY119	2108445	S	4065	1015	5080	0.00024
Mesorhizobium_sp._B1-1-8	2589976	S	3907	1048	4955	0.00024
Mesorhizobium_sp._Pch-S	2082387	S	3873	564	4437	0.00021
Mesorhizobium_sp._B2-8-5	2589903	S	3872	1361	5233	0.00025
Mesorhizobium_sp._M1B.F.Ca.ET.045.04.1.1	2493673	S	3826	1550	5376	0.00026
Mesorhizobium_sp._M3A.F.Ca.ET.080.04.2.1	2493676	S	3743	1209	4952	0.00024
Mesorhizobium_sp._B2-1-1	2589974	S	3699	893	4592	0.00022
Mesorhizobium_sp._M1D.F.Ca.ET.043.01.1.1	2493669	S	3662	2321	5983	0.00028
Mesorhizobium_sp._L-2-11	2744521	S	3476	1427	4903	0.00023
Mesorhizobium_sp._M1E.F.Ca.ET.045.02.1.1	2493672	S	3463	1829	5292	0.00025
Mesorhizobium_sp._131-2-1	2744518	S	3286	1846	5132	0.00024
Mesorhizobium_sp._INR15	2654248	S	3087	472	3559	0.00017
Mesorhizobium_sp._PAMC28654	2880934	S	3048	609	3657	0.00017
Mesorhizobium_sp._M9A.F.Ca.ET.002.03.1.2	2493668	S	2990	1452	4442	0.00021
Mesorhizobium_sp._M4B.F.Ca.ET.058.02.1.1	2493675	S	2963	1326	4289	0.00020
Mesorhizobium_sp._B4-1-4	2589888	S	2689	691	3380	0.00016
Mesorhizobium_sp._B2-1-8	2589967	S	2566	837	3403	0.00016
Mesorhizobium_sp._M6A.T.Cr.TU.016.01.1.1	2493677	S	2537	903	3440	0.00016
Mesorhizobium_sp._M2A.F.Ca.ET.043.05.1.1	2493671	S	2312	2081	4393	0.00021
Mesorhizobium_sp._M7D.F.Ca.US.005.01.1.1	2493678	S	2165	791	2956	0.00014
Mesorhizobium_sp._M8A.F.Ca.ET.057.01.1.1	2493679	S	2133	865	2998	0.00014
Mesorhizobium_sp._NZP2077	2483404	S	1921	679	2600	0.00012
Mesorhizobium_sp._L-8-10	2744523	S	1828	6092	7920	0.00038
Mesorhizobium_sp._113-3-3	2744516	S	1823	1072	2895	0.00014
Mesorhizobium_sp._M7A.F.Ce.TU.012.03.2.1	2493681	S	1766	694	2460	0.00012
Mesorhizobium_sp._L-8-3	2744522	S	1684	5765	7449	0.00035
Mesorhizobium_sp._113-1-2	2744515	S	1619	853	2472	0.00012
Mesorhizobium_sp._NBSH29	2654249	S	1594	120	1714	0.00008
Mesorhizobium_sp._AA22	1854057	S	1565	1063	2628	0.00012
Mesorhizobium_sp._113-3-9	2744517	S	1451	1155	2606	0.00012
Mesorhizobium_sp._NZP2298	2483403	S	1387	882	2269	0.00011
Mesorhizobium_sp._M2A.F.Ca.ET.046.03.2.1	2493674	S	1270	3573	4843	0.00023
Mesorhizobium_sp._M2A.F.Ca.ET.043.02.1.1	2493670	S	996	2664	3660	0.00017
Mesorhizobium_sp._WSM1497	278153	S	431	945	1376	0.00007
Mesorhizobium_sp._131-3-5	2744520	S	253	850	1103	0.00005
Mesorhizobium_sp._131-2-5	2744519	S	234	1715	1949	0.00009
Mesorhizobium_sp._NZP2234	2483402	S	175	680	855	0.00004
Mesorhizobium_terrae	2725666	S	3912	1397	5309	0.00025
Mesorhizobium_opportunistum	593909	S	3883	1734	5617	0.00027
Mesorhizobium_amorphae	71433	S	2983	771	3754	0.00018
Mesorhizobium_ciceri	39645	S	2329	6187	8516	0.00040
Mesorhizobium_loti	381	S	2191	19365	21556	0.00102
Mesorhizobium_australicum	536018	S	2162	726	2888	0.00014
Mesorhizobium_huakuii	28104	S	1989	1598	3587	0.00017
Mesorhizobium_erdmanii	1777866	S	1754	536	2290	0.00011
Mesorhizobium_japonicum	2066070	S	1668	1322	2990	0.00014
Aquibium_microcysteis	675281	S	7711	2349	10060	0.00048
Aquibium_oceanicum	1670800	S	5835	1467	7302	0.00035
Aminobacter_sp._MSH1	374606	S	3984	2563	6547	0.00031
Aminobacter_sp._SR38	2774562	S	891	3748	4639	0.00022
Aminobacter_sp._MDW-2	2666139	S	581	2753	3334	0.00016
Aminobacter_aminovorans	83263	S	556	1877	2433	0.00012
Nitratireductor_sp._SY7	2599600	S	5146	1044	6190	0.00029
Nitratireductor_sp._OM-1	1756988	S	2455	462	2917	0.00014
Nitratireductor_kimnyeongensis	430679	S	1620	255	1875	0.00009
Phyllobacterium_sp._T1018	555316	S	1803	243	2046	0.00010
Phyllobacterium_sp._628	2718938	S	865	124	989	0.00005
Phyllobacterium_sp._T1293	555317	S	784	98	882	0.00004
Phyllobacterium_zundukense	1867719	S	1831	276	2107	0.00010
Roseitalea_porphyridii	1852022	S	4069	740	4809	0.00023
Hoeflea_sp._IMCC20628	1620421	S	1686	174	1860	0.00009
Hoeflea_phototrophica	244596	S	1576	201	1777	0.00008
Oricola_thermophila	2742145	S	3094	454	3548	0.00017
Salaquimonas_pukyongi	2712698	S	1360	63	1423	0.00007
Lentilitoribacter_sp._Alg239-R112	2305987	S	62	1	63	0.00000
Pseudolabrys_taiwanensis	331696	S	22966	4322	27288	0.00130
Pseudolabrys_sp._FHR47	2562284	S	14127	2843	16970	0.00081
Xanthobacter_dioxanivorans	2528964	S	7659	2844	10503	0.00050
Xanthobacter_sp._YC-JY1	2419844	S	2598	2752	5350	0.00025
Xanthobacter_autotrophicus	280	S	2441	2789	5230	0.00025
Starkeya_sp._ORNL1	2709380	S	8312	1847	10159	0.00048
Starkeya_novella	921	S	7164	2933	10097	0.00048
Ancylobacter_sp._TS-1	1850374	S	5194	2350	7544	0.00036
Ancylobacter_polymorphus	223390	S	5191	2775	7966	0.00038
Ancylobacter_pratisalsi	1745854	S	4236	1050	5286	0.00025
Labrys_sp._KNU-23	2789216	S	6032	680	6712	0.00032
Azorhizobium_caulinodans	7	S	5505	1274	6779	0.00032
Rhodoplanes_sp._Z2-YC6860	674703	S	28360	3084	31444	0.00149
Hyphomicrobium_denitrificans	53399	S	6587	773	7360	0.00035
Hyphomicrobium_nitrativorans	1427356	S	4228	379	4607	0.00022
Hyphomicrobium_sp._MC1	717785	S	2895	214	3109	0.00015
Methyloceanibacter_sp._wino2	2170729	S	2677	612	3289	0.00016
Methyloceanibacter_caenitepidi	1384459	S	2605	556	3161	0.00015
Aquabacter_sp._L1I39	2820278	S	4599	856	5455	0.00026
Methyloligella_sp._GL2	2742204	S	3935	508	4443	0.00021
Rhodomicrobium_vannielii	1069	S	3559	254	3813	0.00018
Caenibius_sp._WL	2872646	S	1801	336	2137	0.00010
Caenibius_tardaugens	169176	S	1176	930	2106	0.00010
Candidatus_Filomicrobium_marinum	1608628	S	1358	40	1398	0.00007
Devosia_sp._A16	1736675	S	11195	1429	12624	0.00060
Devosia_sp._JXJ_CY_41	2917991	S	3100	606	3706	0.00018
Devosia_sp._SL43	2806348	S	3092	609	3701	0.00018
Devosia_sp._1566	2499144	S	2826	322	3148	0.00015
Devosia_sp._I507	2083786	S	2160	699	2859	0.00014
Devosia_sp._MC521	2759954	S	1015	169	1184	0.00006
Devosia_ginsengisoli	400770	S	3512	688	4200	0.00020
Devosia_beringensis	2657486	S	3131	493	3624	0.00017
Devosia_salina	2860336	S	3020	1080	4100	0.00019
Devosia_oryziradicis	2801335	S	2990	590	3580	0.00017
Devosia_rhizoryzae	2774137	S	2624	299	2923	0.00014
Youhaiella_tibetensis	1447062	S	5092	1182	6274	0.00030
Paradevosia_shaoguanensis	1335043	S	4755	1832	6587	0.00031
Pelagibacterium_halotolerans	531813	S	2059	273	2332	0.00011
Maritalea_myrionectae	454601	S	396	13	409	0.00002
Bosea_sp._Tri-49	1867715	S	7699	1927	9626	0.00046
Bosea_sp._F3-2	2599640	S	7411	2574	9985	0.00047
Bosea_sp._RAC05	1842539	S	6802	2392	9194	0.00044
Bosea_sp._ANAM02	2020412	S	6122	2471	8593	0.00041
Bosea_sp._AS-1	2015316	S	6024	2067	8091	0.00038
Bosea_sp._PAMC_26642	1792307	S	5225	1205	6430	0.00031
Bosea_vaviloviae	1526658	S	6044	1580	7624	0.00036
Aureimonas_sp._SA4125	2826993	S	5239	1059	6298	0.00030
Aureimonas_sp._AU20	1349819	S	4637	726	5363	0.00025
Aureimonas_sp._OT7	2816454	S	2361	1993	4354	0.00021
Aureimonas_populi	1701758	S	3925	822	4747	0.00023
Aureimonas_mangrovi	2758041	S	3763	853	4616	0.00022
Aureimonas_altamirensis	370622	S	2310	813	3123	0.00015
Martelella_sp._AD-3	686597	S	1361	3949	5310	0.00025
Martelella_mediterranea	293089	S	2595	1008	3603	0.00017
Martelella_endophytica	1486262	S	2226	537	2763	0.00013
Martelella_lutilitoris	2583532	S	1359	1206	2565	0.00012
Aurantimonas_sp._HBX-1	2906072	S	6960	2282	9242	0.00044
Methylocystis_bryophila	655015	S	3680	394	4074	0.00019
Methylocystis_parvus	134	S	3486	441	3927	0.00019
Methylocystis_heyeri	391905	S	3288	389	3677	0.00017
Methylocystis_sp._SC2	187303	S	2290	613	2903	0.00014
Methylocystis_sp._SB2	743836	S	813	1247	2060	0.00010
Methylocystis_rosea	173366	S	2316	1728	4044	0.00019
Methylosinus_trichosporium	426	S	4640	1041	5681	0.00027
Methylosinus_sp._C49	2699395	S	3773	826	4599	0.00022
Stappia_indica	538381	S	6501	1659	8160	0.00039
Stappia_sp._ES.058	1881061	S	3327	441	3768	0.00018
Roseibium_aggregatum	187304	S	3526	526	4052	0.00019
Roseibium_alexandrii	388408	S	1033	105	1138	0.00005
Pannonibacter_phragmitetus	121719	S	4540	3435	7975	0.00038
Labrenzia_sp._VG12	2021862	S	2035	256	2291	0.00011
Labrenzia_sp._PHM005	2590016	S	861	69	930	0.00004
Labrenzia_sp._THAF82	2587861	S	806	53	859	0.00004
Pseudovibrio_brasiliensis	1898042	S	336	146	482	0.00002
Pseudovibrio_sp._FO-BEG1	911045	S	287	127	414	0.00002
Pseudorhodoplanes_sinuspersici	1235591	S	9950	820	10770	0.00051
Nordella_sp._HKS_07	2712222	S	9513	580	10093	0.00048
Terrihabitans_soli	708113	S	4427	554	4981	0.00024
Candidatus_Hodgkinia_cicadicola	573658	S	79	1	80	0.00000
Phreatobacter_stygius	1940610	S	8673	1431	10104	0.00048
Phreatobacter_cathodiphilus	1868589	S	7767	2507	10274	0.00049
Phreatobacter_sp._NMCR1094	2570229	S	5380	1109	6489	0.00031
Kaustia_mangrovi	2593653	S	9133	969	10102	0.00048
Parvibaculum_lavamentivorans	256618	S	4393	3175	7568	0.00036
Pyruvatibacter_mobilis	1712261	S	2793	375	3168	0.00015
Candidatus_Phaeomarinobacter_ectocarpi	1458461	S	1096	61	1157	0.00005
Chelatococcus_sp._CO-6	1702325	S	7712	4894	12606	0.00060
Chelatococcus_daeguensis	444444	S	4000	2495	6495	0.00031
Methylocella_silvestris	199596	S	3378	423	3801	0.00018
Methylocella_tundrae	227605	S	2954	311	3265	0.00016
Methylovirgula_ligni	569860	S	2724	377	3101	0.00015
Methylovirgula_sp._HY1	2822761	S	2348	164	2512	0.00012
Beijerinckia_indica	533	S	1537	134	1671	0.00008
Blastochloris_tepida	2233851	S	6498	2368	8866	0.00042
Blastochloris_viridis	1079	S	5836	1691	7527	0.00036
Acuticoccus_sp._I52.16.1	2928472	S	8608	997	9605	0.00046
Kaistia_sp._32K	2795690	S	7635	2082	9717	0.00046
Brucella_anthropi	529	S	1281	8677	9958	0.00047
Brucella_intermedia	94625	S	1248	234	1482	0.00007
Brucella_sp._BTU1	2840456	S	195	37	232	0.00001
Brucella_sp._10RB9215	1149953	S	84	89	173	0.00001
Brucella_sp._09RB8910	1844051	S	83	85	168	0.00001
Brucella_sp._6810	2769351	S	70	110	180	0.00001
Brucella_sp._BO3	2691913	S	57	91	148	0.00001
Brucella_sp._09RB8471	1149952	S	54	97	151	0.00001
Brucella_sp._BO2	693750	S	46	102	148	0.00001
Brucella_sp._2280	2592625	S	41	80	121	0.00001
Brucella_sp._458	2821140	S	35	75	110	0.00001
[Ochrobactrum]_quorumnocens	271865	S	588	94	682	0.00003
Brucella_pseudogrignonensis	419475	S	321	103	424	0.00002
Brucella_pituitosa	571256	S	136	49	185	0.00001
Brucella_melitensis	29459	S	69	2259	2328	0.00011
Brucella_inopinata	1218315	S	52	56	108	0.00001
Brucella_abortus	235	S	27	1414	1441	0.00007
Brucella_suis	29461	S	18	375	393	0.00002
Brucella_ceti	120577	S	13	138	151	0.00001
Brucella_ovis	236	S	12	34	46	0.00000
Pseudochrobactrum_sp._XF203	2879116	S	146	155	301	0.00001
Pseudochrobactrum_sp._Wa41.01b-1	2864102	S	111	130	241	0.00001
Pseudochrobactrum_algeriensis	2834768	S	135	139	274	0.00001
Hartmannibacter_diazotrophicus	1482074	S	4920	977	5897	0.00028
Breoghania_sp._L-A4	2304600	S	4882	701	5583	0.00026
Lichenihabitans_psoromatis	2528642	S	1634	979	2613	0.00012
Lichenihabitans_sp._PAMC28606	2880932	S	1404	978	2382	0.00011
Cohaesibacter_sp._ES.047	1798205	S	952	39	991	0.00005
Bartonella_apis	1686310	S	332	20	352	0.00002
Bartonella_sp._HY038	2759660	S	83	14	97	0.00000
Bartonella_sp._46A	2893471	S	28	26	54	0.00000
Bartonella_australis	388640	S	35	4	39	0.00000
Bartonella_vinsonii	33047	S	31	17	48	0.00000
Bartonella_quintana	803	S	24	7	31	0.00000
Bartonella_birtlesii	111504	S	22	7	29	0.00000
Bartonella_henselae	38323	S	19	5	24	0.00000
Bartonella_tribocorum	85701	S	17	48	65	0.00000
Bartonella_ancashensis	1318743	S	17	2	19	0.00000
Bartonella_clarridgeiae	56426	S	15	8	23	0.00000
Bartonella_schoenbuchensis	165694	S	15	12	27	0.00000
Bartonella_krasnovii	2267275	S	14	13	27	0.00000
Bartonella_alsatica	52764	S	13	3	16	0.00000
Bartonella_bacilliformis	774	S	12	2	14	0.00000
Sphingomonas_sp._S8-45	2938948	S	20014	2632	22646	0.00107
Sphingomonas_sp._HDW15A	2714942	S	18153	1541	19694	0.00093
Sphingomonas_sp._DM2-R-LB4	2899123	S	15526	5741	21267	0.00101
Sphingomonas_sp._CL5.1	2653203	S	9912	3652	13564	0.00064
Sphingomonas_sp._AK-PDB1-5	2872652	S	9650	1719	11369	0.00054
Sphingomonas_sp._MM-1	745310	S	9402	13034	22436	0.00106
Sphingomonas_sp._Cra20	1327635	S	9288	1637	10925	0.00052
Sphingomonas_sp._AP4-R1	2735134	S	8491	1169	9660	0.00046
Sphingomonas_sp._LM7	1938607	S	8280	2028	10308	0.00049
Sphingomonas_sp._S2-65	2903960	S	7206	1560	8766	0.00042
Sphingomonas_sp._NBWT7	2596913	S	6801	2457	9258	0.00044
Sphingomonas_sp._AAP5	1523415	S	6671	1887	8558	0.00041
Sphingomonas_sp._FARSPH	2219696	S	6414	5752	12166	0.00058
Sphingomonas_sp._PAMC26645	2565555	S	5157	1954	7111	0.00034
Sphingomonas_sp._HMP9	1517554	S	4909	2465	7374	0.00035
Sphingomonas_sp._KC8	1030157	S	4591	626	5217	0.00025
Sphingomonas_sp._HMP6	1517551	S	4284	950	5234	0.00025
Sphingomonas_sp._LK11	1390395	S	3155	3790	6945	0.00033
Sphingomonas_sp._NIC1	1961362	S	2751	10336	13087	0.00062
Sphingomonas_sp._IC081	304378	S	782	5504	6286	0.00030
Sphingomonas_sediminicola	386874	S	75204	7943	83147	0.00395
Sphingomonas_daechungensis	1176646	S	63573	6786	70359	0.00334
Sphingomonas_lutea	1045317	S	49902	6978	56880	0.00270
Sphingomonas_sabuli	2764186	S	33641	4449	38090	0.00181
Sphingomonas_sinipercae	2714944	S	32618	4720	37338	0.00177
Sphingomonas_ginsengisoli_An_et_al._2013	363835	S	29825	4446	34271	0.00163
Sphingomonas_rhizophila	2071607	S	23687	6792	30479	0.00145
Sphingomonas_piscis	2714943	S	22276	2210	24486	0.00116
Sphingomonas_xanthus	2594473	S	19322	4853	24175	0.00115
Sphingomonas_alpina	653931	S	11465	1054	12519	0.00059
Sphingomonas_profundi	2681549	S	10985	1920	12905	0.00061
Sphingomonas_sanxanigenens	397260	S	9446	5014	14460	0.00069
Sphingomonas_changnyeongensis	2698679	S	8123	1685	9808	0.00047
Sphingomonas_hengshuiensis	1609977	S	7406	1078	8484	0.00040
Sphingomonas_koreensis	93064	S	7379	6337	13716	0.00065
Sphingomonas_panacis	1560345	S	7100	1158	8258	0.00039
Sphingomonas_taxi	1549858	S	7085	2507	9592	0.00046
Sphingomonas_panacisoli	1813879	S	6800	1023	7823	0.00037
Sphingomonas_suaedae	2599297	S	6026	875	6901	0.00033
Sphingomonas_radiodurans	2890321	S	5780	839	6619	0.00031
Sphingomonas_insulae	424800	S	4937	1603	6540	0.00031
Sphingomonas_aliaeris	2759526	S	4707	648	5355	0.00025
Sphingomonas_paucimobilis	13689	S	4018	3031	7049	0.00033
Sphingomonas_sanguinis	33051	S	3329	3502	6831	0.00032
Sphingomonas_melonis	152682	S	3144	12997	16141	0.00077
Sphingomonas_lacunae	2698828	S	2183	289	2472	0.00012
Sphingomonas_paeninsulae	2319844	S	2128	93	2221	0.00011
Sphingobium_sp._SYK-6	627192	S	5625	1609	7234	0.00034
Sphingobium_sp._Cam5-1	2789327	S	4920	1815	6735	0.00032
Sphingobium_sp._EP60837	1855519	S	3107	898	4005	0.00019
Sphingobium_sp._TKS	1315974	S	2980	4406	7386	0.00035
Sphingobium_sp._YG1	2082188	S	2907	1292	4199	0.00020
Sphingobium_sp._SCG-1	2072936	S	2880	215	3095	0.00015
Sphingobium_sp._CAP-1	2676077	S	2842	1894	4736	0.00022
Sphingobium_sp._RAC03	1843368	S	2603	495	3098	0.00015
Sphingobium_sp._KCTC_72723	2733867	S	2043	362	2405	0.00011
Sphingobium_sp._MI1205	407020	S	2019	2921	4940	0.00023
Sphingobium_sp._PAMC28499	2565554	S	666	1365	2031	0.00010
Sphingobium_sp._YBL2	484429	S	377	2562	2939	0.00014
Sphingobium_sp._RSMS	520734	S	274	1681	1955	0.00009
Sphingobium_sp._LF-16	2185111	S	51	868	919	0.00004
Sphingobium_yanoikuyae	13690	S	4526	9035	13561	0.00064
Sphingobium_amiense	135719	S	3732	4865	8597	0.00041
Sphingobium_phenoxybenzoativorans	1592790	S	3698	1543	5241	0.00025
Sphingobium_indicum	332055	S	3613	2779	6392	0.00030
Sphingobium_cloacae	120107	S	2933	4534	7467	0.00035
Sphingobium_xenophagum	121428	S	2574	1817	4391	0.00021
Sphingobium_chlorophenolicum	46429	S	2539	1204	3743	0.00018
Sphingobium_baderi	1332080	S	2346	2398	4744	0.00023
Sphingobium_herbicidovorans	76947	S	2017	1825	3842	0.00018
Sphingobium_fuliginis	336203	S	1101	4439	5540	0.00026
Sphingopyxis_sp._QXT-31	1357916	S	5086	1510	6596	0.00031
Sphingopyxis_sp._YF1	2482763	S	4598	1120	5718	0.00027
Sphingopyxis_sp._BSN-002	2911495	S	4304	821	5125	0.00024
Sphingopyxis_sp._OPL5	2486273	S	4290	872	5162	0.00024
Sphingopyxis_sp._113P3	292913	S	4263	1772	6035	0.00029
Sphingopyxis_sp._PAMC25046	2565556	S	4074	1984	6058	0.00029
Sphingopyxis_sp._FD7	1914525	S	3481	1552	5033	0.00024
Sphingopyxis_sp._EG6	1874061	S	3180	1655	4835	0.00023
Sphingopyxis_sp._MG	1866325	S	224	2143	2367	0.00011
Sphingopyxis_macrogoltabida	33050	S	7659	4052	11711	0.00056
Sphingopyxis_terrae	33052	S	4592	2619	7211	0.00034
Sphingopyxis_lindanitolerans	2054227	S	4054	2123	6177	0.00029
Sphingopyxis_fribergensis	1515612	S	3625	1552	5177	0.00025
Sphingopyxis_granuli	267128	S	3562	10246	13808	0.00066
Sphingopyxis_alaskensis	117207	S	3349	812	4161	0.00020
Novosphingobium_sp._Gsoil_351	2675225	S	5799	500	6299	0.00030
Novosphingobium_sp._Sx8-5	2896849	S	5146	737	5883	0.00028
Novosphingobium_sp._EMRT-2	2571749	S	4405	2717	7122	0.00034
Novosphingobium_sp._P6W	1609758	S	3599	593	4192	0.00020
Novosphingobium_sp._ES2-1	2780074	S	2789	1462	4251	0.00020
Novosphingobium_sp._THN1	1016987	S	2708	979	3687	0.00017
Novosphingobium_sp._PP1Y	702113	S	1759	2195	3954	0.00019
Novosphingobium_sp._KA1	164608	S	946	5424	6370	0.00030
Novosphingobium_resinovorum	158500	S	4788	2477	7265	0.00034
Novosphingobium_aromaticivorans	48935	S	3954	1905	5859	0.00028
Novosphingobium_decolorationis	2698673	S	3775	2179	5954	0.00028
Novosphingobium_ginsenosidimutans	1176536	S	2985	311	3296	0.00016
Novosphingobium_pentaromativorans	205844	S	1397	2601	3998	0.00019
Rhizorhabdus_wittichii	160791	S	11724	7508	19232	0.00091
Rhizorhabdus_dicambivorans	1850238	S	6853	6145	12998	0.00062
Rhizorhabdus_phycosphaerae	2711156	S	5340	712	6052	0.00029
Allosphingosinicella_indica	941907	S	13313	1710	15023	0.00071
Sphingosinithalassobacter_sp._CS137	2762748	S	6771	1485	8256	0.00039
Sphingosinithalassobacter_tenebrarum	2711215	S	4606	1516	6122	0.00029
Parasphingopyxis_algicola	2026624	S	5909	399	6308	0.00030
Parasphingopyxis_sp._CP4	2724527	S	1599	73	1672	0.00008
Sphingorhabdus_sp._YGSMI21	2077182	S	1612	288	1900	0.00009
Sphingorhabdus_sp._SMR4y	2584094	S	1438	262	1700	0.00008
Sphingorhabdus_sp._M41	1806885	S	1106	147	1253	0.00006
Sphingorhabdus_lacus	392610	S	1015	41	1056	0.00005
Sphingorhabdus_lutea	1913578	S	133	9	142	0.00001
Blastomonas_sp._RAC04	1842535	S	1286	1835	3121	0.00015
Blastomonas_fulva	1550728	S	1150	2113	3263	0.00015
Hankyongella_ginsenosidimutans	1763828	S	4180	858	5038	0.00024
Tardibacter_chloracetimidivorans	1921510	S	3948	3444	7392	0.00035
Citromicrobium_sp._JL477	1634516	S	2820	1352	4172	0.00020
Novosphingopyxis_iocasae	2762729	S	2807	1631	4438	0.00021
Aquisediminimonas_profunda	1550733	S	1797	69	1866	0.00009
Parasphingorhabdus_sp._JHSY0214	2806553	S	646	41	687	0.00003
Parasphingorhabdus_halotolerans	2725558	S	544	21	565	0.00003
Parasphingorhabdus_litoris	394733	S	486	32	518	0.00002
Erythrobacter_sp._HL-111	1798193	S	3713	701	4414	0.00021
Erythrobacter_sp._JK5	2829500	S	3029	898	3927	0.00019
Erythrobacter_sp._HKB08	2502843	S	2865	623	3488	0.00017
Erythrobacter_sp._SDW2	2907154	S	2522	664	3186	0.00015
Erythrobacter_sp._THAF29	2587851	S	1638	382	2020	0.00010
Erythrobacter_sp._3-20A1M	2653850	S	1433	2303	3736	0.00018
Erythrobacter_sp._A30-3	2785907	S	1408	1122	2530	0.00012
Erythrobacter_sp._KY5	2011159	S	1307	101	1408	0.00007
Erythrobacter_sp._LQ02-29	2920384	S	1304	1491	2795	0.00013
Erythrobacter_sp._SCSIO_43205	2779361	S	674	131	805	0.00004
Erythrobacter_litoralis	39960	S	4829	2087	6916	0.00033
Erythrobacter_neustonensis	1112	S	2090	472	2562	0.00012
Erythrobacter_mangrovi	2739433	S	2042	724	2766	0.00013
Erythrobacter_aureus	2182384	S	1577	280	1857	0.00009
Porphyrobacter_sp._CACIAM_03H1	2003315	S	4198	1226	5424	0.00026
Porphyrobacter_sp._LM_6	1896196	S	2238	779	3017	0.00014
Porphyrobacter_sp._GA68	2883480	S	1906	816	2722	0.00013
Porphyrobacter_sp._HT-58-2	2023229	S	1812	424	2236	0.00011
Qipengyuania_flava	192812	S	5348	3047	8395	0.00040
Qipengyuania_sediminis	1532023	S	3427	482	3909	0.00019
Qipengyuania_soli	2782568	S	2299	420	2719	0.00013
Qipengyuania_aurantiaca	2867233	S	1914	630	2544	0.00012
Qipengyuania_gelatinilytica	2867231	S	1714	323	2037	0.00010
Qipengyuania_seohaensis	266951	S	1389	296	1685	0.00008
Qipengyuania_aquimaris	255984	S	1072	1072	2144	0.00010
Qipengyuania_psychrotolerans	2867238	S	1027	128	1155	0.00005
Qipengyuania_xiapuensis	2867236	S	955	943	1898	0.00009
Altererythrobacter_sp._B11	2060312	S	4089	1956	6045	0.00029
Altererythrobacter_sp._TH136	2067415	S	3092	566	3658	0.00017
Altererythrobacter_sp._BO-6	2604537	S	1950	305	2255	0.00011
Altererythrobacter_sp._ZODW24	2185142	S	775	37	812	0.00004
Altererythrobacter_epoxidivorans	361183	S	1514	439	1953	0.00009
Altererythrobacter_ishigakiensis	476157	S	619	47	666	0.00003
Tsuneonella_amylolytica	2338327	S	4103	1195	5298	0.00025
Tsuneonella_dongtanensis	692370	S	3626	716	4342	0.00021
Tsuneonella_mangrovi	1982042	S	2967	450	3417	0.00016
Tsuneonella_flava	2055955	S	1183	358	1541	0.00007
Croceicoccus_sp._YJ47	2798724	S	2542	1447	3989	0.00019
Croceicoccus_sp._Ery5	1703340	S	842	921	1763	0.00008
Croceicoccus_sp._Ery15	1703338	S	763	1221	1984	0.00009
Croceicoccus_marinus	450378	S	4301	2318	6619	0.00031
Croceicoccus_naphthovorans	1348774	S	1830	2231	4061	0.00019
Aurantiacibacter_gangjinensis	502682	S	1631	157	1788	0.00008
Aurantiacibacter_atlanticus	1648404	S	709	237	946	0.00004
Pelagerythrobacter_marensis	543877	S	2282	319	2601	0.00012
Paraurantiacibacter_namhicola	645517	S	2177	284	2461	0.00012
Croceibacterium_atlanticum	1267766	S	1898	816	2714	0.00013
Sphingosinicella_sp._BN140058	1892855	S	13553	1245	14798	0.00070
Sphingosinicella_flava	2771430	S	6484	965	7449	0.00035
Sphingosinicella_microcystinivorans	335406	S	4728	619	5347	0.00025
Polymorphobacter_sp._PAMC_29362	2835787	S	2930	1957	4887	0.00023
Polymorphobacter_sp._PAMC_29334	2862331	S	2679	1845	4524	0.00021
Sandaracinobacter_sp._M6	2759707	S	3858	269	4127	0.00020
Zymomonas_mobilis	542	S	255	173	428	0.00002
Azospirillum_sp._B510	137722	S	4972	1885	6857	0.00033
Azospirillum_sp._TSH100	652764	S	4211	1968	6179	0.00029
Azospirillum_sp._TSA2s	709810	S	4171	3263	7434	0.00035
Azospirillum_sp._TSH58	664962	S	2941	4009	6950	0.00033
Azospirillum_brasilense	192	S	17080	15292	32372	0.00154
Azospirillum_thermophilum	2202148	S	13009	2925	15934	0.00076
Azospirillum_thiophilum	528244	S	6522	2147	8669	0.00041
Azospirillum_ramasamyi	682998	S	3915	2284	6199	0.00029
Azospirillum_humicireducens	1226968	S	3196	1913	5109	0.00024
Azospirillum_lipoferum	193	S	3099	2337	5436	0.00026
Azospirillum_oryzae	286727	S	3021	2675	5696	0.00027
Azospirillum_baldaniorum	1064539	S	2091	4360	6451	0.00031
Skermanella_mucosa	1789672	S	7735	5280	13015	0.00062
Skermanella_sp._TT6	2775420	S	7123	7147	14270	0.00068
Skermanella_rosea	1817965	S	6514	5820	12334	0.00059
Skermanella_pratensis	2233999	S	6134	3337	9471	0.00045
Nitrospirillum_amazonense	28077	S	7674	889	8563	0.00041
Indioceanicola_profundi	2220096	S	6417	881	7298	0.00035
Niveispirillum_cyanobacteriorum	1612173	S	3262	350	3612	0.00017
Roseomonas_sp._OT10	2897332	S	13954	3284	17238	0.00082
Roseomonas_sp._S08	1750527	S	13165	787	13952	0.00066
Roseomonas_sp._FDAARGOS_362	2018065	S	952	4870	5822	0.00028
Roseomonas_gilardii	257708	S	9505	4200	13705	0.00065
Roseomonas_haemaphysalidis	2768162	S	8260	894	9154	0.00043
Roseomonas_marmotae	2768161	S	7773	828	8601	0.00041
Roseomonas_mucosa	207340	S	778	4619	5397	0.00026
Rhodovastum_atsumiense	504468	S	11547	1102	12649	0.00060
Roseococcus_microcysteis	2771361	S	8343	734	9077	0.00043
Komagataeibacter_xylinus	28448	S	2213	3759	5972	0.00028
Komagataeibacter_saccharivorans	265959	S	894	317	1211	0.00006
Komagataeibacter_nataicola	265960	S	638	284	922	0.00004
Komagataeibacter_oboediens	65958	S	628	292	920	0.00004
Komagataeibacter_europaeus	33995	S	572	281	853	0.00004
Komagataeibacter_medellinensis	1177712	S	492	402	894	0.00004
Komagataeibacter_rhaeticus	215221	S	36	582	618	0.00003
Acidiphilium_multivorum	62140	S	1585	6644	8229	0.00039
Acidiphilium_cryptum	524	S	350	2324	2674	0.00013
Sediminicoccus_rosea	1225128	S	5741	279	6020	0.00029
Acidibrevibacterium_fodinaquatile	1969806	S	4994	432	5426	0.00026
Lichenicola_cladoniae	1484109	S	4810	219	5029	0.00024
Acetobacter_aceti	435	S	1751	645	2396	0.00011
Acetobacter_sp._KACC_21233	2592655	S	370	73	443	0.00002
Acetobacter_sp._JWB	2259883	S	10	638	648	0.00003
Acetobacter_persici	1076596	S	367	47	414	0.00002
Acetobacter_ghanensis	431306	S	235	56	291	0.00001
Acetobacter_pasteurianus	438	S	173	261	434	0.00002
Acetobacter_tropicalis	104102	S	106	62	168	0.00001
Acetobacter_senegalensis	446692	S	95	67	162	0.00001
Acetobacter_orientalis	146474	S	93	12	105	0.00000
Acetobacter_ascendens	481146	S	93	91	184	0.00001
Acetobacter_oryzoeni	2500548	S	25	27	52	0.00000
Acetobacter_oryzifermentans	1633874	S	22	96	118	0.00001
Gluconacetobacter_diazotrophicus	33996	S	3181	654	3835	0.00018
Gluconobacter_oxydans	442	S	1117	1136	2253	0.00011
Gluconobacter_albidus	318683	S	495	86	581	0.00003
Gluconobacter_sphaericus	574987	S	390	90	480	0.00002
Gluconobacter_frateurii	38308	S	214	54	268	0.00001
Gluconobacter_thailandicus	257438	S	92	67	159	0.00001
Granulibacter_bethesdensis	364410	S	2097	179	2276	0.00011
Asaia_bogorensis	91915	S	1320	216	1536	0.00007
Neoasaia_chiangmaiensis	320497	S	1225	247	1472	0.00007
Kozakia_baliensis	153496	S	859	303	1162	0.00006
Novacetimonas_hansenii	436	S	713	328	1041	0.00005
Oecophyllibacter_saccharovorans	2558360	S	627	20	647	0.00003
Parasaccharibacter_sp._TMW_2.1888	2268025	S	40	221	261	0.00001
Parasaccharibacter_apium	1510841	S	25	133	158	0.00001
Swingsia_sp._F3b2	2558361	S	248	6	254	0.00001
Swingsia_samuiensis	1293412	S	31	4	35	0.00000
Neokomagataea_tanensis	661191	S	157	24	181	0.00001
Entomobacter_blattae	2762277	S	107	7	114	0.00001
Bombella_sp._KACC_21507	2697033	S	37	4	41	0.00000
Hypericibacter_adhaerens	2602016	S	22475	4290	26765	0.00127
Hypericibacter_terrae	2602015	S	17311	2657	19968	0.00095
Magnetospirillum_sp._XM-1	1663591	S	3685	1268	4953	0.00024
Magnetospirillum_sp._ME-1	1639348	S	3292	1231	4523	0.00021
Magnetospirillum_gryphiswaldense	55518	S	4750	380821	385571	0.01830
Magnetospirillum_magneticum	84159	S	3707	380	4087	0.00019
Rhodospirillum_centenum	34018	S	8337	1136	9473	0.00045
Rhodospirillum_rubrum	1085	S	3975	287	4262	0.00020
Ferrovibrio_terrae	2594003	S	11326	696	12022	0.00057
Tistrella_mobilis	171437	S	7855	3558	11413	0.00054
Defluviicoccus_vanus	111831	S	4432	380	4812	0.00023
Pararhodospirillum_photometricum	1084	S	2364	170	2534	0.00012
Haematospirillum_jordaniae	1549855	S	405	32	437	0.00002
Candidatus_Endolissoclinum_faulkneri	1263979	S	221	2	223	0.00001
Stella_humosa	94	S	18535	1250	19785	0.00094
Elioraea_tepida	2843330	S	8496	407	8903	0.00042
Thalassospira_sp._A40-3	2785908	S	418	162	580	0.00003
Thalassospira_sp._B30-1	2785911	S	247	362	609	0.00003
Thalassospira_marina	2048283	S	550	34	584	0.00003
Thalassospira_indica	1891279	S	502	296	798	0.00004
Thalassospira_xiamenensis	220697	S	252	349	601	0.00003
Magnetospira_sp._QH-2	1288970	S	1699	53	1752	0.00008
Terasakiella_sp._SH-1	2560057	S	196	4	200	0.00001
Paracoccus_sp._MC1862	2760307	S	2463	265	2728	0.00013
Paracoccus_sp._MA	2895796	S	2075	1100	3175	0.00015
Paracoccus_sp._AK26	2589076	S	1773	305	2078	0.00010
Paracoccus_sp._H4-D09	2812658	S	1208	252	1460	0.00007
Paracoccus_sp._S8-55	2903900	S	1010	138	1148	0.00005
Paracoccus_sp._Arc7-R13	2500532	S	749	757	1506	0.00007
Paracoccus_sanguinis	1545044	S	3925	1025	4950	0.00023
Paracoccus_liaowanqingii	2560053	S	2648	302	2950	0.00014
Paracoccus_yeei	147645	S	2476	3808	6284	0.00030
Paracoccus_denitrificans	266	S	2413	2748	5161	0.00024
Paracoccus_zhejiangensis	1077935	S	2299	552	2851	0.00014
Paracoccus_aminovorans	34004	S	2240	640	2880	0.00014
Paracoccus_pantotrophus	82367	S	2091	1172	3263	0.00015
Paracoccus_contaminans	1945662	S	2037	461	2498	0.00012
Paracoccus_suum	2259340	S	2022	361	2383	0.00011
Paracoccus_jeotgali	2065379	S	1905	366	2271	0.00011
Paracoccus_aminophilus	34003	S	1591	158	1749	0.00008
Paracoccus_tegillarcae	1529068	S	1034	62	1096	0.00005
Paracoccus_kondratievae	135740	S	955	184	1139	0.00005
Paracoccus_marcusii	59779	S	768	685	1453	0.00007
Paracoccus_mutanolyticus	1499308	S	264	871	1135	0.00005
Cereibacter_sphaeroides	1063	S	7684	3958	11642	0.00055
Cereibacter_azotoformans	43057	S	746	2794	3540	0.00017
Rhodobacter_sp._CZR27	2033869	S	3168	1010	4178	0.00020
Rhodobacter_sp._N10	2807096	S	2544	308	2852	0.00014
Rhodobacter_sp._LPB0142	1850250	S	2310	1610	3920	0.00019
Rhodobacter_capsulatus	1061	S	2842	600	3442	0.00016
Rhodovulum_sp._P5	1564506	S	1663	184	1847	0.00009
Rhodovulum_sp._MB263	308754	S	1561	629	2190	0.00010
Rhodovulum_sulfidophilum	35806	S	2540	1504	4044	0.00019
Paroceanicella_profunda	2579971	S	5334	1399	6733	0.00032
Polymorphum_gilvum	991904	S	5276	1276	6552	0.00031
Pikeienuella_piscinae	2748098	S	4038	380	4418	0.00021
Thioclava_electrotropha	1549850	S	1550	441	1991	0.00009
Thioclava_nitratireducens	1915078	S	1384	523	1907	0.00009
Pontivivens_ytuae	2789856	S	3445	259	3704	0.00018
Silicimonas_algicola	1826607	S	3169	190	3359	0.00016
Pelagovum_pacificum	2588711	S	2889	361	3250	0.00015
Frigidibacter_mobilis	1335048	S	2470	1049	3519	0.00017
Brevirhabdus_pacifica	1267768	S	2161	1027	3188	0.00015
Pukyongiella_litopenaei	2605946	S	2086	507	2593	0.00012
Fuscovulum_blasticum	1075	S	1862	239	2101	0.00010
Gymnodinialimonas_ceratoperidinii	2856823	S	1774	170	1944	0.00009
Haematobacter_massiliensis	195105	S	1673	666	2339	0.00011
Falsirhodobacter_sp._PG104	2692330	S	1585	228	1813	0.00009
Gemmobacter_aquarius	2169400	S	1496	306	1802	0.00009
Pseudopuniceibacterium_antarcticum	2613965	S	1448	114	1562	0.00007
Pacificitalea_manganoxidans	1411902	S	1403	312	1715	0.00008
Pseudooceanicola_algae	1537215	S	1340	133	1473	0.00007
Tabrizicola_piscis	2494374	S	1309	120	1429	0.00007
Monaibacterium_sp._h42	2758038	S	1294	305	1599	0.00008
Roseicitreum_antarcticum	564137	S	1158	61	1219	0.00006
Tritonibacter_mobilis	379347	S	821	374	1195	0.00006
Yoonia_vestfoldensis	245188	S	767	176	943	0.00004
Rhodophyticola_sp._CCM32	2916397	S	766	23	789	0.00004
Pseudohalocynthiibacter_aestuariivivens	1591409	S	738	150	888	0.00004
Qingshengfaniella_alkalisoli	2599296	S	668	36	704	0.00003
Profundibacter_amoris	2171755	S	641	22	663	0.00003
Rhodobaca_barguzinensis	441209	S	600	27	627	0.00003
Pseudorhodobacter_turbinis	2500533	S	505	32	537	0.00003
Parasedimentitalea_marina	2483033	S	429	20	449	0.00002
Aestuarium_zhoushanense	2820523	S	404	167	571	0.00003
Cognatishimia_activa	1715691	S	337	15	352	0.00002
Planktomarina_temperata	1284658	S	225	5	230	0.00001
Roseovarius_sp._SCSIO_43702	2823043	S	2620	203	2823	0.00013
Roseovarius_sp._THAF9	2587847	S	1222	307	1529	0.00007
Roseovarius_sp._THAF8	2587846	S	495	810	1305	0.00006
Roseovarius_sp._THAF27	2587850	S	489	856	1345	0.00006
Roseovarius_sp._TM1035	391613	S	211	437	648	0.00003
Roseovarius_indicus	540747	S	3111	983	4094	0.00019
Roseovarius_faecimaris	2494550	S	1134	48	1182	0.00006
Roseovarius_mucosus	215743	S	231	482	713	0.00003
Sulfitobacter_sp._JK7-1	2829501	S	1260	68	1328	0.00006
Sulfitobacter_sp._THAF37	2587855	S	1215	510	1725	0.00008
Sulfitobacter_sp._D7	1968541	S	637	244	881	0.00004
Sulfitobacter_sp._JL08	2070369	S	528	12	540	0.00003
Sulfitobacter_sp._SK011	1389004	S	425	10	435	0.00002
Sulfitobacter_sp._DSM_110093	2883127	S	383	112	495	0.00002
Sulfitobacter_sp._SK012	1389005	S	356	6	362	0.00002
Sulfitobacter_sp._BSw21498	664426	S	318	50	368	0.00002
Sulfitobacter_sp._SK025	1389011	S	143	300	443	0.00002
Sulfitobacter_sp._B30-2	2785912	S	91	199	290	0.00001
Sulfitobacter_sp._CB2047	1525218	S	68	191	259	0.00001
Sulfitobacter_alexandrii	1917485	S	1918	985	2903	0.00014
Sulfitobacter_mediterraneus	83219	S	873	88	961	0.00005
Sulfitobacter_indolifex	225422	S	574	130	704	0.00003
Sulfitobacter_dubius	218673	S	477	213	690	0.00003
Sulfitobacter_pontiacus	60137	S	209	471	680	0.00003
Salipiger_profundus	1229727	S	3483	1554	5037	0.00024
Salipiger_abyssi	1250539	S	2673	1069	3742	0.00018
Salipiger_sp._CCB-MM3	1792508	S	2286	328	2614	0.00012
Roseivivax_sp._THAF30	2587852	S	1752	380	2132	0.00010
Roseivivax_sp._THAF197b	2588299	S	54	894	948	0.00005
Roseivivax_sp._THAF40	2587858	S	43	923	966	0.00005
Roseivivax_marinus	1379903	S	3404	537	3941	0.00019
Celeribacter_indicus	1208324	S	3060	1486	4546	0.00022
Celeribacter_ethanolicus	1758178	S	1100	375	1475	0.00007
Celeribacter_baekdonensis	875171	S	435	116	551	0.00003
Celeribacter_marinus	1397108	S	343	11	354	0.00002
Phaeobacter_gallaeciensis	60890	S	1322	559	1881	0.00009
Phaeobacter_inhibens	221822	S	1089	435	1524	0.00007
Phaeobacter_piscinae	1580596	S	537	447	984	0.00005
Phaeobacter_porticola	1844006	S	345	110	455	0.00002
Phaeobacter_sp._LSS9	681157	S	90	140	230	0.00001
Leisingera_aquaemixtae	1396826	S	1567	280	1847	0.00009
Leisingera_sp._NJS201	2508306	S	314	450	764	0.00004
Leisingera_sp._NJS204	2508307	S	284	429	713	0.00003
Leisingera_methylohalidivorans	133924	S	963	208	1171	0.00006
Ruegeria_sp._TM1040	292414	S	585	98	683	0.00003
Ruegeria_sp._THAF33	2587853	S	491	123	614	0.00003
Ruegeria_sp._SCSIO_43209	2793010	S	469	86	555	0.00003
Ruegeria_sp._AD91A	2293862	S	422	45	467	0.00002
Ruegeria_pomeroyi	89184	S	1559	300	1859	0.00009
Yangia_pacifica	311180	S	3070	517	3587	0.00017
Sulfitobacter_pseudonitzschiae	1402135	S	2050	725	2775	0.00013
Pseudosulfitobacter_sp._DSM_107133	2883100	S	802	328	1130	0.00005
Sagittula_sp._P11	2009329	S	2922	1223	4145	0.00020
Ponticoccus_alexandrii	1943633	S	2352	353	2705	0.00013
Mameliella_alba	561184	S	2188	410	2598	0.00012
Dinoroseobacter_shibae	215813	S	2094	768	2862	0.00014
Roseobacter_ponti	1891787	S	757	20	777	0.00004
Roseobacter_denitrificans	2434	S	574	77	651	0.00003
Roseobacter_litoralis	42443	S	420	61	481	0.00002
Ketogulonicigenium_vulgare	92945	S	904	331	1235	0.00006
Ketogulonicigenium_robustum	92947	S	726	80	806	0.00004
Roseibacterium_elongatum	159346	S	1639	137	1776	0.00008
Octadecabacter_sp._SW4	2602067	S	660	95	755	0.00004
Octadecabacter_arcticus	53946	S	372	44	416	0.00002
Octadecabacter_antarcticus	1217908	S	325	32	357	0.00002
Octadecabacter_temperatus	1458307	S	200	4	204	0.00001
Actibacterium_sp._EMB200-NS6	1609966	S	1615	785	2400	0.00011
Oceanicola_sp._D3	2587163	S	1570	80	1650	0.00008
Tateyamaria_omphalii	299262	S	1142	38	1180	0.00006
Maribius_sp._THAF1	2587842	S	1087	55	1142	0.00005
Thalassococcus_sp._S3	2017482	S	1034	26	1060	0.00005
Antarctobacter_heliothermus	74033	S	963	49	1012	0.00005
Jannaschia_sp._CCS1	290400	S	951	25	976	0.00005
Thalassobius_gelatinovorus	53501	S	595	31	626	0.00003
Falsihalocynthiibacter_arcticus	1579316	S	240	7	247	0.00001
Caulobacter_sp._S6	2823693	S	12218	1258	13476	0.00064
Caulobacter_sp._FWC26	69665	S	3857	1547	5404	0.00026
Caulobacter_segnis	88688	S	13199	4320	17519	0.00083
Caulobacter_mirabilis	69666	S	11786	2051	13837	0.00066
Caulobacter_flavus	1679497	S	8310	2130	10440	0.00050
Caulobacter_vibrioides	155892	S	8240	7237	15477	0.00073
Caulobacter_rhizosphaerae	2010972	S	7249	1916	9165	0.00044
Caulobacter_soli	2708539	S	5898	1705	7603	0.00036
Caulobacter_henricii	69395	S	3271	512	3783	0.00018
Brevundimonas_sp._PAMC22021	2861285	S	3386	713	4099	0.00019
Brevundimonas_sp._M20	2591463	S	2872	419	3291	0.00016
Brevundimonas_sp._MF30-B	2561924	S	2821	422	3243	0.00015
Brevundimonas_sp._LM2	1938605	S	2752	450	3202	0.00015
Brevundimonas_sp._AJA228-03	2752515	S	2220	279	2499	0.00012
Brevundimonas_sp._CS1	2813778	S	673	685	1358	0.00006
Brevundimonas_sp._SGAir0440	2579977	S	657	645	1302	0.00006
Brevundimonas_sp._Bb-A	2560058	S	591	1305	1896	0.00009
Brevundimonas_sp._GW460-12-10-14-LB2	1827469	S	534	954	1488	0.00007
Brevundimonas_sp._DS20	1532555	S	498	1307	1805	0.00009
Brevundimonas_sp._'scallop'	2562582	S	486	876	1362	0.00006
Brevundimonas_naejangsanensis	588932	S	5211	1734	6945	0.00033
Brevundimonas_albigilva	1312364	S	3318	1756	5074	0.00024
Brevundimonas_goettingensis	2774190	S	3251	483	3734	0.00018
Brevundimonas_subvibrioides	74313	S	2768	474	3242	0.00015
Brevundimonas_pondensis	2774189	S	2097	619	2716	0.00013
Brevundimonas_vitisensis	2800818	S	2034	236	2270	0.00011
Brevundimonas_diminuta	293	S	1982	3771	5753	0.00027
Brevundimonas_mediterranea	74329	S	1792	681	2473	0.00012
Brevundimonas_nasdae	172043	S	1744	1079	2823	0.00013
Brevundimonas_vancanneytii	1325724	S	546	2140	2686	0.00013
Brevundimonas_vesicularis	41276	S	543	1176	1719	0.00008
Phenylobacterium_zucineum	284016	S	39006	7555	46561	0.00221
Phenylobacterium_parvum	2201350	S	7104	745	7849	0.00037
Terricaulis_silvestris	2686094	S	5663	187	5850	0.00028
Asticcacaulis_excentricus	78587	S	2164	334	2498	0.00012
Asticcacaulis_sp._AND118	2840468	S	1924	286	2210	0.00010
Marinicauda_algicola	2029849	S	4567	731	5298	0.00025
Maricaulis_maris	74318	S	1428	85	1513	0.00007
Glycocaulis_alkaliphilus	1434191	S	1387	67	1454	0.00007
Hyphobacterium_sp._CCMP332	2749086	S	1059	40	1099	0.00005
Hyphomonas_sp._CACIAM_19H1	1873716	S	1493	200	1693	0.00008
Hyphomonas_sp._Mor2	1906738	S	815	17	832	0.00004
Hyphomonas_sp._KY3	2016196	S	758	85	843	0.00004
Hyphomonas_neptunium	81032	S	1299	119	1418	0.00007
Candidatus_Viadribacter_manganicus	1759059	S	3060	76	3136	0.00015
Hirschia_baltica	2724	S	62	1	63	0.00000
Aquisalinus_flavus	1526572	S	1838	81	1919	0.00009
Parvularcula_bermudensis	208216	S	731	83	814	0.00004
Anaplasma_ovis	142058	S	94	12	106	0.00001
Anaplasma_platys	949	S	56	6	62	0.00000
Anaplasma_marginale	770	S	40	59	99	0.00000
Anaplasma_centrale	769	S	16	15	31	0.00000
Anaplasma_phagocytophilum	948	S	16	1	17	0.00000
Wolbachia_endosymbiont_of_Cimex_lectularius	246273	S	17	21	38	0.00000
Wolbachia_endosymbiont_of_Ctenocephalides_felis_wCfeT	2732593	S	16	3	19	0.00000
Wolbachia_endosymbiont_of_Ctenocephalides_felis_wCfeJ	2732594	S	12	14	26	0.00000
Wolbachia_endosymbiont_of_Folsomia_candida	169402	S	11	2	13	0.00000
Candidatus_Wolbachia_massiliensis	1845000	S	13	34	47	0.00000
Neorickettsia_helminthoeca	33994	S	17	7	24	0.00000
Neorickettsia_findlayensis	2686014	S	10	32	42	0.00000
Ehrlichia_ruminantium	779	S	36	12	48	0.00000
Ehrlichia_canis	944	S	12	9	21	0.00000
Candidatus_Neoehrlichia_mikurensis	89586	S	22	5	27	0.00000
Rickettsia_tillamookensis	2761623	S	153	74	227	0.00001
Rickettsia_endosymbiont_of_Ixodes_scapularis	444612	S	17	18	35	0.00000
Rickettsia_conorii	781	S	13	50	63	0.00000
Rickettsia_amblyommatis	33989	S	10	12	22	0.00000
Rickettsia_endosymbiont_of_Oedothorax_gibbosus	931099	S	32	4	36	0.00000
Rickettsia_endosymbiont_of_Bemisia_tabaci	337479	S	10	8	18	0.00000
Rickettsia_bellii	33990	S	14	23	37	0.00000
Orientia_tsutsugamushi	784	S	26	2	28	0.00000
Candidatus_Sneabacter_namystus	2601646	S	12	1	13	0.00000
Candidatus_Phycorickettsia_trachydisci	2115978	S	65	5	70	0.00000
Candidatus_Midichloria_mitochondrii	234827	S	34	4	38	0.00000
Candidatus_Fokinia_solitaria	1802984	S	31	1	32	0.00000
Candidatus_Deianiraea_vastatrix	2163644	S	48	0	48	0.00000
Rickettsiales_endosymbiont_of_Stachyamoeba_lipophora	2486578	S	30	4	34	0.00000
Luteithermobacter_gelatinilyticus	2582913	S	665	106	771	0.00004
Paremcibacter_congregatus	2043170	S	621	17	638	0.00003
Micavibrio_aeruginosavorus	349221	S	861	10	871	0.00004
Candidatus_Puniceispirillum_marinum	767892	S	149	4	153	0.00001
Candidatus_Hydrogenosomobacter_endosymbioticus	2558174	S	57	1	58	0.00000
endosymbiont_of_Acanthamoeba_sp._UWC8	86106	S	42	0	42	0.00000
Candidatus_Cytomitobacter_indipagum	2601575	S	22	5	27	0.00000
Candidatus_Cytomitobacter_primus	2066024	S	15	3	18	0.00000
Candidatus_Gromoviella_agglomerans	2806609	S	35	1	36	0.00000
Candidatus_Nesciobacter_abundans	2601668	S	20	3	23	0.00000
Candidatus_Nucleicultrix_amoebiphila	1509244	S	132	6	138	0.00001
Candidatus_Paracaedibacter_acanthamoebae	91604	S	101	4	105	0.00001
Magnetococcus_marinus	1124597	S	291	7	298	0.00001
Candidatus_Pelagibacter_sp._RS40	1977865	S	39	3	42	0.00000
Candidatus_Pelagibacter_sp._IMCC9063	1002672	S	15	0	15	0.00000
Candidatus_Pelagibacter_sp._FZCC0015	2268451	S	14	2	16	0.00000
Candidatus_Pelagibacter_sp._RS39	1977864	S	11	1	12	0.00000
Candidatus_Pelagibacter_giovannonii	2563896	S	10	14	24	0.00000
Candidatus_Fonsibacter_ubiquis	1925548	S	76	5	81	0.00000
Kordiimonas_pumila	2161677	S	120	2	122	0.00001
Burkholderia_multivorans	87883	S	11322	4546	15868	0.00075
Burkholderia_ubonensis	101571	S	10307	5669	15976	0.00076
Burkholderia_cenocepacia	95486	S	7608	17428	25036	0.00119
Burkholderia_cepacia	292	S	6581	14094	20675	0.00098
Burkholderia_pyrrocinia	60550	S	4446	1970	6416	0.00030
Burkholderia_contaminans	488447	S	3644	2035	5679	0.00027
Burkholderia_ambifaria	152480	S	3497	4614	8111	0.00038
Burkholderia_stagnalis	1503054	S	3449	1099	4548	0.00022
Burkholderia_dolosa	152500	S	3179	7240	10419	0.00049
Burkholderia_anthina	179879	S	3177	2467	5644	0.00027
Burkholderia_stabilis	95485	S	2741	1754	4495	0.00021
Burkholderia_lata	482957	S	2740	2154	4894	0.00023
Burkholderia_territorii	1503055	S	2226	901	3127	0.00015
Burkholderia_seminalis	488731	S	1967	776	2743	0.00013
Burkholderia_vietnamiensis	60552	S	1884	86976	88860	0.00422
Burkholderia_metallica	488729	S	1445	594	2039	0.00010
Burkholderia_diffusa	488732	S	1087	444	1531	0.00007
Burkholderia_pseudomultivorans	1207504	S	854	801	1655	0.00008
Burkholderia_latens	488446	S	562	1006	1568	0.00007
Burkholderia_aenigmatica	2015348	S	445	869	1314	0.00006
Burkholderia_pseudomallei	28450	S	4944	56768	61712	0.00293
Burkholderia_mayonis	1385591	S	3745	759	4504	0.00021
Burkholderia_thailandensis	57975	S	3496	6375	9871	0.00047
Burkholderia_oklahomensis	342113	S	2447	1136	3583	0.00017
Burkholderia_savannae	1637837	S	550	501	1051	0.00005
Burkholderia_sp._MSMB1588	1636423	S	228	356	584	0.00003
Burkholderia_sp._MSMB617WGS	1637831	S	161	292	453	0.00002
Burkholderia_mallei	13373	S	139	7605	7744	0.00037
Burkholderia_sp._DHOD12	2571746	S	8373	920	9293	0.00044
Burkholderia_sp._Bp7605	1740163	S	3925	545	4470	0.00021
Burkholderia_sp._NRF60-BP8	1637853	S	1122	471	1593	0.00008
Burkholderia_sp._LA-2-3-30-S1-D2	1637862	S	1081	487	1568	0.00007
Burkholderia_sp._MSMB0856	1637869	S	1021	496	1517	0.00007
Burkholderia_sp._JP2-270	2217913	S	1005	482	1487	0.00007
Burkholderia_sp._PAMC_26561	1795043	S	830	777	1607	0.00008
Burkholderia_sp._MS455	2811788	S	727	389	1116	0.00005
Burkholderia_sp._PAMC_28687	1795874	S	594	852	1446	0.00007
Burkholderia_sp._IDO3	1705310	S	437	482	919	0.00004
Burkholderia_sp._KBS0801	1179675	S	211	304	515	0.00002
Burkholderia_sp._LAS2	2813843	S	170	578	748	0.00004
Burkholderia_sp._MBR-1	2732364	S	83	265	348	0.00002
Burkholderia_sp._KJ006	416344	S	74	357	431	0.00002
Burkholderia_sp._MS389	2811789	S	69	375	444	0.00002
Burkholderia_sp._B21-007	2890407	S	23	684	707	0.00003
Burkholderia_sp._B21-005	2890406	S	21	739	760	0.00004
Burkholderia_gladioli	28095	S	12008	3780	15788	0.00075
Burkholderia_glumae	337	S	4761	1625	6386	0.00030
Burkholderia_plantarii	41899	S	3179	1004	4183	0.00020
Burkholderia_perseverans	2615214	S	2521	849	3370	0.00016
Paraburkholderia_sp._SOS3	1926494	S	4701	721	5422	0.00026
Paraburkholderia_sp._PGU16	2735433	S	2251	1331	3582	0.00017
Paraburkholderia_sp._PGU19	2735434	S	1873	1727	3600	0.00017
Paraburkholderia_pallida	2547399	S	6148	1165	7313	0.00035
Paraburkholderia_aromaticivorans	2026199	S	5249	2424	7673	0.00036
Paraburkholderia_acidisoli	2571748	S	5214	984	6198	0.00029
Paraburkholderia_tropica	92647	S	4826	1128	5954	0.00028
Paraburkholderia_acidiphila	2571747	S	4821	982	5803	0.00028
Paraburkholderia_caribensis	75105	S	4740	3732	8472	0.00040
Paraburkholderia_edwinii	2861782	S	4679	672	5351	0.00025
Paraburkholderia_terricola	169427	S	4321	1344	5665	0.00027
Paraburkholderia_phytofirmans	261302	S	4304	1927	6231	0.00030
Paraburkholderia_phenoliruptrix	252970	S	4046	1235	5281	0.00025
Paraburkholderia_phymatum	148447	S	3930	1060	4990	0.00024
Paraburkholderia_atlantica	2654982	S	3896	998	4894	0.00023
Paraburkholderia_graminis	60548	S	3644	945	4589	0.00022
Paraburkholderia_sprentiae	948107	S	3586	824	4410	0.00021
Paraburkholderia_megapolitana	420953	S	3577	354	3931	0.00019
Paraburkholderia_fungorum	134537	S	3477	862	4339	0.00021
Paraburkholderia_ginsengisoli	311231	S	2932	941	3873	0.00018
Paraburkholderia_caledonica	134536	S	2909	553	3462	0.00016
Paraburkholderia_terrae	311230	S	2861	3528	6389	0.00030
Paraburkholderia_caffeinilytica	1761016	S	2534	703	3237	0.00015
Paraburkholderia_dokdonella	2211211	S	2498	701	3199	0.00015
Paraburkholderia_hospita	169430	S	2469	3021	5490	0.00026
Paraburkholderia_xenovorans	36873	S	2352	3073	5425	0.00026
Paraburkholderia_dioscoreae	2604047	S	1567	1124	2691	0.00013
Cupriavidus_taiwanensis	164546	S	17043	13771	30814	0.00146
Cupriavidus_pauculus	82633	S	14721	6335	21056	0.00100
Cupriavidus_necator	106590	S	7549	6708	14257	0.00068
Cupriavidus_basilensis	68895	S	7507	4144	11651	0.00055
Cupriavidus_oxalaticus	96344	S	7413	3261	10674	0.00051
Cupriavidus_sp._EM10	2839983	S	3383	1986	5369	0.00025
Cupriavidus_sp._MP-37	2884455	S	1598	1599	3197	0.00015
Cupriavidus_sp._ISTL7	2771360	S	726	4526	5252	0.00025
Cupriavidus_sp._KK10	1478019	S	613	1766	2379	0.00011
Cupriavidus_sp._USMAA2-4	876364	S	385	2609	2994	0.00014
Cupriavidus_sp._USMAHM13	1389192	S	374	2535	2909	0.00014
Cupriavidus_campinensis	151783	S	6150	2202	8352	0.00040
Cupriavidus_metallidurans	119219	S	4395	9128	13523	0.00064
Cupriavidus_pinatubonensis	248026	S	4103	708	4811	0.00023
Cupriavidus_gilardii	82541	S	2660	13449	16109	0.00076
Cupriavidus_neocaledonicus	1040979	S	1365	1629	2994	0.00014
Cupriavidus_nantongensis	1796606	S	1182	3132	4314	0.00020
Cupriavidus_malaysiensis	367825	S	396	2527	2923	0.00014
Ralstonia_solanacearum	305	S	9845	21086	30931	0.00147
Ralstonia_insidiosa	190721	S	2927	2189	5116	0.00024
Ralstonia_mannitolilytica	105219	S	2043	2492	4535	0.00022
Ralstonia_pickettii	329	S	1921	913	2834	0.00013
Ralstonia_sp._56D2	2842456	S	1873	303	2176	0.00010
Ralstonia_syzygii	28097	S	164	584	748	0.00004
Ralstonia_pseudosolanacearum	1310165	S	63	1737	1800	0.00009
Caballeronia_sp._Lep1P3	2878150	S	3698	954	4652	0.00022
Caballeronia_sp._TF1N1	2878153	S	3208	400	3608	0.00017
Caballeronia_sp._SL2Y3	2878151	S	1827	1048	2875	0.00014
Caballeronia_sp._M1242	2814653	S	1553	1092	2645	0.00013
Caballeronia_sp._Sq4a	2878152	S	1494	1082	2576	0.00012
Caballeronia_sp._SBC2	2705547	S	224	1782	2006	0.00010
Caballeronia_sp._SBC1	2705548	S	199	2213	2412	0.00011
Caballeronia_zhejiangensis	871203	S	4370	1142	5512	0.00026
Caballeronia_insecticola	758793	S	3754	879	4633	0.00022
Caballeronia_grimmiae	1071679	S	3323	1795	5118	0.00024
Pandoraea_pnomenusa	93220	S	4090	2046	6136	0.00029
Pandoraea_thiooxydans	445709	S	3498	297	3795	0.00018
Pandoraea_pulmonicola	93221	S	3225	749	3974	0.00019
Pandoraea_sp._XY-2	2518599	S	2415	1290	3705	0.00018
Pandoraea_norimbergensis	93219	S	2319	389	2708	0.00013
Pandoraea_faecigallinarum	656179	S	2259	652	2911	0.00014
Pandoraea_vervacti	656178	S	2218	693	2911	0.00014
Pandoraea_apista	93218	S	1933	1130	3063	0.00015
Pandoraea_fibrosis	1891094	S	1766	630	2396	0.00011
Pandoraea_oxalativorans	573737	S	1619	825	2444	0.00012
Pandoraea_sputorum	93222	S	1520	725	2245	0.00011
Polynucleobacter_sp._MWH-UH24A	2689110	S	85	5	90	0.00000
Polynucleobacter_sp._MWH-CaK5	2689107	S	72	4	76	0.00000
Polynucleobacter_sp._MWH-Spelu-300-X4	2689109	S	58	3	61	0.00000
Polynucleobacter_sp._MWH-P3-07-1	1743173	S	56	9	65	0.00000
Polynucleobacter_sp._TSB-Sco08W16	1758374	S	56	9	65	0.00000
Polynucleobacter_sp._MWH-UH35A	1855619	S	55	10	65	0.00000
Polynucleobacter_sp._AP-Nino-20-G2	2576917	S	48	13	61	0.00000
Polynucleobacter_sp._MWH-UH25E	1855616	S	47	9	56	0.00000
Polynucleobacter_sp._AP-Kolm-20A-A1	2081041	S	46	30	76	0.00000
Polynucleobacter_sp._AP-Sving-400A-A2	2081049	S	46	26	72	0.00000
Polynucleobacter_sp._MWH-Aus1W21	1855880	S	46	11	57	0.00000
Polynucleobacter_sp._AP-Ainpum-60-G11	2576926	S	42	11	53	0.00000
Polynucleobacter_sp._MWH-S4W17	1855910	S	41	22	63	0.00000
Polynucleobacter_sp._LimPoW16	1743162	S	41	2	43	0.00000
Polynucleobacter_sp._JS-JIR-II-b4	1758390	S	39	22	61	0.00000
Polynucleobacter_sp._MWH-Svant-W18	1855909	S	39	8	47	0.00000
Polynucleobacter_sp._MWH-UH2A	1855617	S	37	7	44	0.00000
Polynucleobacter_sp._es-MAR-2	1819725	S	36	8	44	0.00000
Polynucleobacter_sp._es-EL-1	1855652	S	35	6	41	0.00000
Polynucleobacter_sp._MWH-Braz-FAM2G	1855883	S	35	4	39	0.00000
Polynucleobacter_sp._JS-JIR-II-50	2576919	S	33	16	49	0.00000
Polynucleobacter_sp._Adler-ghost	2770234	S	32	15	47	0.00000
Polynucleobacter_sp._MG-6-Vaara-E2	2576932	S	32	6	38	0.00000
Polynucleobacter_sp._AP-Titi-500A-B4	2576923	S	32	7	39	0.00000
Polynucleobacter_sp._VK25	1758398	S	29	7	36	0.00000
Polynucleobacter_sp._AP-Melu-1000-A1	2081042	S	29	12	41	0.00000
Polynucleobacter_sp._MWH-UH21B	1743174	S	27	5	32	0.00000
Polynucleobacter_sp._AP-Elch-400A-B2	2576930	S	25	12	37	0.00000
Polynucleobacter_sp._MG-Unter2-18	2081052	S	24	19	43	0.00000
Polynucleobacter_sp._JS-Mosq-20-D10	2576922	S	23	9	32	0.00000
Polynucleobacter_sp._AP-Jannik-300A-C4	2576928	S	21	22	43	0.00000
Polynucleobacter_sp._UB-Siik-W21	1855646	S	17	48	65	0.00000
Polynucleobacter_sp._JS-JIR-5-A7	1758395	S	16	44	60	0.00000
Polynucleobacter_necessarius	576610	S	314	62	376	0.00002
Polynucleobacter_asymbioticus	576611	S	169	34	203	0.00001
Polynucleobacter_difficilis	556054	S	165	15	180	0.00001
Polynucleobacter_acidiphobus	556053	S	92	7	99	0.00000
Polynucleobacter_paneuropaeus	2527775	S	52	6	58	0.00000
Polynucleobacter_wuianus	1743168	S	45	15	60	0.00000
Polynucleobacter_duraquae	1835254	S	30	23	53	0.00000
Lautropia_mirabilis	47671	S	2734	528	3262	0.00015
Mycetohabitans_rhizoxinica	412963	S	2127	150	2277	0.00011
Chitinimonas_arctica	2594795	S	1880	160	2040	0.00010
Mycoavidus_sp._HKI	2840467	S	208	13	221	0.00001
Mycoavidus_sp._B2-EB	2651972	S	103	11	114	0.00001
Mycoavidus_cysteinexigens	1553431	S	168	12	180	0.00001
Limnobacter_sp._SAORIC-580	2732163	S	308	15	323	0.00002
Candidatus_Vallotia_cooleyia	1177211	S	72	9	81	0.00000
Candidatus_Vallotia_lariciata	2018052	S	68	26	94	0.00000
Candidatus_Vallotia_sp._(ex_Adelges_kitamiensis)	2864217	S	48	18	66	0.00000
Candidatus_Vallotia_tarda	1177213	S	31	5	36	0.00000
Ephemeroptericola_cinctiostellae	2268024	S	194	13	207	0.00001
Variovorax_sp._HW608	1034889	S	12042	2228	14270	0.00068
Variovorax_sp._PBS-H4	434008	S	6635	4294	10929	0.00052
Variovorax_sp._PBL-H6	434009	S	6452	6313	12765	0.00061
Variovorax_sp._RA8	662548	S	5949	4793	10742	0.00051
Variovorax_sp._WDL1	207745	S	5942	9679	15621	0.00074
Variovorax_sp._PAMC_28711	1795631	S	5061	942	6003	0.00028
Variovorax_sp._RKNM96	2681552	S	4769	2004	6773	0.00032
Variovorax_sp._PAMC26660	2762322	S	3800	1051	4851	0.00023
Variovorax_sp._PAMC28562	2762323	S	3792	356	4148	0.00020
Variovorax_sp._SRS16	282217	S	3339	7670	11009	0.00052
Variovorax_sp._38R	2774875	S	2749	3665	6414	0.00030
Variovorax_sp._PBL-E5	434014	S	2670	7113	9783	0.00046
Variovorax_sp._PDNC026	2811425	S	89	3498	3587	0.00017
Variovorax_sp._PMC12	2126319	S	61	3080	3141	0.00015
Variovorax_paradoxus	34073	S	24522	24010	48532	0.00230
Variovorax_boronicumulans	436515	S	3686	3000	6686	0.00032
Hydrogenophaga_sp._BA0156	2716225	S	7027	5431	12458	0.00059
Hydrogenophaga_sp._YM1	2806262	S	6157	3505	9662	0.00046
Hydrogenophaga_sp._PBC	795665	S	5372	6587	11959	0.00057
Hydrogenophaga_sp._BPS33	2651974	S	5320	4238	9558	0.00045
Hydrogenophaga_sp._SL48	2806347	S	4291	1143	5434	0.00026
Hydrogenophaga_sp._RAC07	1842537	S	3548	1347	4895	0.00023
Hydrogenophaga_sp._PBL-H3	434010	S	3295	3200	6495	0.00031
Hydrogenophaga_sp._NH-16	2184519	S	2299	5048	7347	0.00035
Hydrogenophaga_sp._PAMC20947	2565558	S	1711	127	1838	0.00009
Hydrogenophaga_taeniospiralis	65656	S	3654	1207	4861	0.00023
Hydrogenophaga_pseudoflava	47421	S	1616	2721	4337	0.00021
Hydrogenophaga_crassostreae	1763535	S	1508	104	1612	0.00008
Acidovorax_sp._YS12	2738413	S	3849	3697	7546	0.00036
Acidovorax_sp._RAC01	1842533	S	2457	2157	4614	0.00022
Acidovorax_sp._KKS102	358220	S	2132	1714	3846	0.00018
Acidovorax_sp._JMULE5	2518343	S	2070	652	2722	0.00013
Acidovorax_sp._HDW3	2714923	S	1984	1563	3547	0.00017
Acidovorax_sp._1608163	2478662	S	1685	402	2087	0.00010
Acidovorax_sp._T1	1858609	S	1292	5041	6333	0.00030
Acidovorax_avenae	80867	S	7650	5195	12845	0.00061
Acidovorax_monticola	1926868	S	4811	2150	6961	0.00033
Acidovorax_antarcticus	2743470	S	4006	3370	7376	0.00035
Acidovorax_carolinensis	553814	S	2551	2292	4843	0.00023
Acidovorax_citrulli	80869	S	2300	4265	6565	0.00031
Acidovorax_cattleyae	80868	S	1876	1409	3285	0.00016
Acidovorax_radicis	758826	S	1708	387	2095	0.00010
Ramlibacter_tataouinensis	94132	S	46245	21027	67272	0.00319
Comamonas_sp._NLF-7-7	2597701	S	2928	2509	5437	0.00026
Comamonas_sp._NLF-1-9	2853163	S	2480	1576	4056	0.00019
Comamonas_sp._B21-038	2918299	S	1398	400	1798	0.00009
Comamonas_sp._Y33R10-2	2853257	S	399	83	482	0.00002
Comamonas_aquatica	225991	S	3339	3526	6865	0.00033
Comamonas_serinivorans	1082851	S	3300	1028	4328	0.00021
Comamonas_testosteroni	285	S	1956	3137	5093	0.00024
Comamonas_odontotermitis	379895	S	1361	300	1661	0.00008
Comamonas_koreensis	160825	S	1338	875	2213	0.00011
Comamonas_piscis	1562974	S	1023	230	1253	0.00006
Comamonas_thiooxydans	363952	S	904	2256	3160	0.00015
Comamonas_kerstersii	225992	S	820	474	1294	0.00006
Comamonas_fluminis	2796366	S	700	329	1029	0.00005
Rhodoferax_sp._BAB1	2741720	S	4622	1435	6057	0.00029
Rhodoferax_sp._AJA081-3	2752316	S	1355	110	1465	0.00007
Rhodoferax_sp._PAMC_29310	2822760	S	878	109	987	0.00005
Rhodoferax_sp._MIZ03	2798804	S	642	74	716	0.00003
Rhodoferax_koreense	1842727	S	6493	3710	10203	0.00048
Rhodoferax_sediminis	2509614	S	5399	938	6337	0.00030
Rhodoferax_ferrireducens	192843	S	1920	147	2067	0.00010
Rhodoferax_saidenbachensis	1484693	S	1583	198	1781	0.00008
Rhodoferax_antarcticus	81479	S	864	74	938	0.00004
Rhodoferax_aquaticus	2527691	S	601	67	668	0.00003
Schlegelella_thermodepolymerans	215580	S	11993	6408	18401	0.00087
Schlegelella_brevitalea	413882	S	9208	1466	10674	0.00051
Diaphorobacter_sp._HDW4A	2714924	S	2435	2467	4902	0.00023
Diaphorobacter_sp._HDW4B	2714925	S	2265	319	2584	0.00012
Diaphorobacter_sp._MNS-0	2866628	S	245	2204	2449	0.00012
Diaphorobacter_sp._JS3050	2735554	S	235	2742	2977	0.00014
Diaphorobacter_sp._JS3051	2792224	S	220	3779	3999	0.00019
Diaphorobacter_ruginosibacter	1715720	S	3056	626	3682	0.00017
Diaphorobacter_aerolatus	1288495	S	2299	3858	6157	0.00029
[Acidovorax]_ebreus	721785	S	384	2455	2839	0.00013
Diaphorobacter_nitroreducens	164759	S	372	1136	1508	0.00007
Delftia_tsuruhatensis	180282	S	2952	8899	11851	0.00056
Delftia_acidovorans	80866	S	2206	4480	6686	0.00032
Delftia_lacustris	558537	S	755	4669	5424	0.00026
Delftia_sp._Cs1-4	742013	S	303	774	1077	0.00005
Delftia_sp._HK171	1920191	S	163	483	646	0.00003
Polaromonas_sp._JS666	296591	S	4549	4026	8575	0.00041
Polaromonas_naphthalenivorans	216465	S	3266	573	3839	0.00018
Polaromonas_vacuolata	37448	S	377	44	421	0.00002
Kinneretia_sp._DAIF2	2714952	S	8225	3270	11495	0.00055
Kinneretia_sp._XES5	2877940	S	2160	2920	5080	0.00024
Ottowia_sp._27C	2816950	S	4067	886	4953	0.00024
Ottowia_sp._oral_taxon_894	1658672	S	1498	236	1734	0.00008
Ottowia_oryzae	2109914	S	3003	748	3751	0.00018
Alicycliphilus_denitrificans	179636	S	7612	14478	22090	0.00105
Melaminivora_sp._SC2-9	2109913	S	3442	4283	7725	0.00037
Melaminivora_jejuensis	1267217	S	2709	2247	4956	0.00024
Serpentinimonas_maccroryi	1458426	S	2258	784	3042	0.00014
Serpentinimonas_raichei	1458425	S	1869	718	2587	0.00012
Verminephrobacter_eiseniae	364317	S	3360	455	3815	0.00018
Hylemonella_gracilis	80880	S	3342	533	3875	0.00018
Pulveribacter_suum	2116657	S	3003	1729	4732	0.00022
Simplicispira_suum	2109915	S	2276	905	3181	0.00015
Limnohabitans_sp._63ED37-2	1678128	S	1041	126	1167	0.00006
Limnohabitans_sp._103DPR2	1678129	S	384	32	416	0.00002
Candidatus_Symbiobacter_mobilis	1436290	S	1027	39	1066	0.00005
Curvibacter_sp._AEP1-3	1844971	S	951	75	1026	0.00005
Massilia_sp._WG5	1707785	S	6351	3110	9461	0.00045
Massilia_sp._HC52	2852099	S	4696	1441	6137	0.00029
Massilia_sp._LPB0304	2769491	S	4557	1264	5821	0.00028
Massilia_sp._DM-R-R2A-13	2899220	S	4111	1015	5126	0.00024
Massilia_sp._YMA4	1593482	S	3841	2198	6039	0.00029
Massilia_sp._NP310	2861282	S	3595	2620	6215	0.00030
Massilia_sp._PAMC28688	2861283	S	2808	473	3281	0.00016
Massilia_sp._MB5	2919578	S	556	2117	2673	0.00013
Massilia_sp._NR_4-1	1678028	S	498	1832	2330	0.00011
Massilia_sp._Dwa41.01b	2709302	S	60	2336	2396	0.00011
Massilia_sp._Se16.2.3	2709303	S	60	2359	2419	0.00011
Massilia_putida	1141883	S	7801	2761	10562	0.00050
Massilia_violaceinigra	2045208	S	6834	2128	8962	0.00043
Massilia_flava	871742	S	6327	1697	8024	0.00038
Massilia_lutea	321985	S	4105	1376	5481	0.00026
Massilia_albidiflava	321983	S	4068	1781	5849	0.00028
Massilia_umbonata	864828	S	3929	1730	5659	0.00027
Massilia_plicata	321984	S	3692	1063	4755	0.00023
Massilia_armeniaca	2072590	S	3658	2120	5778	0.00027
Massilia_oculi	945844	S	3218	2266	5484	0.00026
Massilia_antarctica	2765360	S	3013	1242	4255	0.00020
Duganella_sp._GN2-R2	2728020	S	5448	2510	7958	0.00038
Duganella_sp._AF9R3	2728021	S	3227	743	3970	0.00019
Herbaspirillum_robiniae	2014887	S	3665	1510	5175	0.00025
Herbaspirillum_frisingense	92645	S	2541	911	3452	0.00016
Herbaspirillum_hiltneri	341045	S	2517	481	2998	0.00014
Herbaspirillum_seropedicae	964	S	2450	1013	3463	0.00016
Herbaspirillum_rubrisubalbicans	80842	S	2144	1106	3250	0.00015
Herbaspirillum_huttiense	863372	S	1581	719	2300	0.00011
Herbaspirillum_sp._meg3	2025949	S	1285	165	1450	0.00007
Janthinobacterium_sp._17J80-10	2497863	S	2153	351	2504	0.00012
Janthinobacterium_sp._1_2014MBL_MicDiv	1644131	S	2090	813	2903	0.00014
Janthinobacterium_sp._LM6	1938606	S	990	641	1631	0.00008
Janthinobacterium_sp._PAMC25594	2861284	S	705	456	1161	0.00006
Janthinobacterium_sp._Marseille	375286	S	644	181	825	0.00004
Janthinobacterium_sp._HH102	1537274	S	449	744	1193	0.00006
Janthinobacterium_sp._B9-8	1236179	S	210	67	277	0.00001
Janthinobacterium_agaricidamnosum	55508	S	2894	4853	7747	0.00037
Janthinobacterium_tructae	2590869	S	666	368	1034	0.00005
Janthinobacterium_lividum	29581	S	658	707	1365	0.00006
Janthinobacterium_svalbardensis	368607	S	624	336	960	0.00005
Collimonas_fungivorans	158899	S	3024	855	3879	0.00018
Collimonas_arenae	279058	S	2275	303	2578	0.00012
Collimonas_pratensis	279113	S	2213	461	2674	0.00013
Noviherbaspirillum_sp._UKPF54	2601898	S	5698	1065	6763	0.00032
Undibacterium_sp._KW1	2058624	S	277	103	380	0.00002
Undibacterium_sp._YM2	2058625	S	264	98	362	0.00002
Undibacterium_parvum	401471	S	345	51	396	0.00002
Glaciimonas_sp._PAMC28666	2807626	S	410	28	438	0.00002
Herminiimonas_arsenitoxidans	1809410	S	378	66	444	0.00002
Oxalobacter_formigenes	847	S	263	26	289	0.00001
Bordetella_sp._H567	1697043	S	3956	487	4443	0.00021
Bordetella_sp._N	1746199	S	3499	413	3912	0.00019
Bordetella_bronchialis	463025	S	5534	761	6295	0.00030
Bordetella_genomosp._13	463040	S	4700	3600	8300	0.00039
Bordetella_genomosp._8	1416806	S	4167	505	4672	0.00022
Bordetella_genomosp._9	1416803	S	4082	1115	5197	0.00025
Bordetella_flabilis	463014	S	4000	353	4353	0.00021
Bordetella_petrii	94624	S	3620	5292	8912	0.00042
Bordetella_hinzii	103855	S	3160	1398	4558	0.00022
Bordetella_trematum	123899	S	2427	1095	3522	0.00017
Bordetella_pseudohinzii	1331258	S	1880	843	2723	0.00013
Bordetella_bronchiseptica	518	S	1857	5121	6978	0.00033
Bordetella_holmesii	35814	S	1114	352	1466	0.00007
Bordetella_avium	521	S	1052	123	1175	0.00006
Bordetella_genomosp._6	463024	S	550	758	1308	0.00006
Bordetella_pertussis	520	S	318	7723	8041	0.00038
Bordetella_parapertussis	519	S	191	13739	13930	0.00066
Achromobacter_xylosoxidans	85698	S	10465	19337	29802	0.00141
Achromobacter_sp._AONIH1	1758194	S	3615	4980	8595	0.00041
Achromobacter_sp._MFA1_R4	1881016	S	2808	893	3701	0.00018
Achromobacter_sp._77	2756133	S	524	1442	1966	0.00009
Achromobacter_sp._ES-001	2860286	S	400	1371	1771	0.00008
Achromobacter_sp._B7	2282475	S	398	997	1395	0.00007
Achromobacter_spanius	217203	S	5518	2441	7959	0.00038
Achromobacter_denitrificans	32002	S	5149	4070	9219	0.00044
Achromobacter_deleyi	1353891	S	3638	2788	6426	0.00030
Achromobacter_insolitus	217204	S	2585	777	3362	0.00016
Achromobacter_pestifer	1353889	S	2033	1509	3542	0.00017
Achromobacter_mucicolens	1389922	S	749	1265	2014	0.00010
Achromobacter_ruhlandii	72557	S	32	1607	1639	0.00008
Pigmentiphaga_sp._H8	2488560	S	6961	964	7925	0.00038
Pigmentiphaga_aceris	1940612	S	1806	136	1942	0.00009
Castellaniella_defragrans	75697	S	4298	3154	7452	0.00035
Orrella_dioscoreae	1851544	S	3536	1341	4877	0.00023
Orrella_marina	2163011	S	424	79	503	0.00002
Orrella_sp._f23	2782176	S	273	18	291	0.00001
Alcaligenes_faecalis	511	S	809	713	1522	0.00007
Alcaligenes_sp._SORT26	2813780	S	220	42	262	0.00001
Alcaligenes_sp._DN25	1367435	S	63	141	204	0.00001
Alcaligenes_aquatilis	323284	S	167	602	769	0.00004
Alcaligenes_ammonioxydans	2582914	S	19	202	221	0.00001
Pusillimonas_thiosulfatoxidans	2028345	S	1032	286	1318	0.00006
Pusillimonas_sp._T7-7	1007105	S	678	111	789	0.00004
Pusillimonas_sp._DMV24BSW_D	2716226	S	283	20	303	0.00001
Paralcaligenes_sp._KSB-10	2901142	S	1231	52	1283	0.00006
Kerstersia_gyiorum	206506	S	1143	259	1402	0.00007
Advenella_mimigardefordensis	302406	S	460	29	489	0.00002
Advenella_kashmirensis	310575	S	443	28	471	0.00002
Oligella_urethralis	90245	S	80	13	93	0.00000
Oligella_ureolytica	90244	S	59	45	104	0.00000
Paenalcaligenes_hominis	643674	S	101	5	106	0.00001
Taylorella_asinigenitalis	84590	S	24	2	26	0.00000
Taylorella_equigenitalis	29575	S	14	1	15	0.00000
Pelistega_ratti	2652177	S	38	6	44	0.00000
Basilea_psittacipulmonis	1472345	S	37	3	40	0.00000
Rhizobacter_sp._AJA081-3	2753607	S	11965	3574	15539	0.00074
Rhizobacter_gummiphilus	946333	S	10614	2427	13041	0.00062
Sphaerotilus_sp._FB-5	2914710	S	7626	5404	13030	0.00062
Sphaerotilus_natans	34103	S	6579	2974	9553	0.00045
Methylibium_petroleiphilum	105560	S	3940	4269	8209	0.00039
Methylibium_sp._Pch-M	2082386	S	3921	3951	7872	0.00037
Rubrivivax_gelatinosus	28068	S	11514	4168	15682	0.00074
Aquincola_tertiaricarbonis	391953	S	10179	4069	14248	0.00068
Mitsuaria_sp._7	1658665	S	9292	2146	11438	0.00054
Thiomonas_sp._X19	1050370	S	3381	1267	4648	0.00022
Thiomonas_intermedia	926	S	2268	333	2601	0.00012
Thiomonas_arsenitoxydans	426114	S	867	1441	2308	0.00011
Leptothrix_cholodnii	34029	S	7723	2876	10599	0.00050
Xylophilus_rhododendri	2697032	S	5560	1870	7430	0.00035
Ideonella_dechloratans	36863	S	4655	3241	7896	0.00037
Tepidimonas_taiwanensis	307486	S	4409	1804	6213	0.00029
Aquabacterium_olei	1296669	S	3699	1132	4831	0.00023
Roseateles_depolymerans	76731	S	3552	791	4343	0.00021
Inhella_inkyongensis	392593	S	2354	431	2785	0.00013
Paucibacter_sp._KCTC_42545	1768242	S	1924	380	2304	0.00011
Candidatus_Ichthyocystis_hellenicum	1561003	S	84	1	85	0.00000
Sutterella_megalosphaeroides	2494234	S	1369	267	1636	0.00008
Sutterella_faecalis	2584944	S	1009	160	1169	0.00006
Sutterella_wadsworthensis	40545	S	431	58	489	0.00002
Turicimonas_muris	1796652	S	185	15	200	0.00001
Thauera_sp._MZ1T	85643	S	6352	7043	13395	0.00064
Thauera_sp._K11	2005884	S	6046	3938	9984	0.00047
Thauera_humireducens	1134435	S	3785	2375	6160	0.00029
Thauera_chlorobenzoica	96773	S	3010	3031	6041	0.00029
Thauera_aromatica	59405	S	2540	3805	6345	0.00030
Thauera_hydrothermalis	2184083	S	1690	535	2225	0.00011
Azoarcus_sp._KH32C	748247	S	6296	1269	7565	0.00036
Azoarcus_sp._DD4	2027405	S	4484	3219	7703	0.00037
Azoarcus_olearius	418699	S	5691	2364	8055	0.00038
Azoarcus_communis	41977	S	3841	1602	5443	0.00026
Nitrogeniibacter_mangrovi	2016596	S	4610	1055	5665	0.00027
Nitrogeniibacter_aestuarii	2815343	S	2124	251	2375	0.00011
Aromatoleum_petrolei	76116	S	6220	1691	7911	0.00038
Aromatoleum_aromaticum	551760	S	4826	3555	8381	0.00040
Aromatoleum_pumilum	2067960	S	4122	1632	5754	0.00027
Aromatoleum_bremense	76115	S	4008	2444	6452	0.00031
Azospira_restricta	404405	S	10685	5984	16669	0.00079
Azospira_inquinata	2785627	S	830	76	906	0.00004
Azospira_sp._I09	1765049	S	667	2092	2759	0.00013
Azospira_oryzae	146939	S	644	1673	2317	0.00011
Niveibacterium_microcysteis	2811415	S	3551	550	4101	0.00019
Oryzomicrobium_terrae	1735038	S	2537	742	3279	0.00016
Rugosibacter_aromaticivorans	1565605	S	703	133	836	0.00004
Dechloromonas_denitrificans	281362	S	3659	995	4654	0.00022
Dechloromonas_sp._HYN0024	2231055	S	1059	232	1291	0.00006
Dechloromonas_sp._TW-R-39-2	2654218	S	578	283	861	0.00004
Ferribacterium_limneticum	76259	S	4849	898	5747	0.00027
Quatrionicoccus_australiensis	138118	S	2170	701	2871	0.00014
Fluviibacter_phosphoraccumulans	1751046	S	373	130	503	0.00002
Usitatibacter_rugosus	2732067	S	21832	2732	24564	0.00117
Usitatibacter_palustris	2732487	S	16797	2235	19032	0.00090
Nitrosospira_multiformis	1231	S	14326	464	14790	0.00070
Nitrosospira_lacus	1288494	S	1023	35	1058	0.00005
Nitrosospira_sp._NRS527	155925	S	411	275	686	0.00003
Nitrosospira_briensis	35799	S	360	258	618	0.00003
Nitrosomonas_communis	44574	S	3364	94	3458	0.00016
Nitrosomonas_ureae	44577	S	350	11	361	0.00002
Nitrosomonas_europaea	915	S	288	46	334	0.00002
Nitrosomonas_eutropha	916	S	208	124	332	0.00002
Nitrosomonas_stercoris	1444684	S	105	63	168	0.00001
Denitratisoma_sp._DHT3	1981880	S	3764	3120	6884	0.00033
Denitratisoma_oestradiolicum	311182	S	1889	355	2244	0.00011
Sulfuritalea_hydrogenivorans	748811	S	4683	775	5458	0.00026
Methyloversatilis_sp._RAC08	1842540	S	3793	567	4360	0.00021
Sterolibacterium_denitrificans	157592	S	2971	916	3887	0.00018
Thiobacillus_denitrificans	36861	S	5753	1247	7000	0.00033
Sulfuritortus_calidifontis	1914471	S	4096	1967	6063	0.00029
Sideroxydans_sp._MIZ01	2764705	S	2113	487	2600	0.00012
Sideroxydans_lithotrophicus	63745	S	1686	284	1970	0.00009
Ferrigenium_kumadai	1682490	S	2797	651	3448	0.00016
Ferriphaselus_amnicola	1188319	S	908	137	1045	0.00005
Candidatus_Nitrotoga_arctica	453162	S	289	108	397	0.00002
Candidatus_Nitrotoga_sp._AM1P	2559597	S	251	100	351	0.00002
Gallionella_capsiferriformans	370405	S	595	60	655	0.00003
Sulfurimicrobium_lacus	2715678	S	3092	447	3539	0.00017
Sulfuriferula_plumbiphila	171865	S	1814	361	2175	0.00010
Sulfuriferula_sp._AH1	1985873	S	888	200	1088	0.00005
Sulfuriferula_nivalis	2675298	S	139	12	151	0.00001
Sulfuricella_denitrificans	649841	S	1438	148	1586	0.00008
Methylovorus_glucosotrophus	266009	S	403	359	762	0.00004
Methylovorus_sp._MP688	887061	S	350	344	694	0.00003
Methylobacillus_flagellatus	405	S	1261	353	1614	0.00008
Methylophilus_sp._TWE2	1662285	S	683	65	748	0.00004
Methylophilus_medardicus	2588534	S	231	28	259	0.00001
Candidatus_Methylopumilus_turicensis	1581680	S	98	17	115	0.00001
Candidatus_Methylopumilus_universalis	2588536	S	48	35	83	0.00000
Candidatus_Methylopumilus_planktonicus	1581557	S	39	32	71	0.00000
Candidatus_Methylopumilus_rimovensis	2588535	S	21	5	26	0.00000
Methylotenera_mobilis	359408	S	176	24	200	0.00001
Methylotenera_versatilis	1055487	S	82	11	93	0.00000
Methyloradius_palustris	2778876	S	209	21	230	0.00001
Chromobacterium_sp._ATCC_53434	2059672	S	2264	874	3138	0.00015
Chromobacterium_sp._Rain0013	2292447	S	444	587	1031	0.00005
Chromobacterium_sp._Beijing	2735795	S	345	1045	1390	0.00007
Chromobacterium_violaceum	536	S	2383	1602	3985	0.00019
Chromobacterium_vaccinii	1108595	S	2262	1080	3342	0.00016
Chromobacterium_phragmitis	2202141	S	1516	737	2253	0.00011
Chromobacterium_paludis	2605945	S	1300	569	1869	0.00009
Chromobacterium_rhizoryzae	1778675	S	395	2210	2605	0.00012
Chromobacterium_haemolyticum	394935	S	223	1551	1774	0.00008
Iodobacter_ciconiae	2496266	S	122	34	156	0.00001
Iodobacter_fluviatilis	537	S	121	39	160	0.00001
Jeongeupia_sp._USM3	1906741	S	3699	1084	4783	0.00023
Jeongeupia_sp._HS-3	1009682	S	1608	352	1960	0.00009
Paludibacterium_paludis	1225769	S	1790	385	2175	0.00010
Paludibacterium_yongneupense	400061	S	1669	257	1926	0.00009
Paludibacterium_sp._B53371	2806263	S	1102	246	1348	0.00006
Pseudogulbenkiania_sp._NH8B	748280	S	3465	1301	4766	0.00023
Vogesella_sp._LIG4	1192162	S	2081	617	2698	0.00013
Vogesella_sp._XCS3	2877939	S	905	271	1176	0.00006
Microvirgula_aerodenitrificans	57480	S	2477	522	2999	0.00014
Aquitalea_aquatilis	1537400	S	676	233	909	0.00004
Aquitalea_magnusonii	332411	S	447	277	724	0.00003
Aquitalea_sp._USM4	1590041	S	396	234	630	0.00003
Aquitalea_denitrificans	519081	S	384	213	597	0.00003
Laribacter_hongkongensis	168471	S	1664	1583	3247	0.00015
Aquaspirillum_sp._LM1	1938604	S	1107	181	1288	0.00006
Chitinibacter_bivalviorum	2739434	S	200	168	368	0.00002
Chitinibacter_fontanus	1737446	S	167	31	198	0.00001
Deefgea_sp._D17	2739061	S	132	51	183	0.00001
Deefgea_sp._D25	2865840	S	110	17	127	0.00001
Deefgea_sp._D13	2864875	S	98	32	130	0.00001
Neisseria_sp._KEM232	655307	S	479	75	554	0.00003
Neisseria_sp._oral_taxon_014	641148	S	210	98	308	0.00001
Neisseria_sp._ZJ785	2709396	S	86	11	97	0.00000
Neisseria_sp._Dent_CA1/247	2912675	S	73	36	109	0.00001
Neisseria_bacilliformis	267212	S	526	135	661	0.00003
Neisseria_shayeganii	607712	S	437	68	505	0.00002
Neisseria_elongata	495	S	349	200	549	0.00003
Neisseria_chenwenguii	1853278	S	340	44	384	0.00002
Neisseria_meningitidis	487	S	319	1489	1808	0.00009
Neisseria_dentiae	194197	S	303	38	341	0.00002
Neisseria_musculi	1815583	S	227	22	249	0.00001
Neisseria_animalis	492	S	186	29	215	0.00001
Neisseria_gonorrhoeae	485	S	151	229	380	0.00002
Neisseria_sicca	490	S	144	320	464	0.00002
Neisseria_brasiliensis	2666100	S	129	126	255	0.00001
Neisseria_lactamica	486	S	116	139	255	0.00001
Neisseria_weaveri	28091	S	109	45	154	0.00001
Neisseria_animaloris	326522	S	106	25	131	0.00001
Neisseria_weixii	1853276	S	96	12	108	0.00001
Neisseria_wadsworthii	607711	S	86	19	105	0.00001
Neisseria_canis	493	S	81	21	102	0.00000
Neisseria_dumasiana	1931275	S	78	34	112	0.00001
Neisseria_arctica	1470200	S	76	8	84	0.00000
Neisseria_zalophi	640030	S	70	7	77	0.00000
Neisseria_mucosa	488	S	60	141	201	0.00001
Neisseria_zoodegmatis	326523	S	55	39	94	0.00000
Neisseria_macacae	496	S	54	127	181	0.00001
Neisseria_cinerea	483	S	43	27	70	0.00000
Neisseria_flavescens	484	S	37	30	67	0.00000
Neisseria_subflava	28449	S	18	14	32	0.00000
Crenobacter_cavernae	2290923	S	4183	1513	5696	0.00027
Chitinolyticbacter_meiyuanensis	682798	S	2729	370	3099	0.00015
Vitreoscilla_filiformis	63	S	1128	229	1357	0.00006
Vitreoscilla_massiliensis	1689272	S	160	19	179	0.00001
Vitreoscilla_sp._C1	96942	S	10	71	81	0.00000
Kingella_potus	265175	S	361	51	412	0.00002
Kingella_denitrificans	502	S	253	168	421	0.00002
Kingella_oralis	505	S	218	37	255	0.00001
Kingella_kingae	504	S	91	15	106	0.00001
Uruburuella_suis	252130	S	384	62	446	0.00002
Uruburuella_testudinis	1282863	S	310	60	370	0.00002
Eikenella_corrodens	539	S	393	296	689	0.00003
Eikenella_exigua	2528037	S	95	84	179	0.00001
Paralysiella_testudinis	2809020	S	253	59	312	0.00001
Alysiella_crassa	153491	S	99	28	127	0.00001
Alysiella_filiformis	194196	S	59	16	75	0.00000
Conchiformibius_steedae	153493	S	98	16	114	0.00001
Neisseriaceae_bacterium_CCUG_44465	2917790	S	78	13	91	0.00000
Aquella_oligotrophica	2067065	S	58	2	60	0.00000
Snodgrassella_alvi	1196083	S	51	16	67	0.00000
Morococcus_cerebrosus	1056807	S	36	206	242	0.00001
Simonsiella_muelleri	72	S	35	6	41	0.00000
Casimicrobium_huifangae	2591109	S	2963	1514	4477	0.00021
Candidatus_Kinetoplastibacterium_sorsogonicusi	1576550	S	18	5	23	0.00000
Candidatus_Kinetoplastibacterium_crithidii	33056	S	16	0	16	0.00000
Candidatus_Kinetoplastibacterium_blastocrithidii	233181	S	15	0	15	0.00000
Lysobacter_sp._KIS68-7	2904252	S	11754	2355	14109	0.00067
Lysobacter_sp._TY2-98	2290922	S	9393	1527	10920	0.00052
Lysobacter_sp._5GHs7-4	2904253	S	6534	2070	8604	0.00041
Lysobacter_sp._CECT_30171	2822368	S	6032	1496	7528	0.00036
Lysobacter_sp._S4-A87	2925843	S	5931	2052	7983	0.00038
Lysobacter_sp._CW239	2762611	S	4259	2391	6650	0.00032
Lysobacter_sp._K5869	2820808	S	3818	1949	5767	0.00027
Lysobacter_sp._H21R4	2781021	S	1225	2540	3765	0.00018
Lysobacter_sp._CJ11	2764185	S	993	85	1078	0.00005
Lysobacter_sp._HDW10	2714936	S	724	200	924	0.00004
Lysobacter_sp._H23M47	2781024	S	637	3362	3999	0.00019
Lysobacter_soli	453783	S	21459	4629	26088	0.00124
Lysobacter_enzymogenes	69	S	15552	5983	21535	0.00102
Lysobacter_solisilvae_(ex_Woo_and_Kim_2022)	2865112	S	15366	4704	20070	0.00095
Lysobacter_capsici	435897	S	9954	11245	21199	0.00101
Lysobacter_solisilvae_(ex_Kim_et_al._2021)	2763317	S	9752	2025	11777	0.00056
Lysobacter_lycopersici	1324796	S	7746	1710	9456	0.00045
Lysobacter_maris	1605891	S	6408	1602	8010	0.00038
Lysobacter_arenosi	2795387	S	5924	2014	7938	0.00038
Lysobacter_antibioticus	84531	S	5912	1296	7208	0.00034
Lysobacter_alkalisoli	2591633	S	4729	878	5607	0.00027
Lysobacter_oculi	2698682	S	4530	1286	5816	0.00028
Lysobacter_ciconiae	2781022	S	977	1899	2876	0.00014
Lysobacter_gummosus	262324	S	829	7395	8224	0.00039
Lysobacter_avium	2781023	S	544	2642	3186	0.00015
Stenotrophomonas_maltophilia	40324	S	27340	34352	61692	0.00293
Stenotrophomonas_sp._ESTM1D_MKCIP4_1	2072414	S	1009	396	1405	0.00007
Stenotrophomonas_sp._SAU14A_NAIMI4_5	2072413	S	912	544	1456	0.00007
Stenotrophomonas_sp._ZAC14D2_NAIMI4_7	2072405	S	461	471	932	0.00004
Stenotrophomonas_sp._ZAC14A_NAIMI4_1	2072412	S	332	588	920	0.00004
Stenotrophomonas_sp._YAU14D1_LEIMI4_1	2072407	S	314	511	825	0.00004
Stenotrophomonas_sp._ZAC14D2_NAIMI4_6	2072406	S	291	538	829	0.00004
Stenotrophomonas_sp._SAU14A_NAIMI4_8	2072409	S	119	638	757	0.00004
Stenotrophomonas_sp._YAU14A_MKIMI4_1	2072408	S	98	525	623	0.00003
Stenotrophomonas_sp._LM091	1904944	S	1817	691	2508	0.00012
Stenotrophomonas_sp._169	2770322	S	1646	268	1914	0.00009
Stenotrophomonas_sp._364	2691571	S	1208	432	1640	0.00008
Stenotrophomonas_sp._NA06056	2742129	S	645	287	932	0.00004
Stenotrophomonas_sp._WZN-1	2005046	S	379	392	771	0.00004
Stenotrophomonas_sp._DR822	2871174	S	258	372	630	0.00003
Stenotrophomonas_sp._Pemsol	2040586	S	209	570	779	0.00004
Stenotrophomonas_sp._pho	2211160	S	134	583	717	0.00003
Stenotrophomonas_sp._ASS1	2282124	S	125	481	606	0.00003
Stenotrophomonas_sp._CW117	2775920	S	117	2400	2517	0.00012
Stenotrophomonas_sp._SI-NJAU-1	2886359	S	95	390	485	0.00002
Stenotrophomonas_sp._MYb57	1827305	S	77	278	355	0.00002
Stenotrophomonas_sp._G4	2303750	S	73	290	363	0.00002
Stenotrophomonas_sp._NY11291	2939415	S	70	700	770	0.00004
Stenotrophomonas_sp._SXG-1	2682487	S	57	549	606	0.00003
Stenotrophomonas_rhizophila	216778	S	5737	1644	7381	0.00035
Stenotrophomonas_acidaminiphila	128780	S	3469	7542	11011	0.00052
Stenotrophomonas_indicatrix	2045451	S	180	592	772	0.00004
Xanthomonas_translucens	343	S	5984	6806	12790	0.00061
Xanthomonas_campestris	339	S	4858	3477	8335	0.00040
Xanthomonas_sacchari	56458	S	3657	1269	4926	0.00023
Xanthomonas_sp._GW	2724121	S	675	858	1533	0.00007
Xanthomonas_sp._SS	2724122	S	590	871	1461	0.00007
Xanthomonas_sp._SI	2724123	S	514	765	1279	0.00006
Xanthomonas_sp._MLO165	2081477	S	168	149	317	0.00002
Xanthomonas_arboricola	56448	S	2768	2234	5002	0.00024
Xanthomonas_theicola	56464	S	2277	728	3005	0.00014
Xanthomonas_oryzae	347	S	2173	821	2994	0.00014
Xanthomonas_citri	346	S	1832	41319	43151	0.00205
Xanthomonas_hyacinthi	56455	S	1760	1021	2781	0.00013
Xanthomonas_albilineans	29447	S	1600	245	1845	0.00009
Xanthomonas_vesicatoria	56460	S	1382	722	2104	0.00010
Xanthomonas_hortorum	56454	S	1365	830	2195	0.00010
Xanthomonas_fragariae	48664	S	1237	233	1470	0.00007
Xanthomonas_cucurbitae	56453	S	1128	189	1317	0.00006
Xanthomonas_vasicola	56459	S	953	330	1283	0.00006
Xanthomonas_cassavae	56450	S	937	192	1129	0.00005
Xanthomonas_hydrangeae	2775159	S	744	189	933	0.00004
Xanthomonas_axonopodis	53413	S	652	959	1611	0.00008
Xanthomonas_euroxanthea	2259622	S	625	447	1072	0.00005
Xanthomonas_phaseoli	1985254	S	473	735	1208	0.00006
Xanthomonas_euvesicatoria	456327	S	321	4418	4739	0.00022
Xanthomonas_perforans	442694	S	79	291	370	0.00002
Luteimonas_sp._MC1750	2799326	S	4727	1824	6551	0.00031
Luteimonas_sp._S4-F44	2925842	S	4385	887	5272	0.00025
Luteimonas_sp._D4P002	2901869	S	4079	1119	5198	0.00025
Luteimonas_sp._MC1572	2799325	S	3911	2036	5947	0.00028
Luteimonas_sp._JM171	1896164	S	3873	814	4687	0.00022
Luteimonas_sp._YGD11-2	2508168	S	3761	1704	5465	0.00026
Luteimonas_sp._MC1825	2761107	S	3740	2002	5742	0.00027
Luteimonas_granuli	1176533	S	4799	1729	6528	0.00031
Luteimonas_yindakuii	2565782	S	3594	1477	5071	0.00024
Luteimonas_chenhongjianii	2006110	S	3518	797	4315	0.00020
Pseudoxanthomonas_suwonensis	314722	S	9136	4878	14014	0.00067
Pseudoxanthomonas_mexicana	128785	S	5103	8304	13407	0.00064
Pseudoxanthomonas_sp._X-1	2571115	S	4426	4145	8571	0.00041
Pseudoxanthomonas_daejeonensis	266062	S	3619	972	4591	0.00022
Pseudoxanthomonas_spadix	415229	S	2619	1002	3621	0.00017
Thermomonas_sp._XSG	2771436	S	3662	1678	5340	0.00025
Thermomonas_sp._HDW16	2714945	S	2604	742	3346	0.00016
Thermomonas_brevis	215691	S	5774	2486	8260	0.00039
Thermomonas_aquatica	2202149	S	4601	2510	7111	0.00034
Thermomonas_carbonis	1463158	S	3721	820	4541	0.00022
Arenimonas_daejeonensis	370777	S	4828	1013	5841	0.00028
Pseudolysobacter_antarcticus	2511995	S	4129	114	4243	0.00020
Xylella_fastidiosa	2371	S	378	115	493	0.00002
Xylella_taiwanensis	1444770	S	260	13	273	0.00001
Rhodanobacter_glycinis	582702	S	13179	2393	15572	0.00074
Rhodanobacter_denitrificans	666685	S	12248	4948	17196	0.00082
Rhodanobacter_sp._FDAARGOS_1247	2778082	S	7990	2727	10717	0.00051
Rhodanobacter_thiooxydans	416169	S	7828	3850	11678	0.00055
Frateuria_sp._5GH9-34	2898793	S	19415	5957	25372	0.00120
Frateuria_sp._5GH9-11	1542730	S	17933	7011	24944	0.00118
Frateuria_aurantia	81475	S	1744	226	1970	0.00009
Dyella_thiooxydans	445710	S	10300	3188	13488	0.00064
Dyella_japonica	231455	S	4916	1707	6623	0.00031
Dyella_telluris	2763498	S	4492	1380	5872	0.00028
Dyella_caseinilytica	1849581	S	4117	333	4450	0.00021
Dyella_terrae	522259	S	3200	511	3711	0.00018
Dyella_sp._M7H15-1	2501295	S	2628	281	2909	0.00014
Luteibacter_sp._321	2911537	S	5145	1575	6720	0.00032
Luteibacter_sp._EIF3	2780091	S	3830	635	4465	0.00021
Luteibacter_sp._335	2911538	S	3085	762	3847	0.00018
Luteibacter_sp._353	2911539	S	3035	1006	4041	0.00019
Luteibacter_pinisoli	2589080	S	3910	1077	4987	0.00024
Luteibacter_rhizovicinus	242606	S	3825	555	4380	0.00021
Luteibacter_anthropi	564369	S	2962	562	3524	0.00017
Dokdonella_koreensis	323415	S	13829	2449	16278	0.00077
Aerosticca_soli	2010829	S	7146	9710	16856	0.00080
Ahniella_affigens	2021234	S	2308	60	2368	0.00011
Pseudomonas_sp._ATCC_13867	1294143	S	1596	582	2178	0.00010
Pseudomonas_sp._KNUC1026	2893890	S	1501	149	1650	0.00008
Pseudomonas_sp._SCB32	2653853	S	1475	329	1804	0.00009
Pseudomonas_sp._PDNC002	2811422	S	1444	364	1808	0.00009
Pseudomonas_sp._LPB0260	2614442	S	1330	284	1614	0.00008
Pseudomonas_sp._TCU-HL1	1856685	S	1305	198	1503	0.00007
Pseudomonas_sp._Ost2	2678260	S	1207	197	1404	0.00007
Pseudomonas_sp._CC6-YY-74	1930532	S	1194	148	1342	0.00006
Pseudomonas_sp._DY-1	1755504	S	1181	159	1340	0.00006
Pseudomonas_sp._ABC1	2748080	S	1031	155	1186	0.00006
Pseudomonas_sp._MTM4	2705472	S	980	186	1166	0.00006
Pseudomonas_sp._StFLB209	1028989	S	923	242	1165	0.00006
Pseudomonas_sp._MM211	2866808	S	870	84	954	0.00005
Pseudomonas_sp._L5B5	2883205	S	859	172	1031	0.00005
Pseudomonas_sp._Pc102	2678261	S	827	558	1385	0.00007
Pseudomonas_sp._OIL-1	2706126	S	818	178	996	0.00005
Pseudomonas_sp._p1(2021b)	2874628	S	817	472	1289	0.00006
Pseudomonas_sp._7SR1	1881017	S	773	157	930	0.00004
Pseudomonas_sp._CMR5c	658630	S	749	242	991	0.00005
Pseudomonas_sp._HN2-3	2886360	S	704	178	882	0.00004
Pseudomonas_sp._B11D7D	2735906	S	641	141	782	0.00004
Pseudomonas_sp._MSPm1	2726956	S	623	161	784	0.00004
Pseudomonas_sp._gcc21	2726989	S	621	275	896	0.00004
Pseudomonas_sp._LAB-08	143813	S	614	129	743	0.00004
Pseudomonas_sp._MPC6	2498848	S	601	151	752	0.00004
Pseudomonas_sp._Marseille-Q3773	2866592	S	560	210	770	0.00004
Pseudomonas_sp._HLS-6	2049589	S	528	165	693	0.00003
Pseudomonas_sp._S09G_359	2054919	S	518	147	665	0.00003
Pseudomonas_sp._URMO17WK12:I11	1283291	S	510	431	941	0.00004
Pseudomonas_sp._15A4	2804761	S	500	160	660	0.00003
Pseudomonas_sp._DG56-2	2320270	S	491	58	549	0.00003
Pseudomonas_sp._ADAK13	2730847	S	476	133	609	0.00003
Pseudomonas_sp._ADPe	2774873	S	469	1321	1790	0.00008
Pseudomonas_sp._Leaf58	1736226	S	468	101	569	0.00003
Pseudomonas_sp._MM213	2866807	S	456	115	571	0.00003
Pseudomonas_sp._DTU12.3	2073078	S	449	131	580	0.00003
Pseudomonas_sp._S34	1573718	S	447	121	568	0.00003
Pseudomonas_sp._M1	95619	S	406	1111	1517	0.00007
Pseudomonas_sp._NIBR-H-19	2901380	S	406	101	507	0.00002
Pseudomonas_sp._Tri1	2823875	S	401	118	519	0.00002
Pseudomonas_sp._31-12	2201356	S	384	114	498	0.00002
Pseudomonas_sp._S35	1573719	S	371	115	486	0.00002
Pseudomonas_sp._RtIB026	2749999	S	371	248	619	0.00003
Pseudomonas_sp._DNDY-54	2870860	S	368	233	601	0.00003
Pseudomonas_sp._Seg1	2678259	S	364	97	461	0.00002
Pseudomonas_sp._R5-89-07	658644	S	357	126	483	0.00002
Pseudomonas_sp._PP3	2815936	S	346	155	501	0.00002
Pseudomonas_sp._RC3H12	2834406	S	344	243	587	0.00003
Pseudomonas_sp._M30-35	1981174	S	339	20	359	0.00002
Pseudomonas_sp._DR48	2871095	S	334	242	576	0.00003
Pseudomonas_sp._LS.1a	2920387	S	332	169	501	0.00002
Pseudomonas_sp._OE_28.3	2745519	S	326	92	418	0.00002
Pseudomonas_sp._LG1E9	2219057	S	322	110	432	0.00002
Pseudomonas_sp._2hn	2866626	S	310	240	550	0.00003
Pseudomonas_sp._ACM7	2052956	S	305	66	371	0.00002
Pseudomonas_sp._ADAK18	2730848	S	292	60	352	0.00002
Pseudomonas_sp._HN11	1344094	S	284	78	362	0.00002
Pseudomonas_sp._HS-18	2879114	S	284	739	1023	0.00005
Pseudomonas_sp._NS1(2017)	2025658	S	283	93	376	0.00002
Pseudomonas_sp._HS6	2850559	S	280	95	375	0.00002
Pseudomonas_sp._R2A2	2213057	S	266	376	642	0.00003
Pseudomonas_sp._MRSN12121	1611770	S	262	455	717	0.00003
Pseudomonas_sp._SDM007	2812000	S	257	177	434	0.00002
Pseudomonas_sp._IzPS59	2774459	S	255	152	407	0.00002
Pseudomonas_sp._CCOS_191	1649877	S	255	250	505	0.00002
Pseudomonas_sp._St316	2678257	S	248	102	350	0.00002
Pseudomonas_sp._SK	2729423	S	244	261	505	0.00002
Pseudomonas_sp._CYM-20-01	2870750	S	236	149	385	0.00002
Pseudomonas_sp._NIBRBAC000502773	2590776	S	230	149	379	0.00002
Pseudomonas_sp._SK3(2021)	2841064	S	228	190	418	0.00002
Pseudomonas_sp._AO-1	2855434	S	219	234	453	0.00002
Pseudomonas_sp._14181154	2662033	S	205	262	467	0.00002
Pseudomonas_sp._R84	1573712	S	203	108	311	0.00001
Pseudomonas_sp._SCA2728.1_7	2825975	S	203	127	330	0.00002
Pseudomonas_sp._FIT81	2837969	S	200	150	350	0.00002
Pseudomonas_sp._LPH1	1898684	S	198	236	434	0.00002
Pseudomonas_sp._RBPA9	2746321	S	196	547	743	0.00004
Pseudomonas_sp._R76	1573711	S	193	122	315	0.00001
Pseudomonas_sp._Z003-0.4C(8344-21)	1855380	S	181	168	349	0.00002
Pseudomonas_sp._02C_26	2054914	S	179	405	584	0.00003
Pseudomonas_sp._FGI182	1259844	S	176	249	425	0.00002
Pseudomonas_sp._B10	118613	S	171	163	334	0.00002
Pseudomonas_sp._UW4	1207075	S	171	143	314	0.00001
Pseudomonas_sp._LTJR-52	2479392	S	156	67	223	0.00001
Pseudomonas_sp._HN2	2884805	S	153	179	332	0.00002
Pseudomonas_sp._THAF7b	2587845	S	152	360	512	0.00002
Pseudomonas_sp._BIGb0427	2724470	S	146	343	489	0.00002
Pseudomonas_sp._MPFS	2795724	S	144	304	448	0.00002
Pseudomonas_sp._Cab53	2678258	S	144	304	448	0.00002
Pseudomonas_sp._3-2	2867408	S	142	222	364	0.00002
Pseudomonas_sp._S07E_245	2866278	S	140	336	476	0.00002
Pseudomonas_sp._SORT22	2813842	S	139	347	486	0.00002
Pseudomonas_sp._DR_5-09	1534110	S	130	213	343	0.00002
Pseudomonas_sp._09C_129	2054915	S	129	211	340	0.00002
Pseudomonas_sp._phDV1	253237	S	128	510	638	0.00003
Pseudomonas_sp._AN-B15	2697023	S	122	365	487	0.00002
Pseudomonas_sp._RU47	2005388	S	119	327	446	0.00002
Pseudomonas_sp._Y5-11	2749808	S	113	369	482	0.00002
Pseudomonas_sp._ADAK22	2730851	S	106	280	386	0.00002
Pseudomonas_sp._C27(2019)	2604941	S	106	16	122	0.00001
Pseudomonas_sp._SC3(2021)	2871493	S	102	145	247	0.00001
Pseudomonas_sp._J380	2605424	S	101	151	252	0.00001
Pseudomonas_sp._PONIH3	1636610	S	96	599	695	0.00003
Pseudomonas_sp._MYb193	1827300	S	95	118	213	0.00001
Pseudomonas_sp._LBUM920	2126069	S	92	241	333	0.00002
Pseudomonas_sp._ArH3a	2862945	S	88	234	322	0.00002
Pseudomonas_sp._FDAARGOS_380	2018067	S	87	91	178	0.00001
Pseudomonas_sp._S150	2559074	S	85	176	261	0.00001
Pseudomonas_sp._LG1D9	2083054	S	82	318	400	0.00002
Pseudomonas_sp._GR_6-02	1659194	S	82	226	308	0.00001
Pseudomonas_sp._S49	1573720	S	79	219	298	0.00001
Pseudomonas_sp._DR208	2870840	S	78	250	328	0.00002
Pseudomonas_sp._BIOMIG1BAC	1758730	S	77	288	365	0.00002
Pseudomonas_sp._ATCC_43928	676210	S	76	212	288	0.00001
Pseudomonas_sp._BC42	2933816	S	74	391	465	0.00002
Pseudomonas_sp._Os17	1500686	S	71	375	446	0.00002
Pseudomonas_sp._IAC-BECa141	2793103	S	70	193	263	0.00001
Pseudomonas_sp._St29	1500687	S	69	301	370	0.00002
Pseudomonas_sp._Y39-6	2749807	S	64	274	338	0.00002
Pseudomonas_sp._R32	1573704	S	59	202	261	0.00001
Pseudomonas_sp._A2	107445	S	59	361	420	0.00002
Pseudomonas_sp._R3-18-08	1173283	S	56	170	226	0.00001
Pseudomonas_sp._SWI36	2083052	S	56	194	250	0.00001
Pseudomonas_sp._R1-43-08	1173270	S	55	335	390	0.00002
Pseudomonas_sp._XWY-1	2069256	S	53	355	408	0.00002
Pseudomonas_sp._R2-37-08W	1173273	S	52	253	305	0.00001
Pseudomonas_sp._SXM-1	2169583	S	52	189	241	0.00001
Pseudomonas_sp._BJP69	2597770	S	52	364	416	0.00002
Pseudomonas_sp._CFSAN084952	2664899	S	51	202	253	0.00001
Pseudomonas_sp._Colony2	2861799	S	50	249	299	0.00001
Pseudomonas_sp._A214	1855331	S	50	183	233	0.00001
Pseudomonas_sp._B14-6	2738843	S	47	168	215	0.00001
Pseudomonas_sp._R4-35-07	658643	S	46	319	365	0.00002
Pseudomonas_sp._HN8-3	2886361	S	46	121	167	0.00001
Pseudomonas_sp._R4-34-07	658642	S	45	268	313	0.00001
Pseudomonas_sp._MPDS	2762896	S	44	210	254	0.00001
Pseudomonas_sp._SWI44	2083053	S	43	366	409	0.00002
Pseudomonas_sp._TMW_2.1634	1886807	S	41	139	180	0.00001
Pseudomonas_sp._DTU12.1	2654238	S	41	169	210	0.00001
Pseudomonas_sp._7-41	2898483	S	38	221	259	0.00001
Pseudomonas_sp._OST1909	2777367	S	37	152	189	0.00001
Pseudomonas_sp._TKP	1415630	S	37	170	207	0.00001
Pseudomonas_sp._R3-52-08	1173284	S	36	225	261	0.00001
Pseudomonas_sp._NC02	2067572	S	36	139	175	0.00001
Pseudomonas_sp._CFA	2651048	S	34	192	226	0.00001
Pseudomonas_sp._R11-23-07	658632	S	33	303	336	0.00002
Pseudomonas_sp._Eqa60	2799184	S	32	247	279	0.00001
Pseudomonas_sp._PS1(2021)	2866282	S	32	1085	1117	0.00005
Pseudomonas_sp._IB20	1702250	S	32	196	228	0.00001
Pseudomonas_sp._SK2	2841063	S	31	567	598	0.00003
Pseudomonas_sp._St290	1602166	S	30	156	186	0.00001
Pseudomonas_sp._So3.2b	2864101	S	28	121	149	0.00001
Pseudomonas_sp._SW-3	147212	S	27	133	160	0.00001
Pseudomonas_sp._R4-39-08	1173288	S	27	163	190	0.00001
Pseudomonas_sp._SWI6	2083051	S	25	421	446	0.00002
Pseudomonas_sp._VLB120	69328	S	25	354	379	0.00002
Pseudomonas_sp._R2-7-07	658641	S	25	242	267	0.00001
Pseudomonas_sp._KUIN-1	2609418	S	24	191	215	0.00001
Pseudomonas_sp._I3-I5	2926671	S	24	120	144	0.00001
Pseudomonas_sp._13159349	2662034	S	23	282	305	0.00001
Pseudomonas_sp._LH1G9	2083055	S	22	100	122	0.00001
Pseudomonas_sp._R2-60-08W	1173280	S	22	157	179	0.00001
Pseudomonas_sp._CIP-10	2892442	S	20	217	237	0.00001
Pseudomonas_sp._SWI7	2587597	S	18	145	163	0.00001
Pseudomonas_sp._BYT-1	2816906	S	18	180	198	0.00001
Pseudomonas_sp._St386	2678256	S	17	190	207	0.00001
Pseudomonas_sp._bs2935	1761895	S	13	531	544	0.00003
Pseudomonas_sp._LTGT-11-2Z	2479393	S	13	433	446	0.00002
Pseudomonas_sp._JY-Q	1338689	S	11	113	124	0.00001
Pseudomonas_sp._JS425	2829498	S	10	411	421	0.00002
Pseudomonas_fluorescens	294	S	8384	8549	16933	0.00080
Pseudomonas_protegens	380021	S	2018	2214	4232	0.00020
Pseudomonas_orientalis	76758	S	1510	460	1970	0.00009
Pseudomonas_azotoformans	47878	S	1116	517	1633	0.00008
Pseudomonas_synxantha	47883	S	970	758	1728	0.00008
Pseudomonas_poae	200451	S	808	492	1300	0.00006
Pseudomonas_rhodesiae	76760	S	762	314	1076	0.00005
Pseudomonas_tolaasii	29442	S	635	136	771	0.00004
Pseudomonas_trivialis	200450	S	632	251	883	0.00004
Pseudomonas_mediterranea	183795	S	589	162	751	0.00004
Pseudomonas_corrugata	47879	S	566	131	697	0.00003
Pseudomonas_migulae	78543	S	511	283	794	0.00004
Pseudomonas_cedrina	651740	S	471	135	606	0.00003
Pseudomonas_mucidolens	46679	S	386	60	446	0.00002
Pseudomonas_brenneri	129817	S	332	134	466	0.00002
Pseudomonas_congelans	200452	S	321	116	437	0.00002
Pseudomonas_libanensis	75588	S	235	291	526	0.00002
Pseudomonas_veronii	76761	S	210	674	884	0.00004
Pseudomonas_mandelii	75612	S	187	616	803	0.00004
Pseudomonas_ogarae	1114970	S	172	156	328	0.00002
Pseudomonas_extremorientalis	169669	S	45	134	179	0.00001
Pseudomonas_aeruginosa	287	S	8305	67833	76138	0.00361
Pseudomonas_mendocina	300	S	3509	1398	4907	0.00023
Pseudomonas_alcaligenes	43263	S	2900	1960	4860	0.00023
Pseudomonas_furukawaii	1149133	S	2113	665	2778	0.00013
Pseudomonas_oleovorans	301	S	369	1486	1855	0.00009
Pseudomonas_resinovorans	53412	S	1894	442	2336	0.00011
Pseudomonas_multiresinivorans	95301	S	1026	376	1402	0.00007
Pseudomonas_nitroreducens	46680	S	273	652	925	0.00004
Pseudomonas_citronellolis	53408	S	1086	1897	2983	0.00014
Pseudomonas_putida	303	S	10624	15359	25983	0.00123
Pseudomonas_oryzihabitans	47885	S	3269	792	4061	0.00019
Pseudomonas_fulva	47880	S	2212	6492	8704	0.00041
Pseudomonas_plecoglossicida	70775	S	739	659	1398	0.00007
Pseudomonas_mosselii	78327	S	426	836	1262	0.00006
Pseudomonas_monteilii	76759	S	351	3508	3859	0.00018
Pseudomonas_sp._SGAir0191	2217867	S	213	165	378	0.00002
Pseudomonas_shirazica	1940636	S	39	570	609	0.00003
Pseudomonas_stutzeri	316	S	14082	9856	23938	0.00114
Pseudomonas_chloritidismutans	203192	S	145	217	362	0.00002
Pseudomonas_balearica	74829	S	2390	2971	5361	0.00025
Pseudomonas_xanthomarina	271420	S	738	132	870	0.00004
Pseudomonas_luteola	47886	S	183	99	282	0.00001
Pseudomonas_syringae	317	S	2456	3883	6339	0.00030
Pseudomonas_viridiflava	33069	S	1749	219	1968	0.00009
Pseudomonas_cichorii	36746	S	917	87	1004	0.00005
Pseudomonas_asturiensis	1190415	S	663	73	736	0.00003
Pseudomonas_amygdali	47877	S	242	1406	1648	0.00008
Pseudomonas_savastanoi	29438	S	101	538	639	0.00003
Pseudomonas_syringae_group_genomosp._7	251699	S	496	54	550	0.00003
Pseudomonas_fuscovaginae	50340	S	280	201	481	0.00002
Pseudomonas_avellanae	46257	S	230	373	603	0.00003
Pseudomonas_coronafaciens	53409	S	90	286	376	0.00002
Pseudomonas_syringae_group_genomosp._3	251701	S	80	1103	1183	0.00006
Pseudomonas_sp._Lz4W	1206777	S	61	138	199	0.00001
Pseudomonas_tremae	200454	S	29	72	101	0.00000
Pseudomonas_chlororaphis	587753	S	4918	6132	11050	0.00052
Pseudomonas_lundensis	86185	S	542	72	614	0.00003
Pseudomonas_fragi	296	S	391	376	767	0.00004
Pseudomonas_otitidis	319939	S	3232	782	4014	0.00019
Pseudomonas_knackmussii	65741	S	3172	2803	5975	0.00028
Pseudomonas_psychrotolerans	237610	S	3135	772	3907	0.00019
Pseudomonas_oryzae	1392877	S	2967	1014	3981	0.00019
Pseudomonas_entomophila	312306	S	2322	1154	3476	0.00016
Pseudomonas_cavernae	2320867	S	2219	378	2597	0.00012
Pseudomonas_lalkuanensis	2604832	S	1970	395	2365	0.00011
Pseudomonas_guangdongensis	1245526	S	1839	642	2481	0.00012
Pseudomonas_parafulva	157782	S	1322	431	1753	0.00008
Pseudomonas_nanhaiensis	2830842	S	1304	163	1467	0.00007
Pseudomonas_eucalypticola	2599595	S	1266	172	1438	0.00007
Pseudomonas_qingdaonensis	2056231	S	1196	264	1460	0.00007
Pseudomonas_vanderleydeniana	2745495	S	1193	183	1376	0.00007
Pseudomonas_campi	2731681	S	1089	164	1253	0.00006
Pseudomonas_rhizosphaerae	216142	S	995	128	1123	0.00005
Pseudomonas_cremoricolorata	157783	S	966	155	1121	0.00005
Pseudomonas_zhaodongensis	1176257	S	922	475	1397	0.00007
Pseudomonas_alkylphenolica	237609	S	907	194	1101	0.00005
Pseudomonas_brassicacearum	930166	S	895	2171	3066	0.00015
Pseudomonas_frederiksbergensis	104087	S	882	307	1189	0.00006
Pseudomonas_saudiphocaensis	1499686	S	877	190	1067	0.00005
Pseudomonas_umsongensis	198618	S	821	146	967	0.00005
Pseudomonas_pohangensis	364197	S	809	62	871	0.00004
Pseudomonas_tohonis	2725477	S	796	733	1529	0.00007
Pseudomonas_muyukensis	2842357	S	786	261	1047	0.00005
Pseudomonas_argentinensis	289370	S	775	200	975	0.00005
Pseudomonas_phragmitis	1931241	S	758	64	822	0.00004
Pseudomonas_yamanorum	515393	S	742	193	935	0.00004
Pseudomonas_alvandae	2842348	S	730	130	860	0.00004
Pseudomonas_palleroniana	191390	S	728	134	862	0.00004
Pseudomonas_fakonensis	2842355	S	692	250	942	0.00004
Pseudomonas_xantholysinigenes	2745490	S	685	211	896	0.00004
Pseudomonas_vancouverensis	95300	S	676	119	795	0.00004
Pseudomonas_tructae	2518644	S	662	128	790	0.00004
Pseudomonas_xanthosomae	2842356	S	636	234	870	0.00004
Pseudomonas_koreensis	198620	S	633	292	925	0.00004
Pseudomonas_marincola	437900	S	590	93	683	0.00003
Pseudomonas_agarici	46677	S	551	30	581	0.00003
Pseudomonas_hamedanensis	2745504	S	543	113	656	0.00003
Pseudomonas_antarctica	219572	S	537	157	694	0.00003
Pseudomonas_arsenicoxydans	702115	S	534	137	671	0.00003
Pseudomonas_thivervalensis	86265	S	520	133	653	0.00003
Pseudomonas_silesiensis	1853130	S	512	123	635	0.00003
Pseudomonas_extremaustralis	359110	S	505	127	632	0.00003
Pseudomonas_granadensis	1421430	S	499	284	783	0.00004
Pseudomonas_prosekii	1148509	S	485	89	574	0.00003
Pseudomonas_promysalinigenes	485898	S	461	75	536	0.00003
Pseudomonas_sediminis	1691904	S	460	150	610	0.00003
Pseudomonas_graminis	158627	S	448	147	595	0.00003
Pseudomonas_wenzhouensis	2906062	S	440	185	625	0.00003
Pseudomonas_maumuensis	2842354	S	421	236	657	0.00003
Pseudomonas_asgharzadehiana	2842349	S	411	109	520	0.00002
Pseudomonas_lurida	244566	S	410	109	519	0.00002
Pseudomonas_reinekei	395598	S	402	133	535	0.00003
Pseudomonas_viciae	2505979	S	396	112	508	0.00002
Pseudomonas_versuta	1788301	S	370	63	433	0.00002
Pseudomonas_simiae	321846	S	364	105	469	0.00002
Pseudomonas_lini	163011	S	362	81	443	0.00002
Pseudomonas_taetrolens	47884	S	354	47	401	0.00002
Pseudomonas_kribbensis	1628086	S	339	395	734	0.00003
Pseudomonas_psychrophila	122355	S	326	47	373	0.00002
Pseudomonas_alcaliphila	101564	S	265	333	598	0.00003
Pseudomonas_chengduensis	489632	S	263	580	843	0.00004
Pseudomonas_gozinkensis	2774461	S	251	140	391	0.00002
Pseudomonas_tritici	2745518	S	247	92	339	0.00002
Pseudomonas_toyotomiensis	554344	S	246	272	518	0.00002
Pseudomonas_allokribbensis	2774460	S	246	113	359	0.00002
Pseudomonas_khazarica	2502979	S	226	335	561	0.00003
Pseudomonas_oryziphila	2894079	S	224	211	435	0.00002
Pseudomonas_sihuiensis	1274359	S	223	349	572	0.00003
Pseudomonas_moraviensis	321662	S	220	421	641	0.00003
Pseudomonas_kunmingensis	1211807	S	218	374	592	0.00003
Pseudomonas_asplenii	53407	S	207	155	362	0.00002
Pseudomonas_germanica	2815720	S	201	132	333	0.00002
Pseudomonas_zeae	2745510	S	195	118	313	0.00001
Pseudomonas_tensinigenes	2745511	S	186	118	304	0.00001
Pseudomonas_atacamensis	2565368	S	182	218	400	0.00002
Pseudomonas_anuradhapurensis	485870	S	182	193	375	0.00002
Pseudomonas_azerbaijanoriens	2842350	S	177	141	318	0.00002
Pseudomonas_iranensis	2745503	S	145	134	279	0.00001
Pseudomonas_zarinae	2745498	S	139	127	266	0.00001
Pseudomonas_monsensis	2745509	S	129	170	299	0.00001
Pseudomonas_juntendi	2666183	S	101	979	1080	0.00005
Pseudomonas_sessilinigenes	658629	S	100	317	417	0.00002
Pseudomonas_salmasensis	2745514	S	95	74	169	0.00001
Pseudomonas_lactis	1615674	S	92	82	174	0.00001
Pseudomonas_bijieensis	2681983	S	88	412	500	0.00002
Pseudomonas_soli	1306993	S	71	302	373	0.00002
Pseudomonas_glycinae	1785145	S	69	150	219	0.00001
Pseudomonas_asiatica	2219225	S	69	470	539	0.00003
Pseudomonas_rhizophila	2045200	S	66	218	284	0.00001
Pseudomonas_donghuensis	1163398	S	66	226	292	0.00001
Pseudomonas_shahriarae	2745512	S	59	285	344	0.00002
Pseudomonas_cerasi	1583341	S	36	92	128	0.00001
Candidatus_Pseudomonas_adelgestsugas	1302376	S	24	0	24	0.00000
Azotobacter_chroococcum	353	S	2775	1677	4452	0.00021
Azotobacter_vinelandii	354	S	1985	1663	3648	0.00017
Azotobacter_salinestris	69964	S	1560	764	2324	0.00011
Halopseudomonas_xinjiangensis	487184	S	935	104	1039	0.00005
Halopseudomonas_sabulinigri	472181	S	830	76	906	0.00004
Halopseudomonas_sp._RR6	2918528	S	772	116	888	0.00004
Halopseudomonas_aestusnigri	857252	S	718	510	1228	0.00006
Halopseudomonas_litoralis	797277	S	573	153	726	0.00003
Halopseudomonas_salegens	1434072	S	382	29	411	0.00002
Permianibacter_aggregans	1510150	S	822	25	847	0.00004
Thiopseudomonas_alkaliphila	1697053	S	81	17	98	0.00000
Entomomonas_moraniae	2213226	S	35	1	36	0.00000
Entomomonas_sp._F2A	2785331	S	26	1	27	0.00000
Marinobacter_sp._CA1	2817656	S	982	79	1061	0.00005
Marinobacter_sp._NP-4(2019)	2488665	S	576	118	694	0.00003
Marinobacter_sp._Arc7-DN-1	2304594	S	550	86	636	0.00003
Marinobacter_sp._LPB0319	2769486	S	540	37	577	0.00003
Marinobacter_sp._LV10R510-11A	1415568	S	292	13	305	0.00001
Marinobacter_sp._LQ44	1749259	S	219	385	604	0.00003
Marinobacter_sp._es.042	1761794	S	216	250	466	0.00002
Marinobacter_sp._JH2	2547598	S	193	58	251	0.00001
Marinobacter_sp._CP1	1671721	S	169	382	551	0.00003
Marinobacter_sp._BSs20148	490759	S	155	112	267	0.00001
Marinobacter_fonticola	2603215	S	800	42	842	0.00004
Marinobacter_salarius	1420917	S	655	95	750	0.00004
Marinobacter_similis	1420916	S	557	54	611	0.00003
Marinobacter_nauticus	2743	S	534	180	714	0.00003
Marinobacter_salsuginis	418719	S	442	73	515	0.00002
Marinobacter_salinus	1874317	S	419	30	449	0.00002
Marinobacter_adhaerens	1033846	S	133	343	476	0.00002
Marinobacter_psychrophilus	330734	S	102	75	177	0.00001
Klebsiella_pneumoniae	573	S	3068	88160	91228	0.00433
Klebsiella_quasipneumoniae	1463165	S	839	3251	4090	0.00019
Klebsiella_oxytoca	571	S	541	367	908	0.00004
Klebsiella_aerogenes	548	S	492	282	774	0.00004
Klebsiella_sp._A52	2834819	S	25	24	49	0.00000
Klebsiella_sp._WP3-W18-ESBL-02	2675710	S	10	634	644	0.00003
Klebsiella_michiganensis	1134687	S	332	1217	1549	0.00007
Klebsiella_variicola	244366	S	317	1139	1456	0.00007
Klebsiella_africana	2489010	S	145	87	232	0.00001
Klebsiella_huaxiensis	2153354	S	131	125	256	0.00001
Klebsiella_quasivariicola	2026240	S	122	132	254	0.00001
Klebsiella_grimontii	2058152	S	66	444	510	0.00002
Raoultella_sp._HC6	2923366	S	324	226	550	0.00003
Raoultella_planticola	575	S	258	270	528	0.00003
Raoultella_ornithinolytica	54291	S	202	1573	1775	0.00008
Raoultella_terrigena	577	S	149	304	453	0.00002
Raoultella_electrica	1259973	S	94	245	339	0.00002
Enterobacter_cloacae	550	S	1372	2253	3625	0.00017
Enterobacter_hormaechei	158836	S	516	8110	8626	0.00041
Enterobacter_cancerogenus	69218	S	483	173	656	0.00003
Enterobacter_asburiae	61645	S	407	1927	2334	0.00011
Enterobacter_roggenkampii	1812935	S	269	1127	1396	0.00007
Enterobacter_ludwigii	299767	S	154	376	530	0.00003
Enterobacter_cloacae_complex_sp.	2027919	S	48	1260	1308	0.00006
Enterobacter_sp._BIDMC_29	1329841	S	32	111	143	0.00001
Enterobacter_sp._BIDMC100	1686399	S	18	196	214	0.00001
Enterobacter_cloacae_complex_sp._ECNIH7	1915310	S	16	125	141	0.00001
Enterobacter_cloacae_complex_sp._ECL414	2912628	S	12	235	247	0.00001
Enterobacter_chengduensis	2494701	S	132	95	227	0.00001
Enterobacter_chuandaensis	2497875	S	116	78	194	0.00001
Enterobacter_kobei	208224	S	97	1132	1229	0.00006
Enterobacter_sichuanensis	2071710	S	64	60	124	0.00001
Enterobacter_sp._SA187	1914861	S	357	68	425	0.00002
Enterobacter_sp._JUb54	2724468	S	339	74	413	0.00002
Enterobacter_sp._E76	2596949	S	174	364	538	0.00003
Enterobacter_sp._RHBSTW-00994	2742676	S	127	34	161	0.00001
Enterobacter_sp._RHBSTW-00175	2742639	S	106	105	211	0.00001
Enterobacter_sp._JBIWA008	2831892	S	61	41	102	0.00000
Enterobacter_sp._SGAir0187	2836161	S	57	70	127	0.00001
Enterobacter_sp._Colony194	2866201	S	56	79	135	0.00001
Enterobacter_sp._JBIWA003	2831890	S	38	52	90	0.00000
Enterobacter_sp._JBIWA005	2831891	S	36	73	109	0.00001
Enterobacter_sp._SES19	2705458	S	26	26	52	0.00000
Enterobacter_sp._N18-03635	2500132	S	19	51	70	0.00000
Enterobacter_sp._E20	1560339	S	18	164	182	0.00001
Enterobacter_sp._DNB-S2	2720029	S	17	81	98	0.00000
Enterobacter_huaxiensis	2494702	S	201	63	264	0.00001
Enterobacter_mori	539813	S	167	223	390	0.00002
Enterobacter_oligotrophicus	2478464	S	138	44	182	0.00001
Enterobacter_bugandensis	881260	S	137	255	392	0.00002
Enterobacter_soli	885040	S	98	27	125	0.00001
Citrobacter_freundii	546	S	407	1938	2345	0.00011
Citrobacter_portucalensis	1639133	S	82	911	993	0.00005
Citrobacter_werkmanii	67827	S	70	184	254	0.00001
Citrobacter_braakii	57706	S	44	372	416	0.00002
Citrobacter_freundii_complex_sp._CFNIH2	2066049	S	33	41	74	0.00000
Citrobacter_sedlakii	67826	S	36	114	150	0.00001
Citrobacter_sp._R56	1573676	S	166	52	218	0.00001
Citrobacter_sp._RHB25-C09	2742624	S	134	34	168	0.00001
Citrobacter_sp._BDA59-3	2781952	S	25	13	38	0.00000
Citrobacter_sp._RHB35-C21	2742626	S	20	181	201	0.00001
Citrobacter_sp._MGH_55	1439319	S	18	49	67	0.00000
Citrobacter_sp._RHB35-C17	2742625	S	11	61	72	0.00000
Citrobacter_sp._CRE-46	1703250	S	11	115	126	0.00001
Citrobacter_rodentium	67825	S	358	0	358	0.00002
Citrobacter_amalonaticus	35703	S	223	1148	1371	0.00007
Citrobacter_farmeri	67824	S	195	102	297	0.00001
Citrobacter_koseri	545	S	124	180	304	0.00001
Citrobacter_tructae	2562449	S	105	51	156	0.00001
Citrobacter_pasteurii	1563222	S	103	94	197	0.00001
Citrobacter_arsenatis	2546350	S	55	21	76	0.00000
Citrobacter_cronae	1748967	S	18	152	170	0.00001
Cronobacter_sakazakii	28141	S	585	494	1079	0.00005
Cronobacter_dublinensis	413497	S	494	185	679	0.00003
Cronobacter_universalis	535744	S	288	213	501	0.00002
Cronobacter_condimenti	1163710	S	273	81	354	0.00002
Cronobacter_malonaticus	413503	S	150	192	342	0.00002
Cronobacter_sp._JZ38	1906275	S	78	234	312	0.00001
Cronobacter_muytjensii	413501	S	40	155	195	0.00001
Kosakonia_sp._SMBL-WEM22	2725560	S	248	117	365	0.00002
Kosakonia_sp._CCTCC_M2018092	2492396	S	145	147	292	0.00001
Kosakonia_sp._MUSA4	2067958	S	112	61	173	0.00001
Kosakonia_cowanii	208223	S	394	333	727	0.00003
Kosakonia_sacchari	1158459	S	306	148	454	0.00002
Kosakonia_pseudosacchari	1646340	S	140	78	218	0.00001
Kosakonia_radicincitans	283686	S	132	120	252	0.00001
Kosakonia_oryzae	497725	S	123	92	215	0.00001
Kosakonia_arachidis	551989	S	123	35	158	0.00001
Leclercia_adecarboxylata	83655	S	665	1187	1852	0.00009
Leclercia_sp._29361	2714951	S	227	93	320	0.00002
Leclercia_sp._J807	2681307	S	44	62	106	0.00001
Leclercia_sp._W6	2282310	S	42	74	116	0.00001
Leclercia_sp._W17	2282309	S	40	108	148	0.00001
Leclercia_sp._119287	2681308	S	39	115	154	0.00001
Leclercia_sp._G3L	2898725	S	33	166	199	0.00001
Leclercia_sp._LSNIH1	1920114	S	12	167	179	0.00001
Leclercia_sp._Colony189	2681309	S	11	191	202	0.00001
Leclercia_pneumoniae	2815358	S	189	89	278	0.00001
Pluralibacter_gergoviae	61647	S	1266	337	1603	0.00008
[Enterobacter]_lignolyticus	1334193	S	615	168	783	0.00004
Salmonella_enterica	28901	S	1412	54535	55947	0.00266
Salmonella_bongori	54736	S	166	62	228	0.00001
Escherichia_coli	562	S	938	18070	19008	0.00090
Escherichia_albertii	208962	S	172	205	377	0.00002
Escherichia_fergusonii	564	S	88	141	229	0.00001
Escherichia_marmotae	1499973	S	81	47	128	0.00001
Escherichia_sp._E4742	2044467	S	43	29	72	0.00000
Cedecea_neteri	158822	S	794	185	979	0.00005
Cedecea_lapagei	158823	S	247	75	322	0.00002
Cedecea_sp._FDAARGOS_727	2545798	S	205	46	251	0.00001
Lelliottia_amnigena	61646	S	602	172	774	0.00004
Lelliottia_sp._AC1	2067959	S	109	108	217	0.00001
Lelliottia_sp._WB101	2153385	S	96	116	212	0.00001
Kluyvera_ascorbata	51288	S	204	174	378	0.00002
Kluyvera_intermedia	61648	S	157	117	274	0.00001
Kluyvera_sp._CRP	2873269	S	40	113	153	0.00001
Kluyvera_genomosp._3	2774055	S	24	63	87	0.00000
Candidatus_Symbiopectobacterium_sp._SyEd1	2871826	S	247	31	278	0.00001
Candidatus_Hamiltonella_defensa	138072	S	54	4	58	0.00000
secondary_endosymbiont_of_Ctenarytaina_eucalypti	1199245	S	40	1	41	0.00000
secondary_endosymbiont_of_Heteropsylla_cubana	134287	S	18	0	18	0.00000
Blochmannia_endosymbiont_of_Colobopsis_nipponica	2681987	S	22	2	24	0.00000
Blochmannia_endosymbiont_of_Camponotus_sp.	700220	S	12	21	33	0.00000
Candidatus_Mikella_endobia	1778264	S	24	4	28	0.00000
Candidatus_Doolittlea_endobia	1778262	S	20	1	21	0.00000
Candidatus_Hoaglandella_endobia	1778263	S	20	1	21	0.00000
Candidatus_Gullanella_endobia	1070130	S	19	1	20	0.00000
Jejubacter_calystegiae	2579935	S	420	47	467	0.00002
Pseudescherichia_vulneris	566	S	354	22	376	0.00002
Shimwellia_blattae	563	S	309	63	372	0.00002
Plesiomonas_shigelloides	703	S	307	100	407	0.00002
Atlantibacter_hermannii	565	S	301	66	367	0.00002
Buttiauxella_agrestis	82977	S	113	22	135	0.00001
Buttiauxella_sp._3AFRM03	2479367	S	26	69	95	0.00000
Buttiauxella_ferragutiae	82989	S	23	67	90	0.00000
Yokenella_regensburgei	158877	S	263	113	376	0.00002
Scandinavium_goeteborgense	1851514	S	243	46	289	0.00001
Pseudocitrobacter_sp._G163CM	2891570	S	223	57	280	0.00001
Phytobacter_ursingii	1972431	S	151	200	351	0.00002
Phytobacter_sp._SCO41	1756993	S	17	26	43	0.00000
Phytobacter_diazotrophicus	395631	S	14	96	110	0.00001
Enterobacteriaceae_endosymbiont_of_Donacia_cincticornis	2675773	S	81	36	117	0.00001
Shigella_flexneri	623	S	37	1902	1939	0.00009
Shigella_boydii	621	S	22	559	581	0.00003
Candidatus_Moranella_endobia	1048758	S	45	0	45	0.00000
Candidatus_Profftia_tarda	1177216	S	11	0	11	0.00000
Candidatus_Profftia_lariciata	1987921	S	11	0	11	0.00000
Candidatus_Ishikawaella_capsulata	168169	S	16	1	17	0.00000
Serratia_marcescens	615	S	2234	4976	7210	0.00034
Serratia_sp._FDAARGOS_506	2420306	S	159	166	325	0.00002
Serratia_sp._FGI94	671990	S	145	169	314	0.00001
Serratia_sp._ATCC_39006	104623	S	142	15	157	0.00001
Serratia_sp._3ACOL1	2448483	S	62	97	159	0.00001
Serratia_sp._1D1416	2447890	S	49	177	226	0.00001
Serratia_sp._MYb239	2033438	S	43	397	440	0.00002
Serratia_sp._FS14	1327989	S	31	164	195	0.00001
Serratia_sp._P2ACOL2	2482769	S	22	73	95	0.00000
Serratia_sp._SCBI	488142	S	16	151	167	0.00001
Serratia_sp._Tan611	2773264	S	15	107	122	0.00001
Serratia_sp._HRI	2663241	S	10	317	327	0.00002
Serratia_sp._JSRIV006	2831896	S	10	60	70	0.00000
Serratia_plymuthica	82996	S	765	409	1174	0.00006
Serratia_entomophila	42906	S	583	155	738	0.00004
Serratia_rubidaea	61652	S	499	611	1110	0.00005
Serratia_odorifera	618	S	417	75	492	0.00002
Serratia_proteamaculans	28151	S	402	100	502	0.00002
Serratia_fonticola	47917	S	281	266	547	0.00003
Serratia_surfactantfaciens	2741499	S	246	153	399	0.00002
Serratia_liquefaciens	614	S	212	304	516	0.00002
Serratia_quinivorans	137545	S	183	74	257	0.00001
Serratia_symbiotica	138074	S	160	26	186	0.00001
Serratia_rhizosphaerae	2597702	S	144	145	289	0.00001
Serratia_inhibens	2338073	S	136	79	215	0.00001
Serratia_grimesii	82995	S	121	15	136	0.00001
Serratia_ureilytica	300181	S	76	1070	1146	0.00005
Serratia_ficaria	61651	S	51	251	302	0.00001
Serratia_nematodiphila	458197	S	13	138	151	0.00001
Rahnella_aquatilis	34038	S	310	433	743	0.00004
Rahnella_victoriana	1510570	S	246	39	285	0.00001
Rahnella_inusitata	58169	S	225	63	288	0.00001
Rahnella_sp._ERMR1:05	1805933	S	221	33	254	0.00001
Rahnella_aceris	2703885	S	41	88	129	0.00001
Yersinia_pseudotuberculosis	633	S	37	224	261	0.00001
Yersinia_similis	367190	S	34	6	40	0.00000
Yersinia_pestis	632	S	16	588	604	0.00003
Yersinia_enterocolitica	630	S	133	146	279	0.00001
Yersinia_entomophaga	935293	S	86	15	101	0.00000
Yersinia_ruckeri	29486	S	84	15	99	0.00000
Yersinia_rohdei	29485	S	71	13	84	0.00000
Yersinia_aleksiciae	263819	S	62	14	76	0.00000
Yersinia_mollaretii	33060	S	60	12	72	0.00000
Yersinia_frederiksenii	29484	S	56	42	98	0.00000
Yersinia_aldovae	29483	S	54	11	65	0.00000
Yersinia_kristensenii	28152	S	45	104	149	0.00001
Yersinia_canariae	2607663	S	35	12	47	0.00000
Yersinia_intermedia	631	S	29	77	106	0.00001
Yersinia_hibernica	2339259	S	24	33	57	0.00000
Yersinia_massiliensis	419257	S	10	25	35	0.00000
Nissabacter_sp._SGAir0207	2126321	S	971	152	1123	0.00005
Gibbsiella_quercinecans	929813	S	507	74	581	0.00003
Ewingella_americana	41202	S	303	46	349	0.00002
Rouxiella_badensis	1646377	S	259	25	284	0.00001
Chania_multitudinisentens	1639108	S	158	19	177	0.00001
Candidatus_Fukatsuia_symbiotica	1878942	S	37	2	39	0.00000
Pantoea_sp._Z09	2886821	S	790	263	1053	0.00005
Pantoea_sp._SO10	2575375	S	369	74	443	0.00002
Pantoea_sp._MSR2	2052056	S	285	37	322	0.00002
Pantoea_sp._CCBC3-3-1	2490851	S	258	51	309	0.00001
Pantoea_sp._At-9b	592316	S	249	53	302	0.00001
Pantoea_sp._MT58	2768165	S	17	147	164	0.00001
Pantoea_sp._SM3640	2787629	S	10	80	90	0.00000
Pantoea_agglomerans	549	S	1526	508	2034	0.00010
Pantoea_dispersa	59814	S	1332	364	1696	0.00008
Pantoea_ananatis	553	S	434	154	588	0.00003
Pantoea_vagans	470934	S	430	693	1123	0.00005
Pantoea_deleyi	470932	S	362	90	452	0.00002
Pantoea_alhagi	1891675	S	288	92	380	0.00002
Pantoea_stewartii	66269	S	281	72	353	0.00002
Pantoea_cypripedii	55209	S	257	17	274	0.00001
Pantoea_rwandensis	1076550	S	187	43	230	0.00001
Pantoea_eucalypti	470933	S	14	111	125	0.00001
Candidatus_Pantoea_carbekii	1235990	S	11	1	12	0.00000
Erwinia_sp._E602	2675378	S	713	128	841	0.00004
Erwinia_sp._J780	2681984	S	144	27	171	0.00001
Erwinia_sp._Ejp617	215689	S	49	70	119	0.00001
Erwinia_sp._QL-Z3	2547962	S	30	72	102	0.00000
Erwinia_gerundensis	1619313	S	424	81	505	0.00002
Erwinia_persicina	55211	S	311	63	374	0.00002
Erwinia_rhapontici	55212	S	252	47	299	0.00001
Erwinia_billingiae	182337	S	193	341	534	0.00003
Erwinia_tasmaniensis	338565	S	186	37	223	0.00001
Erwinia_amylovora	552	S	178	210	388	0.00002
Erwinia_tracheiphila	65700	S	148	20	168	0.00001
[Pantoea]_beijingensis	1324864	S	77	15	92	0.00000
Candidatus_Erwinia_haradaeae	1922217	S	77	1	78	0.00000
Erwinia_pyrifoliae	79967	S	27	37	64	0.00000
Mixta_gaviniae	665914	S	624	244	868	0.00004
Mixta_calida	665913	S	508	277	785	0.00004
Mixta_theicola	1458355	S	433	141	574	0.00003
Mixta_sp._X22927	2872648	S	240	128	368	0.00002
Mixta_intestinalis	1615494	S	222	64	286	0.00001
Buchnera_aphidicola	9	S	283	36	319	0.00002
Tatumella_ptyseos	82987	S	122	21	143	0.00001
Tatumella_citrea	53336	S	70	10	80	0.00000
Wigglesworthia_glossinidia	51229	S	20	2	22	0.00000
Dickeya_dadantii	204038	S	528	301	829	0.00004
Dickeya_zeae	204042	S	428	415	843	0.00004
Dickeya_chrysanthemi	556	S	369	143	512	0.00002
Dickeya_dianthicola	204039	S	360	267	627	0.00003
Dickeya_fangzhongdai	1778540	S	191	781	972	0.00005
Dickeya_solani	1089444	S	158	83	241	0.00001
Dickeya_sp._NCPPB_3274	568766	S	122	82	204	0.00001
Dickeya_sp._Secpp_1600	2037915	S	12	116	128	0.00001
Dickeya_poaceiphila	568768	S	130	22	152	0.00001
Dickeya_oryzae	1240404	S	29	59	88	0.00000
Dickeya_parazeae	2893572	S	21	79	100	0.00000
Pectobacterium_carotovorum	554	S	239	537	776	0.00004
Pectobacterium_brasiliense	180957	S	216	258	474	0.00002
Pectobacterium_parmentieri	1905730	S	145	51	196	0.00001
Pectobacterium_sp._LJ1	2878098	S	96	27	123	0.00001
Pectobacterium_sp._PL64	2738983	S	34	23	57	0.00000
Pectobacterium_sp._21LCBS03	2935858	S	13	48	61	0.00000
Pectobacterium_atrosepticum	29471	S	127	41	168	0.00001
Pectobacterium_wasabiae	55208	S	94	29	123	0.00001
Pectobacterium_polaris	2042057	S	91	66	157	0.00001
Pectobacterium_punjabense	2108399	S	85	21	106	0.00001
Pectobacterium_odoriferum	78398	S	57	43	100	0.00000
Pectobacterium_versatile	2488639	S	46	105	151	0.00001
Pectobacterium_parvum	2778550	S	39	56	95	0.00000
Pectobacterium_quasiaquaticum	2774015	S	35	34	69	0.00000
Pectobacterium_aroidearum	1201031	S	33	52	85	0.00000
Pectobacterium_aquaticum	2204145	S	11	14	25	0.00000
Brenneria_izadpanahii	2722756	S	347	383	730	0.00003
Brenneria_goodwinii	1109412	S	329	351	680	0.00003
Brenneria_rubrifaciens	55213	S	270	107	377	0.00002
Lonsdalea_populi	1172565	S	399	105	504	0.00002
Lonsdalea_britannica	1082704	S	350	84	434	0.00002
Musicola_paradisiaca	69223	S	420	27	447	0.00002
Edwardsiella_tarda	636	S	598	845	1443	0.00007
Edwardsiella_hoshinae	93378	S	328	72	400	0.00002
Edwardsiella_ictaluri	67780	S	243	555	798	0.00004
Edwardsiella_piscicida	1263550	S	61	672	733	0.00003
Edwardsiella_sp._EA181011	1578828	S	11	108	119	0.00001
Hafnia_alvei	569	S	144	167	311	0.00001
Hafnia_paralvei	546367	S	61	25	86	0.00000
Obesumbacterium_proteus	82983	S	55	38	93	0.00000
Morganella_morganii	582	S	654	542	1196	0.00006
Providencia_rettgeri	587	S	124	216	340	0.00002
Providencia_alcalifaciens	126385	S	82	35	117	0.00001
Providencia_heimbachae	333962	S	30	12	42	0.00000
Providencia_rustigianii	158850	S	25	9	34	0.00000
Providencia_sp._R33	2828763	S	20	4	24	0.00000
Providencia_vermicola	333965	S	19	90	109	0.00001
Providencia_sneebia	516075	S	11	1	12	0.00000
Xenorhabdus_bovienii	40576	S	118	28	146	0.00001
Xenorhabdus_doucetiae	351671	S	86	13	99	0.00000
Xenorhabdus_nematophila	628	S	71	12	83	0.00000
Xenorhabdus_budapestensis	290110	S	46	6	52	0.00000
Xenorhabdus_poinarii	40577	S	40	8	48	0.00000
Xenorhabdus_hominickii	351679	S	39	6	45	0.00000
Proteus_mirabilis	584	S	187	263	450	0.00002
Proteus_vulgaris	585	S	35	80	115	0.00001
Proteus_hauseri	183417	S	21	4	25	0.00000
Proteus_penneri	102862	S	14	14	28	0.00000
Photorhabdus_thracensis	230089	S	101	17	118	0.00001
Photorhabdus_asymbiotica	291112	S	53	6	59	0.00000
Photorhabdus_akhurstii	171438	S	41	7	48	0.00000
Photorhabdus_laumondii	2218628	S	25	5	30	0.00000
Arsenophonus_endosymbiont_of_Apis_mellifera	1541805	S	23	9	32	0.00000
Arsenophonus_endosymbiont_of_Aphis_craccivora	1231049	S	18	5	23	0.00000
Arsenophonus_nasoniae	638	S	20	8	28	0.00000
Moellerella_wisconsensis	158849	S	31	24	55	0.00000
Sodalis_sp._dw_23	2697027	S	612	41	653	0.00003
Sodalis_endosymbiont_of_Henestaris_halophilus	1929246	S	14	0	14	0.00000
Sodalis_praecaptivus	1239307	S	345	236	581	0.00003
Sodalis_glossinidius	63612	S	256	37	293	0.00001
Candidatus_Sodalis_pierantonius	1486991	S	125	91	216	0.00001
Leminorella_richardii	158841	S	230	31	261	0.00001
Pragia_fontium	82985	S	57	8	65	0.00000
Limnobaculum_parvum	2172103	S	51	10	61	0.00000
Jinshanibacter_zhutongyuii	2498113	S	27	4	31	0.00000
Thioalkalivibrio_sulfidiphilus	1033854	S	3186	1969	5155	0.00024
Thioalkalivibrio_paradoxus	108010	S	2925	937	3862	0.00018
Thioalkalivibrio_nitratireducens	186931	S	2742	799	3541	0.00017
Thioalkalivibrio_sp._K90mix	396595	S	2196	302	2498	0.00012
Thioalkalivibrio_versutus	106634	S	2126	306	2432	0.00012
Spiribacter_sp._E85	2182432	S	5760	605	6365	0.00030
Spiribacter_sp._2438	2666185	S	1134	122	1256	0.00006
Spiribacter_curvatus	1335757	S	1461	90	1551	0.00007
Spiribacter_salinus	1335746	S	943	79	1022	0.00005
Acidihalobacter_aeolianus	2792603	S	2345	368	2713	0.00013
Acidihalobacter_ferrooxydans	1765967	S	2100	239	2339	0.00011
Acidihalobacter_yilgarnensis	2819280	S	1409	110	1519	0.00007
Halorhodospira_halophila	1053	S	2685	347	3032	0.00014
Halorhodospira_halochloris	1052	S	441	23	464	0.00002
Aquisalimonas_sp._2447	2740807	S	2810	227	3037	0.00014
Alkalilimnicola_ehrlichii	351052	S	2656	385	3041	0.00014
Ectothiorhodospira_sp._BSL-9	1442136	S	992	336	1328	0.00006
Ectothiorhodospira_haloalkaliphila	421628	S	975	342	1317	0.00006
Ectothiorhodosinus_mongolicus	233100	S	376	29	405	0.00002
Allochromatium_tepidum	553982	S	2114	1135	3249	0.00015
Allochromatium_vinosum	1049	S	2035	888	2923	0.00014
Candidatus_Thiodictyon_syntrophicum	1166950	S	4526	259	4785	0.00023
Thioflavicoccus_mobilis	80679	S	4394	424	4818	0.00023
Marichromatium_purpuratum	37487	S	4141	854	4995	0.00024
Thiocapsa_bogorovii	521689	S	3308	189	3497	0.00017
Thiocystis_violascens	73141	S	2518	228	2746	0.00013
Thermochromatium_tepidum	1050	S	1595	408	2003	0.00010
Nitrosococcus_halophilus	133539	S	330	44	374	0.00002
Nitrosococcus_wardiae	1814290	S	281	35	316	0.00002
Nitrosococcus_oceani	1229	S	200	46	246	0.00001
Nitrosococcus_watsonii	473531	S	194	49	243	0.00001
Caldichromatium_japonicum	2699430	S	1141	134	1275	0.00006
Rheinheimera_sp._F8	1763998	S	158	8	166	0.00001
Rheinheimera_sp._D18	2545632	S	60	51	111	0.00001
Rheinheimera_mangrovi	2498451	S	92	9	101	0.00000
Candidatus_Nitrosacidococcus_tergens	553981	S	66	3	69	0.00000
Candidatus_Nitrosoglobus_terrae	1630141	S	45	3	48	0.00000
Wenzhouxiangella_marina	1579979	S	2909	221	3130	0.00015
Wenzhouxiangella_sp._AB-CW3	2771012	S	1745	94	1839	0.00009
Thiohalobacter_sp._COW1	2795687	S	618	1537	2155	0.00010
Thiohalobacter_thiocyanaticus	585455	S	552	1702	2254	0.00011
Guyparkeria_halophila	47960	S	2908	726	3634	0.00017
Sulfurivermis_fontis	1972068	S	2805	1142	3947	0.00019
Halothiobacillus_sp._LS2	1860122	S	1131	109	1240	0.00006
Halothiobacillus_neapolitanus	927	S	418	48	466	0.00002
Woeseia_oceani	1548547	S	1500	26	1526	0.00007
Sulfuriflexus_mobilis	1811807	S	602	18	620	0.00003
Granulosicoccus_antarcticus	437505	S	460	8	468	0.00002
Halomonas_sp._JS92-SW72	2306583	S	2823	2764	5587	0.00027
Halomonas_sp._THAF5a	2587844	S	2215	834	3049	0.00014
Halomonas_sp._1513	1883416	S	1716	392	2108	0.00010
Halomonas_sp._HG01	1609967	S	1585	632	2217	0.00011
Halomonas_sp._THAF12	2587849	S	1581	921	2502	0.00012
Halomonas_sp._MCCC_1A13316	2733487	S	1530	207	1737	0.00008
Halomonas_sp._YLGW01	2773308	S	1468	251	1719	0.00008
Halomonas_sp._PGE1	2730360	S	929	1138	2067	0.00010
Halomonas_sp._Y2R2	2562282	S	472	27	499	0.00002
Halomonas_sp._A40-4	2785909	S	424	112	536	0.00003
Halomonas_sp._SH5A2	2749040	S	301	52	353	0.00002
Halomonas_sp._R57-5	1610576	S	274	115	389	0.00002
Halomonas_sp._KO116	1504981	S	268	110	378	0.00002
Halomonas_sp._FeN2	2832500	S	212	93	305	0.00001
Halomonas_sp._SS10-MC5	2854257	S	185	1706	1891	0.00009
Halomonas_sp._18071143	2855441	S	182	405	587	0.00003
Halomonas_sp._GFAJ-1	1118153	S	162	31	193	0.00001
Halomonas_sp._SF2003	2136172	S	149	720	869	0.00004
Halomonas_sp._NyZ770	2883106	S	128	547	675	0.00003
Halomonas_sp._TD01	999141	S	92	47	139	0.00001
Halomonas_sp._HL-93	1666906	S	78	425	503	0.00002
Halomonas_sp._hl-4	1761789	S	68	359	427	0.00002
Halomonas_sp._N3-2A	2014541	S	65	83	148	0.00001
Halomonas_sp._GT	1971364	S	61	42	103	0.00000
Halomonas_sp._A3H3	1346287	S	24	662	686	0.00003
Halomonas_beimenensis	475662	S	2462	500	2962	0.00014
Halomonas_aestuarii	1897729	S	1859	404	2263	0.00011
Halomonas_socia	1081866	S	1575	313	1888	0.00009
Halomonas_sulfidivorans	2733488	S	1527	321	1848	0.00009
Halomonas_tianxiuensis	2497861	S	1452	332	1784	0.00008
Halomonas_elongata	2746	S	1317	141	1458	0.00007
Halomonas_chromatireducens	507626	S	1093	90	1183	0.00006
Halomonas_subglaciescola	29571	S	801	92	893	0.00004
Halomonas_meridiana	29570	S	789	659	1448	0.00007
Halomonas_huangheensis	1178482	S	565	33	598	0.00003
Halomonas_piezotolerans	2609667	S	485	274	759	0.00004
Halomonas_profundi	2852117	S	252	38	290	0.00001
Halomonas_sulfidoxydans	2733484	S	208	1888	2096	0.00010
Halomonas_titanicae	664683	S	183	956	1139	0.00005
Halomonas_hydrothermalis	115561	S	130	391	521	0.00002
Halomonas_venusta	44935	S	128	168	296	0.00001
Halomonas_campaniensis	213554	S	31	151	182	0.00001
Halomonas_alkaliphila	272774	S	16	85	101	0.00000
Cobetia_sp._L2A1	2686360	S	498	64	562	0.00003
Cobetia_sp._cqz5-12	2609415	S	322	470	792	0.00004
Cobetia_sp._4B	2758724	S	132	603	735	0.00003
Cobetia_sp._AM6	2661553	S	111	676	787	0.00004
Cobetia_pacifica	1055101	S	138	462	600	0.00003
Cobetia_amphilecti	1055104	S	106	709	815	0.00004
Cobetia_marina	28258	S	16	235	251	0.00001
Halotalea_alkalilenta	376489	S	2294	466	2760	0.00013
Salinicola_tamaricis	1771309	S	2234	265	2499	0.00012
Kushneria_phosphatilytica	657387	S	600	24	624	0.00003
Kushneria_konosiri	698828	S	539	125	664	0.00003
Kushneria_marisflavi	157779	S	466	105	571	0.00003
Chromohalobacter_salexigens	158080	S	1727	195	1922	0.00009
Pistricoccus_aurantiacus	1883414	S	1174	82	1256	0.00006
Zymobacter_palmae	33074	S	343	47	390	0.00002
Candidatus_Portiera_aleyrodidarum	91844	S	56	17	73	0.00000
Alcanivorax_sp._N3-2A	2014542	S	1801	1862	3663	0.00017
Alcanivorax_sp._NBRC_101098	1113728	S	17	232	249	0.00001
Alcanivorax_pacificus	1306787	S	1405	507	1912	0.00009
Alcanivorax_dieselolei	285091	S	825	260	1085	0.00005
Alcanivorax_xenomutans	1094342	S	807	411	1218	0.00006
Alcanivorax_borkumensis	59754	S	12	158	170	0.00001
Ketobacter_alkanivorans	1917421	S	271	24	295	0.00001
Marinobacterium_aestuarii	1821621	S	896	70	966	0.00005
Marinobacterium_sediminicola	518898	S	403	60	463	0.00002
Marinobacterium_georgiense	48076	S	355	115	470	0.00002
Marinobacterium_sp._LSUCC0821	2668067	S	74	5	79	0.00000
Marinomonas_sp._CT5	2066133	S	54	5	59	0.00000
Marinomonas_sp._A3A	2065312	S	44	7	51	0.00000
Marinomonas_sp._FW-1	2071621	S	35	9	44	0.00000
Marinomonas_primoryensis	178399	S	72	9	81	0.00000
Marinomonas_profundi	2726122	S	69	21	90	0.00000
Marinomonas_arctica	383750	S	61	14	75	0.00000
Marinomonas_mediterranea	119864	S	53	5	58	0.00000
Marinomonas_algicola	2773454	S	46	9	55	0.00000
Marinomonas_posidonica	936476	S	43	6	49	0.00000
Marinomonas_foliarum	491950	S	34	12	46	0.00000
Thalassolituus_sp._C2-1	2597518	S	237	17	254	0.00001
Thalassolituus_oleivorans	187493	S	101	20	121	0.00001
Venatorbacter_cucullus	2661630	S	300	73	373	0.00002
Bacterioplanes_sanyensis	1249553	S	225	13	238	0.00001
Neptunomonas_japonica	417574	S	66	4	70	0.00000
Neptunomonas_concharum	1031538	S	60	5	65	0.00000
Neptunomonas_phycophila	1572645	S	52	4	56	0.00000
Nitrincola_iocasae	2614693	S	133	23	156	0.00001
Amphritea_japonica	452627	S	103	8	111	0.00001
Bermanella_marisrubri	207949	S	50	2	52	0.00000
Hahella_sp._KA22	1628392	S	583	107	690	0.00003
Hahella_chejuensis	158327	S	548	88	636	0.00003
Saccharospirillum_mangrovi	2161747	S	673	40	713	0.00003
Reinekea_forsetii	1336806	S	292	15	307	0.00001
Gynuella_sunshinyii	1445505	S	203	6	209	0.00001
Litoricola_lipolytica	418701	S	388	19	407	0.00002
Spartinivicinus_ruber	2683272	S	166	5	171	0.00001
Endozoicomonas_montiporae	1027273	S	125	7	132	0.00001
Oleiphilus_messinensis	141451	S	96	8	104	0.00000
Solimonas_sp._K1W22B-7	2303331	S	14423	1575	15998	0.00076
Flagellatimonas_centrodinii	2806210	S	3639	273	3912	0.00019
Sinimarinibacterium_sp._NLF-5-8	2698684	S	1783	1015	2798	0.00013
Steroidobacter_denitrificans	465721	S	12000	3441	15441	0.00073
Methylococcus_sp._EFPC2	2812648	S	2493	177	2670	0.00013
Methylococcus_sp._Mc7	2860258	S	2155	755	2910	0.00014
Methylococcus_capsulatus	414	S	2112	531	2643	0.00013
Methylococcus_geothermalis	2681310	S	1978	594	2572	0.00012
Methylomonas_sp._LL1	2785785	S	634	29	663	0.00003
Methylomonas_sp._LW13	107637	S	256	143	399	0.00002
Methylomonas_sp._EFPC1	2812647	S	243	145	388	0.00002
Methylomonas_sp._DH-1	1727196	S	234	466	700	0.00003
Methylomonas_koyamae	702114	S	646	692	1338	0.00006
Methylomonas_denitrificans	1538553	S	579	40	619	0.00003
Methylomonas_rhizoryzae	2608981	S	576	23	599	0.00003
Methylomonas_methanica	421	S	528	26	554	0.00003
Methylomonas_paludis	1173101	S	158	7	165	0.00001
Methylomagnum_ishizawai	1760988	S	2807	124	2931	0.00014
Methylomicrobium_album	39775	S	2239	91	2330	0.00011
Methylomicrobium_sp._wino1	2049332	S	444	366	810	0.00004
Methylocaldum_marinum	1432792	S	2542	152	2694	0.00013
Methylogaea_oryzae	1295382	S	2535	198	2733	0.00013
Candidatus_Methylospira_mobilis	1808979	S	835	35	870	0.00004
Methylotuvimicrobium_alcaliphilum	271065	S	211	270	481	0.00002
Methylotuvimicrobium_buryatense	95641	S	207	226	433	0.00002
Methylovulum_psychrotolerans	1704499	S	310	7	317	0.00002
Methylobacter_sp._S3L5C	2839024	S	127	7	134	0.00001
Aeromonas_sp._FDAARGOS_1415	2778064	S	434	253	687	0.00003
Aeromonas_sp._CA23	2033032	S	380	173	553	0.00003
Aeromonas_sp._FDAARGOS_1409	2778058	S	209	329	538	0.00003
Aeromonas_sp._CU5	2033033	S	183	81	264	0.00001
Aeromonas_sp._FDAARGOS_1405	2778054	S	58	104	162	0.00001
Aeromonas_sp._FDAARGOS_1407	2778056	S	57	186	243	0.00001
Aeromonas_sp._1805	2560028	S	53	163	216	0.00001
Aeromonas_sp._FDAARGOS_1403	2778052	S	50	168	218	0.00001
Aeromonas_sp._FDAARGOS_1410	2778059	S	44	113	157	0.00001
Aeromonas_sp._ASNIH4	1636609	S	43	219	262	0.00001
Aeromonas_sp._FDAARGOS_1417	2778066	S	35	109	144	0.00001
Aeromonas_sp._2692-1	2560029	S	35	187	222	0.00001
Aeromonas_sp._FDAARGOS_1402	2778051	S	34	369	403	0.00002
Aeromonas_sp._ASNIH2	1636607	S	29	403	432	0.00002
Aeromonas_sp._FDAARGOS_1419	2778068	S	29	93	122	0.00001
Aeromonas_sp._FDAARGOS_1408	2778057	S	27	168	195	0.00001
Aeromonas_sp._FDAARGOS_1411	2778060	S	25	87	112	0.00001
Aeromonas_sp._ASNIH1	1636606	S	24	486	510	0.00002
Aeromonas_sp._FDAARGOS_1414	2778063	S	23	80	103	0.00000
Aeromonas_sp._FDAARGOS_1416	2778065	S	23	74	97	0.00000
Aeromonas_sp._FDAARGOS_1406	2778055	S	22	228	250	0.00001
Aeromonas_sp._FDAARGOS_1404	2778053	S	21	80	101	0.00000
Aeromonas_sp._ASNIH5	1758179	S	18	319	337	0.00002
Aeromonas_sp._ASNIH3	1636608	S	16	787	803	0.00004
Aeromonas_sp._WP2-W18-CRE-05	2675707	S	10	410	420	0.00002
Aeromonas_hydrophila	644	S	1907	4880	6787	0.00032
Aeromonas_veronii	654	S	1388	3250	4638	0.00022
Aeromonas_media	651	S	1014	1959	2973	0.00014
Aeromonas_schubertii	652	S	935	280	1215	0.00006
Aeromonas_salmonicida	645	S	841	868	1709	0.00008
Aeromonas_simiae	218936	S	840	827	1667	0.00008
Aeromonas_encheleia	73010	S	833	302	1135	0.00005
Aeromonas_caviae	648	S	622	5293	5915	0.00028
Aeromonas_rivuli	648794	S	569	164	733	0.00003
Aeromonas_enteropelogenes	29489	S	547	483	1030	0.00005
Aeromonas_dhakensis	196024	S	430	944	1374	0.00007
Aeromonas_jandaei	650	S	385	429	814	0.00004
Aeromonas_sanarellii	633415	S	124	637	761	0.00004
Aeromonas_rivipollensis	948519	S	87	151	238	0.00001
Aeromonas_allosaccharophila	656	S	82	139	221	0.00001
Zobellella_denitrificans	347534	S	1848	443	2291	0.00011
Oceanimonas_sp._GK1	511062	S	719	158	877	0.00004
Oceanisphaera_profunda	1416627	S	115	13	128	0.00001
Oceanisphaera_avium	1903694	S	72	10	82	0.00000
Dongshaea_marina	2047966	S	161	15	176	0.00001
Tolumonas_auensis	43948	S	145	63	208	0.00001
Succinivibrio_dextrinosolvens	83771	S	46	2	48	0.00000
Sulfurifustis_variabilis	1675686	S	12404	835	13239	0.00063
Sulfuricaulis_limicola	1620215	S	4922	404	5326	0.00025
Acidiferrobacter_sp._SPIII_3	1281578	S	1310	337	1647	0.00008
Acidiferrobacter_thiooxydans	163359	S	1191	309	1500	0.00007
Microbulbifer_sp._YPW16	2904242	S	1094	103	1197	0.00006
Microbulbifer_sp._SH-1	2681547	S	872	138	1010	0.00005
Microbulbifer_sp._YPW1	2745199	S	605	112	717	0.00003
Microbulbifer_sp._ALW1	1516059	S	562	98	660	0.00003
Microbulbifer_sp._GL-2	2591606	S	197	35	232	0.00001
Microbulbifer_sp._THAF38	2587856	S	176	63	239	0.00001
Microbulbifer_sp._A4B17	359370	S	162	39	201	0.00001
Microbulbifer_aggregans	1769779	S	679	84	763	0.00004
Microbulbifer_celer	435905	S	595	76	671	0.00003
Microbulbifer_hydrolyticus	48074	S	568	109	677	0.00003
Microbulbifer_thermotolerans	252514	S	518	32	550	0.00003
Microbulbifer_elongatus	86173	S	482	82	564	0.00003
Microbulbifer_agarilyticus	260552	S	361	42	403	0.00002
Microbulbifer_variabilis	266805	S	118	45	163	0.00001
Kineobactrum_salinum	2708301	S	1516	59	1575	0.00007
Halioglobus_japonicus	930805	S	583	29	612	0.00003
Halioglobus_maricola	2601894	S	397	16	413	0.00002
Congregibacter_litoralis	393662	S	582	234	816	0.00004
Aequoribacter_fuscus	2518989	S	151	19	170	0.00001
Cellvibrio_sp._PSBB006	1987723	S	380	11	391	0.00002
Cellvibrio_sp._KY-GH-1	2303332	S	246	12	258	0.00001
Cellvibrio_sp._KY-YJ-3	454662	S	224	20	244	0.00001
Cellvibrio_sp._PSBB023	1945512	S	212	15	227	0.00001
Cellvibrio_japonicus	155077	S	312	19	331	0.00002
Simiduia_agarivorans	447471	S	568	29	597	0.00003
Teredinibacter_turnerae	2426	S	273	10	283	0.00001
Teredinibacter_haidensis	2731755	S	131	7	138	0.00001
Teredinibacter_purpureus	2731756	S	101	3	104	0.00000
Saccharophagus_degradans	86304	S	106	3	109	0.00001
Marinagarivorans_sp._GE09	2721545	S	104	8	112	0.00001
Agarilytica_rhodophyticola	1737490	S	66	1	67	0.00000
Spongiibacter_taiwanensis	1748242	S	418	19	437	0.00002
Spongiibacter_nanhainus	2794344	S	385	44	429	0.00002
Spongiibacter_sp._IMCC21906	1620392	S	121	32	153	0.00001
Zhongshania_aliphaticivorans	1470434	S	222	16	238	0.00001
Oceanicoccus_sagamiensis	716816	S	125	2	127	0.00001
Shewanella_sp._FJAT-53555	2864204	S	102	84	186	0.00001
Shewanella_sp._FJAT-51860	2864212	S	101	15	116	0.00001
Shewanella_sp._FJAT-53764	2864207	S	81	119	200	0.00001
Shewanella_sp._FJAT-54031	2864209	S	75	106	181	0.00001
Shewanella_sp._FJAT-52076	2864202	S	72	93	165	0.00001
Shewanella_sp._FJAT-53532	2864203	S	63	101	164	0.00001
Shewanella_sp._SNU_WT4	2590015	S	61	15	76	0.00000
Shewanella_sp._FJAT-53681	2864205	S	59	90	149	0.00001
Shewanella_sp._FJAT-52072	2864213	S	58	70	128	0.00001
Shewanella_sp._KX20019	2803864	S	47	5	52	0.00000
Shewanella_sp._WE21	2029986	S	40	20	60	0.00000
Shewanella_sp._FJAT-53749	2864206	S	37	6	43	0.00000
Shewanella_sp._Scap07	2589987	S	35	4	39	0.00000
Shewanella_sp._ANA-3	94122	S	32	82	114	0.00001
Shewanella_sp._FJAT-53870	2864208	S	31	5	36	0.00000
Shewanella_sp._FJAT-51754	2864211	S	29	40	69	0.00000
Shewanella_sp._MR-4	60480	S	26	27	53	0.00000
Shewanella_sp._Pdp11	2059264	S	24	68	92	0.00000
Shewanella_sp._OM3-2	2908650	S	14	2	16	0.00000
Shewanella_sp._Arc9-LZ	2698686	S	14	5	19	0.00000
Shewanella_sp._FJAT-51649	2864210	S	11	15	26	0.00000
Shewanella_algae	38313	S	304	261	565	0.00003
Shewanella_khirikhana	1965282	S	288	44	332	0.00002
Shewanella_cyperi	2814292	S	270	147	417	0.00002
Shewanella_litorisediminis	1173586	S	182	44	226	0.00001
Shewanella_baltica	62322	S	169	196	365	0.00002
Shewanella_marisflavi	260364	S	144	27	171	0.00001
Shewanella_putrefaciens	24	S	142	467	609	0.00003
Shewanella_sedimentimangrovi	2814293	S	131	99	230	0.00001
Shewanella_amazonensis	60478	S	130	32	162	0.00001
Shewanella_dokdonensis	712036	S	118	11	129	0.00001
Shewanella_yunxiaonensis	2829809	S	107	16	123	0.00001
Shewanella_avicenniae	2814294	S	101	16	117	0.00001
Shewanella_loihica	359303	S	100	171	271	0.00001
Shewanella_sediminis	271097	S	97	12	109	0.00001
Shewanella_benthica	43661	S	75	16	91	0.00000
Shewanella_pealeana	70864	S	70	11	81	0.00000
Shewanella_psychropiezotolerans	2593655	S	68	12	80	0.00000
Shewanella_indica	768528	S	65	91	156	0.00001
Shewanella_halifaxensis	271098	S	64	8	72	0.00000
Shewanella_denitrificans	192073	S	61	9	70	0.00000
Shewanella_psychrophila	225848	S	58	7	65	0.00000
Shewanella_oneidensis	70863	S	56	16	72	0.00000
Shewanella_psychromarinicola	2487742	S	50	7	57	0.00000
Shewanella_inventionis	1738770	S	48	22	70	0.00000
Shewanella_maritima	2520507	S	47	4	51	0.00000
Shewanella_woodyi	60961	S	44	4	48	0.00000
Shewanella_carassii	1987584	S	40	44	84	0.00000
Shewanella_livingstonensis	150120	S	40	8	48	0.00000
Shewanella_violacea	60217	S	39	7	46	0.00000
Shewanella_chilikensis	558541	S	38	112	150	0.00001
Shewanella_piezotolerans	404011	S	36	3	39	0.00000
Shewanella_xiamenensis	332186	S	33	170	203	0.00001
Shewanella_decolorationis	256839	S	33	37	70	0.00000
Shewanella_glacialimarina	2590884	S	24	3	27	0.00000
Shewanella_aestuarii	1028752	S	23	8	31	0.00000
Shewanella_vesiculosa	518738	S	23	5	28	0.00000
Shewanella_donghaensis	238836	S	23	2	25	0.00000
Shewanella_bicestrii	2018305	S	18	72	90	0.00000
Shewanella_frigidimarina	56812	S	12	6	18	0.00000
Parashewanella_tropica	2547970	S	29	2	31	0.00000
Parashewanella_spongiae	342950	S	25	1	26	0.00000
Alteromonas_sp._RKMC-009	2267264	S	164	19	183	0.00001
Alteromonas_sp._BL110	1714845	S	22	4	26	0.00000
Alteromonas_sp._76-1	2358187	S	18	6	24	0.00000
Alteromonas_sp._RW2A1	1917158	S	14	93	107	0.00001
Alteromonas_macleodii	28108	S	165	59	224	0.00001
Alteromonas_mediterranea	314275	S	92	59	151	0.00001
Alteromonas_pelagimontana	1858656	S	84	10	94	0.00000
Alteromonas_australica	589873	S	41	68	109	0.00001
Alteromonas_naphthalenivorans	715451	S	17	8	25	0.00000
Alteromonas_stellipolaris	233316	S	13	35	48	0.00000
Salinimonas_marina	2785918	S	107	11	118	0.00001
Salinimonas_lutimaris	914153	S	96	17	113	0.00001
Salinimonas_iocasae	2572577	S	95	19	114	0.00001
Salinimonas_sediminis	2303538	S	69	16	85	0.00000
Hydrocarboniclastica_marina	2259620	S	667	92	759	0.00004
Saliniradius_amylolyticus	2183582	S	223	20	243	0.00001
Agarivorans_sp._TSD2052	2937286	S	50	6	56	0.00000
Agarivorans_sp._B2Z047	2652721	S	14	14	28	0.00000
Agarivorans_gilvus	680279	S	61	6	67	0.00000
Agarivorans_aestuarii	1563703	S	24	11	35	0.00000
Agarivorans_albus	182262	S	17	19	36	0.00000
Lacimicrobium_alkaliphilum	1526571	S	178	12	190	0.00001
Paraglaciecola_sp._L1A13	2686359	S	48	3	51	0.00000
Paraglaciecola_sp._L3A3	2686358	S	39	2	41	0.00000
Paraglaciecola_psychrophila	326544	S	46	3	49	0.00000
Paraglaciecola_mesophila	197222	S	44	3	47	0.00000
Paraneptunicella_aestuarii	2831148	S	92	5	97	0.00000
Glaciecola_nitratireducens	300231	S	90	6	96	0.00000
Saccharobesus_litoralis	2172099	S	57	3	60	0.00000
Catenovulum_sediminis	1740262	S	40	2	42	0.00000
Pseudoalteromonas_sp._R3	1709477	S	74	10	84	0.00000
Pseudoalteromonas_sp._A25	116092	S	41	5	46	0.00000
Pseudoalteromonas_sp._GCY	2003316	S	15	12	27	0.00000
Pseudoalteromonas_sp._THAF3	2587843	S	15	12	27	0.00000
Pseudoalteromonas_sp._DL-6	1390185	S	14	11	25	0.00000
Pseudoalteromonas_sp._A22	327511	S	10	16	26	0.00000
Pseudoalteromonas_sp._LC2018020214	2799564	S	10	26	36	0.00000
Pseudoalteromonas_sp._1_2015MBL_MicDiv	1720343	S	10	27	37	0.00000
Pseudoalteromonas_rubra	43658	S	234	25	259	0.00001
Pseudoalteromonas_viridis	339617	S	142	38	180	0.00001
Pseudoalteromonas_luteoviolacea	43657	S	94	12	106	0.00001
Pseudoalteromonas_shioyasakiensis	1190813	S	56	21	77	0.00000
Pseudoalteromonas_piscicida	43662	S	55	41	96	0.00000
Pseudoalteromonas_spongiae	298657	S	49	10	59	0.00000
Pseudoalteromonas_prydzensis	182141	S	46	6	52	0.00000
Pseudoalteromonas_xiamenensis	882626	S	41	4	45	0.00000
Pseudoalteromonas_translucida	166935	S	34	91	125	0.00001
Pseudoalteromonas_agarivorans	176102	S	34	63	97	0.00000
Pseudoalteromonas_tunicata	314281	S	33	4	37	0.00000
Pseudoalteromonas_aliena	247523	S	27	7	34	0.00000
Pseudoalteromonas_ulvae	107327	S	26	1	27	0.00000
Pseudoalteromonas_phenolica	161398	S	26	3	29	0.00000
Pseudoalteromonas_arctica	394751	S	24	13	37	0.00000
Pseudoalteromonas_mariniglutinosa	206042	S	22	32	54	0.00000
Pseudoalteromonas_ruthenica	151081	S	17	14	31	0.00000
Pseudoalteromonas_piratica	1348114	S	15	1	16	0.00000
Pseudoalteromonas_espejiana	28107	S	14	2	16	0.00000
Pseudoalteromonas_donghaensis	621376	S	12	78	90	0.00000
Pseudoalteromonas_carrageenovora	227	S	12	3	15	0.00000
Pseudoalteromonas_tetraodonis	43659	S	11	59	70	0.00000
Psychrosphaera_ytuae	2820710	S	40	7	47	0.00000
Psychrosphaera_aestuarii	1266052	S	20	3	23	0.00000
Flocculibacter_collagenilyticus	2744479	S	31	2	33	0.00000
Ferrimonas_balearica	44012	S	737	92	829	0.00004
Ferrimonas_lipolytica	2724191	S	113	16	129	0.00001
Thalassotalea_sp._PS06	2594005	S	73	10	83	0.00000
Thalassotalea_sp._HSM_43	2552945	S	33	5	38	0.00000
Thalassotalea_sp._LPB0316	2769490	S	28	8	36	0.00000
Thalassotalea_crassostreae	1763536	S	29	3	32	0.00000
Colwellia_sp._MT41	58049	S	32	3	35	0.00000
Colwellia_sp._PAMC_20917	1816218	S	30	2	32	0.00000
Colwellia_sp._Arc7-D	2161872	S	24	4	28	0.00000
Colwellia_sp._Arc7-635	2497879	S	24	3	27	0.00000
Colwellia_sp._20A7	2689569	S	20	2	22	0.00000
Colwellia_psychrerythraea	28229	S	28	2	30	0.00000
Litorilituus_sediminis	718192	S	23	2	25	0.00000
Cognaticolwellia_beringensis	1967665	S	21	3	24	0.00000
Idiomarina_sp._OT37-5b	2100422	S	161	35	196	0.00001
Idiomarina_sp._X4	2055892	S	31	11	42	0.00000
Idiomarina_loihiensis	135577	S	54	0	54	0.00000
Idiomarina_abyssalis	86102	S	51	6	57	0.00000
Idiomarina_piscisalsi	1096243	S	47	17	64	0.00000
Moritella_sp._24	2746230	S	17	37	54	0.00000
Moritella_yayanosii	69539	S	22	9	31	0.00000
Moritella_marina	90736	S	20	7	27	0.00000
Psychromonas_ingrahamii	357794	S	74	9	83	0.00000
Psychromonas_sp._CNPT3	314282	S	21	4	25	0.00000
Vibrio_parahaemolyticus	670	S	241	1133	1374	0.00007
Vibrio_campbellii	680	S	65	36	101	0.00000
Vibrio_diabolicus	50719	S	39	40	79	0.00000
Vibrio_owensii	696485	S	61	22	83	0.00000
Vibrio_harveyi	669	S	58	12	70	0.00000
Vibrio_alginolyticus	663	S	52	47	99	0.00000
Vibrio_rotiferianus	190895	S	51	15	66	0.00000
Vibrio_natriegens	691	S	36	25	61	0.00000
Vibrio_azureus	512649	S	29	3	32	0.00000
Vibrio_jasicida	766224	S	11	6	17	0.00000
Vibrio_sp._OG9-811	2841925	S	191	29	220	0.00001
Vibrio_sp._B1FLJ16	2751178	S	68	14	82	0.00000
Vibrio_sp._THAF190c	2587865	S	63	8	71	0.00000
Vibrio_sp._HDW18	2714948	S	56	9	65	0.00000
Vibrio_sp._SS-MA-C1-2	2908646	S	41	7	48	0.00000
Vibrio_sp._Scap24	2589990	S	26	17	43	0.00000
Vibrio_sp._VB16	2785746	S	24	2	26	0.00000
Vibrio_sp._ED004	2785124	S	24	15	39	0.00000
Vibrio_sp._SCSIO_43132	2779363	S	22	5	27	0.00000
Vibrio_vulnificus	672	S	343	71	414	0.00002
Vibrio_furnissii	29494	S	336	102	438	0.00002
Vibrio_fluvialis	676	S	323	50	373	0.00002
Vibrio_sinaloensis	379097	S	97	13	110	0.00001
Vibrio_tubiashii	29498	S	43	22	65	0.00000
Vibrio_europaeus	300876	S	30	12	42	0.00000
Vibrio_navarrensis	29495	S	164	35	199	0.00001
Vibrio_cholerae	666	S	152	4132	4284	0.00020
Vibrio_anguillarum	55601	S	137	18	155	0.00001
Vibrio_coralliilyticus	190893	S	112	24	136	0.00001
Vibrio_mimicus	674	S	106	20	126	0.00001
Vibrio_cyclitrophicus	47951	S	86	16	102	0.00000
Vibrio_maritimus	990268	S	76	8	84	0.00000
Vibrio_spartinae	1918945	S	75	7	82	0.00000
Vibrio_tapetis	52443	S	73	5	78	0.00000
Vibrio_metoecus	1481663	S	62	15	77	0.00000
Vibrio_nigripulchritudo	28173	S	59	7	66	0.00000
Vibrio_mediterranei	689	S	59	5	64	0.00000
Vibrio_scophthalmi	45658	S	59	10	69	0.00000
Vibrio_zhugei	2479546	S	57	13	70	0.00000
Vibrio_alfacsensis	1074311	S	57	23	80	0.00000
Vibrio_metschnikovii	28172	S	56	10	66	0.00000
Vibrio_neptunius	170651	S	54	7	61	0.00000
Vibrio_breoganii	553239	S	50	5	55	0.00000
Vibrio_astriarenae	1481923	S	49	6	55	0.00000
Vibrio_gazogenes	687	S	46	4	50	0.00000
Vibrio_ziniensis	2711221	S	45	5	50	0.00000
Vibrio_chagasii	170679	S	44	6	50	0.00000
Vibrio_penaeicida	104609	S	43	4	47	0.00000
Vibrio_taketomensis	2572923	S	41	5	46	0.00000
Vibrio_cidicii	1763883	S	41	11	52	0.00000
Vibrio_panuliri	1381081	S	41	5	46	0.00000
Vibrio_ponticus	265668	S	40	3	43	0.00000
Vibrio_rumoiensis	76258	S	39	23	62	0.00000
Vibrio_gigantis	296199	S	38	7	45	0.00000
Vibrio_atlanticus	693153	S	36	5	41	0.00000
Vibrio_cincinnatiensis	675	S	35	6	41	0.00000
Vibrio_aquimaris	2587862	S	34	3	37	0.00000
Vibrio_aphrogenes	1891186	S	34	4	38	0.00000
Vibrio_algicola	2662262	S	33	5	38	0.00000
Vibrio_tritonius	1435069	S	32	3	35	0.00000
Vibrio_crassostreae	246167	S	31	9	40	0.00000
Vibrio_splendidus	29497	S	31	6	37	0.00000
Vibrio_bathopelagicus	2777577	S	25	4	29	0.00000
Vibrio_casei	673372	S	24	6	30	0.00000
Vibrio_kanaloae	170673	S	20	4	24	0.00000
Vibrio_qinghaiensis	2025808	S	19	6	25	0.00000
Vibrio_hyugaensis	1534743	S	10	2	12	0.00000
Photobacterium_damselae	38293	S	1702	593	2295	0.00011
Photobacterium_sp._GJ3	2829502	S	189	25	214	0.00001
Photobacterium_sp._TLY01	2907534	S	175	30	205	0.00001
Photobacterium_gaetbulicola	1295392	S	228	20	248	0.00001
Photobacterium_ganghwense	320778	S	160	32	192	0.00001
Photobacterium_profundum	74109	S	39	4	43	0.00000
Salinivibrio_kushneri	1908198	S	123	18	141	0.00001
Salinivibrio_sp._YCSC6	2003370	S	24	41	65	0.00000
Salinivibrio_costicola	51367	S	21	36	57	0.00000
Grimontia_hollisae	673	S	170	21	191	0.00001
Thaumasiovibrio_subtropicus	1891207	S	68	8	76	0.00000
Aliivibrio_fischeri	668	S	41	7	48	0.00000
Aliivibrio_salmonicida	40269	S	17	14	31	0.00000
Paraphotobacterium_marinum	1755811	S	21	3	24	0.00000
Candidatus_Enterovibrio_luxaltus	1927128	S	20	0	20	0.00000
Acinetobacter_baumannii	470	S	1231	4536	5767	0.00027
Acinetobacter_pittii	48296	S	46	46	92	0.00000
Acinetobacter_seifertii	1530123	S	40	14	54	0.00000
Acinetobacter_calcoaceticus	471	S	31	3	34	0.00000
Acinetobacter_nosocomialis	106654	S	17	6	23	0.00000
Acinetobacter_sp._WCHAc010034	1879049	S	287	135	422	0.00002
Acinetobacter_sp._10FS3-1	2563897	S	35	25	60	0.00000
Acinetobacter_sp._TGL-Y2	1407071	S	29	3	32	0.00000
Acinetobacter_sp._CS-2	2798861	S	21	13	34	0.00000
Acinetobacter_sp._LoGeW2-3	1808001	S	19	6	25	0.00000
Acinetobacter_sp._Marseille-Q1620	2714110	S	17	1	18	0.00000
Acinetobacter_sp._TTH0-4	1646498	S	15	3	18	0.00000
Acinetobacter_sp._WCHA55	2004646	S	14	16	30	0.00000
Acinetobacter_sp._WCHAc010052	2004647	S	13	7	20	0.00000
Acinetobacter_sp._ASP199	2773709	S	12	6	18	0.00000
Acinetobacter_sp._F9	2853158	S	10	3	13	0.00000
Acinetobacter_sp._Tol_5	710648	S	10	11	21	0.00000
Acinetobacter_indicus	756892	S	146	119	265	0.00001
Acinetobacter_johnsonii	40214	S	121	75	196	0.00001
Acinetobacter_soli	487316	S	86	7	93	0.00000
Acinetobacter_lwoffii	28090	S	65	63	128	0.00001
Acinetobacter_haemolyticus	29430	S	60	30	90	0.00000
Acinetobacter_bouvetii	202951	S	54	7	61	0.00000
Acinetobacter_radioresistens	40216	S	51	7	58	0.00000
Acinetobacter_schindleri	108981	S	50	43	93	0.00000
Acinetobacter_junii	40215	S	46	17	63	0.00000
Acinetobacter_gyllenbergii	134534	S	43	3	46	0.00000
Acinetobacter_variabilis	70346	S	42	50	92	0.00000
Acinetobacter_larvae	1789224	S	35	2	37	0.00000
Acinetobacter_tandoii	202954	S	27	2	29	0.00000
Acinetobacter_cumulans	2136182	S	27	11	38	0.00000
Acinetobacter_chinensis	2004650	S	27	16	43	0.00000
Acinetobacter_lanii	2715163	S	25	2	27	0.00000
Acinetobacter_wanghuae	2662362	S	19	2	21	0.00000
Acinetobacter_baylyi	202950	S	19	1	20	0.00000
Acinetobacter_guillouiae	106649	S	19	4	23	0.00000
Acinetobacter_dispersus	70348	S	18	1	19	0.00000
Acinetobacter_defluvii	1871111	S	18	13	31	0.00000
Acinetobacter_shaoyimingii	2715164	S	17	1	18	0.00000
Acinetobacter_wuhouensis	1879050	S	15	7	22	0.00000
Acinetobacter_towneri	202956	S	15	30	45	0.00000
Acinetobacter_piscicola	2006115	S	13	7	20	0.00000
Acinetobacter_equi	1324350	S	12	1	13	0.00000
Acinetobacter_bereziniae	106648	S	12	6	18	0.00000
Acinetobacter_ursingii	108980	S	11	7	18	0.00000
Acinetobacter_venetianus	52133	S	11	2	13	0.00000
Psychrobacter_sp._P11F6	1699621	S	42	22	64	0.00000
Psychrobacter_sp._DAB_AL43B	1028416	S	25	4	29	0.00000
Psychrobacter_sp._28M-43	2772254	S	23	8	31	0.00000
Psychrobacter_sp._P11G5	1699624	S	22	24	46	0.00000
Psychrobacter_sp._P2G3	1699622	S	20	19	39	0.00000
Psychrobacter_sp._P11G3	1699623	S	18	6	24	0.00000
Psychrobacter_sp._WY6	2708350	S	15	7	22	0.00000
Psychrobacter_sp._G	571800	S	14	83	97	0.00000
Psychrobacter_sp._AntiMn-1	1720344	S	13	40	53	0.00000
Psychrobacter_sp._KH172YL61	2517899	S	13	30	43	0.00000
Psychrobacter_sp._KCTC_72983	2733866	S	11	14	25	0.00000
Psychrobacter_sp._PraFG1	2565531	S	10	11	21	0.00000
Psychrobacter_arenosus	256326	S	36	2	38	0.00000
Psychrobacter_urativorans	45610	S	30	5	35	0.00000
Psychrobacter_arcticus	334543	S	20	8	28	0.00000
Psychrobacter_sanguinis	861445	S	15	7	22	0.00000
Moraxella_osloensis	34062	S	152	23	175	0.00001
Moraxella_bovis	476	S	48	13	61	0.00000
Moraxella_cuniculi	34061	S	39	4	43	0.00000
Moraxella_bovoculi	386891	S	36	60	96	0.00000
Moraxella_catarrhalis	480	S	35	7	42	0.00000
Moraxella_sp._ZY201115	2904121	S	19	2	21	0.00000
Moraxella_nonliquefaciens	478	S	13	3	16	0.00000
Aquirhabdus_parva	2283318	S	166	7	173	0.00001
Immundisolibacter_cernigliae	1810504	S	4813	911	5724	0.00027
Candidatus_Endoriftia_persephone	393765	S	1330	62	1392	0.00007
Candidatus_Vesicomyosocius_sp._SY067_SCS001	2732590	S	38	17	55	0.00000
Bathymodiolus_thermophilus_thioautotrophic_gill_symbiont	2360	S	28	1	29	0.00000
Bathymodiolus_septemdierum_thioautotrophic_gill_symbiont	113267	S	21	2	23	0.00000
Candidatus_Ruthia_magnifica	386487	S	10	2	12	0.00000
Candidatus_Ruthia_endofausta	2738852	S	10	4	14	0.00000
Sedimenticola_thiotaurini	1543721	S	847	34	881	0.00004
Candidatus_Reidiella_endopervernicosa	2738883	S	670	14	684	0.00003
Thiolapillus_brandeum	1076588	S	557	13	570	0.00003
Pseudohongiella_spirulinae	1249552	S	277	7	284	0.00001
Gallaecimonas_mangrovi	2291597	S	203	16	219	0.00001
Celerinatantimonas_diazotrophica	412034	S	76	5	81	0.00000
Ignatzschineria_sp._HR5S32	2923279	S	39	3	42	0.00000
Candidatus_Thioglobus_autotrophicus	1705394	S	18	1	19	0.00000
Candidatus_Steffania_adelgidicola	1076626	S	21	0	21	0.00000
Candidatus_Pseudothioglobus_singularis	1427364	S	17	4	21	0.00000
Pasteurella_multocida	747	S	1898	4388	6286	0.00030
Pasteurella_canis	753	S	17	3	20	0.00000
Pasteurella_skyensis	97481	S	10	0	10	0.00000
Aggregatibacter_actinomycetemcomitans	714	S	133	28	161	0.00001
Aggregatibacter_aphrophilus	732	S	69	41	110	0.00001
Aggregatibacter_segnis	739	S	15	28	43	0.00000
Haemophilus_parainfluenzae	729	S	77	27	104	0.00000
Haemophilus_influenzae	727	S	59	50	109	0.00001
Haemophilus_haemolyticus	726	S	31	15	46	0.00000
Haemophilus_parahaemolyticus	735	S	25	4	29	0.00000
[Haemophilus]_ducreyi	730	S	23	11	34	0.00000
Haemophilus_pittmaniae	249188	S	23	4	27	0.00000
Mannheimia_granulomatis	85402	S	63	9	72	0.00000
Mannheimia_varigena	85404	S	50	19	69	0.00000
Mannheimia_haemolytica	75985	S	39	60	99	0.00000
Mannheimia_bovis	2770636	S	15	5	20	0.00000
Mannheimia_ovis	2679994	S	14	21	35	0.00000
Mannheimia_sp._USDA-ARS-USMARC-1261	1432056	S	12	6	18	0.00000
Actinobacillus_sp._GY-402	2774188	S	79	37	116	0.00001
Actinobacillus_pleuropneumoniae	715	S	34	64	98	0.00000
Actinobacillus_delphinicola	51161	S	18	2	20	0.00000
Actinobacillus_indolicus	51049	S	17	12	29	0.00000
Actinobacillus_lignieresii	720	S	16	7	23	0.00000
Actinobacillus_porcitonsillarum	189834	S	13	4	17	0.00000
Actinobacillus_equuli	718	S	11	2	13	0.00000
Avibacterium_paragallinarum	728	S	28	7	35	0.00000
Avibacterium_sp._21-595	2911527	S	11	12	23	0.00000
Avibacterium_volantium	762	S	19	5	24	0.00000
Glaesserella_parasuis	738	S	50	25	75	0.00000
Glaesserella_sp._15-184	2030797	S	19	5	24	0.00000
Rodentibacter_haemolyticus	2778911	S	29	3	32	0.00000
Rodentibacter_heylii	1906744	S	24	2	26	0.00000
Basfia_succiniciproducens	653940	S	10	36	46	0.00000
Histophilus_somni	731	S	36	10	46	0.00000
Gallibacterium_anatis	750	S	32	9	41	0.00000
Bibersteinia_trehalosi	47735	S	21	47	68	0.00000
Frederiksenia_canicola	123824	S	21	5	26	0.00000
Bisgaardia_hudsonensis	109472	S	12	1	13	0.00000
Legionella_pneumophila	446	S	786	166	952	0.00005
Legionella_geestiana	45065	S	246	16	262	0.00001
Legionella_sp._MW5194	2662448	S	157	19	176	0.00001
Legionella_sp._PC997	2755562	S	34	5	39	0.00000
Legionella_sp._PC1000	2746060	S	26	3	29	0.00000
Legionella_spiritensis	452	S	156	13	169	0.00001
Legionella_sainthelensi	28087	S	77	9	86	0.00000
Legionella_lansingensis	45067	S	62	3	65	0.00000
Legionella_oakridgensis	29423	S	62	4	66	0.00000
Legionella_jordanis	456	S	61	5	66	0.00000
Legionella_fallonii	96230	S	55	3	58	0.00000
Legionella_israelensis	454	S	54	2	56	0.00000
Legionella_antarctica	2708020	S	45	1	46	0.00000
Legionella_hackeliae	449	S	45	5	50	0.00000
Legionella_longbeachae	450	S	41	11	52	0.00000
Legionella_waltersii	66969	S	36	3	39	0.00000
Legionella_anisa	28082	S	32	5	37	0.00000
Legionella_cherrii	28084	S	29	1	30	0.00000
Legionella_clemsonensis	1867846	S	28	2	30	0.00000
Legionella_adelaidensis	45056	S	23	1	24	0.00000
Tatlockia_micdadei	451	S	72	4	76	0.00000
Fluoribacter_dumoffii	463	S	42	6	48	0.00000
Aquicella_siphonis	254247	S	278	78	356	0.00002
Aquicella_lusitana	254246	S	212	64	276	0.00001
Coxiella_burnetii	777	S	211	97	308	0.00001
Coxiella_endosymbiont_of_Amblyomma_nuttalli	2749996	S	52	6	58	0.00000
Coxiella_endosymbiont_of_Amblyomma_sculptum	2487929	S	42	18	60	0.00000
Candidatus_Coxiella_mudrowiae	2054173	S	56	5	61	0.00000
Candidatus_Rickettsiella_viridis	676208	S	33	19	52	0.00000
Rickettsiella_endosymbiont_of_Dermanyssus_gallinae	2856608	S	27	13	40	0.00000
Thiomicrorhabdus_xiamenensis	2739063	S	180	10	190	0.00001
Thiomicrorhabdus_sediminis	2580412	S	75	4	79	0.00000
Thiomicrorhabdus_sp._Am19	2791037	S	46	2	48	0.00000
Thiomicrorhabdus_aquaedulcis	2211106	S	45	2	47	0.00000
Thiomicrorhabdus_indica	2267253	S	31	1	32	0.00000
Methylophaga_frappieri	754477	S	132	70	202	0.00001
Methylophaga_nitratireducenticrescens	754476	S	91	19	110	0.00001
Methylophaga_sp._TMB456	2881052	S	72	28	100	0.00000
Thiomicrospira_sp._S5	1803865	S	86	79	165	0.00001
Thiomicrospira_microaerophila	406020	S	58	8	66	0.00000
Thiomicrospira_aerophila	92245	S	55	6	61	0.00000
Thiomicrospira_cyclica	147268	S	37	2	39	0.00000
Hydrogenovibrio_thermophilus	265883	S	124	114	238	0.00001
Hydrogenovibrio_marinus	28885	S	50	2	52	0.00000
Hydrogenovibrio_crunogenus	39765	S	38	2	40	0.00000
Piscirickettsia_salmonis	1238	S	72	5	77	0.00000
Thiosulfatimonas_sediminis	2675054	S	65	4	69	0.00000
Thiosulfativibrio_zosterae	2675053	S	43	2	45	0.00000
Thiothrix_litoralis	2891210	S	374	38	412	0.00002
Thiothrix_sp._CT3	96472	S	219	111	330	0.00002
Thiothrix_subterranea	2735563	S	212	90	302	0.00001
Thiothrix_unzii	111769	S	119	99	218	0.00001
Candidatus_Thiothrix_anitrata	2823902	S	112	106	218	0.00001
Beggiatoa_leptomitoformis	288004	S	98	3	101	0.00000
Francisella_tularensis	263	S	49	72	121	0.00001
Francisella_sp._FSC1006	1547445	S	14	2	16	0.00000
Francisella_sp._LA112445	1395624	S	12	2	14	0.00000
Francisella_frigiditurris	1542390	S	23	2	25	0.00000
Allofrancisella_guangzhouensis	594679	S	30	8	38	0.00000
Salinisphaera_sp._LB1	2183911	S	3042	126	3168	0.00015
endosymbiont_of_unidentified_scaly_snail_isolate_Monju	1248727	S	2461	211	2672	0.00013
Abyssogena_phaseoliformis_symbiont	596095	S	17	4	21	0.00000
Isorropodon_fossajaponicum_symbiont	883811	S	13	2	15	0.00000
Cardiobacterium_hominis	2718	S	845	188	1033	0.00005
Cardiobacterium_sp._Marseille-Q4385	2866573	S	544	110	654	0.00003
Suttonella_sp._R2A3	2908648	S	89	4	93	0.00000
Dichelobacter_nodosus	870	S	62	20	82	0.00000
Kangiella_sediminilitoris	1144748	S	86	5	91	0.00000
Kangiella_koreensis	261964	S	83	9	92	0.00000
Kangiella_profundi	1561924	S	59	11	70	0.00000
Kangiella_geojedonensis	914150	S	36	2	38	0.00000
Gilliamella_sp._ESL0441	2704654	S	19	14	33	0.00000
Gilliamella_sp._ESL0405	2704653	S	16	2	18	0.00000
Gilliamella_sp._ESL0443	2704655	S	16	3	19	0.00000
Gilliamella_apicola	1196095	S	13	2	15	0.00000
Zophobihabitans_entericus	1635327	S	22	2	24	0.00000
Frischella_perrara	1267021	S	12	3	15	0.00000
Archangium_violaceum	83451	S	62371	8135	70506	0.00335
Archangium_gephyra	48	S	27295	4156	31451	0.00149
Cystobacter_fuscus	43	S	31446	5345	36791	0.00175
Stigmatella_aurantiaca	41	S	11902	657	12559	0.00060
Melittangium_boletus	83453	S	9992	1568	11560	0.00055
Myxococcus_xanthus	34	S	13063	87403	100466	0.00477
Myxococcus_hansupus	1297742	S	7284	430	7714	0.00037
Myxococcus_stipitatus	83455	S	6355	447	6802	0.00032
Myxococcus_sp._SCHIC003	2813577	S	5290	378	5668	0.00027
Corallococcus_coralloides	184914	S	12296	4510	16806	0.00080
Corallococcus_macrosporus	35	S	8275	987	9262	0.00044
Corallococcus_sp._EGB	1521117	S	7609	2691	10300	0.00049
Pyxidicoccus_sp._SCPEA002	2813578	S	26616	943	27559	0.00131
Anaeromyxobacter_sp._Red232	2918170	S	21761	2303	24064	0.00114
Anaeromyxobacter_sp._Fw109-5	404589	S	17570	2258	19828	0.00094
Anaeromyxobacter_sp._Red630	2918171	S	15531	1984	17515	0.00083
Anaeromyxobacter_sp._K	447217	S	4130	8511	12641	0.00060
Anaeromyxobacter_dehalogenans	161493	S	13160	9888	23048	0.00109
Vulgatibacter_incomptus	1391653	S	9008	645	9653	0.00046
Sorangium_cellulosum	56	S	127616	15077	142693	0.00677
Polyangium_aurulentum	2567896	S	30712	2937	33649	0.00160
Chondromyces_crocatus	52	S	14531	682	15213	0.00072
Pajaroellobacter_abortibovis	1882918	S	228	7	235	0.00001
Sandaracinus_amylolyticus	927083	S	51691	2737	54428	0.00258
Labilithrix_luteola	1391654	S	24101	1097	25198	0.00120
Haliangium_ochraceum	80816	S	23103	1137	24240	0.00115
Geomonas_sp._RF6	2897342	S	4137	507	4644	0.00022
Geomonas_paludis	2740185	S	2772	1373	4145	0.00020
Geomonas_nitrogeniifigens	2847991	S	2615	1330	3945	0.00019
Geomonas_subterranea	2847989	S	2214	1014	3228	0.00015
Geomonas_oryzisoli	2847992	S	2123	1145	3268	0.00016
Geobacter_sp._FeAm09	2597769	S	2576	321	2897	0.00014
Geobacter_sp._SVR	2495594	S	1788	256	2044	0.00010
Geobacter_sp._DSM_9736	1277350	S	971	68	1039	0.00005
Geobacter_sulfurreducens	35554	S	2928	664	3592	0.00017
Geobacter_pickeringii	345632	S	2640	661	3301	0.00016
Geobacter_metallireducens	28232	S	1644	380	2024	0.00010
Geobacter_benzoatilyticus	2815309	S	1075	234	1309	0.00006
Citrifermentans_bremense	60035	S	2341	945	3286	0.00016
Citrifermentans_bemidjiense	225194	S	2076	770	2846	0.00014
Geotalea_uraniireducens	351604	S	1316	96	1412	0.00007
Geotalea_daltonii	1203471	S	791	61	852	0.00004
Geoalkalibacter_subterraneus	483547	S	1187	942	2129	0.00010
Trichlorobacter_lovleyi	313985	S	730	98	828	0.00004
Desulfuromonas_versatilis	2802975	S	4520	789	5309	0.00025
Desulfuromonas_sp._DDH964	1823759	S	3014	531	3545	0.00017
Desulfuromonas_sp._AOP6	1566351	S	910	100	1010	0.00005
Desulfuromonas_soudanensis	1603606	S	2620	293	2913	0.00014
Pelobacter_propionicus	29543	S	1706	594	2300	0.00011
Syntrophotalea_acetylenica	29542	S	944	169	1113	0.00005
Syntrophotalea_carbinolica	19	S	667	49	716	0.00003
Syntrophotalea_acetylenivorans	1842532	S	598	80	678	0.00003
Pseudodesulfovibrio_indicus	1716143	S	2083	460	2543	0.00012
Pseudodesulfovibrio_mercurii	641491	S	1931	473	2404	0.00011
Pseudodesulfovibrio_aespoeensis	182210	S	1411	946	2357	0.00011
Pseudodesulfovibrio_cashew	2678688	S	1142	229	1371	0.00007
Pseudodesulfovibrio_tunisiensis	463192	S	1015	102	1117	0.00005
Pseudodesulfovibrio_sp._SF6	2810563	S	548	53	601	0.00003
Pseudodesulfovibrio_sp._zrk46	2725288	S	452	76	528	0.00003
Pseudodesulfovibrio_profundus	57320	S	334	313	647	0.00003
Pseudodesulfovibrio_piezophilus	879567	S	160	22	182	0.00001
Desulfovibrio_sp._IOR2	2583823	S	1222	233	1455	0.00007
Desulfovibrio_sp._86	2666132	S	431	122	553	0.00003
Desulfovibrio_sp._G11	631220	S	342	255	597	0.00003
Desulfovibrio_vulgaris	881	S	1694	57	1751	0.00008
Desulfovibrio_sulfodismutans	63561	S	1491	379	1870	0.00009
Desulfovibrio_desulfuricans	876	S	1254	279	1533	0.00007
Desulfovibrio_piger	901	S	1081	212	1293	0.00006
Desulfovibrio_fairfieldensis	44742	S	934	82	1016	0.00005
Desulfovibrio_ferrophilus	241368	S	507	40	547	0.00003
Candidatus_Desulfovibrio_trichonymphae	1725232	S	229	19	248	0.00001
Solidesulfovibrio_carbinoliphilus	345370	S	2740	344	3084	0.00015
Solidesulfovibrio_magneticus	184917	S	1090	721	1811	0.00009
Solidesulfovibrio_carbinolicus	296842	S	1082	944	2026	0.00010
Oceanidesulfovibrio_marinus	370038	S	2712	168	2880	0.00014
Desulfocurvibacter_africanus	873	S	1920	141	2061	0.00010
Desulfolutivibrio_sulfoxidireducens	2773299	S	1805	493	2298	0.00011
Megalodesulfovibrio_gigas	879	S	1454	72	1526	0.00007
Oleidesulfovibrio_alaskensis	58180	S	448	568	1016	0.00005
Maridesulfovibrio_salexigens	880	S	158	16	174	0.00001
Maridesulfovibrio_hydrothermalis	191026	S	97	10	107	0.00001
Paradesulfovibrio_bizertensis	376490	S	205	20	225	0.00001
Lawsonia_intracellularis	29546	S	46	0	46	0.00000
Desulfomicrobium_baculatum	899	S	1326	101	1427	0.00007
Desulfomicrobium_orale	132132	S	732	172	904	0.00004
Desulfohalobium_retbaense	45663	S	502	24	526	0.00003
Desulfosarcina_ovata	83564	S	1567	79	1646	0.00008
Desulfosarcina_alkanivorans	571177	S	1547	613	2160	0.00010
Desulfosarcina_widdelii	947919	S	1267	137	1404	0.00007
Desulfococcus_multivorans	897	S	1111	190	1301	0.00006
Desulfatibacillum_aliphaticivorans	218208	S	820	25	845	0.00004
Desulfoluna_sp._ASN36	2810562	S	761	36	797	0.00004
Desulfonema_magnum	45655	S	380	8	388	0.00002
Desulfonema_limicola	45656	S	76	5	81	0.00000
Desulfobacter_hydrogenophilus	2291	S	190	33	223	0.00001
Desulfobacter_postgatei	2293	S	171	28	199	0.00001
Desulforapulum_autotrophicum	2296	S	267	27	294	0.00001
Desulfobacula_toluolica	28223	S	113	8	121	0.00001
Desulfobulbus_propionicus	894	S	1299	74	1373	0.00007
Desulfobulbus_oralis	1986146	S	967	191	1158	0.00005
Desulfobulbus_oligotrophicus	1909699	S	290	224	514	0.00002
Desulfurivibrio_alkaliphilus	427923	S	1042	49	1091	0.00005
Desulfomarina_profundi	2772557	S	101	9	110	0.00001
Desulfosudis_oleivorans	181663	S	997	65	1062	0.00005
Desulfosediminicola_ganghwensis	2569540	S	233	24	257	0.00001
Desulfosediminicola_flagellatus	2569541	S	96	9	105	0.00000
Desulfotalea_psychrophila	84980	S	120	20	140	0.00001
Desulfocapsa_sulfexigens	65555	S	96	5	101	0.00000
Persicimonas_caeni	2292766	S	7074	226	7300	0.00035
Bradymonas_sediminis	1548548	S	2239	164	2403	0.00011
Bradymonadales_bacterium_V1718	2600177	S	851	39	890	0.00004
Syntrophobacter_fumaroxidans	119484	S	1786	658	2444	0.00012
Desulfoglaeba_alkanexedens	361111	S	1542	72	1614	0.00008
Desulfarculus_baarsii	453230	S	3012	1567	4579	0.00022
Syntrophus_aciditrophicus	316277	S	624	37	661	0.00003
Desulfobacca_acetoxidans	60893	S	621	15	636	0.00003
Desulfomonile_tiedjei	2358	S	567	5	572	0.00003
Dissulfurimicrobium_hydrothermale	1750598	S	348	20	368	0.00002
Candidatus_Desulfofervidus_auxilii	1621989	S	163	3	166	0.00001
Hippea_maritima	84405	S	61	2	63	0.00000
Campylobacter_showae	204	S	208	29	237	0.00001
Campylobacter_gracilis	824	S	207	16	223	0.00001
Campylobacter_curvus	200	S	148	16	164	0.00001
Campylobacter_concisus	199	S	134	19	153	0.00001
Campylobacter_sp._19-13652	2840180	S	26	3	29	0.00000
Campylobacter_sp._CCUG_57310	2517362	S	18	7	25	0.00000
Campylobacter_sp._RM6914	1032243	S	16	2	18	0.00000
Campylobacter_sp._RM16192	1660080	S	15	6	21	0.00000
Campylobacter_rectus	203	S	95	17	112	0.00001
Campylobacter_geochelonis	1780362	S	48	4	52	0.00000
Campylobacter_jejuni	197	S	30	210	240	0.00001
Campylobacter_mucosalis	202	S	20	1	21	0.00000
Campylobacter_iguaniorum	1244531	S	18	2	20	0.00000
Campylobacter_fetus	196	S	17	5	22	0.00000
Campylobacter_hominis	76517	S	16	6	22	0.00000
Campylobacter_blaseri	2042961	S	14	2	16	0.00000
Campylobacter_pinnipediorum	1965231	S	13	1	14	0.00000
Campylobacter_sputorum	206	S	12	2	14	0.00000
Campylobacter_hyointestinalis	198	S	10	4	14	0.00000
Sulfurimonas_sp._HSL-3221	2894755	S	725	60	785	0.00004
Sulfurimonas_sp._SWIR-19	2878390	S	37	35	72	0.00000
Sulfurimonas_sp._H1576	2672570	S	17	1	18	0.00000
Sulfurimonas_sp._B2	2590551	S	16	2	18	0.00000
Sulfurimonas_paralvinellae	317658	S	23	3	26	0.00000
Sulfurimonas_lithotrophica	2590022	S	17	1	18	0.00000
Sulfurimonas_denitrificans	39766	S	14	2	16	0.00000
Sulfurimonas_gotlandica	1176482	S	12	1	13	0.00000
Sulfuricurvum_kujiense	148813	S	58	4	62	0.00000
Helicobacter_pylori	210	S	218	70	288	0.00001
Helicobacter_sp._NHP19-0003	2849641	S	38	10	48	0.00000
Helicobacter_sp._NHP19-0012	2849642	S	24	10	34	0.00000
Helicobacter_cinaedi	213	S	39	13	52	0.00000
Helicobacter_heilmannii	35817	S	37	15	52	0.00000
Helicobacter_bizzozeronii	56877	S	32	4	36	0.00000
Helicobacter_felis	214	S	27	4	31	0.00000
Helicobacter_himalayensis	1591088	S	23	3	26	0.00000
Helicobacter_mustelae	217	S	19	4	23	0.00000
Helicobacter_canis	29419	S	19	5	24	0.00000
Helicobacter_hepaticus	32025	S	17	14	31	0.00000
Helicobacter_bilis	37372	S	16	9	25	0.00000
Helicobacter_typhlonius	76936	S	13	11	24	0.00000
Helicobacter_suis	104628	S	11	3	14	0.00000
Helicobacter_cetorum	138563	S	11	1	12	0.00000
Helicobacter_cholecystus	45498	S	10	2	12	0.00000
Wolinella_succinogenes	844	S	69	20	89	0.00000
Nitratifractor_salsuginis	269261	S	401	36	437	0.00002
Sulfurovum_sp._NBC37-1	387093	S	62	30	92	0.00000
Sulfurovum_sp._HSL1-3	2893889	S	53	15	68	0.00000
Sulfurovum_sp._XGS-02	2925411	S	25	3	28	0.00000
Sulfurovum_lithotrophicum	206403	S	37	20	57	0.00000
Sulfurovum_indicum	2779528	S	35	4	39	0.00000
Hydrogenimonas_urashimensis	2740515	S	421	50	471	0.00002
Aliarcobacter_butzleri	28197	S	23	35	58	0.00000
Aliarcobacter_lanthieri	1355374	S	14	6	20	0.00000
Aliarcobacter_cryaerophilus	28198	S	13	17	30	0.00000
Arcobacter_sp._FWKO_B	2593672	S	13	2	15	0.00000
Arcobacter_venerupis	1054033	S	12	6	18	0.00000
Arcobacter_suis	1278212	S	10	6	16	0.00000
Halarcobacter_bivalviorum	663364	S	15	3	18	0.00000
Pseudoarcobacter_acticola	1849015	S	19	11	30	0.00000
Sulfurospirillum_cavolei	366522	S	85	8	93	0.00000
Sulfurospirillum_sp._UCH001	1581011	S	12	34	46	0.00000
Sulfurospirillum_halorespirans	194424	S	39	27	66	0.00000
Sulfurospirillum_multivorans	66821	S	21	15	36	0.00000
Sulfurospirillum_barnesii	44674	S	13	1	14	0.00000
Sulfurospirillum_deleyianum	65553	S	11	1	12	0.00000
Nitratiruptor_sp._YY09-18	2724901	S	40	30	70	0.00000
Nitratiruptor_sp._SB155-2	387092	S	31	37	68	0.00000
Nitrosophilus_labii	2706014	S	55	18	73	0.00000
Nitrosophilus_alvini	2714855	S	36	11	47	0.00000
Caminibacter_mediatlanticus	291048	S	52	29	81	0.00000
Caminibacter_pacificus	1424653	S	25	11	36	0.00000
Nautilia_sp._PV-1	2579250	S	31	14	45	0.00000
Nautilia_profundicola	244787	S	23	12	35	0.00000
Acidithiobacillus_caldus	33059	S	852	132	984	0.00005
Acidithiobacillus_ferrivorans	160808	S	541	107	648	0.00003
Acidithiobacillus_ferrooxidans	920	S	401	352	753	0.00004
Acidithiobacillus_thiooxidans	930	S	246	14	260	0.00001
Acidithiobacillus_ferriphilus	1689834	S	157	31	188	0.00001
Acidithiobacillus_ferridurans	1232575	S	27	225	252	0.00001
Acidithiobacillus_sp._'AMD_consortium'	2614801	S	19	249	268	0.00001
Bdellovibrio_bacteriovorus	959	S	600	88	688	0.00003
Bdellovibrio_sp._LBG001	2835041	S	84	13	97	0.00000
Bdellovibrio_sp._NC01	2220073	S	81	11	92	0.00000
Bdellovibrio_sp._ZAP7	2231053	S	66	24	90	0.00000
Bdellovibrio_sp._KM01	2748865	S	58	22	80	0.00000
Pseudobdellovibrio_exovorus	453816	S	87	7	94	0.00000
Bacteriovorax_stolpii	960	S	66	23	89	0.00000
Halobacteriovorax_marinus	97084	S	20	13	33	0.00000
Halobacteriovorax_sp._BALOs_7	2109558	S	19	6	25	0.00000
Silvanigrella_aquatica	1915309	S	36	12	48	0.00000
Fluviispira_sanaruensis	2493639	S	23	7	30	0.00000
Hydrogenophilus_thermoluteolus	297	S	1026	195	1221	0.00006
Mariprofundus_ferrinatatus	1921087	S	342	31	373	0.00002
Mariprofundus_aestuarium	1921086	S	301	32	333	0.00002
Streptomyces_sp._WAC_01438	2203204	S	24710	8260	32970	0.00156
Streptomyces_sp._3214.6	1882757	S	22749	6555	29304	0.00139
Streptomyces_sp._P3	2135430	S	22728	5632	28360	0.00135
Streptomyces_sp._ZYC-3	2797636	S	22425	4390	26815	0.00127
Streptomyces_sp._CdTB01	1725411	S	21009	5939	26948	0.00128
Streptomyces_sp._Z423-1	2730915	S	20166	5796	25962	0.00123
Streptomyces_sp._HM190	2695266	S	16698	5231	21929	0.00104
Streptomyces_sp._GQFP	2907545	S	16143	2746	18889	0.00090
Streptomyces_sp._MG28	2865673	S	15186	5160	20346	0.00097
Streptomyces_sp._SAT1	1849967	S	14595	5367	19962	0.00095
Streptomyces_sp._LRE541	2931983	S	14302	3218	17520	0.00083
Streptomyces_sp._A2-16	2781734	S	13698	4182	17880	0.00085
Streptomyces_sp._RPA4-2	2721244	S	13656	3909	17565	0.00083
Streptomyces_sp._AMCC400023	2056258	S	13040	5029	18069	0.00086
Streptomyces_sp._ST1015	1848900	S	12852	2680	15532	0.00074
Streptomyces_sp._NEAU-sy36	2751189	S	12696	4649	17345	0.00082
Streptomyces_sp._BH-MK-02	2880933	S	12669	2727	15396	0.00073
Streptomyces_sp._BJ20	2930049	S	12562	5014	17576	0.00083
Streptomyces_sp._SCSIO_64649	2878388	S	12332	2286	14618	0.00069
Streptomyces_sp._JB150	2714844	S	11794	3892	15686	0.00074
Streptomyces_sp._SN-593	659352	S	11668	2816	14484	0.00069
Streptomyces_sp._MG62	2838015	S	11666	4231	15897	0.00075
Streptomyces_sp._Go-475	2072505	S	11530	5132	16662	0.00079
Streptomyces_sp._HP-A2021	2927875	S	11460	6022	17482	0.00083
Streptomyces_sp._DSM_40868	2721173	S	10770	3834	14604	0.00069
Streptomyces_sp._So13.3	2136173	S	10384	1970	12354	0.00059
Streptomyces_sp._CB01881	2078691	S	10377	1973	12350	0.00059
Streptomyces_sp._S1D4-11	2721246	S	9880	6337	16217	0.00077
Streptomyces_sp._Go_40/10	2825844	S	9843	4170	14013	0.00067
Streptomyces_sp._NA02950	2742137	S	9346	1862	11208	0.00053
Streptomyces_sp._NHF165	2175864	S	9124	1607	10731	0.00051
Streptomyces_sp._YIM_121038	2136401	S	8802	2550	11352	0.00054
Streptomyces_sp._MA3_2.13	2867410	S	8473	1116	9589	0.00046
Streptomyces_sp._GMY02	1333528	S	8281	1472	9753	0.00046
Streptomyces_sp._C8S0	2585716	S	8255	2365	10620	0.00050
Streptomyces_sp._SCUT-3	2684469	S	8167	3266	11433	0.00054
Streptomyces_sp._891-h	2720714	S	7914	1457	9371	0.00044
Streptomyces_sp._SYP-A7193	2662065	S	7897	4276	12173	0.00058
Streptomyces_sp._MST-110588	2833628	S	7881	1930	9811	0.00047
Streptomyces_sp._NA04227	2742136	S	7707	1789	9496	0.00045
Streptomyces_sp._MBT27	1488356	S	7681	2242	9923	0.00047
Streptomyces_sp._3025	2923272	S	7519	1350	8869	0.00042
Streptomyces_sp._GS7	2692234	S	7460	1991	9451	0.00045
Streptomyces_sp._RTd22	1841249	S	7211	2658	9869	0.00047
Streptomyces_sp._QHH-9511	2684468	S	7173	1961	9134	0.00043
Streptomyces_sp._jing01	2726118	S	7141	3785	10926	0.00052
Streptomyces_sp._HSG2	2797167	S	7080	1555	8635	0.00041
Streptomyces_sp._135	2838850	S	6971	2202	9173	0.00044
Streptomyces_sp._W1SF4	2305220	S	6439	2252	8691	0.00041
Streptomyces_sp._Rer75	2750011	S	6265	2537	8802	0.00042
Streptomyces_sp._BHT-5-2	2866715	S	6205	1898	8103	0.00038
Streptomyces_sp._CB09001	2083284	S	5993	3622	9615	0.00046
Streptomyces_sp._SM18	1736046	S	5978	1602	7580	0.00036
Streptomyces_sp._SirexAA-E	862751	S	5780	1665	7445	0.00035
Streptomyces_sp._WAC_01529	2203205	S	5722	1959	7681	0.00036
Streptomyces_sp._Tu_2975	2676871	S	5631	1753	7384	0.00035
Streptomyces_sp._SUK_48	2582831	S	5476	3122	8598	0.00041
Streptomyces_sp._CCM_MD2014	1561022	S	5134	3996	9130	0.00043
Streptomyces_sp._AgN23	1188315	S	5130	4157	9287	0.00044
Streptomyces_sp._fd1-xmd	1812480	S	5123	2082	7205	0.00034
Streptomyces_sp._S4.7	2705439	S	4827	1551	6378	0.00030
Streptomyces_sp._CMB-StM0423	2059884	S	4790	1979	6769	0.00032
Streptomyces_sp._NA02536	2742133	S	4682	11336	16018	0.00076
Streptomyces_sp._INR7	2607753	S	4403	2036	6439	0.00031
Streptomyces_sp._HF10	2692233	S	4358	2783	7141	0.00034
Streptomyces_sp._TN58	234612	S	4271	1803	6074	0.00029
Streptomyces_sp._RLB1-33	2721243	S	4145	10946	15091	0.00072
Streptomyces_sp._ADI95-16	1522758	S	3352	2488	5840	0.00028
Streptomyces_sp._YPW6	2840373	S	3236	1527	4763	0.00023
Streptomyces_sp._Mg1	465541	S	3219	2545	5764	0.00027
Streptomyces_sp._WY228	2855836	S	3162	1537	4699	0.00022
Streptomyces_sp._EAS-AB2608	2779671	S	3152	4298	7450	0.00035
Streptomyces_sp._WAC_06738	2203210	S	3148	2543	5691	0.00027
Streptomyces_sp._769	1262452	S	3133	2154	5287	0.00025
Streptomyces_sp._PBH53	1577075	S	3064	3863	6927	0.00033
Streptomyces_sp._CNQ-509	444103	S	3037	2410	5447	0.00026
Streptomyces_sp._2323.1	1938841	S	2788	1575	4363	0.00021
Streptomyces_sp._RPA4-5	2721245	S	2596	1541	4137	0.00020
Streptomyces_sp._S063	2005885	S	2319	1440	3759	0.00018
Streptomyces_sp._S8	1837283	S	2252	1709	3961	0.00019
Streptomyces_sp._NEAU-S7GS2	2202000	S	2174	1605	3779	0.00018
Streptomyces_sp._11-1-2	1851167	S	1953	3329	5282	0.00025
Streptomyces_sp._XC_2026	2782004	S	1927	1545	3472	0.00016
Streptomyces_sp._ID38640	1265399	S	1922	1220	3142	0.00015
Streptomyces_sp._3211	1964449	S	1864	2023	3887	0.00018
Streptomyces_sp._M2	646637	S	1777	8209	9986	0.00047
Streptomyces_sp._CB09030	2913412	S	1745	5360	7105	0.00034
Streptomyces_sp._Sge12	1972846	S	1734	2315	4049	0.00019
Streptomyces_sp._WA6-1-16	2879427	S	1708	1540	3248	0.00015
Streptomyces_sp._HNA39	2850561	S	1661	1657	3318	0.00016
Streptomyces_sp._A144	2871487	S	1607	6300	7907	0.00038
Streptomyces_sp._CRSS-Y-16	2906474	S	1607	7855	9462	0.00045
Streptomyces_sp._MOE7	1961713	S	1540	1695	3235	0.00015
Streptomyces_sp._NA03103	2742134	S	1531	8489	10020	0.00048
Streptomyces_sp._Tue_6075	1661694	S	1499	1528	3027	0.00014
Streptomyces_sp._SGAir0924	2109593	S	1386	5907	7293	0.00035
Streptomyces_sp._M56	1495638	S	1333	3242	4575	0.00022
Streptomyces_sp._V17-9	2831149	S	1282	5224	6506	0.00031
Streptomyces_sp._SS52	2563602	S	1247	5134	6381	0.00030
Streptomyces_sp._CB00271	2750025	S	1243	1520	2763	0.00013
Streptomyces_sp._LBUM_1480	2609808	S	1192	10971	12163	0.00058
Streptomyces_sp._CFMR_7	1649184	S	1116	1693	2809	0.00013
Streptomyces_sp._WAC00288	2094021	S	1080	4131	5211	0.00025
Streptomyces_sp._endophyte_N2	2153485	S	1039	2758	3797	0.00018
Streptomyces_sp._CB04723	2748873	S	1032	1671	2703	0.00013
Streptomyces_sp._WAC00303	2933779	S	982	1273	2255	0.00011
Streptomyces_sp._Tu6071	355249	S	977	2572	3549	0.00017
Streptomyces_sp._BSE6.1	2605730	S	960	3707	4667	0.00022
Streptomyces_sp._RLB3-17	2594455	S	944	12896	13840	0.00066
Streptomyces_sp._VN1	1821625	S	943	3662	4605	0.00022
Streptomyces_sp._LBUM_1482	2609809	S	929	21863	22792	0.00108
Streptomyces_sp._CLI2509	1984801	S	912	2689	3601	0.00017
Streptomyces_sp._HU2014	2939414	S	848	2673	3521	0.00017
Streptomyces_sp._S1A1-7	2594459	S	826	6782	7608	0.00036
Streptomyces_sp._PAMC_26508	1265601	S	824	2525	3349	0.00016
Streptomyces_sp._KPB2	2305221	S	679	4760	5439	0.00026
Streptomyces_sp._GF20	2692235	S	678	3489	4167	0.00020
Streptomyces_sp._S501	2420135	S	628	2077	2705	0.00013
Streptomyces_sp._604F	1476754	S	605	4791	5396	0.00026
Streptomyces_sp._S1D4-20	2594462	S	581	13790	14371	0.00068
Streptomyces_sp._2114.2	1881022	S	530	3020	3550	0.00017
Streptomyces_sp._A1-5	2738410	S	523	2233	2756	0.00013
Streptomyces_sp._CC0208	2306165	S	517	12851	13368	0.00063
Streptomyces_sp._R527F	1664033	S	494	2564	3058	0.00015
Streptomyces_sp._WA1-19	2884220	S	478	2343	2821	0.00013
Streptomyces_sp._RLB3-6	2594457	S	461	12626	13087	0.00062
Streptomyces_sp._LBUM_1475	2609807	S	439	12117	12556	0.00060
Streptomyces_sp._CA-256286	2801033	S	395	2226	2621	0.00012
Streptomyces_sp._NBU3104	2911367	S	339	2038	2377	0.00011
Streptomyces_sp._FR-008	206662	S	264	1974	2238	0.00011
Streptomyces_sp._PVA_94-07	1225337	S	253	3267	3520	0.00017
Streptomyces_sp._PLM4	2929798	S	233	1761	1994	0.00009
Streptomyces_sp._RLB1-9	2594454	S	229	11014	11243	0.00053
Streptomyces_sp._GBA_94-10	1218177	S	211	2358	2569	0.00012
Streptomyces_sp._S1D4-23	2594463	S	197	9206	9403	0.00045
Streptomyces_sp._S1D4-14	2594461	S	168	9577	9745	0.00046
Streptomyces_sp._OUCMDZ-3434	1535304	S	158	1453	1611	0.00008
Streptomyces_sp._A10(2020)	2782013	S	140	1497	1637	0.00008
Streptomyces_sp._ICC1	2099583	S	58	2909	2967	0.00014
Streptomyces_sp._SM17	565560	S	45	1705	1750	0.00008
Streptomyces_sp._ICC4	2099584	S	42	2437	2479	0.00012
Streptomyces_sp._HNM0561	2903099	S	27	4939	4966	0.00024
Streptomyces_nodosus	40318	S	80212	18758	98970	0.00470
Streptomyces_cadmiisoli	2184053	S	14808	3420	18228	0.00087
Streptomyces_aurantiacus	47760	S	10676	2361	13037	0.00062
Streptomyces_qaidamensis	1783515	S	10177	3884	14061	0.00067
Streptomyces_alboniger	132473	S	4766	1615	6381	0.00030
Streptomyces_koyangensis	188770	S	2844	2578	5422	0.00026
Streptomyces_capitiformicae	2014920	S	37754	5390	43144	0.00205
Streptomyces_venezuelae	54571	S	37666	13647	51313	0.00244
Streptomyces_avermitilis	33903	S	36404	9542	45946	0.00218
Streptomyces_hygroscopicus	1912	S	18143	23090	41233	0.00196
Streptomyces_rapamycinicus	1226757	S	7265	1537	8802	0.00042
Streptomyces_violaceusniger	68280	S	3779	2208	5987	0.00028
Streptomyces_yatensis	155177	S	2844	1835	4679	0.00022
Streptomyces_malaysiensis	92644	S	1119	2997	4116	0.00020
Streptomyces_chartreusis	1969	S	26146	10810	36956	0.00175
Streptomyces_dengpaensis	2049881	S	21444	5440	26884	0.00128
Streptomyces_calvus	67282	S	20798	7348	28146	0.00134
Streptomyces_aquilus	2548456	S	19255	5185	24440	0.00116
Streptomyces_cyaneochromogenes	2496836	S	18096	4828	22924	0.00109
Streptomyces_griseorubiginosus	67304	S	17741	5310	23051	0.00109
Streptomyces_ferrugineus	1413221	S	17500	5116	22616	0.00107
Streptomyces_fodineus	1904616	S	16893	5416	22309	0.00106
Streptomyces_viridosporus	67581	S	16759	6170	22929	0.00109
Streptomyces_bingchenggensis	379067	S	16568	2923	19491	0.00093
Streptomyces_griseochromogenes	68214	S	16211	4098	20309	0.00096
Streptomyces_phaeolivaceus	2653200	S	15988	4003	19991	0.00095
Streptomyces_asoensis	249586	S	15533	4208	19741	0.00094
Streptomyces_lincolnensis	1915	S	15319	4034	19353	0.00092
Streptomyces_albus	1888	S	14918	6788	21706	0.00103
Streptomyces_seoulensis	73044	S	14029	4919	18948	0.00090
Streptomyces_griseus	1911	S	5508	4279	9787	0.00046
Streptomyces_sp._M54	2759525	S	513	1169	1682	0.00008
Streptomyces_anulatus	1892	S	3942	3637	7579	0.00036
Streptomyces_microflavus	1919	S	1994	7684	9678	0.00046
Streptomyces_globisporus	1908	S	1602	10299	11901	0.00056
Streptomyces_formicae	1616117	S	13612	3940	17552	0.00083
Streptomyces_davaonensis	348043	S	13293	3390	16683	0.00079
Streptomyces_nigra	1827580	S	12800	4580	17380	0.00082
Streptomyces_actuosus	1885	S	12719	4913	17632	0.00084
Streptomyces_roseochromogenus	285450	S	12691	3616	16307	0.00077
Streptomyces_lydicus	47763	S	12532	7621	20153	0.00096
Streptomyces_prasinus	67345	S	11814	3517	15331	0.00073
Streptomyces_roseirectus	2768066	S	11614	2591	14205	0.00067
Streptomyces_deccanensis	424188	S	11570	4325	15895	0.00075
Streptomyces_broussonetiae	2686304	S	11408	3136	14544	0.00069
Streptomyces_incarnatus	665007	S	11397	3011	14408	0.00068
Streptomyces_pluripotens	1355015	S	10975	2314	13289	0.00063
Streptomyces_tendae	1932	S	10910	4104	15014	0.00071
Streptomyces_chromofuscus	42881	S	10687	3749	14436	0.00069
Streptomyces_griseoviridis	45398	S	10583	3131	13714	0.00065
Streptomyces_tsukubensis	83656	S	10530	2800	13330	0.00063
Streptomyces_spectabilis	68270	S	10505	3119	13624	0.00065
Streptomyces_galilaeus	33899	S	10483	3215	13698	0.00065
Streptomyces_antibioticus	1890	S	10327	3355	13682	0.00065
Streptomyces_buecherae	2763006	S	10318	2425	12743	0.00060
Streptomyces_ambofaciens	1889	S	10098	6024	16122	0.00077
Streptomyces_lunaelactis	1535768	S	10088	1936	12024	0.00057
Streptomyces_bathyalis	2710756	S	9978	1548	11526	0.00055
Streptomyces_collinus	42684	S	9976	5589	15565	0.00074
Streptomyces_armeniacus	83291	S	9669	1292	10961	0.00052
Streptomyces_glaucescens	1907	S	9542	3751	13293	0.00063
Streptomyces_niveus	193462	S	9451	3898	13349	0.00063
Streptomyces_cattleya	29303	S	9408	2534	11942	0.00057
Streptomyces_pactum	68249	S	8971	3288	12259	0.00058
Streptomyces_durmitorensis	319947	S	8906	1762	10668	0.00051
Streptomyces_xanthii	2768069	S	8817	2447	11264	0.00053
Streptomyces_hawaiiensis	67305	S	8786	3458	12244	0.00058
Streptomyces_fagopyri	2662397	S	8772	2714	11486	0.00055
Streptomyces_coeruleorubidus	116188	S	8767	3775	12542	0.00060
Streptomyces_dangxiongensis	1442032	S	8359	2632	10991	0.00052
Streptomyces_cyanogenus	80860	S	7940	3176	11116	0.00053
Streptomyces_rimosus	1927	S	7869	8669	16538	0.00078
Streptomyces_aureoverticillatus	66871	S	7636	1885	9521	0.00045
Streptomyces_vietnamensis	362257	S	7544	2302	9846	0.00047
Streptomyces_clavuligerus	1901	S	7491	1668	9159	0.00043
Streptomyces_alboflavus	67267	S	7461	1893	9354	0.00044
Streptomyces_xinghaiensis	1038928	S	7393	2072	9465	0.00045
Streptomyces_parvulus	146923	S	7375	2962	10337	0.00049
Streptomyces_tuirus	68278	S	7322	3344	10666	0.00051
Streptomyces_atratus	1893	S	7285	1348	8633	0.00041
Streptomyces_albulus	68570	S	7213	2001	9214	0.00044
Streptomyces_genisteinicus	2768068	S	7032	2033	9065	0.00043
Streptomyces_griseocarneus	51201	S	6897	2221	9118	0.00043
Streptomyces_exfoliatus	1905	S	6890	2154	9044	0.00043
Streptomyces_ficellus	1977088	S	6873	2256	9129	0.00043
Streptomyces_liangshanensis	2717324	S	6756	1571	8327	0.00040
Streptomyces_paludis	2282738	S	6738	1353	8091	0.00038
Streptomyces_olivoreticuli	68246	S	6703	1744	8447	0.00040
Streptomyces_pristinaespiralis	38300	S	6617	2221	8838	0.00042
Streptomyces_peucetius	1950	S	6555	1641	8196	0.00039
Streptomyces_luteoverticillatus	66425	S	6399	1954	8353	0.00040
Streptomyces_globosus	68209	S	6363	2137	8500	0.00040
Streptomyces_rectiverticillatus	173860	S	6145	1814	7959	0.00038
Streptomyces_hundungensis	1077946	S	6023	1724	7747	0.00037
Streptomyces_gilvosporeus	553510	S	5972	1738	7710	0.00037
Streptomyces_katrae	68223	S	5805	1992	7797	0.00037
Streptomyces_lavendulae	1914	S	5804	1842	7646	0.00036
Streptomyces_inhibens	2293571	S	5800	1596	7396	0.00035
Streptomyces_harbinensis	1176198	S	5764	1459	7223	0.00034
Streptomyces_leeuwenhoekii	1437453	S	5560	3477	9037	0.00043
Streptomyces_subrutilus	36818	S	5528	1874	7402	0.00035
Streptomyces_finlayi	67296	S	5512	1146	6658	0.00032
Streptomyces_tirandamycinicus	2174846	S	5485	1665	7150	0.00034
Streptomyces_spongiicola	1690221	S	5337	2013	7350	0.00035
Streptomyces_vinaceus	1960	S	5298	1731	7029	0.00033
Streptomyces_kanamyceticus	1967	S	5165	1577	6742	0.00032
Streptomyces_huasconensis	1854574	S	4998	1769	6767	0.00032
Streptomyces_nitrosporeus	28894	S	4931	1269	6200	0.00029
Streptomyces_pratensis	1169025	S	4712	1043	5755	0.00027
Streptomyces_qinzhouensis	2599401	S	4673	1022	5695	0.00027
Streptomyces_rutgersensis	53451	S	4575	2031	6606	0.00031
Streptomyces_angustmyceticus	285578	S	4485	1654	6139	0.00029
Streptomyces_mobaraensis	35621	S	4461	154962	159423	0.00757
Streptomyces_gobiensis	2875706	S	4450	779	5229	0.00025
Streptomyces_cyaneogriseus	68192	S	4315	3002	7317	0.00035
Streptomyces_gardneri	66892	S	4312	1575	5887	0.00028
Streptomyces_nojiriensis	66374	S	3743	1449	5192	0.00025
Streptomyces_fungicidicus	68203	S	3454	9031	12485	0.00059
Streptomyces_auratus	114687	S	2488	1479	3967	0.00019
Streptomyces_antimycoticus	68175	S	2465	2253	4718	0.00022
Streptomyces_platensis	58346	S	2394	1597	3991	0.00019
Streptomyces_decoyicus	249567	S	2357	1175	3532	0.00017
Streptomyces_mirabilis	68239	S	2317	12422	14739	0.00070
Streptomyces_lydicamycinicus	1546107	S	2138	1147	3285	0.00016
Streptomyces_alfalfae	1642299	S	1948	9893	11841	0.00056
Streptomyces_olivaceus	47716	S	1758	5791	7549	0.00036
Streptomyces_albidoflavus	1886	S	840	11345	12185	0.00058
Streptomyces_coelicolor	1902	S	562	4906	5468	0.00026
Streptomyces_sampsonii	42239	S	302	2180	2482	0.00012
Streptomyces_rochei	1928	S	1675	11305	12980	0.00062
Streptomyces_xiamenensis	408015	S	1516	1164	2680	0.00013
Streptomyces_autolyticus	75293	S	1331	4017	5348	0.00025
Streptomyces_griseofuscus	146922	S	1316	5301	6617	0.00031
Streptomyces_filamentosus	67294	S	1296	1440	2736	0.00013
Streptomyces_californicus	67351	S	1134	3296	4430	0.00021
Streptomyces_cavourensis	67258	S	1117	1790	2907	0.00014
Streptomyces_murinus	33900	S	1010	2580	3590	0.00017
Streptomyces_lividans	1916	S	913	5852	6765	0.00032
Streptomyces_fradiae	1906	S	904	12371	13275	0.00063
Streptomyces_scabiei	1930	S	806	6375	7181	0.00034
Streptomyces_noursei	1971	S	625	2203	2828	0.00013
Streptomyces_albireticuli	1940	S	522	1982	2504	0.00012
Streptomyces_cinereoruber	67260	S	419	1969	2388	0.00011
Streptomyces_violaceoruber	1935	S	395	1552	1947	0.00009
Streptomyces_rubrolavendulae	285473	S	278	1819	2097	0.00010
Streptomyces_sviceus	285530	S	22	1715	1737	0.00008
Streptomyces_violascens	67381	S	16	1413	1429	0.00007
Kitasatospora_sp._MMS16-BH015	2018025	S	6773	2101	8874	0.00042
Kitasatospora_sp._NA04385	2742135	S	5886	2994	8880	0.00042
Kitasatospora_setae	2066	S	6056	2964	9020	0.00043
Kitasatospora_aureofaciens	1894	S	5112	1957	7069	0.00034
Kitasatospora_albolonga	68173	S	1941	1258	3199	0.00015
Streptacidiphilus_sp._P02-A3a	2704468	S	7200	2151	9351	0.00044
Streptacidiphilus_sp._PB12-B1b	2705012	S	6262	2395	8657	0.00041
Streptacidiphilus_bronchialis	2126346	S	5732	1757	7489	0.00036
Yinghuangia_sp._ASG_101	2896848	S	8832	1404	10236	0.00049
Microbacterium_sp._No._7	1714373	S	4071	1737	5808	0.00028
Microbacterium_sp._4R-513	2567934	S	3279	576	3855	0.00018
Microbacterium_sp._JZ31	1906274	S	2911	776	3687	0.00018
Microbacterium_sp._10M-3C3	2483401	S	2890	809	3699	0.00018
Microbacterium_sp._SSW1-51	2851650	S	2385	558	2943	0.00014
Microbacterium_sp._YJN-G	2763257	S	2335	723	3058	0.00015
Microbacterium_sp._ABRD_28	2268461	S	2095	271	2366	0.00011
Microbacterium_sp._XT11	367477	S	2010	405	2415	0.00011
Microbacterium_sp._BH-3-3-3	1906742	S	1986	453	2439	0.00012
Microbacterium_sp._NIBRBAC000506063	2734618	S	1979	779	2758	0.00013
Microbacterium_sp._cx-55	2875948	S	1896	267	2163	0.00010
Microbacterium_sp._H1-D42	2925844	S	1841	290	2131	0.00010
Microbacterium_sp._A18JL241	2782166	S	1786	391	2177	0.00010
Microbacterium_sp._LKL04	912630	S	1785	405	2190	0.00010
Microbacterium_sp._PM5	2014534	S	1751	309	2060	0.00010
Microbacterium_sp._SSW1-36	2851648	S	1678	344	2022	0.00010
Microbacterium_sp._Y-01	2048898	S	1643	607	2250	0.00011
Microbacterium_sp._1S1	2606451	S	1494	576	2070	0.00010
Microbacterium_sp._CBA3102	2603598	S	1454	328	1782	0.00008
Microbacterium_sp._TPU_3598	1938334	S	1291	310	1601	0.00008
Microbacterium_sp._Nx66	2766784	S	1207	711	1918	0.00009
Microbacterium_sp._RG1	2489212	S	835	597	1432	0.00007
Microbacterium_sp._1.5R	1916917	S	333	966	1299	0.00006
Microbacterium_sp._PAMC22086	2861281	S	310	601	911	0.00004
Microbacterium_sp._CGR1	1696072	S	290	874	1164	0.00006
Microbacterium_sp._SGAir0570	2070348	S	281	925	1206	0.00006
Microbacterium_sp._str._'China'	2103230	S	258	1209	1467	0.00007
Microbacterium_sp._PAMC_28756	1795053	S	109	1581	1690	0.00008
Microbacterium_sp._KUDC0406	2909588	S	46	3055	3101	0.00015
Microbacterium_sp._PAMC21962	2861280	S	19	724	743	0.00004
Microbacterium_sp._Se5.02b	2864103	S	17	1140	1157	0.00005
Microbacterium_sp._KUDC0405	2909587	S	12	793	805	0.00004
Microbacterium_cremeum	2782169	S	4576	933	5509	0.00026
Microbacterium_foliorum	104336	S	4524	902	5426	0.00026
Microbacterium_hominis	162426	S	3916	10159	14075	0.00067
Microbacterium_oleivorans	273677	S	3767	707	4474	0.00021
Microbacterium_atlanticum	2782168	S	3278	699	3977	0.00019
Microbacterium_resistens	156977	S	2975	530	3505	0.00017
Microbacterium_sediminis	904291	S	2783	1205	3988	0.00019
Microbacterium_lemovicicum	1072463	S	2673	585	3258	0.00015
Microbacterium_oryzae	743009	S	2543	730	3273	0.00016
Microbacterium_pygmaeum	370764	S	2245	271	2516	0.00012
Microbacterium_testaceum	2033	S	2237	393	2630	0.00012
Microbacterium_caowuchunii	2614638	S	2219	407	2626	0.00012
Microbacterium_wangchenii	2541726	S	2203	479	2682	0.00013
Microbacterium_protaetiae	2509458	S	2126	469	2595	0.00012
Microbacterium_luteum	2782167	S	2119	850	2969	0.00014
Microbacterium_lushaniae	2614639	S	2098	465	2563	0.00012
Microbacterium_aurum	36805	S	2030	612	2642	0.00013
Microbacterium_esteraromaticum	57043	S	1972	422	2394	0.00011
Microbacterium_chocolatum	84292	S	1939	420	2359	0.00011
Microbacterium_oxydans	82380	S	1876	1355	3231	0.00015
Microbacterium_hydrocarbonoxydans	273678	S	1447	250	1697	0.00008
Microbacterium_schleiferi	69362	S	1231	394	1625	0.00008
Microbacterium_fandaimingii	2708079	S	1082	87	1169	0.00006
Microbacterium_binotii	462710	S	822	579	1401	0.00007
Microbacterium_amylolyticum	936337	S	752	155	907	0.00004
Microbacterium_chengjingii	2769067	S	749	38	787	0.00004
Microbacterium_endophyticum	1526412	S	549	37	586	0.00003
Microbacterium_paludicola	300019	S	307	1056	1363	0.00006
Microbacterium_paraoxydans	199592	S	288	1808	2096	0.00010
Agromyces_sp._H17E-10	2932244	S	4205	1425	5630	0.00027
Agromyces_sp._LHK192	2498704	S	3847	1150	4997	0.00024
Agromyces_sp._CFWR-12	2929802	S	2881	1732	4613	0.00022
Agromyces_flavus	589382	S	4846	1576	6422	0.00030
Agromyces_soli	659012	S	3880	1450	5330	0.00025
Agromyces_aureus	453304	S	3566	1038	4604	0.00022
Agromyces_marinus	1389020	S	3183	1193	4376	0.00021
Agromyces_protaetiae	2509455	S	3121	917	4038	0.00019
Agromyces_archimandritae	2781962	S	3082	908	3990	0.00019
Agromyces_badenianii	2080742	S	2706	912	3618	0.00017
Agromyces_intestinalis	2592652	S	2682	1527	4209	0.00020
Agromyces_laixinhei	2585717	S	2462	583	3045	0.00014
Curtobacterium_sp._L6-1	2841594	S	2253	744	2997	0.00014
Curtobacterium_sp._BH-2-1-1	1905847	S	2187	740	2927	0.00014
Curtobacterium_sp._YC1	2795488	S	1753	820	2573	0.00012
Curtobacterium_sp._MR_MD2014	1561023	S	1612	763	2375	0.00011
Curtobacterium_sp._TC1	2862880	S	1494	788	2282	0.00011
Curtobacterium_sp._24E2	2804758	S	1371	767	2138	0.00010
Curtobacterium_sp._SGAir0471	2070337	S	1162	966	2128	0.00010
Curtobacterium_sp._TXMA1	2876939	S	1108	953	2061	0.00010
Curtobacterium_sp._C1	2898151	S	437	1399	1836	0.00009
Curtobacterium_sp._Csp2	2495430	S	326	1185	1511	0.00007
Curtobacterium_sp._Csp1	2495429	S	65	1554	1619	0.00008
Curtobacterium_flaccumfaciens	2035	S	3434	1622	5056	0.00024
Curtobacterium_luteum	33881	S	2165	793	2958	0.00014
Rathayibacter_sp._VKM_Ac-2759	2609252	S	2876	1033	3909	0.00019
Rathayibacter_sp._VKM_Ac-2760	2609253	S	2813	1476	4289	0.00020
Rathayibacter_sp._VKM_Ac-2804	2609257	S	1991	1482	3473	0.00016
Rathayibacter_sp._VKM_Ac-2801	2609255	S	1160	1092	2252	0.00011
Rathayibacter_sp._VKM_Ac-2762	2609254	S	554	1505	2059	0.00010
Rathayibacter_sp._VKM_Ac-2805	2609258	S	410	1149	1559	0.00007
Rathayibacter_festucae	110937	S	3001	3140	6141	0.00029
Rathayibacter_tanaceti	1671680	S	1786	471	2257	0.00011
Rathayibacter_iranicus	59737	S	1145	157	1302	0.00006
Rathayibacter_tritici	33888	S	1132	355	1487	0.00007
Rathayibacter_rathayi	33887	S	1046	290	1336	0.00006
Rathayibacter_toxicus	145458	S	473	41	514	0.00002
Leucobacter_sp._H25R-14	2932245	S	2133	365	2498	0.00012
Leucobacter_sp._NB_10	2873270	S	1976	563	2539	0.00012
Leucobacter_sp._Psy1	2875729	S	1771	226	1997	0.00009
Leucobacter_sp._CX169	2813744	S	1425	384	1809	0.00009
Leucobacter_sp._H21R-36	2932246	S	661	1821	2482	0.00012
Leucobacter_sp._H21R-40	2932247	S	556	1535	2091	0.00010
Leucobacter_muris	1935379	S	2373	881	3254	0.00015
Leucobacter_triazinivorans	1784719	S	2156	1259	3415	0.00016
Leucobacter_luti	340320	S	803	77	880	0.00004
Leucobacter_viscericola	2714935	S	613	63	676	0.00003
Leucobacter_insecticola	2714934	S	541	47	588	0.00003
Leucobacter_coleopterorum	2714933	S	396	41	437	0.00002
Leucobacter_denitrificans	683042	S	382	58	440	0.00002
Leifsonia_sp._ZF2019	2781978	S	3086	929	4015	0.00019
Leifsonia_sp._PS1209	2724914	S	2744	817	3561	0.00017
Leifsonia_sp._21MFCrub1.1	1798223	S	2718	3751	6469	0.00031
Leifsonia_shinshuensis	150026	S	4027	1225	5252	0.00025
Leifsonia_xyli	1575	S	2488	362	2850	0.00014
Clavibacter_michiganensis	28447	S	13031	16367	29398	0.00140
Clavibacter_zhangzhiyongii	2768071	S	1671	837	2508	0.00012
Clavibacter_sp._A6099	2860285	S	865	574	1439	0.00007
Agrococcus_sp._SCSIO52902	2933290	S	3287	1737	5024	0.00024
Agrococcus_sp._Marseille-Q4369	2810513	S	3282	1251	4533	0.00022
Agrococcus_sp._SGAir0287	2070347	S	3229	1049	4278	0.00020
Agrococcus_jejuensis	399736	S	3555	1201	4756	0.00023
Agrococcus_carbonis	684552	S	3190	1577	4767	0.00023
Protaetiibacter_intestinalis	2419774	S	2827	1112	3939	0.00019
Protaetiibacter_sp._SSC-01	2759943	S	2818	1134	3952	0.00019
Protaetiibacter_larvae	2592654	S	2103	730	2833	0.00013
Salinibacterium_sp._ZJ450	2708338	S	2256	368	2624	0.00012
Salinibacterium_sp._ZJ70	2708084	S	1892	511	2403	0.00011
Salinibacterium_sp._dk2585	2603292	S	1609	284	1893	0.00009
Salinibacterium_sp._M195	2583374	S	484	58	542	0.00003
Salinibacterium_sp._UTAS2018	2508880	S	475	48	523	0.00002
Salinibacterium_hongtaonis	2079791	S	833	92	925	0.00004
Cryobacterium_sp._LW097	1978566	S	1848	417	2265	0.00011
Cryobacterium_sp._PAMC25264	2861288	S	956	611	1567	0.00007
Cryobacterium_soli	2220095	S	1404	771	2175	0.00010
Cryobacterium_arcticum	670052	S	1079	862	1941	0.00009
Frondihabitans_sp._PAMC_28766	1795630	S	2879	410	3289	0.00016
Frondihabitans_sp._762G35	1446794	S	2403	549	2952	0.00014
Microterricola_viridarii	412690	S	5059	1329	6388	0.00030
Microcella_flavibacter	1804990	S	2742	1387	4129	0.00020
Microcella_alkaliphila	279828	S	1675	310	1985	0.00009
Plantibacter_sp._PA-3-X8	2480625	S	819	853	1672	0.00008
Plantibacter_sp._M259	2583822	S	799	807	1606	0.00008
Plantibacter_flavus	150123	S	894	817	1711	0.00008
Cnuibacter_physcomitrellae	1619308	S	3367	782	4149	0.00020
Mycetocola_sp._JXN-3	2116510	S	1157	179	1336	0.00006
Mycetocola_zhujimingii	2079792	S	1146	143	1289	0.00006
Mycetocola_spongiae	2859226	S	901	123	1024	0.00005
Herbiconiux_sp._SALV-R1	2735133	S	3205	686	3891	0.00018
Gryllotalpicola_protaetiae	2419771	S	3201	657	3858	0.00018
Frigoribacterium_sp._NBH87	2596916	S	3175	998	4173	0.00020
Subtercola_sp._AK-R2A1-2	2895559	S	1827	180	2007	0.00010
Subtercola_sp._PAMC28395	2846775	S	1096	115	1211	0.00006
Humibacter_sp._WJ7-1	2599293	S	2708	644	3352	0.00016
Chryseoglobus_indicus	2750620	S	525	1117	1642	0.00008
Chryseoglobus_sp._28M-23	2772253	S	456	923	1379	0.00007
Amnibacterium_sp._L3-i23	2905871	S	2392	614	3006	0.00014
Marisediminicola_antarctica	674079	S	2074	273	2347	0.00011
Gulosibacter_sediminis	1729695	S	2036	615	2651	0.00013
Diaminobutyricimonas_sp._LJ205	2683590	S	1948	389	2337	0.00011
Agreia_sp._COWG	2773266	S	1577	202	1779	0.00008
Glaciihabitans_sp._INWT7	2596912	S	1533	130	1663	0.00008
Aquiluna_borgnonia	2499157	S	199	16	215	0.00001
Candidatus_Aquiluna_sp._UB-MaderosW2red	1855377	S	114	5	119	0.00001
Rhodoluna_limnophila	232537	S	137	9	146	0.00001
Rhodoluna_lacicola	529884	S	79	5	84	0.00000
Candidatus_Rhodoluna_planktonica	535712	S	70	4	74	0.00000
Pseudoclavibacter_sp._Marseille-Q3772	2866588	S	377	75	452	0.00002
Aurantimicrobium_photophilum	1987356	S	138	11	149	0.00001
Aurantimicrobium_sp._MWH-Uga1	2079575	S	66	18	84	0.00000
Aurantimicrobium_minutum	708131	S	52	14	66	0.00000
Pontimonas_salivibrio	1159327	S	181	8	189	0.00001
Arthrobacter_sp._QXT-31	1357915	S	6082	1877	7959	0.00038
Arthrobacter_sp._QL17	2895818	S	2546	619	3165	0.00015
Arthrobacter_sp._FW305-BF8	2879617	S	2269	696	2965	0.00014
Arthrobacter_sp._NicSoilB8	2830998	S	1997	585	2582	0.00012
Arthrobacter_sp._PM3	2017685	S	1989	371	2360	0.00011
Arthrobacter_sp._24S4-2	2575374	S	1746	447	2193	0.00010
Arthrobacter_sp._UKPF54-2	2600159	S	1721	823	2544	0.00012
Arthrobacter_sp._ERGS1:01	1704044	S	1690	345	2035	0.00010
Arthrobacter_sp._U41	1849032	S	1617	525	2142	0.00010
Arthrobacter_sp._KBS0702	2578107	S	1602	720	2322	0.00011
Arthrobacter_sp._PAMC25564	2565366	S	1538	466	2004	0.00010
Arthrobacter_sp._NicSoilB4	2830997	S	1535	544	2079	0.00010
Arthrobacter_sp._NicSoilC5	2831000	S	1379	842	2221	0.00011
Arthrobacter_sp._FB24	290399	S	1301	499	1800	0.00009
Arthrobacter_sp._Helios	2828862	S	1294	223	1517	0.00007
Arthrobacter_sp._FW306-2-2C-D06B	2879618	S	1209	256	1465	0.00007
Arthrobacter_sp._PAMC25284	2861279	S	1145	327	1472	0.00007
Arthrobacter_sp._PGP41	2079227	S	1139	480	1619	0.00008
Arthrobacter_sp._zg-Y462	2886936	S	964	207	1171	0.00006
Arthrobacter_sp._PAMC_25486	1494608	S	898	155	1053	0.00005
Arthrobacter_sp._zg-Y809	2886940	S	783	282	1065	0.00005
Arthrobacter_sp._StoSoilB20	2830995	S	709	234	943	0.00004
Arthrobacter_sp._StoSoilB5	2830992	S	704	235	939	0.00004
Arthrobacter_sp._NtRootA1	2830983	S	628	228	856	0.00004
Arthrobacter_sp._YN	2020486	S	504	256	760	0.00004
Arthrobacter_sp._D5-1	1477518	S	482	384	866	0.00004
Arthrobacter_sp._C1-1	2813727	S	411	60	471	0.00002
Arthrobacter_sp._FW306-06-A	2879621	S	253	1115	1368	0.00006
Arthrobacter_sp._FW306-07-I	2879622	S	227	1601	1828	0.00009
Arthrobacter_sp._StoSoilA2	2830990	S	208	467	675	0.00003
Arthrobacter_sp._FW306-05-C	2879620	S	194	1283	1477	0.00007
Arthrobacter_sp._StoSoilB13	2830993	S	184	424	608	0.00003
Arthrobacter_sp._NicSoilB11	2830999	S	182	911	1093	0.00005
Arthrobacter_sp._StoSoilB19	2830994	S	178	1024	1202	0.00006
Arthrobacter_sp._AQ5-05	2184581	S	45	759	804	0.00004
Arthrobacter_agilis	37921	S	3853	592	4445	0.00021
Arthrobacter_crystallopoietes	37928	S	3364	638	4002	0.00019
Arthrobacter_sulfonylureivorans	2486855	S	2010	335	2345	0.00011
Arthrobacter_dokdonellae	2211210	S	1840	325	2165	0.00010
Arthrobacter_woluwensis	156980	S	1758	417	2175	0.00010
Arthrobacter_jiangjiafuii	2817475	S	1299	365	1664	0.00008
Arthrobacter_alpinus	656366	S	968	1406	2374	0.00011
Arthrobacter_sunyaminii	2816859	S	781	260	1041	0.00005
Kocuria_rosea	1275	S	3974	1215	5189	0.00025
Kocuria_flava	446860	S	3673	1825	5498	0.00026
Kocuria_turfanensis	388357	S	3486	1141	4627	0.00022
Kocuria_palustris	71999	S	1906	755	2661	0.00013
Kocuria_rhizophila	72000	S	1425	3334	4759	0.00023
Kocuria_varians	1272	S	1165	764	1929	0.00009
Kocuria_sp._TGY1127_2	2711328	S	509	86	595	0.00003
Kocuria_sp._KD4	2719588	S	246	305	551	0.00003
Kocuria_sp._BT304	1702043	S	150	570	720	0.00003
Kocuria_indica	1049583	S	292	444	736	0.00003
Pseudarthrobacter_sp._L1SW	2851598	S	1235	568	1803	0.00009
Pseudarthrobacter_sp._BIM_B-2242	2772401	S	1200	331	1531	0.00007
Pseudarthrobacter_sp._SSS035	2931399	S	824	684	1508	0.00007
Pseudarthrobacter_sp._NIBRBAC000502772	2590775	S	741	535	1276	0.00006
Pseudarthrobacter_sp._NBSH8	2596911	S	638	251	889	0.00004
Pseudarthrobacter_sp._NIBRBAC000502771	2590774	S	308	1084	1392	0.00007
Pseudarthrobacter_sp._NIBRBAC000502770	2590785	S	296	926	1222	0.00006
Pseudarthrobacter_phenanthrenivorans	361575	S	1226	664	1890	0.00009
Pseudarthrobacter_chlorophenolicus	85085	S	1010	394	1404	0.00007
Pseudarthrobacter_equi	728066	S	989	401	1390	0.00007
Pseudarthrobacter_psychrotolerans	2697569	S	982	407	1389	0.00007
Pseudarthrobacter_sulfonivorans	121292	S	735	714	1449	0.00007
Micrococcus_luteus	1270	S	4175	6629	10804	0.00051
Micrococcus_sp._KD337-16	2856555	S	1823	1138	2961	0.00014
Micrococcus_sp._KBS0714	1179670	S	79	675	754	0.00004
Micrococcus_yunnanensis	566027	S	47	378	425	0.00002
Sinomonas_atrocyanea	37927	S	3909	1298	5207	0.00025
Sinomonas_sp._R1AF57	2020377	S	3370	804	4174	0.00020
Glutamicibacter_protophormiae	37930	S	1285	800	2085	0.00010
Glutamicibacter_creatinolyticus	162496	S	1266	310	1576	0.00007
Glutamicibacter_halophytocola	1933880	S	598	113	711	0.00003
Glutamicibacter_mishrai	1775880	S	458	104	562	0.00003
Glutamicibacter_arilaitensis	256701	S	393	149	542	0.00003
Glutamicibacter_nicotianae	37929	S	331	974	1305	0.00006
Glutamicibacter_sp._ZJUTW	1155384	S	108	455	563	0.00003
Rothia_kristinae	37923	S	2114	1264	3378	0.00016
Rothia_mucilaginosa	43675	S	657	129	786	0.00004
Rothia_nasimurium	85336	S	347	171	518	0.00002
Rothia_aeria	172042	S	300	126	426	0.00002
Rothia_dentocariosa	2047	S	186	79	265	0.00001
Rothia_terrae	396015	S	133	55	188	0.00001
Rothia_amarae	169480	S	114	50	164	0.00001
Rothia_sp._ZJ932	2810516	S	105	16	121	0.00001
Paenarthrobacter_aurescens	43663	S	804	558	1362	0.00006
Paenarthrobacter_ureafaciens	37931	S	788	1397	2185	0.00010
Paenarthrobacter_sp._YJN-5	2735316	S	272	670	942	0.00004
Paenarthrobacter_sp._YJN-D	2735317	S	157	359	516	0.00002
Paenarthrobacter_nicotinovorans	29320	S	173	347	520	0.00002
Citricoccus_sp._SGAir0253	2567881	S	3172	916	4088	0.00019
Nesterenkonia_sp._NBAIMH1	2600320	S	1301	88	1389	0.00007
Paeniglutamicibacter_sp._Y32M11	2853258	S	633	104	737	0.00003
Psychromicrobium_lacuslunae	1618207	S	453	65	518	0.00002
Neomicrococcus_aestuarii	556325	S	388	173	561	0.00003
Auritidibacter_sp._NML130574	2170745	S	344	37	381	0.00002
Renibacterium_salmoninarum	1646	S	305	19	324	0.00002
Cellulomonas_sp._Y8	2591145	S	5749	2773	8522	0.00040
Cellulomonas_sp._H30R-01	2704467	S	5100	2227	7327	0.00035
Cellulomonas_sp._C5510	2871170	S	4688	2124	6812	0.00032
Cellulomonas_sp._JZ18	2654191	S	4407	2108	6515	0.00031
Cellulomonas_sp._zg-ZUI188	2819978	S	4242	1329	5571	0.00026
Cellulomonas_sp._zg-ZUI222	2816956	S	3780	1588	5368	0.00025
Cellulomonas_sp._zg-ZUI157	2819979	S	3616	1403	5019	0.00024
Cellulomonas_sp._EW123	2608402	S	3305	2188	5493	0.00026
Cellulomonas_sp._PSBB021	2003551	S	3084	2784	5868	0.00028
Cellulomonas_fimi	1708	S	4783	4689	9472	0.00045
Cellulomonas_iranensis	76862	S	4230	2193	6423	0.00030
Cellulomonas_shaoxiangyii	2566013	S	4045	1861	5906	0.00028
Cellulomonas_flavigena	1711	S	4029	1697	5726	0.00027
Cellulomonas_gilvus	11	S	3568	1753	5321	0.00025
Cellulomonas_taurus	2729175	S	3160	1119	4279	0.00020
Actinotalea_sp._JY-7876	2758442	S	4751	1923	6674	0.00032
Oerskovia_sp._KBS0722	1179673	S	3328	1198	4526	0.00021
Pseudactinotalea_sp._HY158	2654547	S	3163	508	3671	0.00017
Paraoerskovia_marina	545619	S	2331	676	3007	0.00014
Janibacter_melonis	262209	S	4491	1627	6118	0.00029
Janibacter_limosus	53458	S	2912	830	3742	0.00018
Janibacter_indicus	857417	S	1702	2508	4210	0.00020
Janibacter_sp._YB324	2761047	S	1073	2114	3187	0.00015
Phycicoccus_sp._HDW14	2714941	S	5982	2085	8067	0.00038
Phycicoccus_endophyticus	1690220	S	4877	1511	6388	0.00030
Intrasporangium_calvum	53358	S	6318	1819	8137	0.00039
Pedococcus_dokdonensis	443156	S	5633	1740	7373	0.00035
Tetrasphaera_sp._HKS02	1813880	S	4594	1255	5849	0.00028
Arsenicicoccus_sp._oral_taxon_190	1658671	S	4439	1843	6282	0.00030
Cellulosimicrobium_cellulans	1710	S	7432	8585	16017	0.00076
Cellulosimicrobium_sp._BI34T	2587808	S	3297	1689	4986	0.00024
Cellulosimicrobium_sp._JZ28	1906273	S	697	1768	2465	0.00012
Cellulosimicrobium_sp._72-3	2731680	S	367	1771	2138	0.00010
Cellulosimicrobium_sp._TH-20	1980001	S	297	1479	1776	0.00008
Xylanimonas_protaetiae	2509457	S	3908	1928	5836	0.00028
Xylanimonas_cellulosilytica	186189	S	3401	1354	4755	0.00023
Xylanimonas_allomyrinae	2509459	S	3262	1148	4410	0.00021
Isoptericola_variabilis	139208	S	4538	2670	7208	0.00034
Isoptericola_dokdonensis	372663	S	3788	1636	5424	0.00026
Ornithinimicrobium_avium	2283195	S	5108	1479	6587	0.00031
Ornithinimicrobium_sp._HY006	2508882	S	3459	1311	4770	0.00023
Ornithinimicrobium_sp._INDO-MA30-4	2908651	S	551	105	656	0.00003
Ornithinimicrobium_flavum	1288636	S	3864	1373	5237	0.00025
Ornithinimicrobium_ciconiae	2594265	S	2960	500	3460	0.00016
Ornithinimicrobium_pratense	2593973	S	2597	840	3437	0.00016
Serinicoccus_chungangensis	767452	S	3671	1338	5009	0.00024
Serinicoccus_hydrothermalis	1758689	S	3230	1567	4797	0.00023
Serinicoccus_profundi	1078471	S	2980	1147	4127	0.00020
Serinicoccus_marinus	247333	S	2820	1442	4262	0.00020
Brachybacterium_sp._CBA3105	2887346	S	3094	754	3848	0.00018
Brachybacterium_sp._SGAir0954	2571029	S	3005	882	3887	0.00018
Brachybacterium_sp._P6-10-X1	1903186	S	2788	512	3300	0.00016
Brachybacterium_ginsengisoli	1331682	S	2725	834	3559	0.00017
Brachybacterium_saurashtrense	556288	S	2581	775	3356	0.00016
Brachybacterium_faecium	43669	S	2532	811	3343	0.00016
Brachybacterium_vulturis	2017484	S	1943	743	2686	0.00013
Brachybacterium_avium	2017485	S	1631	624	2255	0.00011
Dermabacter_vaginalis	1630135	S	781	552	1333	0.00006
Dermabacter_jinjuensis	1667168	S	749	668	1417	0.00007
Devriesea_agamarum	472569	S	439	26	465	0.00002
Brevibacterium_sp._CS2	2575923	S	2861	1242	4103	0.00019
Brevibacterium_sp._SMBL_HHYL_HB1	2777556	S	1345	332	1677	0.00008
Brevibacterium_sp._HY170	2898795	S	555	189	744	0.00004
Brevibacterium_sp._'Marine'	2725563	S	458	349	807	0.00004
Brevibacterium_sp._W7.2	2823518	S	366	2001	2367	0.00011
Brevibacterium_casei	33889	S	2996	2306	5302	0.00025
Brevibacterium_luteolum	199591	S	1625	699	2324	0.00011
Brevibacterium_linens	1703	S	1508	1028	2536	0.00012
Brevibacterium_atlanticum	2697563	S	1018	240	1258	0.00006
Brevibacterium_sandarakinum	629680	S	981	200	1181	0.00006
Brevibacterium_aurantiacum	273384	S	960	694	1654	0.00008
Brevibacterium_oceani	358099	S	943	237	1180	0.00006
Brevibacterium_limosum	2697565	S	750	312	1062	0.00005
Brevibacterium_siliguriense	1136497	S	627	209	836	0.00004
Brevibacterium_pigmentatum	1496080	S	444	376	820	0.00004
Georgenia_sp._TF02-10	2917725	S	5147	2082	7229	0.00034
Georgenia_yuyongxinii	2589797	S	4919	1319	6238	0.00030
Georgenia_wutianyii	2585135	S	4122	1565	5687	0.00027
Georgenia_faecalis	2483799	S	4052	1233	5285	0.00025
Haloactinobacterium_kanbiaonis	2675754	S	4842	774	5616	0.00027
Ruania_sp._LR1S40	2897774	S	2777	637	3414	0.00016
Ruania_sp._M4N3S171	2897773	S	1675	251	1926	0.00009
Ruania_zhangjianzhongii	2603206	S	3088	335	3423	0.00016
Ruania_alkalisoli	2779775	S	1988	355	2343	0.00011
Dermacoccus_nishinomiyaensis	1274	S	2994	1402	4396	0.00021
Dermacoccus_sp._PAMC28757	2762331	S	1853	726	2579	0.00012
Luteipulveratus_mongoliensis	571913	S	3706	556	4262	0.00020
Allobranchiibius_sp._GilTou73	2904523	S	3169	749	3918	0.00019
Yimella_sp._cx-51	2770551	S	1918	412	2330	0.00011
Pengzhenrongella_sicca	2819238	S	5485	1706	7191	0.00034
Luteimicrobium_xylanilyticum	1133546	S	4423	1531	5954	0.00028
Beutenbergia_cavernae	84757	S	5756	1066	6822	0.00032
Miniimonas_sp._S16	2171623	S	3913	2313	6226	0.00030
Sanguibacter_keddieii	60920	S	3240	1070	4310	0.00020
Sanguibacter_sp._HDW7	2714931	S	2941	1021	3962	0.00019
Gephyromycinifex_aptenodytis	2716227	S	1554	197	1751	0.00008
Austwickia_chelonae	100225	S	1355	115	1470	0.00007
Dermatophilus_congolensis	1863	S	369	36	405	0.00002
Kytococcus_sedentarius	1276	S	2927	1802	4729	0.00022
Demequina_sp._TMPB413	2881056	S	1207	102	1309	0.00006
Jonesia_denitrificans	43674	S	212	40	252	0.00001
Tropheryma_whipplei	2039	S	54	0	54	0.00000
Micromonospora_sp._WMMC415	2675222	S	16148	5972	22120	0.00105
Micromonospora_sp._WMMA2032	2039870	S	8912	5745	14657	0.00070
Micromonospora_sp._HM134	2583243	S	8513	3753	12266	0.00058
Micromonospora_sp._B006	2201999	S	6940	5318	12258	0.00058
Micromonospora_sp._L5	648999	S	793	8410	9203	0.00044
Micromonospora_inositola	47865	S	23759	11571	35330	0.00168
Micromonospora_echinaurantiaca	47857	S	16549	7896	24445	0.00116
Micromonospora_terminaliae	1914461	S	15639	7797	23436	0.00111
Micromonospora_purpureochromogenes	47872	S	13841	7235	21076	0.00100
Micromonospora_krabiensis	307121	S	13561	4605	18166	0.00086
Micromonospora_viridifaciens	1881	S	13410	5791	19201	0.00091
Micromonospora_carbonacea	47853	S	13226	5807	19033	0.00090
Micromonospora_auratinigra	261654	S	11825	6145	17970	0.00085
Micromonospora_echinofusca	47858	S	11788	5291	17079	0.00081
Micromonospora_siamensis	299152	S	11498	5429	16927	0.00080
Micromonospora_narathiwatensis	299146	S	11369	5277	16646	0.00079
Micromonospora_coriariae	285665	S	11258	3973	15231	0.00072
Micromonospora_coxensis	356852	S	11029	6034	17063	0.00081
Micromonospora_ferruginea	2749844	S	9682	5527	15209	0.00072
Micromonospora_echinospora	1877	S	9292	3211	12503	0.00059
Micromonospora_sagamiensis	47875	S	9030	3422	12452	0.00059
Micromonospora_maris	1003110	S	8485	2561	11046	0.00052
Micromonospora_endophytica_(Xie_et_al._2001)_Li_et_al._2019	515350	S	8005	2417	10422	0.00049
Micromonospora_chokoriensis	356851	S	7987	2561	10548	0.00050
Micromonospora_zamorensis	709883	S	7937	2522	10459	0.00050
Micromonospora_rifamycinica	291594	S	7836	3482	11318	0.00054
Micromonospora_craniellae	2294034	S	6291	3920	10211	0.00048
Micromonospora_tulbaghiae	479978	S	4965	5315	10280	0.00049
Micromonospora_aurantiaca	47850	S	3791	24835	28626	0.00136
Actinoplanes_sp._L3-i22	2836373	S	20079	14613	34692	0.00165
Actinoplanes_sp._N902-109	649831	S	18778	5744	24522	0.00116
Actinoplanes_sp._OR16	946334	S	17230	8351	25581	0.00121
Actinoplanes_friuliensis	196914	S	18281	3029	21310	0.00101
Actinoplanes_ianthinogenes	122358	S	16810	6894	23704	0.00112
Actinoplanes_teichomyceticus	1867	S	16449	7074	23523	0.00112
Actinoplanes_missouriensis	1866	S	16060	5370	21430	0.00102
Actinoplanes_derwentensis	113562	S	13069	2042	15111	0.00072
Phytohabitans_suffuscus	624315	S	24256	6341	30597	0.00145
Phytohabitans_flavus	1076124	S	20133	4058	24191	0.00115
Plantactinospora_sp._KBS50	2024580	S	13259	3375	16634	0.00079
Plantactinospora_sp._BC1	2108470	S	2565	8198	10763	0.00051
Plantactinospora_sp._BB1	2071627	S	2368	7487	9855	0.00047
Dactylosporangium_vinaceum	53362	S	28536	3299	31835	0.00151
Actinocatenispora_sera	390989	S	9839	3048	12887	0.00061
Actinocatenispora_thailandica	227318	S	9643	2836	12479	0.00059
Catellatospora_sp._IY07-71	2728827	S	21391	4889	26280	0.00125
Couchioplanes_caeruleus	56438	S	20163	5271	25434	0.00121
Polymorphospora_rubra	338584	S	15117	3436	18553	0.00088
Natronosporangium_hydrolyticum	2811111	S	7981	565	8546	0.00041
Verrucosispora_sp._NA02020	2742132	S	5451	4259	9710	0.00046
Salinispora_tropica	168695	S	4669	801	5470	0.00026
Mycolicibacterium_smegmatis	1772	S	6621	3787	10408	0.00049
Mycolicibacterium_litorale	758802	S	6086	1596	7682	0.00036
Mycolicibacterium_sp._YH-1	2908837	S	2983	1731	4714	0.00022
Mycolicibacterium_fortuitum	1766	S	4356	1571	5927	0.00028
Mycolicibacterium_rutilum	370526	S	4166	1178	5344	0.00025
Mycolicibacterium_madagascariense	212765	S	3984	578	4562	0.00022
Mycolicibacterium_phlei	1771	S	3937	1269	5206	0.00025
Mycolicibacterium_hassiacum	46351	S	3927	1006	4933	0.00023
Mycolicibacterium_neoaurum	1795	S	3905	1018	4923	0.00023
Mycolicibacterium_chubuense	1800	S	3747	808	4555	0.00022
Mycolicibacterium_mageritense	53462	S	3743	609	4352	0.00021
Mycolicibacterium_arabiense	1286181	S	3679	539	4218	0.00020
Mycolicibacterium_parafortuitum	39692	S	3542	673	4215	0.00020
Mycolicibacterium_sediminis	1286180	S	3526	609	4135	0.00020
Mycolicibacterium_pulveris	36813	S	3521	563	4084	0.00019
Mycolicibacterium_vaccae	1810	S	3457	652	4109	0.00020
Mycolicibacterium_psychrotolerans	216929	S	3417	735	4152	0.00020
Mycolicibacterium_moriokaense	39691	S	3297	386	3683	0.00017
Mycolicibacterium_celeriflavum	1249101	S	3254	608	3862	0.00018
Mycolicibacterium_chitae	1792	S	3237	736	3973	0.00019
Mycolicibacterium_thermoresistibile	1797	S	3159	676	3835	0.00018
Mycolicibacterium_duvalii	39688	S	3118	586	3704	0.00018
Mycolicibacterium_monacense	85693	S	3034	1143	4177	0.00020
Mycolicibacterium_poriferae	39694	S	3016	605	3621	0.00017
Mycolicibacterium_tokaiense	39695	S	3003	456	3459	0.00016
Mycolicibacterium_fallax	1793	S	2962	1130	4092	0.00019
Mycolicibacterium_rhodesiae	36814	S	2899	451	3350	0.00016
Mycolicibacterium_gadium	1794	S	2882	370	3252	0.00015
Mycolicibacterium_fluoranthenivorans	258505	S	2820	352	3172	0.00015
Mycolicibacterium_phocaicum	319706	S	2747	1335	4082	0.00019
Mycolicibacterium_confluentis	28047	S	2706	394	3100	0.00015
Mycolicibacterium_gilvum	1804	S	2690	945	3635	0.00017
Mycolicibacterium_baixiangningiae	2761578	S	2647	406	3053	0.00014
Mycolicibacterium_aurum	1791	S	2647	330	2977	0.00014
Mycolicibacterium_insubricum	444597	S	2596	701	3297	0.00016
Mycolicibacterium_aichiense	1799	S	2343	387	2730	0.00013
Mycolicibacterium_anyangense	1431246	S	2339	367	2706	0.00013
Mycolicibacterium_boenickei	146017	S	2221	2673	4894	0.00023
Mycolicibacterium_austroafricanum	39687	S	2167	7534	9701	0.00046
Mycolicibacterium_mengxianglii	2736649	S	2167	222	2389	0.00011
Mycobacterium_doricum	126673	S	1967	425	2392	0.00011
Mycolicibacterium_helvum	1534349	S	1928	219	2147	0.00010
Mycolicibacterium_mucogenicum	56689	S	1674	629	2303	0.00011
Mycolicibacterium_alvei	67081	S	1584	413	1997	0.00009
Mycolicibacterium_sarraceniae	1534348	S	1404	172	1576	0.00007
Mycolicibacterium_septicum	98668	S	1204	747	1951	0.00009
Mycolicibacterium_farcinogenes	1802	S	758	2499	3257	0.00015
Mycolicibacterium_vanbaalenii	110539	S	568	7940	8508	0.00040
Mycolicibacterium_nivoides	2487344	S	243	1019	1262	0.00006
Mycobacterium_sp._JS623	212767	S	5142	414	5556	0.00026
Mycobacterium_sp._IDR2000157661	2867005	S	3138	555	3693	0.00018
Mycobacterium_sp._YC-RL4	1682113	S	2382	845	3227	0.00015
Mycobacterium_sp._DL592	2675524	S	2241	354	2595	0.00012
Mycobacterium_sp._MS1601	1936029	S	2194	301	2495	0.00012
Mycobacterium_sp._EPa45	1545728	S	2061	343	2404	0.00011
Mycobacterium_sp._TY59	2775496	S	1552	277	1829	0.00009
Mycobacterium_sp._DL440	2675523	S	1513	330	1843	0.00009
Mycobacterium_sp._WY10	1920667	S	262	884	1146	0.00005
Mycobacterium_sp._20KCMC460	2903536	S	131	2347	2478	0.00012
Mycobacterium_sp._PYR15	2051552	S	130	1290	1420	0.00007
Mycobacterium_sp._MOTT36Y	1168287	S	44	677	721	0.00003
Mycobacterium_sp._IWGMT90018-18076	2871094	S	18	579	597	0.00003
Mycobacterium_saskatchewanense	220927	S	2993	579	3572	0.00017
Mycobacterium_parmense	185642	S	2728	533	3261	0.00015
Mycobacterium_kubicae	120959	S	2432	427	2859	0.00014
Mycobacterium_simiae	1784	S	2012	171	2183	0.00010
Mycobacterium_shigaense	722731	S	1989	280	2269	0.00011
Mycobacterium_heidelbergense	53376	S	1886	461	2347	0.00011
Mycobacterium_stomatepiae	470076	S	1856	365	2221	0.00011
Mycobacterium_florentinum	292462	S	1854	406	2260	0.00011
Mycobacterium_lentiflavum	141349	S	1830	428	2258	0.00011
Mycobacterium_avium	1764	S	4678	5070	9748	0.00046
Mycobacterium_intracellulare	1767	S	2134	12017	14151	0.00067
Mycobacterium_mantenii	560555	S	2018	253	2271	0.00011
Mycobacterium_colombiense	339268	S	1848	326	2174	0.00010
Mycobacterium_marseillense	701042	S	1596	389	1985	0.00009
Mycobacterium_paraintracellulare	1138383	S	503	3935	4438	0.00021
Mycobacterium_goodii	134601	S	9729	3408	13137	0.00062
Mycobacterium_grossiae	1552759	S	4055	1164	5219	0.00025
Mycobacterium_rufum	318424	S	3538	1007	4545	0.00022
Mycobacterium_dioxanotrophicus	482462	S	3053	725	3778	0.00018
Mycobacterium_holsaticum	152142	S	2915	442	3357	0.00016
Mycobacterium_canettii	78331	S	1121	758	1879	0.00009
Mycobacterium_tuberculosis	1773	S	573	14663	15236	0.00072
Mycobacterium_branderi	43348	S	2860	340	3200	0.00015
Mycobacterium_diernhoferi	1801	S	2676	516	3192	0.00015
Mycobacterium_paragordonae	1389713	S	2642	322	2964	0.00014
Mycobacterium_frederiksbergense	117567	S	2591	782	3373	0.00016
Mycobacterium_conspicuum	44010	S	2482	305	2787	0.00013
Mycobacterium_koreense	1069220	S	2268	651	2919	0.00014
Mycobacterium_gordonae	1778	S	2206	181	2387	0.00011
Mycobacterium_cookii	1775	S	2055	199	2254	0.00011
Mycobacterium_heckeshornense	110505	S	2033	161	2194	0.00010
Mycobacterium_paraterrae	577492	S	1905	205	2110	0.00010
Mycobacterium_vicinigordonae	1719132	S	1814	95	1909	0.00009
Mycobacterium_noviomagense	459858	S	1793	139	1932	0.00009
Mycobacterium_riyadhense	486698	S	1789	74	1863	0.00009
Mycobacterium_kansasii	1768	S	1787	185	1972	0.00009
Mycobacterium_shinjukuense	398694	S	1733	171	1904	0.00009
Mycobacterium_malmoense	1780	S	1722	279	2001	0.00010
Mycobacterium_paraseoulense	590652	S	1693	369	2062	0.00010
Mycobacterium_lacus	169765	S	1659	121	1780	0.00008
Mycobacterium_virginiense	1795032	S	1646	427	2073	0.00010
Mycobacterium_xenopi	1789	S	1601	191	1792	0.00009
Mycobacterium_ostraviense	2738409	S	1575	173	1748	0.00008
Mycobacterium_seoulense	386911	S	1539	388	1927	0.00009
Mycobacterium_basiliense	2094119	S	1374	48	1422	0.00007
Mycobacterium_spongiae	886343	S	1352	36	1388	0.00007
Mycobacterium_crocinum	388459	S	1052	653	1705	0.00008
Mycobacterium_haemophilum	29311	S	865	42	907	0.00004
Mycobacterium_marinum	1781	S	432	1863	2295	0.00011
Mycobacterium_senegalense	1796	S	304	1635	1939	0.00009
Mycobacterium_novum	2492438	S	250	3363	3613	0.00017
Mycobacterium_leprae	1769	S	219	6	225	0.00001
Mycobacterium_lepromatosis	480418	S	215	5	220	0.00001
Mycobacterium_ulcerans	1809	S	195	1336	1531	0.00007
Mycobacterium_pallens	370524	S	89	999	1088	0.00005
Mycobacterium_shottsii	133549	S	86	187	273	0.00001
Mycobacterium_pseudoshottsii	265949	S	47	357	404	0.00002
Mycolicibacter_sp._MYC340	2855503	S	1525	383	1908	0.00009
Mycolicibacter_sp._MYC098	2872309	S	1329	333	1662	0.00008
Mycolicibacter_sp._MYC017	2875777	S	846	672	1518	0.00007
Mycolicibacter_sp._MYC101	2872311	S	289	1179	1468	0.00007
Mycolicibacter_sp._MYC123	2855502	S	253	1061	1314	0.00006
Mycolicibacter_terrae	1788	S	1926	604	2530	0.00012
Mycolicibacter_hiberniae	29314	S	1760	374	2134	0.00010
Mycolicibacter_minnesotensis	1118379	S	1175	204	1379	0.00007
Mycolicibacter_sinensis	875328	S	270	2967	3237	0.00015
Mycobacteroides_abscessus	36809	S	2902	2868	5770	0.00027
Mycobacteroides_chelonae	1774	S	1817	1083	2900	0.00014
Mycobacteroides_immunogenum	83262	S	1137	231	1368	0.00006
Mycobacteroides_saopaulense	1578165	S	992	129	1121	0.00005
Mycobacteroides_salmoniphilum	404941	S	940	95	1035	0.00005
[Mycobacterium]_stephanolepidis	1520670	S	511	139	650	0.00003
Mycolicibacillus_parakoreensis	1069221	S	2635	746	3381	0.00016
Hoyosella_subflava	639313	S	1138	63	1201	0.00006
Rhodococcus_sp._X156	2499145	S	4633	1614	6247	0.00030
Rhodococcus_sp._MTM3W5.2	1805827	S	3891	964	4855	0.00023
Rhodococcus_sp._SGAir0479	2567884	S	3364	1016	4380	0.00021
Rhodococcus_sp._W8901	2742603	S	3048	828	3876	0.00018
Rhodococcus_sp._PBTS_1	1653478	S	2682	715	3397	0.00016
Rhodococcus_sp._R79	2811421	S	2013	1248	3261	0.00015
Rhodococcus_sp._ABRD24	2507582	S	2005	364	2369	0.00011
Rhodococcus_sp._USK10	2789739	S	1570	1021	2591	0.00012
Rhodococcus_sp._B7740	1564114	S	1429	202	1631	0.00008
Rhodococcus_sp._P1Y	1302308	S	1348	127	1475	0.00007
Rhodococcus_sp._WMMA185	679318	S	1232	162	1394	0.00007
Rhodococcus_sp._WAY2	2663121	S	1094	937	2031	0.00010
Rhodococcus_sp._USK13	2806442	S	891	615	1506	0.00007
Rhodococcus_sp._RDE2	2885078	S	773	732	1505	0.00007
Rhodococcus_sp._WB9	2594007	S	641	829	1470	0.00007
Rhodococcus_sp._ZPP	2749906	S	519	1409	1928	0.00009
Rhodococcus_sp._S2-17	1990687	S	467	1320	1787	0.00008
Rhodococcus_sp._DMU1	2722825	S	436	1564	2000	0.00009
Rhodococcus_sp._M8	1925550	S	415	1231	1646	0.00008
Rhodococcus_sp._21391	2683591	S	238	1052	1290	0.00006
Rhodococcus_sp._WB1	1033922	S	220	1802	2022	0.00010
Rhodococcus_sp._P-2	2795031	S	136	159	295	0.00001
Rhodococcus_sp._2G	1570939	S	129	508	637	0.00003
Rhodococcus_sp._DMF-1	2907624	S	128	972	1100	0.00005
Rhodococcus_sp._p52	935199	S	115	595	710	0.00003
Rhodococcus_sp._LW-XY12	2856851	S	100	868	968	0.00005
Rhodococcus_sp._YL-1	1045808	S	90	377	467	0.00002
Rhodococcus_sp._008	1723645	S	73	433	506	0.00002
Rhodococcus_sp._PSBB049	2812863	S	71	979	1050	0.00005
Rhodococcus_sp._AQ5-07	2054902	S	66	219	285	0.00001
Rhodococcus_sp._NJ-530	2490853	S	50	274	324	0.00002
Rhodococcus_sp._H-CA8f	1727214	S	42	174	216	0.00001
Rhodococcus_sp._BH4	1807790	S	37	231	268	0.00001
Rhodococcus_sp._C1	644410	S	25	282	307	0.00001
Rhodococcus_opacus	37919	S	9684	9499	19183	0.00091
Rhodococcus_equi	43767	S	4740	1728	6468	0.00031
Rhodococcus_fascians	1828	S	3930	882	4812	0.00023
Rhodococcus_rhodochrous	1829	S	2917	1667	4584	0.00022
Rhodococcus_koreensis	99653	S	2445	712	3157	0.00015
Rhodococcus_triatomae	300028	S	2438	757	3195	0.00015
Rhodococcus_coprophilus	38310	S	2041	368	2409	0.00011
Rhodococcus_jostii	132919	S	1886	760	2646	0.00013
Rhodococcus_pyridinivorans	103816	S	1549	5687	7236	0.00034
Rhodococcus_qingshengii	334542	S	663	3926	4589	0.00022
Rhodococcus_erythropolis	1833	S	630	2799	3429	0.00016
Rhodococcus_ruber	1830	S	1383	4295	5678	0.00027
Rhodococcus_globerulus	33008	S	1164	134	1298	0.00006
Rhodococcus_aetherivorans	191292	S	478	4221	4699	0.00022
Nocardia_asteroides	1824	S	18369	6434	24803	0.00118
Nocardia_brasiliensis	37326	S	10144	2842	12986	0.00062
Nocardia_terpenica	455432	S	7416	1358	8774	0.00042
Nocardia_cyriacigeorgica	135487	S	6910	3091	10001	0.00047
Nocardia_farcinica	37329	S	5776	3748	9524	0.00045
Nocardia_arthritidis	228602	S	4354	564	4918	0.00023
Nocardia_wallacei	480035	S	4194	1230	5424	0.00026
Nocardia_huaxiensis	2755382	S	3915	791	4706	0.00022
Nocardia_gipuzkoensis	2749991	S	3829	1449	5278	0.00025
Nocardia_otitidiscaviarum	1823	S	3692	751	4443	0.00021
Nocardia_sp._CS682	1047172	S	3566	885	4451	0.00021
Nocardia_yamanashiensis	209247	S	3554	728	4282	0.00020
Nocardia_seriolae	37332	S	3547	983	4530	0.00021
Nocardia_yunnanensis	2382165	S	3528	891	4419	0.00021
Nocardia_nova	37330	S	3505	509	4014	0.00019
Nocardia_iowensis	204891	S	3501	782	4283	0.00020
Nocardia_tengchongensis	2055889	S	3431	883	4314	0.00020
Nocardia_mangyaensis	2213200	S	3144	859	4003	0.00019
Corynebacterium_sphenisci	191493	S	2702	760	3462	0.00016
Corynebacterium_cyclohexanicum	322009	S	2651	975	3626	0.00017
Corynebacterium_frankenforstense	1230998	S	2220	616	2836	0.00013
Corynebacterium_bovis	36808	S	2142	451	2593	0.00012
Corynebacterium_xerosis	1725	S	2029	1042	3071	0.00015
Corynebacterium_halotolerans	225326	S	1668	356	2024	0.00010
Corynebacterium_nuruki	1032851	S	1642	360	2002	0.00010
Corynebacterium_freneyi	134034	S	1634	590	2224	0.00011
Corynebacterium_vitaeruminis	38305	S	1453	399	1852	0.00009
Corynebacterium_sp._CNCTC7651	2815361	S	652	119	771	0.00004
Corynebacterium_sp._NML98-0116	702967	S	395	133	528	0.00003
Corynebacterium_sp._1864	2820399	S	106	202	308	0.00001
Corynebacterium_sp._4H37-19	2684405	S	70	6	76	0.00000
Corynebacterium_sp._FDAARGOS_1242	2778078	S	67	158	225	0.00001
Corynebacterium_sp._sy039	2599641	S	37	3	40	0.00000
Corynebacterium_maris	575200	S	1303	193	1496	0.00007
Corynebacterium_humireducens	1223514	S	1288	345	1633	0.00008
Corynebacterium_variabile	1727	S	1272	670	1942	0.00009
Corynebacterium_marinum	349751	S	1234	431	1665	0.00008
Corynebacterium_doosanense	1121358	S	1162	497	1659	0.00008
Corynebacterium_timonense	441500	S	1138	251	1389	0.00007
Corynebacterium_yudongzhengii	2080740	S	1067	184	1251	0.00006
Corynebacterium_mycetoides	38302	S	1066	467	1533	0.00007
Corynebacterium_liangguodongii	2079535	S	950	196	1146	0.00005
Corynebacterium_uterequi	1072256	S	906	142	1048	0.00005
Corynebacterium_atypicum	191610	S	903	242	1145	0.00005
Corynebacterium_terpenotabidum	89154	S	873	230	1103	0.00005
Corynebacterium_glyciniphilum	1404244	S	864	100	964	0.00005
Corynebacterium_provencense	1737425	S	850	181	1031	0.00005
Corynebacterium_jeikeium	38289	S	821	1868	2689	0.00013
Corynebacterium_comes	2675218	S	818	189	1007	0.00005
Corynebacterium_sanguinis	2594913	S	799	490	1289	0.00006
Corynebacterium_imitans	156978	S	747	424	1171	0.00006
Corynebacterium_urealyticum	43771	S	739	662	1401	0.00007
Corynebacterium_ureicelerivorans	401472	S	713	217	930	0.00004
Corynebacterium_uberis	2883169	S	696	79	775	0.00004
Corynebacterium_glaucum	187491	S	648	128	776	0.00004
Corynebacterium_falsenii	108486	S	625	239	864	0.00004
Corynebacterium_lujinxingii	2763010	S	612	191	803	0.00004
Corynebacterium_efficiens	152794	S	595	101	696	0.00003
Corynebacterium_testudinoris	136857	S	594	112	706	0.00003
Corynebacterium_qintianiae	2709392	S	588	152	740	0.00004
Corynebacterium_aurimucosum	169292	S	536	232	768	0.00004
Corynebacterium_glucuronolyticum	39791	S	526	114	640	0.00003
Corynebacterium_coyleae	53374	S	515	121	636	0.00003
Corynebacterium_kroppenstedtii	161879	S	495	46	541	0.00003
Corynebacterium_genitalium	38288	S	484	98	582	0.00003
Corynebacterium_striatum	43770	S	474	367	841	0.00004
Corynebacterium_tuberculostearicum	38304	S	468	259	727	0.00003
Corynebacterium_incognita	2754725	S	461	97	558	0.00003
Corynebacterium_occultum	2675219	S	453	74	527	0.00003
Corynebacterium_matruchotii	43768	S	450	30	480	0.00002
Corynebacterium_lactis	1231000	S	446	65	511	0.00002
Corynebacterium_riegelii	156976	S	415	98	513	0.00002
Corynebacterium_aquilae	203263	S	405	58	463	0.00002
Corynebacterium_zhongnanshanii	2768834	S	400	52	452	0.00002
Corynebacterium_endometrii	2488819	S	361	65	426	0.00002
Corynebacterium_renale	1724	S	348	38	386	0.00002
Corynebacterium_flavescens	28028	S	346	92	438	0.00002
Corynebacterium_lizhenjunii	2709394	S	288	46	334	0.00002
Corynebacterium_simulans	146827	S	286	201	487	0.00002
Corynebacterium_singulare	161899	S	279	221	500	0.00002
Corynebacterium_urogenitale	2487892	S	272	46	318	0.00002
Corynebacterium_kalinowskii	2675216	S	269	123	392	0.00002
Corynebacterium_cystitidis	35757	S	261	15	276	0.00001
Corynebacterium_minutissimum	38301	S	249	233	482	0.00002
Corynebacterium_camporealensis	161896	S	247	58	305	0.00001
Corynebacterium_phocae	161895	S	233	29	262	0.00001
Corynebacterium_epidermidicanis	1050174	S	228	36	264	0.00001
Corynebacterium_diphtheriae	1717	S	216	238	454	0.00002
Corynebacterium_stationis	1705	S	202	48	250	0.00001
Corynebacterium_macginleyi	38290	S	199	44	243	0.00001
Corynebacterium_deserti	1408191	S	194	65	259	0.00001
Corynebacterium_choanae	1862358	S	194	18	212	0.00001
Corynebacterium_gerontici	2079234	S	193	36	229	0.00001
Corynebacterium_propinquum	43769	S	189	75	264	0.00001
Corynebacterium_argentoratense	42817	S	186	37	223	0.00001
Corynebacterium_pelargi	1471400	S	185	58	243	0.00001
Corynebacterium_pseudopelargi	2080757	S	179	59	238	0.00001
Corynebacterium_kefirresidentii	1979527	S	173	106	279	0.00001
Corynebacterium_casei	160386	S	161	174	335	0.00002
Corynebacterium_resistens	258224	S	161	83	244	0.00001
Corynebacterium_pseudodiphtheriticum	37637	S	154	47	201	0.00001
Corynebacterium_glutamicum	1718	S	147	1918	2065	0.00010
Corynebacterium_mustelae	571915	S	143	10	153	0.00001
Corynebacterium_amycolatum	43765	S	121	839	960	0.00005
Corynebacterium_ulcerans	65058	S	118	47	165	0.00001
Corynebacterium_pseudotuberculosis	1719	S	115	357	472	0.00002
Corynebacterium_segmentosum	43990	S	109	244	353	0.00002
Corynebacterium_ammoniagenes	1697	S	98	20	118	0.00001
Corynebacterium_anserum	2684406	S	94	10	104	0.00000
Corynebacterium_hindlerae	699041	S	92	167	259	0.00001
Corynebacterium_rouxii	2719119	S	81	45	126	0.00001
Corynebacterium_accolens	38284	S	77	172	249	0.00001
Corynebacterium_callunae	1721	S	73	23	96	0.00000
Corynebacterium_suranareeae	2506452	S	69	19	88	0.00000
Corynebacterium_silvaticum	2320431	S	62	24	86	0.00000
Corynebacterium_crudilactis	1652495	S	61	65	126	0.00001
Corynebacterium_kutscheri	35755	S	20	2	22	0.00000
Gordonia_sp._PP30	2935861	S	3125	871	3996	0.00019
Gordonia_sp._YC-JH1	2059875	S	1981	1454	3435	0.00016
Gordonia_sp._KTR9	337191	S	1900	387	2287	0.00011
Gordonia_sp._PDNC005	2811424	S	1528	228	1756	0.00008
Gordonia_sp._WA4-43	2878678	S	339	1096	1435	0.00007
Gordonia_sp._JH63	2698900	S	249	759	1008	0.00005
Gordonia_sp._135	2676309	S	155	967	1122	0.00005
Gordonia_sp._1D	1737359	S	70	982	1052	0.00005
Gordonia_polyisoprenivorans	84595	S	4680	947	5627	0.00027
Gordonia_terrae	2055	S	3096	1711	4807	0.00023
Gordonia_insulae	2420509	S	2771	393	3164	0.00015
Gordonia_phthalatica	1136941	S	2474	986	3460	0.00016
Gordonia_amarae	36821	S	2379	485	2864	0.00014
Gordonia_iterans	1004901	S	2337	817	3154	0.00015
Gordonia_jinghuaiqii	2758710	S	2210	436	2646	0.00013
Gordonia_bronchialis	2054	S	2164	515	2679	0.00013
Gordonia_pseudoamarae	2831662	S	1841	355	2196	0.00010
Gordonia_rubripertincta	36822	S	1758	1019	2777	0.00013
Gordonia_otitidis	249058	S	1721	285	2006	0.00010
Gordonia_zhaorongruii	2597659	S	1546	279	1825	0.00009
Gordonia_alkanivorans	84096	S	528	1831	2359	0.00011
Gordonia_amicalis	89053	S	406	2749	3155	0.00015
Gordonia_hongkongensis	1701090	S	310	906	1216	0.00006
Gordonia_ajococcus	1292359	S	22	1030	1052	0.00005
Skermania_piniformis	39122	S	2770	344	3114	0.00015
Tsukamurella_paurometabola	2061	S	4737	2326	7063	0.00034
Tsukamurella_tyrosinosolvens	57704	S	4009	1774	5783	0.00027
Tsukamurella_pulmonis	47312	S	2756	993	3749	0.00018
Tsukamurella_sp._PLM1	2929795	S	2667	875	3542	0.00017
Dietzia_sp._oral_taxon_368	712270	S	1643	1099	2742	0.00013
Dietzia_sp._DQ12-45-1b	912801	S	20	2023	2043	0.00010
Dietzia_lutea	546160	S	1981	1120	3101	0.00015
Dietzia_psychralcaliphila	139021	S	1920	556	2476	0.00012
Dietzia_timorensis	499555	S	1525	905	2430	0.00012
Tomitella_gaofuii	2760083	S	2920	922	3842	0.00018
Tomitella_fengzijianii	2597660	S	2533	863	3396	0.00016
Segniliparus_rotundus	286802	S	1478	85	1563	0.00007
Lawsonella_clevelandensis	1528099	S	230	27	257	0.00001
Amycolatopsis_sp._WQ_127309	2932773	S	12818	3768	16586	0.00079
Amycolatopsis_sp._Hca4	2742131	S	12149	4697	16846	0.00080
Amycolatopsis_sp._DSM_110486	2865832	S	11441	2416	13857	0.00066
Amycolatopsis_sp._FDAARGOS_1241	2778070	S	10463	2409	12872	0.00061
Amycolatopsis_sp._YIM_10	2653857	S	8833	2751	11584	0.00055
Amycolatopsis_sp._CA-230715	2745196	S	8555	1390	9945	0.00047
Amycolatopsis_sp._FU40	2914159	S	5416	2496	7912	0.00038
Amycolatopsis_sp._AA4	1896961	S	4718	2533	7251	0.00034
Amycolatopsis_sp._BJA-103	1911175	S	4104	1747	5851	0.00028
Amycolatopsis_sp._TNS106	2861750	S	3243	2033	5276	0.00025
Amycolatopsis_sp._EV170708-02-1	2919322	S	2832	2993	5825	0.00028
Amycolatopsis_pretoriensis	218821	S	12361	4208	16569	0.00079
Amycolatopsis_mediterranei	33910	S	10945	7854	18799	0.00089
Amycolatopsis_acidiphila	715473	S	10728	2441	13169	0.00063
Amycolatopsis_methanolica	1814	S	8378	3549	11927	0.00057
Amycolatopsis_thermalba	944492	S	8278	3679	11957	0.00057
Amycolatopsis_albispora	1804986	S	8006	4973	12979	0.00062
Amycolatopsis_keratiniphila	129921	S	4187	3699	7886	0.00037
Amycolatopsis_japonica	208439	S	2220	2220	4440	0.00021
Amycolatopsis_aidingensis	2842453	S	7188	913	8101	0.00038
Amycolatopsis_orientalis	31958	S	4517	1637	6154	0.00029
Pseudonocardia_sp._DSM_110487	2865833	S	62917	9344	72261	0.00343
Pseudonocardia_sp._CGMCC_4.1532	2761535	S	12600	7683	20283	0.00096
Pseudonocardia_sp._HH130630-07	1690815	S	9796	3061	12857	0.00061
Pseudonocardia_sp._AL041005-10	445576	S	7903	3016	10919	0.00052
Pseudonocardia_sp._HH130629-09	1641402	S	6606	2930	9536	0.00045
Pseudonocardia_sp._EC080625-04	1096868	S	221	5636	5857	0.00028
Pseudonocardia_sp._EC080619-01	1096856	S	35	8217	8252	0.00039
Pseudonocardia_sp._EC080610-09	1688404	S	21	1676	1697	0.00008
Pseudonocardia_dioxanivorans	240495	S	19505	5546	25051	0.00119
Pseudonocardia_broussonetiae	2736640	S	19195	6757	25952	0.00123
Pseudonocardia_autotrophica	2074	S	10898	3122	14020	0.00067
Pseudonocardia_abyssalis	2792008	S	10386	5704	16090	0.00076
Saccharopolyspora_erythraea	1836	S	17692	5372	23064	0.00109
Saccharopolyspora_gregorii	33914	S	8425	1843	10268	0.00049
Saccharopolyspora_spinosa	60894	S	3894	2426	6320	0.00030
Saccharopolyspora_pogona	333966	S	3612	4105	7717	0.00037
Saccharopolyspora_sp._ASAGF58	2719023	S	2276	2870	5146	0.00024
Saccharothrix_syringae	103733	S	12723	4763	17486	0.00083
Saccharothrix_sp._6-C	2781735	S	10262	3780	14042	0.00067
Saccharothrix_espanaensis	103731	S	9761	3110	12871	0.00061
Saccharomonospora_marina	632569	S	5402	1430	6832	0.00032
Saccharomonospora_cyanea	40989	S	4002	1616	5618	0.00027
Saccharomonospora_azurea	40988	S	3864	1260	5124	0.00024
Saccharomonospora_xinjiangensis	75294	S	2940	535	3475	0.00016
Saccharomonospora_viridis	1852	S	2577	430	3007	0.00014
Saccharomonospora_glauca	40990	S	2488	970	3458	0.00016
Kutzneria_sp._CA-103260	2802641	S	12860	2978	15838	0.00075
Kutzneria_albida	43357	S	9172	2272	11444	0.00054
Allokutzneria_albata	211114	S	15793	4057	19850	0.00094
Actinoalloteichus_hoggarensis	1470176	S	4273	616	4889	0.00023
Actinoalloteichus_hymeniacidonis	340345	S	3184	325	3509	0.00017
Actinoalloteichus_sp._GBA129-24	1612551	S	220	2746	2966	0.00014
Actinoalloteichus_fjordicus	1612552	S	152	2291	2443	0.00012
Actinosynnema_pretiosum	42197	S	4002	8413	12415	0.00059
Actinosynnema_mirum	40567	S	347	3409	3756	0.00018
Lentzea_guizhouensis	1586287	S	10825	2458	13283	0.00063
Kibdelosporangium_phytohabitans	860235	S	9092	1181	10273	0.00049
Alloactinosynnema_sp._L-07	1653480	S	7152	1703	8855	0.00042
Prauserella_marina	530584	S	4399	433	4832	0.00023
Allosaccharopolyspora_coralli	2665642	S	4168	977	5145	0.00024
Nocardioides_sp._G188	2849501	S	10725	3586	14311	0.00068
Nocardioides_sp._JS614	196162	S	9198	2898	12096	0.00057
Nocardioides_sp._LMS-CY	2840457	S	8668	3036	11704	0.00056
Nocardioides_sp._TF02-7	2917724	S	7859	2753	10612	0.00050
Nocardioides_sp._W7	2931390	S	6712	2422	9134	0.00043
Nocardioides_sp._HDW12B	2714939	S	6633	2368	9001	0.00043
Nocardioides_sp._S-1144	2582905	S	6604	2726	9330	0.00044
Nocardioides_sp._cx-173	2898796	S	6146	2246	8392	0.00040
Nocardioides_sp._zg-579	2663857	S	6073	3267	9340	0.00044
Nocardioides_sp._SCSIO_67246	2872154	S	5639	1610	7249	0.00034
Nocardioides_sp._zg-1228	2763008	S	5482	2558	8040	0.00038
Nocardioides_sp._603	2483798	S	5405	2659	8064	0.00038
Nocardioides_sp._InS609-2	2760705	S	5176	1285	6461	0.00031
Nocardioides_sp._MC1495	2736757	S	5126	1961	7087	0.00034
Nocardioides_sp._S5	2017486	S	5051	2674	7725	0.00037
Nocardioides_sp._zg-536	2803858	S	4535	2119	6654	0.00032
Nocardioides_sp._CF8	110319	S	4389	1928	6317	0.00030
Nocardioides_sp._JQ2195	2592334	S	4189	949	5138	0.00024
Nocardioides_sp._dk884	2662361	S	3856	3955	7811	0.00037
Nocardioides_sp._WS12	2486272	S	3836	734	4570	0.00022
Nocardioides_sp._ZJ1313	2685869	S	3793	3916	7709	0.00037
Nocardioides_sp._Kera_G14	2884264	S	3473	787	4260	0.00020
Nocardioides_mesophilus	433659	S	9630	3206	12836	0.00061
Nocardioides_anomalus	2712223	S	8132	2697	10829	0.00051
Nocardioides_ungokensis	1643322	S	7259	2780	10039	0.00048
Nocardioides_humi	449461	S	7249	2663	9912	0.00047
Nocardioides_cynanchi	2558918	S	6730	1754	8484	0.00040
Nocardioides_aromaticivorans	200618	S	6232	2613	8845	0.00042
Nocardioides_euryhalodurans	2518370	S	6186	2074	8260	0.00039
Nocardioides_okcheonensis	2894081	S	6181	3085	9266	0.00044
Nocardioides_aquaticus	160826	S	5861	1968	7829	0.00037
Nocardioides_dongkuii	2760089	S	5853	3159	9012	0.00043
Nocardioides_rotundus	1774216	S	5604	2384	7988	0.00038
Nocardioides_marinisabuli	419476	S	5181	3130	8311	0.00039
Nocardioides_sambongensis	2589074	S	4790	1516	6306	0.00030
Nocardioides_dokdonensis	450734	S	4677	2362	7039	0.00033
Nocardioides_panacisoli	627624	S	4367	1186	5553	0.00026
Nocardioides_houyundeii	2045452	S	4150	1391	5541	0.00026
Nocardioides_seonyuensis	2518371	S	3952	1158	5110	0.00024
Nocardioides_piscis	2714938	S	3573	1464	5037	0.00024
Nocardioides_daphniae	402297	S	3094	1546	4640	0.00022
Nocardioides_jishulii	2575440	S	2750	1094	3844	0.00018
Nocardioides_baekrokdamisoli	1804624	S	2154	297	2451	0.00012
Nocardioides_yefusunii	2500546	S	1912	617	2529	0.00012
Aeromicrobium_sp._Leaf245	1736306	S	3732	1279	5011	0.00024
Aeromicrobium_sp._zg-629	2663859	S	2940	1077	4017	0.00019
Aeromicrobium_sp._A1-2	2107713	S	2613	410	3023	0.00014
Aeromicrobium_erythreum	2041	S	4010	1336	5346	0.00025
Aeromicrobium_choanae	1736691	S	3669	1228	4897	0.00023
Aeromicrobium_chenweiae	2079793	S	3643	1384	5027	0.00024
Aeromicrobium_marinum	219314	S	3416	831	4247	0.00020
Aeromicrobium_yanjiei	2662028	S	3247	1147	4394	0.00021
Friedmanniella_luteola	546871	S	8887	2098	10985	0.00052
Pimelobacter_simplex	2045	S	6562	2888	9450	0.00045
Marmoricola_scoriae	642780	S	6004	2608	8612	0.00041
Mumia_sp._ZJ1417	2708082	S	4835	940	5775	0.00027
Micropruina_glycogenica	75385	S	3296	555	3851	0.00018
Microlunatus_sagamiharensis	546874	S	7480	2057	9537	0.00045
Microlunatus_phosphovorus	29405	S	5511	761	6272	0.00030
Microlunatus_soli	630515	S	4821	618	5439	0.00026
Microlunatus_elymi	2596828	S	4408	647	5055	0.00024
Microlunatus_sp._Gsoil_973	2672569	S	3833	396	4229	0.00020
Tessaracoccus_sp._J1M15	2829499	S	2592	813	3405	0.00016
Tessaracoccus_sp._MC1865	2760310	S	2141	576	2717	0.00013
Tessaracoccus_defluvii	1285901	S	2970	1925	4895	0.00023
Tessaracoccus_aquimaris	1332264	S	2689	1314	4003	0.00019
Tessaracoccus_flavescens	399497	S	2265	1768	4033	0.00019
Tessaracoccus_flavus	1610493	S	2035	1419	3454	0.00016
Tessaracoccus_timonensis	2161816	S	1224	531	1755	0.00008
Brevilactibacter_coleopterorum	2714937	S	4401	2169	6570	0.00031
Brevilactibacter_sp._MC1595	2819349	S	3897	1680	5577	0.00026
Acidipropionibacterium_jensenii	1749	S	2550	1743	4293	0.00020
Acidipropionibacterium_acidipropionici	1748	S	2393	1608	4001	0.00019
Acidipropionibacterium_virtanenii	2057246	S	1724	366	2090	0.00010
Propionibacterium_acidifaciens	556499	S	2566	584	3150	0.00015
Propionibacterium_freudenreichii	1744	S	2041	1990	4031	0.00019
Propionibacterium_australiense	119981	S	1908	324	2232	0.00011
Auraticoccus_monumenti	675864	S	5627	1166	6793	0.00032
Cutibacterium_avidum	33010	S	1531	500	2031	0.00010
Cutibacterium_granulosum	33011	S	912	204	1116	0.00005
Cutibacterium_acnes	1747	S	608	471	1079	0.00005
Cutibacterium_modestum	2559073	S	367	59	426	0.00002
Arachnia_propionica	1750	S	2080	248	2328	0.00011
Arachnia_rubra	1547448	S	1222	132	1354	0.00006
Raineyella_fluvialis	2662261	S	3269	489	3758	0.00018
Vaginimicrobium_propionicum	1871034	S	102	40	142	0.00001
Kribbella_flavida	182640	S	19435	4971	24406	0.00116
Kribbella_qitaiheensis	1544730	S	14423	2476	16899	0.00080
Actinopolymorpha_singaporensis	117157	S	9005	1122	10127	0.00048
Nonomuraea_sp._ATCC_55076	1909395	S	80161	22309	102470	0.00486
Nonomuraea_nitratireducens	2656914	S	33050	6772	39822	0.00189
Nonomuraea_gerenzanensis	93944	S	30045	8687	38732	0.00184
Nonomuraea_coxensis	404386	S	26842	7488	34330	0.00163
Streptosporangium_roseum	2001	S	19911	5624	25535	0.00121
Streptosporangium_sp._'caverna'	2202249	S	16518	3688	20206	0.00096
Thermobispora_bispora	2006	S	8762	2119	10881	0.00052
Actinomadura_sp._NAK00032	2742128	S	21915	8816	30731	0.00146
Actinomadura_sp._WMMB_499	1219491	S	16650	4353	21003	0.00100
Actinomadura_sp._WMMA1423	2591108	S	15848	5354	21202	0.00101
Actinomadura_madurae	1993	S	20957	7152	28109	0.00133
Actinomadura_verrucosospora	46165	S	18801	6360	25161	0.00119
Actinomadura_graeca	2750812	S	14380	3678	18058	0.00086
Thermomonospora_amylolytica	1411117	S	12444	4852	17296	0.00082
Thermomonospora_curvata	2020	S	8060	2465	10525	0.00050
Nocardiopsis_sp._MT53	2865672	S	6775	1698	8473	0.00040
Nocardiopsis_sp._HDS12	2831968	S	2553	2378	4931	0.00023
Nocardiopsis_gilva	280236	S	5149	1101	6250	0.00030
Nocardiopsis_dassonvillei	2014	S	4606	4101	8707	0.00041
Nocardiopsis_alba	53437	S	3458	663	4121	0.00020
Thermobifida_halotolerans	483545	S	4079	1418	5497	0.00026
Thermobifida_alba	53522	S	4054	1729	5783	0.00027
Thermobifida_fusca	2021	S	2043	375	2418	0.00011
Streptomonospora_litoralis	2498135	S	5986	1245	7231	0.00034
Spiractinospora_alimapuensis	2820884	S	3714	259	3973	0.00019
Blastococcus_sp._PRF04-17	2933797	S	15990	5732	21722	0.00103
Blastococcus_saxobsidens	138336	S	14547	4673	19220	0.00091
Modestobacter_marinus	477641	S	15914	5722	21636	0.00103
Modestobacter_sp._L9-4	2851567	S	9189	3640	12829	0.00061
Geodermatophilus_obscurus	1861	S	22870	8045	30915	0.00147
Frankia_inefficax	298654	S	13683	1691	15374	0.00073
Frankia_sp._QA3	710111	S	5448	2462	7910	0.00038
Frankia_sp._ArI3	1858	S	4220	3017	7237	0.00034
Candidatus_Frankia_datiscae	2716812	S	6453	935	7388	0.00035
Frankia_casuarinae	106370	S	5313	595	5908	0.00028
Frankia_alni	1859	S	4640	3473	8113	0.00039
Actinomyces_sp._oral_taxon_414	712122	S	2096	443	2539	0.00012
Actinomyces_sp._MAS-1	2755559	S	1492	305	1797	0.00009
Actinomyces_sp._Z16	2079536	S	1150	426	1576	0.00007
Actinomyces_sp._Chiba101	1851395	S	902	440	1342	0.00006
Actinomyces_sp._432	2057798	S	877	202	1079	0.00005
Actinomyces_sp._oral_taxon_171	706438	S	489	395	884	0.00004
Actinomyces_sp._oral_taxon_169	712116	S	286	532	818	0.00004
Actinomyces_sp._oral_taxon_897	2081702	S	238	699	937	0.00004
Actinomyces_sp._HMT897	2789424	S	194	558	752	0.00004
Actinomyces_sp._HMT_175	2789425	S	162	687	849	0.00004
Actinomyces_sp._zg-332	2708340	S	18	3	21	0.00000
Actinomyces_radicidentis	111015	S	2227	946	3173	0.00015
Actinomyces_howellii	52771	S	1749	284	2033	0.00010
Actinomyces_slackii	52774	S	1376	242	1618	0.00008
Actinomyces_respiraculi	2744574	S	1251	322	1573	0.00007
Actinomyces_procaprae	2560010	S	1249	480	1729	0.00008
Actinomyces_faecalis	2722820	S	1052	157	1209	0.00006
Actinomyces_weissii	675090	S	880	180	1060	0.00005
Actinomyces_qiguomingii	2057800	S	878	127	1005	0.00005
Actinomyces_viscosus	1656	S	860	377	1237	0.00006
Actinomyces_naeslundii	1655	S	757	440	1197	0.00006
Actinomyces_wuliandei	2057743	S	673	191	864	0.00004
Actinomyces_gaoshouyii	1960083	S	671	362	1033	0.00005
Actinomyces_lilanjuaniae	2321394	S	618	161	779	0.00004
Actinomyces_oris	544580	S	610	1774	2384	0.00011
Actinomyces_marmotae	2737173	S	572	331	903	0.00004
Actinomyces_trachealis	2763540	S	459	92	551	0.00003
Actinomyces_pacaensis	1852377	S	178	23	201	0.00001
Schaalia_sp._19OD2882	2794089	S	826	113	939	0.00004
Schaalia_sp._JY-X169	2758572	S	281	10	291	0.00001
Schaalia_sp._ZJ405	2709403	S	268	24	292	0.00001
Schaalia_odontolytica	1660	S	1207	291	1498	0.00007
Schaalia_meyeri	52773	S	652	119	771	0.00004
Schaalia_cardiffensis	181487	S	420	63	483	0.00002
Schaalia_turicensis	131111	S	213	224	437	0.00002
Flaviflexus_salsibiostraticola	1282737	S	1132	340	1472	0.00007
Flaviflexus_sp._dk850	2758573	S	544	216	760	0.00004
Flaviflexus_ciconiae	2496867	S	529	77	606	0.00003
Trueperella_pecoris	2733571	S	1023	295	1318	0.00006
Trueperella_pyogenes	1661	S	673	391	1064	0.00005
Trueperella_bialowiezensis	312285	S	465	25	490	0.00002
Nanchangia_anserum	2692125	S	1041	118	1159	0.00006
Pauljensenia_hongkongensis	178339	S	1015	376	1391	0.00007
Actinobaculum_sp._313	2495645	S	429	25	454	0.00002
Actinotignum_schaalii	59505	S	347	24	371	0.00002
Arcanobacterium_haemolyticum	28264	S	111	52	163	0.00001
Arcanobacterium_phocisimile	1302235	S	68	22	90	0.00000
Arcanobacterium_phocae	131112	S	61	21	82	0.00000
Arcanobacterium_sp._2701	2722751	S	50	14	64	0.00000
Changpingibacter_yushuensis	2758440	S	313	93	406	0.00002
Mobiluncus_curtisii	2051	S	203	61	264	0.00001
Varibaculum_sp._EMRHCC_39	2811781	S	112	35	147	0.00001
Fannyhessea_vaginae	82135	S	86	26	112	0.00001
Boudabousia_tangfeifanii	1912795	S	81	6	87	0.00000
Jiangella_alkaliphila	419479	S	12838	3817	16655	0.00079
Jiangella_sp._DSM_45060	1798224	S	12659	3920	16579	0.00079
Bifidobacterium_pseudolongum	1694	S	1414	547	1961	0.00009
Bifidobacterium_choerinum	35760	S	1278	559	1837	0.00009
Bifidobacterium_longum	216816	S	1270	2410	3680	0.00017
Bifidobacterium_scardovii	158787	S	1265	125	1390	0.00007
Bifidobacterium_bifidum	1681	S	980	472	1452	0.00007
Bifidobacterium_pullorum	78448	S	940	383	1323	0.00006
Bifidobacterium_asteroides	1684	S	753	23	776	0.00004
Bifidobacterium_animalis	28025	S	737	794	1531	0.00007
Bifidobacterium_subtile	77635	S	666	101	767	0.00004
Bifidobacterium_adolescentis	1680	S	626	157	783	0.00004
Bifidobacterium_eulemuris	1765219	S	492	120	612	0.00003
Bifidobacterium_lemurum	1603886	S	485	122	607	0.00003
Bifidobacterium_thermophilum	33905	S	485	112	597	0.00003
Bifidobacterium_breve	1685	S	468	514	982	0.00005
Bifidobacterium_actinocoloniiforme	638619	S	389	14	403	0.00002
Bifidobacterium_angulatum	1683	S	365	98	463	0.00002
Bifidobacterium_dentium	1689	S	310	24	334	0.00002
Bifidobacterium_catenulatum	1686	S	252	370	622	0.00003
Bifidobacterium_pseudocatenulatum	28026	S	219	139	358	0.00002
Bifidobacterium_imperatoris	2020965	S	134	77	211	0.00001
Bifidobacterium_coryneforme	1687	S	83	115	198	0.00001
Bifidobacterium_saguini	762210	S	76	39	115	0.00001
Bifidobacterium_indicum	1691	S	51	71	122	0.00001
Parascardovia_denticolens	78258	S	320	59	379	0.00002
Gardnerella_vaginalis	2702	S	28	34	62	0.00000
Gardnerella_piotii	2792977	S	13	27	40	0.00000
Scardovia_inopinata	78259	S	36	13	49	0.00000
Nakamurella_multipartita	53461	S	7926	1564	9490	0.00045
Nakamurella_panacisegetis	1090615	S	4019	612	4631	0.00022
Nakamurella_sp._PAMC28650	2762325	S	3607	424	4031	0.00019
Nakamurella_antarctica	1902245	S	678	53	731	0.00003
Catenulispora_acidiphila	304895	S	9476	1432	10908	0.00052
Jatrophihabitans_sp._GAS493	1907575	S	4144	411	4555	0.00022
Jatrophihabitans_telluris	2038343	S	3994	372	4366	0.00021
Stackebrandtia_nassauensis	283811	S	5989	564	6553	0.00031
Natronoglycomyces_albus	2811108	S	1015	36	1051	0.00005
Kineococcus_radiotolerans	131568	S	5595	1603	7198	0.00034
Epidermidibacterium_keratini	1891644	S	3538	1778	5316	0.00025
Actinopolyspora_erythraea	414996	S	3493	369	3862	0.00018
Acidothermus_cellulolyticus	28049	S	2387	123	2510	0.00012
Candidatus_Planktophila_versatilis	1884905	S	95	27	122	0.00001
Candidatus_Planktophila_lacus	1884913	S	79	15	94	0.00000
Candidatus_Planktophila_dulcis	1884914	S	60	48	108	0.00001
Candidatus_Planktophila_sulfonica	1884904	S	53	22	75	0.00000
Candidatus_Planktophila_limnetica	573600	S	36	7	43	0.00000
Candidatus_Planktophila_vernalis	1884907	S	17	4	21	0.00000
Candidatus_Nanopelagicus_hibericus	1884915	S	29	21	50	0.00000
Candidatus_Nanopelagicus_abundans	1884916	S	18	11	29	0.00000
Candidatus_Nanopelagicus_limnes	1884634	S	16	31	47	0.00000
Rubrobacter_xylanophilus	49319	S	29291	3921	33212	0.00158
Rubrobacter_tropicus	2653851	S	25682	2005	27687	0.00131
Rubrobacter_marinus	2653852	S	18978	1776	20754	0.00098
Rubrobacter_radiotolerans	42256	S	7072	998	8070	0.00038
Rubrobacter_indicoceani	2051957	S	3981	336	4317	0.00020
Baekduia_soli	496014	S	25191	4290	29481	0.00140
Conexibacter_sp._SYSU_D00693	2812560	S	27220	6628	33848	0.00161
Conexibacter_sp._DBS9H8	2937801	S	8129	774	8903	0.00042
Conexibacter_sp._S30A1	2937800	S	8083	853	8936	0.00042
Conexibacter_woesei	191495	S	34709	6202	40911	0.00194
Miltoncostaea_marina	2843215	S	12269	3154	15423	0.00073
Miltoncostaea_oceani	2843216	S	11343	1743	13086	0.00062
Aquihabitans_sp._G128	2849779	S	20529	4308	24837	0.00118
Aquihabitans_sp._Kera_3	2884263	S	19069	3185	22254	0.00106
Iamia_sp._SCSIO_61187	2722752	S	22646	3743	26389	0.00125
Actinomarinicola_tropica	2789776	S	21207	4320	25527	0.00121
Ilumatobacter_coccineus	467094	S	7029	437	7466	0.00035
Acidimicrobium_ferrooxidans	53635	S	2680	210	2890	0.00014
Eggerthella_lenta	84112	S	1556	1058	2614	0.00012
Eggerthella_guodeyinii	2690837	S	1380	637	2017	0.00010
Eggerthella_sp._YY7918	502558	S	371	166	537	0.00003
Gordonibacter_pamelaeae	471189	S	783	817	1600	0.00008
Gordonibacter_urolithinfaciens	1335613	S	701	520	1221	0.00006
Adlercreutzia_equolifaciens	446660	S	709	444	1153	0.00005
Adlercreutzia_hattorii	2707299	S	417	526	943	0.00004
Arabiibacter_massiliensis	1870985	S	1650	357	2007	0.00010
Berryella_intestinalis	1531429	S	906	1027	1933	0.00009
Raoultibacter_timonensis	1907662	S	882	70	952	0.00005
Slackia_heliotrinireducens	84110	S	604	19	623	0.00003
Denitrobacterium_detoxificans	79604	S	374	156	530	0.00003
Cryptobacterium_curtum	84163	S	89	9	98	0.00000
Phoenicibacter_congonensis	1944646	S	88	38	126	0.00001
Olsenella_timonensis	1805478	S	1521	456	1977	0.00009
Olsenella_uli	133926	S	826	81	907	0.00004
Olsenella_sp._oral_taxon_807	712411	S	544	30	574	0.00003
Parolsenella_massiliensis	1871022	S	841	448	1289	0.00006
Parolsenella_catena	2003188	S	660	379	1039	0.00005
Thermophilibacter_immobilis	2779519	S	1013	395	1408	0.00007
Parafannyhessea_umbonata	604330	S	903	537	1440	0.00007
Atopobium_sp._oral_taxon_416	712157	S	274	29	303	0.00001
Lancefieldella_parvula	1382	S	47	4	51	0.00000
Collinsella_aerofaciens	74426	S	1220	630	1850	0.00009
Collinsella_stercoris	147206	S	854	140	994	0.00005
Collinsella_sp._zg1085	2844380	S	71	3	74	0.00000
Coriobacterium_glomerans	33871	S	596	19	615	0.00003
Egicoccus_halophilus	1670830	S	7524	1204	8728	0.00041
Euzebya_pacifica	1608957	S	7387	648	8035	0.00038
Egibacter_rhizosphaerae	1670831	S	6973	433	7406	0.00035
Priestia_megaterium	1404	S	27122	33805	60927	0.00289
Priestia_filamentosa	1402861	S	6856	933	7789	0.00037
Priestia_aryabhattai	412384	S	749	3429	4178	0.00020
Priestia_flexa	86664	S	282	93	375	0.00002
Priestia_koreensis	284581	S	240	89	329	0.00002
Priestia_sp._J2	2886505	S	132	960	1092	0.00005
Bacillus_sp._S3	486398	S	1006	305	1311	0.00006
Bacillus_sp._Y1	352858	S	997	401	1398	0.00007
Bacillus_sp._1NLA3E	666686	S	441	162	603	0.00003
Bacillus_sp._JY-23	2933872	S	280	114	394	0.00002
Bacillus_sp._FJAT-18017	1705566	S	271	76	347	0.00002
Bacillus_sp._NSP9.1	1071078	S	212	18	230	0.00001
Bacillus_sp._KH172YL63	2709784	S	171	62	233	0.00001
Bacillus_sp._WP8	756828	S	170	241	411	0.00002
Bacillus_sp._OxB-1	98228	S	160	42	202	0.00001
Bacillus_sp._PAMC26568	2760090	S	153	16	169	0.00001
Bacillus_sp._FJAT-42376	2014076	S	140	55	195	0.00001
Bacillus_sp._SB49	1071080	S	123	22	145	0.00001
Bacillus_sp._FJAT-22090	1581038	S	122	35	157	0.00001
Bacillus_sp._THAF10	2587848	S	110	39	149	0.00001
Bacillus_sp._M4U3P1	2592382	S	91	12	103	0.00000
Bacillus_sp._N1-1	2682541	S	44	29	73	0.00000
Bacillus_sp._Cs-700	2589818	S	36	25	61	0.00000
Bacillus_sp._H8-1	2930532	S	29	470	499	0.00002
Bacillus_sp._275	1941347	S	26	3354	3380	0.00016
Bacillus_sp._N447-1	2789208	S	20	213	233	0.00001
Bacillus_sp._ZJS3	2928154	S	17	43	60	0.00000
Bacillus_sp._NP247	2846779	S	12	18	30	0.00000
Bacillus_sp._N3536	2666127	S	12	15	27	0.00000
Bacillus_sp._BD59S	2499213	S	12	19	31	0.00000
Bacillus_sp._PGP15	2933563	S	10	49	59	0.00000
Bacillus_sp._MBGLi79	2070759	S	10	67	77	0.00000
Bacillus_thuringiensis	1428	S	842	34613	35455	0.00168
Bacillus_cereus	1396	S	679	14142	14821	0.00070
Bacillus_pseudomycoides	64104	S	340	161	501	0.00002
Bacillus_mycoides	1405	S	245	373	618	0.00003
Bacillus_cytotoxicus	580165	S	187	127	314	0.00001
Bacillus_wiedmannii	1890302	S	75	125	200	0.00001
Bacillus_luti	2026191	S	30	32	62	0.00000
Bacillus_anthracis	1392	S	29	2867	2896	0.00014
Bacillus_sp._ABP14	1892404	S	15	93	108	0.00001
Bacillus_toyonensis	155322	S	21	163	184	0.00001
Bacillus_nitratireducens	2026193	S	15	27	42	0.00000
Bacillus_paranthracis	2026186	S	13	334	347	0.00002
Bacillus_albus	2026189	S	10	47	57	0.00000
Bacillus_velezensis	492670	S	290	5477	5767	0.00027
Bacillus_amyloliquefaciens	1390	S	144	3903	4047	0.00019
Bacillus_siamensis	659243	S	40	130	170	0.00001
Bacillus_subtilis	1423	S	636	15714	16350	0.00078
Bacillus_paralicheniformis	1648923	S	373	254	627	0.00003
Bacillus_mojavensis	72360	S	68	83	151	0.00001
Bacillus_halotolerans	260554	S	36	94	130	0.00001
Bacillus_atrophaeus	1452	S	90	134	224	0.00001
Bacillus_vallismortis	72361	S	80	102	182	0.00001
Bacillus_tequilensis	227866	S	66	63	129	0.00001
Bacillus_licheniformis	1402	S	48	1188	1236	0.00006
Bacillus_inaquosorum	483913	S	19	179	198	0.00001
Bacillus_spizizenii	96241	S	11	40	51	0.00000
[Brevibacterium]_frigoritolerans	450367	S	453	167	620	0.00003
Bacillus_safensis	561879	S	430	667	1097	0.00005
Bacillus_glycinifermentans	1664069	S	329	114	443	0.00002
Bacillus_dafuensis	1742359	S	318	122	440	0.00002
Bacillus_methanolicus	1471	S	262	140	402	0.00002
Bacillus_badius	1455	S	238	101	339	0.00002
Bacillus_pumilus	1408	S	223	213	436	0.00002
Bacillus_infantis	324767	S	220	66	286	0.00001
Bacillus_altitudinis	293387	S	177	763	940	0.00004
Bacillus_gobiensis	1441095	S	188	59	247	0.00001
Bacillus_cabrialesii	2487276	S	165	169	334	0.00002
Bacillus_weihaiensis	1547283	S	146	53	199	0.00001
Bacillus_aquiflavi	2672567	S	118	33	151	0.00001
Bacillus_fonticola	2728853	S	112	33	145	0.00001
Bacillus_smithii	1479	S	105	63	168	0.00001
Bacillus_shivajii	1983719	S	83	13	96	0.00000
Bacillus_rugosus	2715209	S	50	54	104	0.00000
Metabacillus_sediminilitoris	2567941	S	2032	801	2833	0.00013
Metabacillus_sp._KUDC1714	2745198	S	905	327	1232	0.00006
Metabacillus_sp._cB07	2806989	S	128	51	179	0.00001
Metabacillus_sp._B2-18	2897333	S	81	113	194	0.00001
Metabacillus_dongyingensis	2874282	S	305	113	418	0.00002
Metabacillus_litoralis	152268	S	99	95	194	0.00001
Metabacillus_endolithicus	1535204	S	84	99	183	0.00001
Geobacillus_subterraneus	129338	S	653	470	1123	0.00005
Geobacillus_genomosp._3	1921421	S	328	108	436	0.00002
Geobacillus_stearothermophilus	1422	S	294	412	706	0.00003
Geobacillus_sp._46C-IIa	1963025	S	149	74	223	0.00001
Geobacillus_sp._C56-T3	691437	S	30	127	157	0.00001
Geobacillus_sp._JS12	1813182	S	30	101	131	0.00001
Geobacillus_sp._Y412MC52	550542	S	21	73	94	0.00000
Geobacillus_sp._GHH01	1233873	S	18	180	198	0.00001
Geobacillus_thermocatenulatus	33938	S	130	139	269	0.00001
Geobacillus_thermoleovorans	33941	S	36	407	443	0.00002
Geobacillus_kaustophilus	1462	S	13	99	112	0.00001
[Bacillus]_caldolyticus	1394	S	12	140	152	0.00001
Geobacillus_thermodenitrificans	33940	S	37	238	275	0.00001
Geobacillus_zalihae	213419	S	24	172	196	0.00001
Cytobacillus_oceanisediminis	665099	S	1703	918	2621	0.00012
Cytobacillus_ciccensis	1670641	S	284	111	395	0.00002
Cytobacillus_gottheilii	859144	S	257	90	347	0.00002
Cytobacillus_firmus	1399	S	218	112	330	0.00002
Cytobacillus_sp._CY-G	2901381	S	162	61	223	0.00001
Cytobacillus_kochii	859143	S	107	35	142	0.00001
Hydrogenibacillus_sp._N12	2866627	S	2475	335	2810	0.00013
Peribacillus_asahii	228899	S	1132	601	1733	0.00008
Peribacillus_simplex	1478	S	424	268	692	0.00003
Peribacillus_butanolivorans	421767	S	261	93	354	0.00002
Peribacillus_muralis	264697	S	195	49	244	0.00001
Peribacillus_psychrosaccharolyticus	1407	S	128	47	175	0.00001
Neobacillus_drentensis	220684	S	1519	707	2226	0.00011
Neobacillus_mesonae	1193713	S	608	218	826	0.00004
Alkalihalobacillus_clausii	79880	S	1541	349	1890	0.00009
Alkalihalobacillus_lehensis	300825	S	201	56	257	0.00001
Alkalihalobacillus_krulwichiae	199441	S	107	34	141	0.00001
Alkalihalobacillus_sp._LMS39	2924032	S	90	20	110	0.00001
Alkalihalobacillus_miscanthi	2598861	S	53	15	68	0.00000
Anoxybacillus_sediminis	2613334	S	1092	268	1360	0.00006
Anoxybacillus_sp._PDR2	1636720	S	36	152	188	0.00001
Anoxybacillus_flavithermus	33934	S	158	133	291	0.00001
Anoxybacillus_caldiproteolyticus	247480	S	137	32	169	0.00001
Anoxybacillus_amylolyticus	294699	S	132	30	162	0.00001
Anoxybacillus_kamchatkensis	196180	S	16	109	125	0.00001
Mesobacillus_foraminis	279826	S	861	244	1105	0.00005
Mesobacillus_jeotgali	129985	S	214	100	314	0.00001
Mesobacillus_sp._S13	2880221	S	187	96	283	0.00001
Terribacillus_goriensis	386490	S	1077	188	1265	0.00006
Terribacillus_aidingensis	586416	S	93	16	109	0.00001
Lysinibacillus_sp._SGAir0095	2070463	S	140	61	201	0.00001
Lysinibacillus_sp._PLM2	2929796	S	68	29	97	0.00000
Lysinibacillus_sp._CD3-6	2892541	S	61	25	86	0.00000
Lysinibacillus_sp._2017	2169540	S	52	25	77	0.00000
Lysinibacillus_sp._Ag94	2936682	S	43	5	48	0.00000
Lysinibacillus_sp._YS11	2072025	S	30	86	116	0.00001
Lysinibacillus_sp._ACHW1.5	2913506	S	12	30	42	0.00000
Lysinibacillus_timonensis	2086577	S	112	61	173	0.00001
Lysinibacillus_fusiformis	28031	S	85	95	180	0.00001
Lysinibacillus_parviboronicapiens	436516	S	62	23	85	0.00000
Lysinibacillus_sphaericus	1421	S	60	77	137	0.00001
Lysinibacillus_agricola	2590012	S	47	15	62	0.00000
Parageobacillus_caldoxylosilyticus	81408	S	157	73	230	0.00001
Parageobacillus_thermoglucosidasius	1426	S	154	93	247	0.00001
Parageobacillus_genomosp._1	1295642	S	153	64	217	0.00001
Parageobacillus_toebii	153151	S	115	87	202	0.00001
Parageobacillus_sp._KH3-4	2916802	S	86	41	127	0.00001
Niallia_sp._Man26	2912824	S	374	90	464	0.00002
Niallia_circulans	1397	S	367	111	478	0.00002
Virgibacillus_sp._NKC19-16	2831673	S	90	8	98	0.00000
Virgibacillus_sp._MSP4-1	2700081	S	55	12	67	0.00000
Virgibacillus_sp._Bac332	2419842	S	51	6	57	0.00000
Virgibacillus_sp._Bac330	2419841	S	22	29	51	0.00000
Virgibacillus_sp._SK37	403957	S	19	23	42	0.00000
Virgibacillus_necropolis	163877	S	84	13	97	0.00000
Virgibacillus_phasianinus	2017483	S	65	9	74	0.00000
Virgibacillus_halodenitrificans	1482	S	44	37	81	0.00000
Virgibacillus_dokdonensis	302167	S	19	27	46	0.00000
Halobacillus_sp._SSBR10-3	2932257	S	86	11	97	0.00000
Halobacillus_sp._SSTM10-2	2932258	S	71	16	87	0.00000
Halobacillus_sp._SSHM10-5	2932259	S	61	15	76	0.00000
Halobacillus_halophilus	1570	S	87	12	99	0.00000
Halobacillus_mangrovi	402384	S	80	12	92	0.00000
Halobacillus_litoralis	45668	S	57	9	66	0.00000
Weizmannia_coagulans	1398	S	453	217	670	0.00003
Rossellomorea_marisflavi	189381	S	331	136	467	0.00002
Rossellomorea_vietnamensis	218284	S	113	46	159	0.00001
Heyndrickxia_oleronia	38875	S	265	106	371	0.00002
Heyndrickxia_vini	1476025	S	156	48	204	0.00001
Salicibibacter_halophilus	2502791	S	97	32	129	0.00001
Salicibibacter_kimchii	2099786	S	96	10	106	0.00001
Salicibibacter_cibarius	2743000	S	83	25	108	0.00001
Salicibibacter_cibi	2743001	S	72	13	85	0.00000
Salisediminibacterium_selenitireducens	85683	S	169	26	195	0.00001
Salisediminibacterium_beveridgei	632773	S	154	23	177	0.00001
Sutcliffiella_horikoshii	79883	S	183	52	235	0.00001
Sutcliffiella_cohnii	33932	S	123	56	179	0.00001
Oceanobacillus_zhaokaii	2052660	S	119	24	143	0.00001
Oceanobacillus_kimchii	746691	S	80	13	93	0.00000
Oceanobacillus_iheyensis	182710	S	54	15	69	0.00000
Lentibacillus_sp._CBA3610	2518176	S	117	11	128	0.00001
Lentibacillus_amyloliquefaciens	1472767	S	85	11	96	0.00000
Gracilibacillus_sp._SSWR10-1	2932256	S	67	14	81	0.00000
Gracilibacillus_sp._SSPM10-3	2932255	S	45	9	54	0.00000
Gracilibacillus_salitolerans	2663022	S	84	10	94	0.00000
Fictibacillus_arsenicus	255247	S	100	19	119	0.00001
Fictibacillus_phosphorivorans	1221500	S	91	16	107	0.00001
Gottfriedia_acidiceleris	371036	S	181	57	238	0.00001
Psychrobacillus_sp._INOP01	2829187	S	76	26	102	0.00000
Psychrobacillus_sp._AK_1817	2303505	S	13	16	29	0.00000
Psychrobacillus_glaciei	2283160	S	83	29	112	0.00001
Caldalkalibacillus_thermarum	296745	S	154	30	184	0.00001
Caldibacillus_thermoamylovorans	35841	S	144	53	197	0.00001
Lederbergia_lenta	1467	S	140	37	177	0.00001
Salimicrobium_jeotgali	1230341	S	126	20	146	0.00001
Pontibacillus_sp._ALD_SL1	2777185	S	65	10	75	0.00000
Pontibacillus_sp._HMF3514	2692425	S	53	9	62	0.00000
Halalkalibacterium_halodurans	86665	S	117	94	211	0.00001
Sediminibacillus_sp._DP4-553-S	2729421	S	116	21	137	0.00001
Aeribacillus_pallidus	33936	S	111	56	167	0.00001
Anaerobacillus_isosaccharinicus	1532552	S	110	26	136	0.00001
Radiobacillus_sp._80	2844358	S	70	14	84	0.00000
Radiobacillus_deserti	2594883	S	39	7	46	0.00000
Pradoshia_sp._D12	2651284	S	94	29	123	0.00001
Alkalihalophilus_pseudofirmus	79885	S	93	17	110	0.00001
Mangrovibacillus_cuniculi	2593652	S	79	45	124	0.00001
Evansella_cellulosilytica	1413	S	57	9	66	0.00000
Paraliobacillus_zengyii	2213194	S	47	8	55	0.00000
Amphibacillus_xylanus	1449	S	40	7	47	0.00000
Paenibacillus_sp._B01	2660554	S	2622	832	3454	0.00016
Paenibacillus_sp._RUD330	2023772	S	1524	166	1690	0.00008
Paenibacillus_sp._32O-W	1695218	S	1310	131	1441	0.00007
Paenibacillus_sp._H1-7	2282849	S	768	72	840	0.00004
Paenibacillus_sp._R14(2021)	2859228	S	652	93	745	0.00004
Paenibacillus_sp._YPD9-1	2908839	S	577	74	651	0.00003
Paenibacillus_sp._sptzw28	715179	S	538	50	588	0.00003
Paenibacillus_sp._JZ16	1906272	S	460	110	570	0.00003
Paenibacillus_sp._BIHB4019	1870819	S	411	33	444	0.00002
Paenibacillus_sp._URB8-2	2741301	S	387	91	478	0.00002
Paenibacillus_sp._JNUCC-32	2777984	S	381	765	1146	0.00005
Paenibacillus_sp._Y412MC10	481743	S	373	707	1080	0.00005
Paenibacillus_sp._FSL_R7-0273	1536772	S	369	61	430	0.00002
Paenibacillus_sp._HWE-109	1306526	S	356	31	387	0.00002
Paenibacillus_sp._PK3_47	2072642	S	343	49	392	0.00002
Paenibacillus_sp._CAA11	1532905	S	279	56	335	0.00002
Paenibacillus_sp._FSL_H7-0357	1536774	S	272	37	309	0.00001
Paenibacillus_sp._FSL_R7-0331	1536773	S	266	46	312	0.00001
Paenibacillus_sp._PAMC21692	2762320	S	260	214	474	0.00002
Paenibacillus_sp._YPG26	2878915	S	222	45	267	0.00001
Paenibacillus_sp._FSL_R5-0912	1536771	S	174	85	259	0.00001
Paenibacillus_sp._FSL_P4-0081	1536769	S	161	87	248	0.00001
Paenibacillus_sp._481	2835869	S	153	15	168	0.00001
Paenibacillus_sp._19GGS1-52	2758563	S	150	15	165	0.00001
Paenibacillus_sp._IHB_B_3084	867076	S	141	79	220	0.00001
Paenibacillus_sp._DCT19	2211212	S	116	19	135	0.00001
Paenibacillus_sp._JNUCC-31	2777983	S	111	30	141	0.00001
Paenibacillus_sp._E222	2748863	S	90	30	120	0.00001
Paenibacillus_sp._N3/727	2925845	S	85	100	185	0.00001
Paenibacillus_sp._IHBB_10380	1566358	S	76	14	90	0.00000
Paenibacillus_sp._FSL_H7-0737	1536775	S	64	19	83	0.00000
Paenibacillus_sp._Cedars	1980674	S	53	298	351	0.00002
Paenibacillus_sp._FSL_R5-0345	1536770	S	51	14	65	0.00000
Paenibacillus_sp._S25	2823905	S	17	262	279	0.00001
Paenibacillus_sp._M-152	2487928	S	15	222	237	0.00001
Paenibacillus_sp._S02	2823904	S	14	108	122	0.00001
Paenibacillus_sp._37	2607911	S	12	145	157	0.00001
Paenibacillus_sp._lzh-N1	2069255	S	11	176	187	0.00001
Paenibacillus_mucilaginosus	61624	S	2883	186	3069	0.00015
Paenibacillus_albicereus	2726185	S	2331	674	3005	0.00014
Paenibacillus_lycopersici	2704462	S	1836	228	2064	0.00010
Paenibacillus_macerans	44252	S	1099	102	1201	0.00006
Paenibacillus_konkukensis	2020716	S	1053	118	1171	0.00006
Paenibacillus_cellulositrophicus	562959	S	1011	102	1113	0.00005
Paenibacillus_rhizovicinus	2704463	S	985	133	1118	0.00005
Paenibacillus_dendritiformis	130049	S	919	158	1077	0.00005
Paenibacillus_beijingensis	1126833	S	810	96	906	0.00004
Paenibacillus_ihbetae	1870820	S	780	112	892	0.00004
Paenibacillus_stellifer	169760	S	675	123	798	0.00004
Paenibacillus_chitinolyticus	79263	S	655	81	736	0.00003
Paenibacillus_thiaminolyticus	49283	S	636	108	744	0.00004
Paenibacillus_lautus	1401	S	592	711	1303	0.00006
Paenibacillus_durus	44251	S	577	213	790	0.00004
Paenibacillus_cellulosilyticus	375489	S	489	63	552	0.00003
Paenibacillus_sabinae	365617	S	471	117	588	0.00003
Paenibacillus_naphthalenovorans	162209	S	440	64	504	0.00002
Paenibacillus_albus	2495582	S	427	58	485	0.00002
Paenibacillus_donghaensis	414771	S	427	46	473	0.00002
Paenibacillus_polymyxa	1406	S	390	1279	1669	0.00008
Paenibacillus_tritici	1873425	S	376	57	433	0.00002
Paenibacillus_protaetiae	2509456	S	373	56	429	0.00002
Paenibacillus_azoreducens	116718	S	362	43	405	0.00002
Paenibacillus_riograndensis	483937	S	128	125	253	0.00001
Paenibacillus_sonchi	373687	S	94	167	261	0.00001
Paenibacillus_physcomitrellae	1619311	S	302	103	405	0.00002
Paenibacillus_xylanilyticus	248903	S	301	64	365	0.00002
Paenibacillus_agaridevorans	171404	S	297	340	637	0.00003
Paenibacillus_algicola	2565926	S	287	48	335	0.00002
Paenibacillus_sophorae	1333845	S	284	100	384	0.00002
Paenibacillus_yonginensis	1462996	S	281	125	406	0.00002
Paenibacillus_swuensis	1178515	S	273	40	313	0.00001
Paenibacillus_tianjinensis	2810347	S	256	44	300	0.00001
Paenibacillus_guangzhouensis	1473112	S	252	25	277	0.00001
Paenibacillus_lutimineralis	2707005	S	241	33	274	0.00001
Paenibacillus_borealis	160799	S	222	76	298	0.00001
Paenibacillus_alvei	44250	S	209	28	237	0.00001
Paenibacillus_lentus	1338368	S	201	21	222	0.00001
Paenibacillus_jilunlii	682956	S	195	130	325	0.00002
Paenibacillus_baekrokdamisoli	1712516	S	191	20	211	0.00001
Paenibacillus_kribbensis	172713	S	191	71	262	0.00001
Paenibacillus_psychroresistens	1778678	S	186	11	197	0.00001
Paenibacillus_graminis	189425	S	170	87	257	0.00001
Paenibacillus_bovis	1616788	S	163	22	185	0.00001
Paenibacillus_brasilensis	128574	S	151	69	220	0.00001
Paenibacillus_barcinonensis	198119	S	150	26	176	0.00001
Paenibacillus_odorifer	189426	S	145	26	171	0.00001
Paenibacillus_larvae	1464	S	120	15	135	0.00001
Paenibacillus_terrae	159743	S	103	49	152	0.00001
Paenibacillus_crassostreae	1763538	S	96	15	111	0.00001
Paenibacillus_pabuli	1472	S	84	30	114	0.00001
Paenibacillus_uliginis	683737	S	72	75	147	0.00001
Paenibacillus_xylanexedens	528191	S	65	45	110	0.00001
Paenibacillus_antarcticus	253703	S	62	10	72	0.00000
Paenibacillus_peoriae	59893	S	59	332	391	0.00002
Paenibacillus_glucanolyticus	59843	S	48	278	326	0.00002
Brevibacillus_marinus	2496837	S	1082	176	1258	0.00006
Brevibacillus_agri	51101	S	773	191	964	0.00005
Brevibacillus_composti	2796470	S	722	181	903	0.00004
Brevibacillus_choshinensis	54911	S	533	121	654	0.00003
Brevibacillus_sp._MMS20-4M-10-Y	2895522	S	388	52	440	0.00002
Brevibacillus_sp._HD3.3A	2738979	S	67	290	357	0.00002
Brevibacillus_sp._DP1.3A	2738867	S	54	49	103	0.00000
Brevibacillus_sp._7WMA2	2683193	S	10	48	58	0.00000
Brevibacillus_brevis	1393	S	471	254	725	0.00003
Brevibacillus_laterosporus	1465	S	168	212	380	0.00002
Brevibacillus_formosus	54913	S	73	64	137	0.00001
Brevibacillus_parabrevis	54914	S	73	327	400	0.00002
Cohnella_candidum	2674991	S	1359	178	1537	0.00007
Cohnella_sp._LGH	1619153	S	826	318	1144	0.00005
Cohnella_sp._MFER-1	2728023	S	462	66	528	0.00003
Cohnella_cholangitidis	2598458	S	485	91	576	0.00003
Cohnella_abietis	2507935	S	132	15	147	0.00001
Thermobacillus_composti	377615	S	2463	364	2827	0.00013
Saccharibacillus_brassicae	2583377	S	1468	179	1647	0.00008
Aneurinibacillus_soli	1500254	S	247	313	560	0.00003
Alicyclobacillus_acidocaldarius	405212	S	2754	244	2998	0.00014
Alicyclobacillus_acidoterrestris	1450	S	328	53	381	0.00002
Alicyclobacillus_mengziensis	2931921	S	301	21	322	0.00002
Alicyclobacillus_sp._SO9	2665646	S	149	11	160	0.00001
Alicyclobacillus_sp._TC	2606450	S	57	7	64	0.00000
Tumebacillus_avium	1903704	S	1817	811	2628	0.00012
Tumebacillus_algifaecis	1214604	S	692	260	952	0.00005
Kyrpidia_spormannii	2055160	S	344	197	541	0.00003
Kyrpidia_tusciae	33943	S	278	226	504	0.00002
Effusibacillus_dendaii	2743772	S	215	28	243	0.00001
Planococcus_plakortidis	1038856	S	270	158	428	0.00002
Planococcus_lenghuensis	2213202	S	212	48	260	0.00001
Planococcus_sp._MB-3u-03	2058136	S	106	67	173	0.00001
Planococcus_sp._107-1	2908840	S	71	31	102	0.00000
Planococcus_sp._PAMC_21323	1526927	S	26	12	38	0.00000
Planococcus_glaciei	459472	S	185	58	243	0.00001
Planococcus_maritimus	192421	S	158	69	227	0.00001
Planococcus_rifietoensis	200991	S	139	94	233	0.00001
Planococcus_halotolerans	2233542	S	112	37	149	0.00001
Planococcus_massiliensis	1499687	S	107	22	129	0.00001
Planococcus_antarcticus	161360	S	56	18	74	0.00000
Planococcus_halocryophilus	1215089	S	42	21	63	0.00000
Planococcus_donghaensis	414778	S	41	23	64	0.00000
Planococcus_versutus	1302659	S	41	19	60	0.00000
Planococcus_faecalis	1598147	S	11	32	43	0.00000
Sporosarcina_sp._Te-1	2818390	S	81	20	101	0.00000
Sporosarcina_sp._Marseille-Q4063	2810514	S	65	12	77	0.00000
Sporosarcina_sp._PTS2304	2283194	S	47	14	61	0.00000
Sporosarcina_sp._resist	2762563	S	20	62	82	0.00000
Sporosarcina_sp._P33	1930764	S	15	45	60	0.00000
Sporosarcina_sp._P37	1930546	S	11	30	41	0.00000
Sporosarcina_ureae	1571	S	136	40	176	0.00001
Sporosarcina_pasteurii	1474	S	35	11	46	0.00000
Sporosarcina_ureilytica	298596	S	23	7	30	0.00000
Sporosarcina_psychrophila	1476	S	10	37	47	0.00000
Solibacillus_silvestris	76853	S	83	34	117	0.00001
Solibacillus_sp._R5-41	2048654	S	42	20	62	0.00000
Ureibacillus_thermosphaericus	51173	S	61	74	135	0.00001
Ureibacillus_thermophilus	367743	S	44	24	68	0.00000
Paenisporosarcina_antarctica	417367	S	47	16	63	0.00000
Paenisporosarcina_cavernae	2320858	S	32	20	52	0.00000
Rummeliibacillus_stabekisii	241244	S	54	29	83	0.00000
Jeotgalibacillus_malaysiensis	1508404	S	51	18	69	0.00000
Kurthia_sp._11kri321	1750719	S	21	18	39	0.00000
Kurthia_zopfii	1650	S	17	13	30	0.00000
Viridibacillus_sp._JNUCC-6	2779527	S	45	18	63	0.00000
Staphylospora_marina	2490858	S	813	133	946	0.00004
Kroppenstedtia_eburnea	714067	S	514	54	568	0.00003
Kroppenstedtia_pulmonis	1380685	S	121	9	130	0.00001
Novibacillus_thermophilus	1471761	S	569	78	647	0.00003
Polycladomyces_abyssicola	1125966	S	350	33	383	0.00002
Laceyella_sacchari	37482	S	252	59	311	0.00001
Thermoactinomyces_vulgaris	2026	S	176	36	212	0.00001
Exiguobacterium_alkaliphilum	1428684	S	336	117	453	0.00002
Exiguobacterium_sp._Helios	2735868	S	70	34	104	0.00000
Exiguobacterium_sp._N4-1P	2051906	S	67	43	110	0.00001
Exiguobacterium_sp._AT1b	360911	S	39	40	79	0.00000
Exiguobacterium_sp._PFWT01	2829816	S	30	32	62	0.00000
Exiguobacterium_sp._MH3	1399115	S	27	43	70	0.00000
Exiguobacterium_mexicanum	340146	S	275	102	377	0.00002
Exiguobacterium_acetylicum	41170	S	102	194	296	0.00001
Exiguobacterium_antarcticum	132920	S	84	32	116	0.00001
Exiguobacterium_sibiricum	332410	S	74	39	113	0.00001
Gemella_haemolysans	1379	S	13	9	22	0.00000
Gemella_sanguinis	84135	S	10	11	21	0.00000
Staphylococcus_aureus	1280	S	105	6964	7069	0.00034
Staphylococcus_sp._CCM_9025	2892440	S	22	9	31	0.00000
Staphylococcus_sp._17KM0847	2583989	S	13	6	19	0.00000
Staphylococcus_pseudintermedius	283734	S	26	24	50	0.00000
Staphylococcus_delphini	53344	S	13	9	22	0.00000
Staphylococcus_epidermidis	1282	S	40	32	72	0.00000
Staphylococcus_pettenkoferi	170573	S	37	9	46	0.00000
Staphylococcus_haemolyticus	1283	S	31	31	62	0.00000
Staphylococcus_pseudoxylosus	2282419	S	27	13	40	0.00000
Staphylococcus_capitis	29388	S	23	24	47	0.00000
Staphylococcus_saprophyticus	29385	S	23	10	33	0.00000
Staphylococcus_succinus	61015	S	21	7	28	0.00000
Staphylococcus_warneri	1292	S	20	25	45	0.00000
Staphylococcus_hominis	1290	S	19	14	33	0.00000
Staphylococcus_nepalensis	214473	S	19	6	25	0.00000
Staphylococcus_chromogenes	46126	S	18	8	26	0.00000
Staphylococcus_lugdunensis	28035	S	18	8	26	0.00000
Staphylococcus_schleiferi	1295	S	18	25	43	0.00000
Staphylococcus_agnetis	985762	S	18	6	24	0.00000
Staphylococcus_lutrae	155085	S	16	7	23	0.00000
Staphylococcus_hyicus	1284	S	16	7	23	0.00000
Staphylococcus_simiae	308354	S	15	8	23	0.00000
Staphylococcus_carnosus	1281	S	15	72	87	0.00000
Staphylococcus_simulans	1286	S	15	5	20	0.00000
Staphylococcus_lloydii	2781774	S	14	6	20	0.00000
Staphylococcus_piscifermentans	70258	S	14	5	19	0.00000
Staphylococcus_auricularis	29379	S	14	5	19	0.00000
Staphylococcus_equorum	246432	S	13	16	29	0.00000
Staphylococcus_roterodami	2699836	S	13	11	24	0.00000
Staphylococcus_xylosus	1288	S	13	5	18	0.00000
Staphylococcus_debuckii	2044912	S	13	5	18	0.00000
Staphylococcus_muscae	1294	S	13	5	18	0.00000
Staphylococcus_pasteuri	45972	S	13	10	23	0.00000
Staphylococcus_gallinarum	1293	S	12	0	12	0.00000
Staphylococcus_arlettae	29378	S	11	7	18	0.00000
Staphylococcus_caprae	29380	S	10	6	16	0.00000
Staphylococcus_felis	46127	S	10	4	14	0.00000
Macrococcus_brunensis	198483	S	41	12	53	0.00000
Macrococcus_canis	1855823	S	27	11	38	0.00000
Macrococcus_caseolyticus	69966	S	25	43	68	0.00000
Macrococcus_armenti	2875764	S	17	7	24	0.00000
Jeotgalicoccus_sp._WY2	2708346	S	54	9	63	0.00000
Jeotgalicoccus_saudimassiliensis	1461582	S	42	3	45	0.00000
Salinicoccus_halodurans	407035	S	73	22	95	0.00000
Mammaliicoccus_sciuri	1296	S	29	17	46	0.00000
Mammaliicoccus_lentus	42858	S	11	7	18	0.00000
Mammaliicoccus_vitulinus	71237	S	10	4	14	0.00000
Nosocomiicoccus_ampullae	489910	S	20	3	23	0.00000
Abyssicoccus_albus	1817405	S	15	4	19	0.00000
Listeria_monocytogenes	1639	S	83	2155	2238	0.00011
Listeria_innocua	1642	S	61	66	127	0.00001
Listeria_weihenstephanensis	1006155	S	59	13	72	0.00000
Listeria_ivanovii	1638	S	36	9	45	0.00000
Listeria_grayi	1641	S	34	10	44	0.00000
Listeria_seeligeri	1640	S	27	9	36	0.00000
Listeria_sp._PSOL-1	1844999	S	23	6	29	0.00000
Listeria_welshimeri	1643	S	13	8	21	0.00000
Listeria_marthii	529731	S	10	3	13	0.00000
Brochothrix_thermosphacta	2756	S	35	11	46	0.00000
Sporolactobacillus_terrae	269673	S	133	19	152	0.00001
Limosilactobacillus_fermentum	1613	S	239	219	458	0.00002
Limosilactobacillus_pontis	35787	S	194	107	301	0.00001
Limosilactobacillus_mucosae	97478	S	92	48	140	0.00001
Limosilactobacillus_panis	47493	S	57	25	82	0.00000
Limosilactobacillus_reuteri	1598	S	50	49	99	0.00000
Limosilactobacillus_frumenti	104955	S	11	4	15	0.00000
Limosilactobacillus_gastricus	227942	S	10	4	14	0.00000
Lactobacillus_delbrueckii	1584	S	212	421	633	0.00003
Lactobacillus_sp._3B(2020)	2695882	S	18	5	23	0.00000
Lactobacillus_sp._CBA3606	2099789	S	12	12	24	0.00000
Lactobacillus_panisapium	2012495	S	42	7	49	0.00000
Lactobacillus_iners	147802	S	20	27	47	0.00000
Lactobacillus_acidophilus	1579	S	19	121	140	0.00001
Lactobacillus_acetotolerans	1600	S	18	4	22	0.00000
Lactobacillus_amylolyticus	83683	S	17	8	25	0.00000
Lactobacillus_kefiranofaciens	267818	S	13	16	29	0.00000
Lactobacillus_kullabergensis	1218493	S	13	2	15	0.00000
Lactobacillus_jensenii	109790	S	12	3	15	0.00000
Lactobacillus_helveticus	1587	S	11	66	77	0.00000
Lactobacillus_amylovorus	1604	S	11	24	35	0.00000
Lactobacillus_crispatus	47770	S	11	5	16	0.00000
Levilactobacillus_zymae	267363	S	222	68	290	0.00001
Levilactobacillus_brevis	1580	S	113	38	151	0.00001
Levilactobacillus_suantsaii	2292255	S	78	28	106	0.00001
Levilactobacillus_koreensis	637971	S	62	8	70	0.00000
Lacticaseibacillus_rhamnosus	47715	S	76	23	99	0.00000
Lacticaseibacillus_casei	1582	S	70	23	93	0.00000
Lacticaseibacillus_paracasei	1597	S	49	174	223	0.00001
Lacticaseibacillus_zeae	57037	S	48	19	67	0.00000
Lacticaseibacillus_manihotivorans	88233	S	36	10	46	0.00000
Lacticaseibacillus_chiayiensis	2100821	S	34	5	39	0.00000
Schleiferilactobacillus_harbinensis	304207	S	224	24	248	0.00001
Lactiplantibacillus_pentosus	1589	S	88	25	113	0.00001
Lactiplantibacillus_plantarum	1590	S	45	61	106	0.00001
Lactiplantibacillus_paraplantarum	60520	S	23	6	29	0.00000
Weissella_confusa	1583	S	29	26	55	0.00000
Weissella_cibaria	137591	S	27	23	50	0.00000
Weissella_soli	155866	S	17	5	22	0.00000
Weissella_diestrammenae	1162633	S	14	4	18	0.00000
Weissella_paramesenteroides	1249	S	10	12	22	0.00000
Ligilactobacillus_ruminis	1623	S	69	24	93	0.00000
Ligilactobacillus_salivarius	1624	S	25	22	47	0.00000
Ligilactobacillus_animalis	1605	S	16	21	37	0.00000
Ligilactobacillus_acidipiscis	89059	S	14	5	19	0.00000
Ligilactobacillus_agilis	1601	S	13	8	21	0.00000
Ligilactobacillus_saerimneri	228229	S	13	15	28	0.00000
Leuconostoc_lactis	1246	S	45	39	84	0.00000
Leuconostoc_pseudomesenteroides	33968	S	32	21	53	0.00000
Leuconostoc_mesenteroides	1245	S	15	15	30	0.00000
Leuconostoc_gelidum	1244	S	12	1	13	0.00000
Lentilactobacillus_buchneri	1581	S	31	11	42	0.00000
Lentilactobacillus_parabuchneri	152331	S	25	7	32	0.00000
Lentilactobacillus_hilgardii	1588	S	24	5	29	0.00000
Lentilactobacillus_kefiri	33962	S	17	5	22	0.00000
Lentilactobacillus_curieae	1138822	S	13	2	15	0.00000
Pediococcus_acidilactici	1254	S	55	26	81	0.00000
Pediococcus_pentosaceus	1255	S	13	6	19	0.00000
Pediococcus_damnosus	51663	S	12	6	18	0.00000
Pediococcus_inopinatus	114090	S	11	7	18	0.00000
Pediococcus_claussenii	187452	S	10	3	13	0.00000
Oenococcus_kitaharae	336988	S	45	3	48	0.00000
Oenococcus_oeni	1247	S	23	9	32	0.00000
Oenococcus_sp._UCMA_16435	2259623	S	11	2	13	0.00000
Oenococcus_sicerae	2203724	S	10	0	10	0.00000
Loigolactobacillus_coryniformis	1610	S	48	47	95	0.00000
Loigolactobacillus_bifermentans	1607	S	22	6	28	0.00000
Loigolactobacillus_backii	375175	S	15	7	22	0.00000
Latilactobacillus_sakei	1599	S	29	12	41	0.00000
Latilactobacillus_curvatus	28038	S	20	10	30	0.00000
Latilactobacillus_graminis	60519	S	19	6	25	0.00000
Latilactobacillus_fuchuensis	164393	S	10	0	10	0.00000
Secundilactobacillus_paracollinoides	240427	S	56	21	77	0.00000
Secundilactobacillus_malefermentans	176292	S	19	8	27	0.00000
Companilactobacillus_paralimentarius	83526	S	11	15	26	0.00000
Liquorilactobacillus_nagelii	82688	S	14	7	21	0.00000
Liquorilactobacillus_hordei	468911	S	12	8	20	0.00000
Liquorilactobacillus_mali	1618	S	10	5	15	0.00000
Periweissella_cryptocerci	2506420	S	28	3	31	0.00000
Furfurilactobacillus_rossiae	231049	S	27	4	31	0.00000
Paucilactobacillus_hokkaidonensis	1193095	S	13	5	18	0.00000
Amylolactobacillus_amylophilus	1603	S	22	19	41	0.00000
Bombilactobacillus_bombi	1303590	S	13	2	15	0.00000
Acetilactobacillus_jinshanensis	1720083	S	13	0	13	0.00000
Lapidilactobacillus_dextrinicus	51664	S	10	2	12	0.00000
Streptococcus_sp._HKU75	2781599	S	24	4	28	0.00000
Streptococcus_sp._A12	1759399	S	12	12	24	0.00000
Streptococcus_sanguinis	1305	S	75	26	101	0.00000
Streptococcus_suis	1307	S	63	57	120	0.00001
Streptococcus_oralis	1303	S	54	50	104	0.00000
Streptococcus_equi	1336	S	26	10	36	0.00000
Streptococcus_dysgalactiae	1334	S	18	70	88	0.00000
Streptococcus_gordonii	1302	S	38	15	53	0.00000
Streptococcus_cristatus	45634	S	38	51	89	0.00000
Streptococcus_pyogenes	1314	S	34	91	125	0.00001
Streptococcus_mutans	1309	S	30	11	41	0.00000
Streptococcus_intermedius	1338	S	12	26	38	0.00000
Streptococcus_anginosus	1328	S	11	76	87	0.00000
Streptococcus_gallolyticus	315405	S	26	44	70	0.00000
Streptococcus_salivarius	1304	S	24	32	56	0.00000
Streptococcus_respiraculi	2021971	S	23	5	28	0.00000
Streptococcus_ferus	1345	S	23	4	27	0.00000
Streptococcus_equinus	1335	S	21	17	38	0.00000
Streptococcus_infantis	68892	S	21	8	29	0.00000
Streptococcus_merionis	400065	S	20	2	22	0.00000
Streptococcus_sobrinus	1310	S	19	3	22	0.00000
Streptococcus_thermophilus	1308	S	18	13	31	0.00000
Streptococcus_mitis	28037	S	18	206	224	0.00001
Streptococcus_urinalis	149016	S	16	9	25	0.00000
Streptococcus_pneumoniae	1313	S	16	14	30	0.00000
Streptococcus_ratti	1341	S	16	2	18	0.00000
Streptococcus_pantholopis	1811193	S	14	1	15	0.00000
Streptococcus_chenjunshii	2173853	S	14	1	15	0.00000
Streptococcus_uberis	1349	S	13	4	17	0.00000
Streptococcus_porcinus	1340	S	13	7	20	0.00000
Streptococcus_agalactiae	1311	S	12	199	211	0.00001
Streptococcus_canis	1329	S	11	8	19	0.00000
Streptococcus_halichoeri	254785	S	10	13	23	0.00000
Lactococcus_lactis	1358	S	29	55	84	0.00000
Lactococcus_raffinolactis	1366	S	25	12	37	0.00000
Lactococcus_cremoris	1359	S	24	23	47	0.00000
Lactococcus_garvieae	1363	S	19	128	147	0.00001
Lactococcus_allomyrinae	2419773	S	10	2	12	0.00000
Floricoccus_penangensis	1859475	S	11	3	14	0.00000
Enterococcus_avium	33945	S	57	34	91	0.00000
Enterococcus_faecalis	1351	S	41	100	141	0.00001
Enterococcus_gilvus	160453	S	38	18	56	0.00000
Enterococcus_faecium	1352	S	31	232	263	0.00001
Enterococcus_casseliflavus	37734	S	31	101	132	0.00001
Enterococcus_raffinosus	71452	S	30	18	48	0.00000
Enterococcus_mundtii	53346	S	24	10	34	0.00000
Enterococcus_wangshanyuanii	2005703	S	23	3	26	0.00000
Enterococcus_cecorum	44008	S	20	16	36	0.00000
Enterococcus_hirae	1354	S	20	17	37	0.00000
Enterococcus_durans	53345	S	18	19	37	0.00000
Enterococcus_saigonensis	1805431	S	17	26	43	0.00000
Enterococcus_rotai	118060	S	15	0	15	0.00000
Enterococcus_thailandicus	417368	S	11	5	16	0.00000
Vagococcus_lutrae	81947	S	24	45	69	0.00000
Vagococcus_coleopterorum	2714946	S	23	8	31	0.00000
Vagococcus_fluvialis	2738	S	18	14	32	0.00000
Vagococcus_sp._CY52-2	2925838	S	16	12	28	0.00000
Vagococcus_teuberi	519472	S	10	7	17	0.00000
Tetragenococcus_halophilus	51669	S	21	10	31	0.00000
Tetragenococcus_osmophilus	526944	S	13	9	22	0.00000
Tetragenococcus_koreensis	290335	S	12	5	17	0.00000
Aerococcus_sanguinicola	119206	S	46	11	57	0.00000
Aerococcus_urinae	1376	S	29	12	41	0.00000
Aerococcus_urinaeequi	51665	S	22	165	187	0.00001
Aerococcus_urinaehominis	128944	S	15	3	18	0.00000
Abiotrophia_defectiva	46125	S	35	10	45	0.00000
Suicoccus_acidiformans	2036206	S	31	21	52	0.00000
Ignavigranum_ruoffiae	89093	S	16	2	18	0.00000
Carnobacterium_divergens	2748	S	34	8	42	0.00000
Carnobacterium_sp._17-4	208596	S	18	24	42	0.00000
Carnobacterium_maltaromaticum	2751	S	28	10	38	0.00000
Carnobacterium_inhibens	147709	S	13	12	25	0.00000
Jeotgalibaca_porci	1868793	S	26	23	49	0.00000
Jeotgalibaca_sp._MA1X17-3	2908211	S	19	4	23	0.00000
Jeotgalibaca_dankookensis	708126	S	17	5	22	0.00000
Jeotgalibaca_ciconiae	2496265	S	11	9	20	0.00000
Dolosigranulum_pigrum	29394	S	41	11	52	0.00000
Granulicatella_adiacens	46124	S	16	8	24	0.00000
Marinilactibacillus_sp._15R	1911586	S	18	6	24	0.00000
Thermaerobacter_sp._FW80	2546351	S	3404	683	4087	0.00019
Thermaerobacter_sp._PB12/4term	2293838	S	2521	609	3130	0.00015
Thermaerobacter_marianensis	73919	S	2842	700	3542	0.00017
Intestinimonas_butyriciproducens	1297617	S	594	227	821	0.00004
Aminipila_luticellarii	2507160	S	91	11	102	0.00000
Aminipila_terrae	2697030	S	61	7	68	0.00000
Aminipila_butyrica	433296	S	45	5	50	0.00000
Emergencia_timonensis	1776384	S	155	55	210	0.00001
Flintibacter_sp._KGMB00164	2610895	S	385	55	440	0.00002
Massilistercora_timonensis	2086584	S	219	223	442	0.00002
Carboxydocella_thermautotrophica	178899	S	157	15	172	0.00001
Faecalibacterium_prausnitzii	853	S	1942	1863	3805	0.00018
Dysosmobacter_sp._Marseille-Q4140	2830675	S	852	357	1209	0.00006
Dysosmobacter_welbionis	2093857	S	547	387	934	0.00004
Flavonifractor_plautii	292800	S	1247	326	1573	0.00007
Ethanoligenens_harbinense	253239	S	698	38	736	0.00003
Vescimonas_coprocola	2714355	S	362	316	678	0.00003
Vescimonas_fastidiosa	2714353	S	282	427	709	0.00003
Ruthenibacterium_lactatiformans	1550024	S	634	190	824	0.00004
Caproiciproducens_sp._NJN-50	2507162	S	541	66	607	0.00003
Oscillibacter_sp._NSJ-62	2763056	S	495	159	654	0.00003
Anaerotruncus_colihominis	169435	S	460	247	707	0.00003
Acutalibacter_muris	1796620	S	333	17	350	0.00002
Ruminococcus_champanellensis	1161942	S	172	14	186	0.00001
Ruminococcus_albus	1264	S	64	2	66	0.00000
Ruminococcus_bicirculans	1160721	S	46	11	57	0.00000
Ruminococcus_bovis	2564099	S	23	3	26	0.00000
Caproicibacter_fermentans	2576756	S	322	18	340	0.00002
Pusillibacter_faecalis	2714358	S	312	213	525	0.00002
Solibaculum_mannosilyticum	2780922	S	206	194	400	0.00002
Caproicibacterium_lactatifermentans	2666138	S	104	11	115	0.00001
Caproicibacterium_amylolyticum	2766537	S	93	6	99	0.00000
Acetivibrio_thermocellus	1515	S	47	6	53	0.00000
Acetivibrio_saccincola	1677857	S	45	29	74	0.00000
Acetivibrio_clariflavus	288965	S	42	28	70	0.00000
Pseudoclostridium_thermosuccinogenes	84032	S	80	19	99	0.00000
Thermoclostridium_stercorarium	1510	S	58	4	62	0.00000
Mageeibacillus_indolicus	884684	S	49	64	113	0.00001
Ruminiclostridium_herbifermentans	2488810	S	27	6	33	0.00000
Ruminiclostridium_cellulolyticum	1521	S	21	4	25	0.00000
Monoglobus_pectinilyticus	1981510	S	31	15	46	0.00000
Fastidiosipila_sanguinis	236753	S	21	13	34	0.00000
Clostridium_tetani	1513	S	1753	175	1928	0.00009
Clostridium_sp._SY8519	1042156	S	117	33	150	0.00001
Clostridium_sp._M62/1	411486	S	87	113	200	0.00001
Clostridium_sp._C5S11	704125	S	38	4	42	0.00000
Clostridium_sp._JN-9	2507159	S	35	4	39	0.00000
Clostridium_sp._DL-VIII	641107	S	33	4	37	0.00000
Clostridium_sp._BNL1100	755731	S	26	2	28	0.00000
Clostridium_sp._'deep_sea'	2779445	S	24	0	24	0.00000
Clostridium_sp._MD294	97138	S	22	1	23	0.00000
Clostridium_sp._C1	1155388	S	21	19	40	0.00000
Clostridium_sp._BJN0001	2930219	S	16	3	19	0.00000
Clostridium_sp._AWRP	2212991	S	15	6	21	0.00000
Clostridium_sp._JN-1	2483110	S	14	1	15	0.00000
Clostridium_sp._001	1970093	S	10	6	16	0.00000
Clostridium_botulinum	1491	S	111	366	477	0.00002
Clostridium_perfringens	1502	S	98	51	149	0.00001
Clostridium_baratii	1561	S	64	13	77	0.00000
Clostridium_thermarum	1716543	S	58	31	89	0.00000
Clostridium_kluyveri	1534	S	56	3	59	0.00000
Clostridium_beijerinckii	1520	S	56	86	142	0.00001
Clostridium_pasteurianum	1501	S	50	7	57	0.00000
Clostridium_intestinale	36845	S	46	4	50	0.00000
Clostridium_cellulovorans	1493	S	40	5	45	0.00000
Clostridium_butyricum	1492	S	40	6	46	0.00000
Clostridium_saccharoperbutylacetonicum	36745	S	35	5	40	0.00000
Clostridium_tyrobutyricum	1519	S	33	2	35	0.00000
Clostridium_aceticum	84022	S	33	2	35	0.00000
Clostridium_argentinense	29341	S	32	3	35	0.00000
Clostridium_gasigenes	94869	S	31	4	35	0.00000
Clostridium_estertheticum	238834	S	30	4	34	0.00000
Clostridium_manihotivorum	2320868	S	30	2	32	0.00000
Clostridium_saccharobutylicum	169679	S	30	4	34	0.00000
Clostridium_fermenticellae	2068654	S	23	2	25	0.00000
Clostridium_formicaceticum	1497	S	22	3	25	0.00000
Clostridium_carboxidivorans	217159	S	20	4	24	0.00000
Clostridium_bornimense	1216932	S	20	6	26	0.00000
Clostridium_sporogenes	1509	S	20	101	121	0.00001
Clostridium_acetobutylicum	1488	S	18	0	18	0.00000
Clostridium_isatidis	182773	S	18	7	25	0.00000
Clostridium_drakei	332101	S	14	9	23	0.00000
Clostridium_cadaveris	1529	S	14	3	17	0.00000
Clostridium_scatologenes	1548	S	11	9	20	0.00000
Clostridium_taeniosporum	394958	S	10	1	11	0.00000
Clostridium_cochlearium	1494	S	10	2	12	0.00000
Hungatella_hathewayi	154046	S	225	8	233	0.00001
Alkaliphilus_oremlandii	461876	S	65	17	82	0.00000
Alkaliphilus_sp._B6464	2731219	S	39	9	48	0.00000
Alkaliphilus_metalliredigens	208226	S	28	5	33	0.00000
Crassaminicella_profunda	1286698	S	24	4	28	0.00000
Crassaminicella_sp._143-21	2855394	S	15	5	20	0.00000
Crassaminicella_thermophila	2599308	S	13	3	16	0.00000
Geosporobacter_ferrireducens	1424294	S	49	6	55	0.00000
Caloramator_sp._E03	2576307	S	39	3	42	0.00000
Candidatus_Arthromitus_sp._SFB-rat-Yit	1041504	S	10	21	31	0.00000
Paraclostridium_bifermentans	1490	S	28	8	36	0.00000
Serpentinicella_alkaliphila	1734049	S	18	2	20	0.00000
Hathewaya_histolytica	1498	S	16	3	19	0.00000
Sarcina_sp._JB2	2726954	S	10	3	13	0.00000
Symbiobacterium_thermophilum	2734	S	3858	319	4177	0.00020
[Clostridium]_scindens	29347	S	218	88	306	0.00001
[Clostridium]_hylemonae	89153	S	174	48	222	0.00001
Lachnoclostridium_phocaeense	1871021	S	164	139	303	0.00001
Lachnoclostridium_sp._YL32	1834196	S	47	63	110	0.00001
Lachnoclostridium_phytofermentans	66219	S	35	1	36	0.00000
Blautia_producta	33035	S	124	20	144	0.00001
Blautia_sp._NBRC_113351	2877527	S	78	81	159	0.00001
Blautia_sp._SC05B48	2479767	S	13	29	42	0.00000
Blautia_liquoris	2779518	S	70	5	75	0.00000
Blautia_pseudococcoides	1796616	S	62	7	69	0.00000
Blautia_massiliensis	1737424	S	61	100	161	0.00001
Blautia_argi	1912897	S	30	26	56	0.00000
Blautia_obeum	40520	S	27	24	51	0.00000
Blautia_hansenii	1322	S	12	7	19	0.00000
Lachnospiraceae_bacterium_NSJ-29	2763667	S	147	44	191	0.00001
Lachnospiraceae_bacterium_NSJ-38	2763669	S	125	49	174	0.00001
Lachnospiraceae_bacterium_sunii_NSJ-8	2763672	S	65	50	115	0.00001
Lachnospiraceae_bacterium_NSJ-4	2763670	S	35	36	71	0.00000
Anaerocolumna_cellulosilytica	433286	S	151	8	159	0.00001
Anaerocolumna_chitinilytica	1727145	S	53	2	55	0.00000
Anaerocolumna_sedimenticola	2696063	S	52	3	55	0.00000
Enterocloster_bolteae	208479	S	222	69	291	0.00001
Enterocloster_clostridioformis	1531	S	29	75	104	0.00000
Roseburia_hominis	301301	S	132	141	273	0.00001
Roseburia_intestinalis	166486	S	47	48	95	0.00000
Roseburia_sp._NSJ-69	2763062	S	42	20	62	0.00000
Coprococcus_comes	410072	S	84	89	173	0.00001
Coprococcus_catus	116085	S	37	20	57	0.00000
Coprococcus_eutactus	33043	S	17	16	33	0.00000
Coprococcus_sp._ART55/1	751585	S	11	9	20	0.00000
Lacrimispora_sphenoides	29370	S	90	11	101	0.00000
Lacrimispora_saccharolytica	84030	S	45	9	54	0.00000
Anaerostipes_caccae	105841	S	53	11	64	0.00000
Anaerostipes_rhamnosivorans	1229621	S	49	21	70	0.00000
Anaerostipes_hadrus	649756	S	20	18	38	0.00000
Butyrivibrio_fibrisolvens	831	S	68	18	86	0.00000
Butyrivibrio_hungatei	185008	S	15	3	18	0.00000
Butyrivibrio_proteoclasticus	43305	S	14	3	17	0.00000
Novisyntrophococcus_fermenticellae	2068655	S	70	9	79	0.00000
Sellimonas_intestinalis	1653434	S	68	37	105	0.00001
Anaerotignum_propionicum	28446	S	63	6	69	0.00000
[Ruminococcus]_gnavus	33038	S	42	28	70	0.00000
[Ruminococcus]_torques	33039	S	16	13	29	0.00000
Anaerobutyricum_hallii	39488	S	39	13	52	0.00000
Pseudobutyrivibrio_xylanivorans	185007	S	37	2	39	0.00000
Faecalicatena_sp._Marseille-Q4148	2823316	S	27	13	40	0.00000
Dorea_longicatena	88431	S	27	25	52	0.00000
Herbinix_luporum	1679721	S	26	17	43	0.00000
Cellulosilyticum_lentocellum	29360	S	13	9	22	0.00000
Lachnospira_eligens	39485	S	16	2	18	0.00000
Lachnoanaerobaculum_umeaense	617123	S	12	3	15	0.00000
[Clostridium]_colinum	36835	S	12	1	13	0.00000
Candidatus_Desulforudis_audaxviator	471827	S	1095	64	1159	0.00006
Desulforamulus_ruminis	1564	S	175	25	200	0.00001
Desulforamulus_ferrireducens	1833852	S	142	89	231	0.00001
Desulforamulus_reducens	59610	S	76	15	91	0.00000
Acididesulfobacillus_acetoxydans	1561005	S	359	14	373	0.00002
Candidatus_Formimonas_warabiya	1761012	S	235	18	253	0.00001
Desulfofarcimen_acetoxidans	58138	S	106	12	118	0.00001
Thermanaerosceptrum_fracticalcis	1712410	S	104	16	120	0.00001
Dehalobacterium_formicoaceticum	51515	S	101	20	121	0.00001
Christensenella_sp._Marseille-P3954	2086585	S	928	449	1377	0.00007
Christensenella_minuta	626937	S	241	68	309	0.00001
Heliomicrobium_modesticaldum	35701	S	951	440	1391	0.00007
Heliorestis_convoluta	356322	S	86	5	91	0.00000
Desulfitobacterium_hafniense	49338	S	173	30	203	0.00001
Desulfitobacterium_dehalogenans	36854	S	69	17	86	0.00000
Desulfitobacterium_metallireducens	142877	S	56	12	68	0.00000
Desulfitobacterium_dichloroeliminans	233055	S	55	47	102	0.00000
Desulfosporosinus_orientis	1563	S	84	17	101	0.00000
Desulfosporosinus_youngiae	339862	S	83	24	107	0.00001
Desulfosporosinus_acidiphilus	885581	S	66	12	78	0.00000
Desulfosporosinus_meridiei	79209	S	44	16	60	0.00000
Dehalobacter_restrictus	55583	S	42	76	118	0.00001
Syntrophobotulus_glycolicus	51197	S	115	7	122	0.00001
Eubacterium_limosum	1736	S	111	141	252	0.00001
Eubacterium_sp._c-25	2841037	S	30	15	45	0.00000
Eubacterium_sp._MSJ-33	2841528	S	17	10	27	0.00000
Eubacterium_sp._NSJ-61	2764325	S	16	24	40	0.00000
Eubacterium_callanderi	53442	S	54	55	109	0.00001
Eubacterium_maltosivorans	2041044	S	24	124	148	0.00001
Acetobacterium_sp._KB-1	2184575	S	154	40	194	0.00001
Acetobacterium_wieringae	52694	S	102	51	153	0.00001
Acetobacterium_woodii	33952	S	39	7	46	0.00000
Alkalibacter_sp._ES005	2815577	S	101	6	107	0.00001
Syntrophothermus_lipocalidus	86170	S	195	18	213	0.00001
Syntrophomonas_wolfei	863	S	86	18	104	0.00000
Candidatus_Contubernalis_alkalaceticum	338645	S	58	2	60	0.00000
Candidatus_Syntrophocurvum_alkaliphilum	2293317	S	21	5	26	0.00000
Clostridioides_difficile	1496	S	56	663	719	0.00003
Peptoclostridium_acidaminophilum	1731	S	66	11	77	0.00000
Terrisporobacter_sp._MCA3	2813371	S	52	7	59	0.00000
Romboutsia_sp._CE17	2724150	S	24	8	32	0.00000
Tepidibacter_sp._8C15b	2925782	S	33	6	39	0.00000
Filifactor_alocis	143361	S	20	28	48	0.00000
Acetoanaerobium_sticklandii	1511	S	17	1	18	0.00000
Paeniclostridium_sordellii	1505	S	15	3	18	0.00000
Desulfoscipio_gibsoniae	102134	S	206	16	222	0.00001
Desulfotomaculum_nigrificans	1565	S	116	48	164	0.00001
Thermincola_potens	863643	S	112	9	121	0.00001
Vallitalea_guaymasensis	1185412	S	27	4	31	0.00000
Vallitalea_pronyensis	1348613	S	24	3	27	0.00000
Petrocella_atlantisensis	2173034	S	45	6	51	0.00000
Caloranaerobacter_azorensis	116090	S	70	9	79	0.00000
Alkalicella_caledoniensis	2731377	S	18	2	20	0.00000
Moorella_sp._Hama-1	2138101	S	563	128	691	0.00003
Moorella_thermoacetica	1525	S	456	83	539	0.00003
Moorella_glycerini	55779	S	369	39	408	0.00002
Ammonifex_degensii	42838	S	582	20	602	0.00003
Gelria_sp._Kuro-4	2796927	S	1390	99	1489	0.00007
Thermacetogenium_phaeum	85874	S	489	425	914	0.00004
Carboxydothermus_hydrogenoformans	129958	S	297	25	322	0.00002
Thermoanaerobacter_mathranii	583357	S	32	73	105	0.00001
Thermoanaerobacter_kivui	2325	S	23	19	42	0.00000
Thermoanaerobacter_wiegelii	46354	S	10	20	30	0.00000
Thermanaeromonas_toyohensis	161154	S	123	3	126	0.00001
Caldanaerobacter_subterraneus	911092	S	74	89	163	0.00001
Caldicellulosiruptor_changbaiensis	1222016	S	20	81	101	0.00000
Caldicellulosiruptor_acetigenus	301953	S	14	17	31	0.00000
Thermoanaerobacterium_thermosaccharolyticum	1517	S	34	68	102	0.00000
Thermoanaerobacterium_xylanolyticum	29329	S	13	11	24	0.00000
Thermoanaerobacterium_sp._RBIITD	1550240	S	10	7	17	0.00000
Mahella_australiensis	252966	S	129	63	192	0.00001
Zhaonella_formicivorans	2528593	S	120	18	138	0.00001
Thermodesulfobium_acidiphilum	1794699	S	37	54	91	0.00000
Iocasia_fonsfrigidae	2682810	S	90	12	102	0.00000
Halanaerobium_praevalens	2331	S	20	19	39	0.00000
Halanaerobium_hydrogeniformans	656519	S	19	13	32	0.00000
Halothermothrix_orenii	31909	S	55	13	68	0.00000
Anoxybacter_fermentans	1323375	S	134	36	170	0.00001
Halobacteroides_halobius	42422	S	40	11	51	0.00000
Acetohalobium_arabaticum	28187	S	22	4	26	0.00000
Thermosediminibacter_oceani	291990	S	216	13	229	0.00001
Biomaibacter_acetigenes	2316383	S	129	8	137	0.00001
Tepidanaerobacter_acetatoxydans	499229	S	52	2	54	0.00000
Koleobacter_methoxysyntrophicus	2751313	S	124	11	135	0.00001
Natranaerofaba_carboxydovora	2742683	S	69	2	71	0.00000
Natranaerobius_thermophilus	375929	S	38	2	40	0.00000
Selenomonas_sp._oral_taxon_126	712528	S	693	158	851	0.00004
Selenomonas_sp._oral_taxon_920	1884263	S	476	94	570	0.00003
Selenomonas_sp._oral_taxon_478	712538	S	217	299	516	0.00002
Selenomonas_sp._oral_taxon_136	713030	S	182	237	419	0.00002
Selenomonas_sputigena	69823	S	1204	87	1291	0.00006
Selenomonas_timonae	2754044	S	474	184	658	0.00003
Selenomonas_ruminantium	971	S	192	15	207	0.00001
Megamonas_hypermegale	158847	S	32	41	73	0.00000
Megamonas_funiformis	437897	S	19	15	34	0.00000
Pectinatus_frisingensis	865	S	36	1	37	0.00000
Sporomusa_termitida	2377	S	223	30	253	0.00001
Methylomusa_anaerophila	1930071	S	191	14	205	0.00001
Pelosinus_fermentans	365349	S	47	9	56	0.00000
Pelosinus_sp._UFO1	484770	S	37	12	49	0.00000
Megasphaera_stantonii	2144175	S	442	233	675	0.00003
Megasphaera_elsdenii	907	S	374	149	523	0.00002
Megasphaera_massiliensis	1232428	S	166	55	221	0.00001
Dialister_pneumosintes	39950	S	15	137	152	0.00001
Veillonella_rodentium	248315	S	50	23	73	0.00000
Veillonella_parvula	29466	S	24	21	45	0.00000
Acidaminococcus_fermentans	905	S	314	50	364	0.00002
Acidaminococcus_intestini	187327	S	88	6	94	0.00000
Phascolarctobacterium_faecium	33025	S	110	10	120	0.00001
Phascolarctobacterium_sp._Marseille-Q4147	2823317	S	53	33	86	0.00000
Phascolarctobacterium_succinatutens	626940	S	44	94	138	0.00001
Limnochorda_pilosa	1555112	S	3846	149	3995	0.00019
Peptoniphilus_ivorii	54006	S	197	43	240	0.00001
Peptoniphilus_harei	54005	S	24	23	47	0.00000
Murdochiella_vaginalis	1852373	S	91	88	179	0.00001
Anaerococcus_mediterraneensis	1870984	S	15	55	70	0.00000
Parvimonas_micra	33033	S	30	50	80	0.00000
Finegoldia_magna	1260	S	17	15	32	0.00000
Helcococcus_kunzii	40091	S	16	7	23	0.00000
Gudongella_oleilytica	1582259	S	43	8	51	0.00000
Schnuerera_ultunensis	45497	S	35	8	43	0.00000
Keratinibaculum_paraultunense	1278232	S	34	17	51	0.00000
Tissierella_sp._JN-28	2507161	S	33	6	39	0.00000
Gottschalkia_acidurici	1556	S	74	7	81	0.00000
Ezakiella_coagulans	46507	S	101	259	360	0.00002
Ezakiella_massiliensis	1852374	S	24	15	39	0.00000
Sedimentibacter_sp._zth1	2816908	S	36	4	40	0.00000
Allobaculum_sp._Allo2	2853432	S	121	23	144	0.00001
Allobaculum_mucolyticum	2834459	S	97	21	118	0.00001
Faecalibaculum_rodentium	1702221	S	187	50	237	0.00001
Erysipelothrix_sp._HDW6B	2714929	S	17	11	28	0.00000
Erysipelothrix_larvae	1514105	S	18	6	24	0.00000
Erysipelothrix_inopinata	225084	S	16	5	21	0.00000
[Clostridium]_innocuum	1522	S	69	59	128	0.00001
Erysipelatoclostridium_ramosum	1547	S	11	5	16	0.00000
Bulleidia_sp._zg-1006	2806552	S	34	12	46	0.00000
Faecalitalea_cylindroides	39483	S	24	49	73	0.00000
Intestinibaculum_porci	2487118	S	21	8	29	0.00000
Faecalibacillus_intestinalis	1982626	S	18	22	40	0.00000
Amedibacterium_intestinale	2583452	S	14	27	41	0.00000
Turicibacter_sp._TJ11	2806443	S	21	21	42	0.00000
Turicibacter_sp._H121	1712675	S	19	21	40	0.00000
Turicibacter_sanguinis	154288	S	13	5	18	0.00000
Ndongobacter_massiliensis	1871025	S	172	140	312	0.00001
endosymbiont_'TC1'_of_Trimyema_compressum	243899	S	62	3	65	0.00000
Fischerella_sp._NIES-3754	1752063	S	11951	1696	13647	0.00065
Fischerella_sp._NIES-4106	2005456	S	2010	162	2172	0.00010
Nostoc_sp._NIES-4103	2005458	S	1089	113	1202	0.00006
Nostoc_sp._MS1	2764711	S	755	90	845	0.00004
Nostoc_sp._TCL26-01	2576904	S	449	28	477	0.00002
Nostoc_sp._UHCC_0702	2814655	S	439	43	482	0.00002
Nostoc_sp._CENA543	1869241	S	417	32	449	0.00002
Nostoc_sp._C052	2576902	S	412	83	495	0.00002
Nostoc_sp._UHCC_0870	2914041	S	375	35	410	0.00002
Nostoc_sp._PCC_7524	28072	S	367	32	399	0.00002
Nostoc_sp._PCC_7107	317936	S	260	79	339	0.00002
Nostoc_sp._'Lobaria_pulmonaria_(5183)_cyanobiont'	1618022	S	230	44	274	0.00001
Nostoc_sp._'Peltigera_membranacea_cyanobiont'_N6	1261031	S	224	56	280	0.00001
Nostoc_sp._ATCC_53789	76335	S	199	277	476	0.00002
Nostoc_sp._NIES-2111	1973475	S	185	305	490	0.00002
Nostoc_sp._C057	2576903	S	184	250	434	0.00002
Nostoc_sp._TCL240-02	2572090	S	161	81	242	0.00001
Nostoc_sp._NIES-3756	1751286	S	138	295	433	0.00002
Nostoc_sp._PCC_7120_=_FACHB-418	103690	S	18	274	292	0.00001
Nostoc_linckia	92942	S	467	66	533	0.00003
Nostoc_piscinale	224012	S	375	48	423	0.00002
Nostoc_sphaeroides	446679	S	322	196	518	0.00002
Nostoc_edaphicum	264686	S	255	65	320	0.00002
Nostoc_flagelliforme	1306274	S	249	81	330	0.00002
Nostoc_punctiforme	272131	S	215	145	360	0.00002
Nostoc_commune	1178	S	169	47	216	0.00001
Anabaena_cylindrica	1165	S	214	24	238	0.00001
Anabaena_sp._WA102	1647413	S	138	169	307	0.00001
Anabaena_sp._90	46234	S	42	226	268	0.00001
Anabaena_sp._YBS01	2490939	S	29	893	922	0.00004
Cylindrospermum_stagnale	142864	S	323	23	346	0.00002
Trichormus_azollae	1164	S	138	10	148	0.00001
Trichormus_variabilis	264691	S	11	57	68	0.00000
Richelia_sinica	1357545	S	146	11	157	0.00001
Calothrix_sp._PCC_7507	99598	S	352	56	408	0.00002
Calothrix_sp._NIES-2100	1954172	S	352	167	519	0.00002
Calothrix_sp._NIES-2098	1954171	S	329	146	475	0.00002
Calothrix_sp._PCC_7716	2853227	S	319	161	480	0.00002
Calothrix_sp._336/3	1337936	S	216	47	263	0.00001
Calothrix_sp._NIES-3974	2005462	S	203	12	215	0.00001
Calothrix_sp._PCC_6303	1170562	S	149	32	181	0.00001
Calothrix_brevissima	938406	S	477	138	615	0.00003
Calothrix_parasitica	1973486	S	211	8	219	0.00001
Scytonema_sp._NIES-4073	2005464	S	809	340	1149	0.00005
Scytonema_sp._HK-05	1137095	S	549	210	759	0.00004
Brasilonema_sennae	1397703	S	476	40	516	0.00002
Sphaerospermopsis_kisseleviana	289435	S	182	62	244	0.00001
Sphaerospermopsis_torques-reginae	984207	S	162	50	212	0.00001
Nodularia_sphaerocarpa	137816	S	192	45	237	0.00001
Nodularia_spumigena	70799	S	172	13	185	0.00001
Anabaenopsis_circularis	109266	S	227	91	318	0.00002
Anabaenopsis_elenkinii	156213	S	86	10	96	0.00000
Dolichospermum_compactum	136073	S	126	116	242	0.00001
Dolichospermum_sp._UHCC_0315A	1914871	S	32	158	190	0.00001
Dolichospermum_flos-aquae	1166	S	31	182	213	0.00001
Cylindrospermopsis_raciborskii	77022	S	14	17	31	0.00000
Tolypothrix_tenuis	457083	S	282	86	368	0.00002
Tolypothrix_sp._PCC_7910	2099387	S	272	62	334	0.00002
Rivularia_sp._PCC_7116	373994	S	128	5	133	0.00001
Synechococcus_sp._CBW1004	1353136	S	1260	286	1546	0.00007
Synechococcus_sp._RSCCF101	2511069	S	1037	210	1247	0.00006
Synechococcus_sp._CBW1107	2789857	S	954	163	1117	0.00005
Synechococcus_sp._JA-3-3Ab	321327	S	692	147	839	0.00004
Synechococcus_sp._SynAce01	1916956	S	681	63	744	0.00004
Synechococcus_sp._CBW1108	1353147	S	640	78	718	0.00003
Synechococcus_sp._CB0101	232348	S	620	119	739	0.00004
Synechococcus_sp._NB0720_10	2907159	S	443	102	545	0.00003
Synechococcus_sp._LA31	2741953	S	431	84	515	0.00002
Synechococcus_sp._RS9909	221352	S	410	132	542	0.00003
Synechococcus_sp._PCC_7336	195250	S	398	10	408	0.00002
Synechococcus_sp._JA-2-3B'a(2-13)	321332	S	375	72	447	0.00002
Synechococcus_sp._LTW-R	2751170	S	355	75	430	0.00002
Synechococcus_sp._HK01-R	2751171	S	297	44	341	0.00002
Synechococcus_sp._A10-1-5-1	2936507	S	297	58	355	0.00002
Synechococcus_sp._Minos11	221341	S	278	17	295	0.00001
Synechococcus_sp._WH_8101	59932	S	271	81	352	0.00002
Synechococcus_sp._KORDI-100	1280380	S	270	16	286	0.00001
Synechococcus_sp._BMK-MC-1	1442551	S	219	77	296	0.00001
Synechococcus_sp._NOUM97013	1442555	S	199	27	226	0.00001
Synechococcus_sp._KORDI-52	585425	S	166	46	212	0.00001
Synechococcus_sp._PROS-U-1	1400866	S	163	25	188	0.00001
Synechococcus_sp._A15-127	1050624	S	163	139	302	0.00001
Synechococcus_sp._MEDNS5	1442554	S	160	46	206	0.00001
Synechococcus_sp._BIOS-E4-1	1400864	S	156	14	170	0.00001
Synechococcus_sp._KORDI-49	585423	S	143	123	266	0.00001
Synechococcus_sp._PCC_6312	195253	S	122	4	126	0.00001
Synechococcus_sp._PROS-7-1	1442556	S	121	46	167	0.00001
Synechococcus_sp._MIT_S9220	166309	S	117	15	132	0.00001
Synechococcus_sp._BIOS-U3-1	1400865	S	105	10	115	0.00001
Synechococcus_sp._A15-62	1050657	S	101	61	162	0.00001
Synechococcus_sp._CBW1006	1353138	S	99	625	724	0.00003
Synechococcus_sp._CBW1002	1353134	S	97	697	794	0.00004
Synechococcus_sp._NIES-970	1827144	S	87	11	98	0.00000
Synechococcus_sp._CC9902	316279	S	83	7	90	0.00000
Synechococcus_sp._PCC_7003	374981	S	80	18	98	0.00000
Synechococcus_sp._WH_8020	32052	S	79	13	92	0.00000
Synechococcus_sp._A15-44	1050646	S	78	117	195	0.00001
Synechococcus_sp._RS9907	221350	S	73	143	216	0.00001
Synechococcus_sp._WH_8109	166314	S	72	47	119	0.00001
Synechococcus_sp._ROS8604	1442557	S	70	15	85	0.00000
Synechococcus_sp._RS9902	221345	S	66	114	180	0.00001
Synechococcus_sp._PROS-9-1	1968775	S	66	14	80	0.00000
Synechococcus_sp._TAK9802	1442558	S	62	128	190	0.00001
Synechococcus_sp._PCC_7502	1173263	S	49	2	51	0.00000
Synechococcus_sp._MVIR-18-1	1386941	S	48	71	119	0.00001
Synechococcus_sp._SYN20	1050714	S	45	57	102	0.00000
Synechococcus_sp._CC9311	64471	S	43	9	52	0.00000
Synechococcus_sp._M16.1	1442553	S	40	101	141	0.00001
Synechococcus_sp._PCC_11901	2579791	S	28	111	139	0.00001
Synechococcus_sp._A15-60	1050655	S	25	149	174	0.00001
Synechococcus_sp._A18-25c	1866938	S	24	148	172	0.00001
Synechococcus_sp._PCC_7117	195498	S	16	63	79	0.00000
Synechococcus_sp._PCC_73109	374982	S	14	53	67	0.00000
Synechococcus_sp._PCC_8807	195248	S	10	48	58	0.00000
Synechococcus_elongatus	32046	S	563	25	588	0.00003
Dactylococcopsis_salina	292566	S	88	23	111	0.00001
Cyanobium_sp._NIES-981	1851505	S	1141	319	1460	0.00007
Cyanobium_sp._NS01	261284	S	955	298	1253	0.00006
Cyanobium_gracile	59930	S	1526	278	1804	0.00009
Parasynechococcus_marenigrum	2881428	S	289	81	370	0.00002
Prochlorococcus_marinus	1219	S	218	23	241	0.00001
Prochlorococcus_sp._MIT_0604	1501268	S	13	8	21	0.00000
Acaryochloris_marina	155978	S	190	37	227	0.00001
Acaryochloris_sp._'Moss_Beach'	2740837	S	67	64	131	0.00001
Synechocystis_sp._PCC_6714	1147	S	54	11	65	0.00000
Synechocystis_sp._CACIAM_05	1933929	S	37	146	183	0.00001
Chamaesiphon_minutus	1173032	S	225	9	234	0.00001
Leptolyngbya_sp._7M	2812896	S	3842	236	4078	0.00019
Leptolyngbya_sp._BL0902	1115757	S	570	25	595	0.00003
Leptolyngbya_sp._NIES-3755	1752064	S	172	14	186	0.00001
Leptolyngbya_sp._PCC_7376	111781	S	66	4	70	0.00000
Leptolyngbya_boryana	1184	S	199	0	199	0.00001
Kovacikia_minuta	2931930	S	521	34	555	0.00003
Leptothermofonsia_sichuanensis	2917832	S	304	22	326	0.00002
Leptodesmis_sichuanensis	2906798	S	282	25	307	0.00001
Thermoleptolyngbya_sp._PKUAC-SCTB121	2811482	S	26	490	516	0.00002
Thermoleptolyngbya_sichuanensis	2885951	S	15	308	323	0.00002
Thermosynechococcus_sp._NK55a	1394889	S	100	33	133	0.00001
Thermosynechococcus_sp._TA-1	2813673	S	50	44	94	0.00000
Thermosynechococcus_sp._CL-1	2583530	S	39	35	74	0.00000
Thermosynechococcus_vestitus	146786	S	154	39	193	0.00001
Halomicronema_hongdechloris	1209493	S	392	12	404	0.00002
Pseudanabaena_sp._PCC_7367	82654	S	170	4	174	0.00001
Pseudanabaena_sp._ABRG5-3	685565	S	108	4	112	0.00001
Gloeobacter_kilaueensis	1416614	S	1902	51	1953	0.00009
Gloeobacter_morelensis	2907343	S	1333	615	1948	0.00009
Gloeobacter_violaceus	33072	S	1295	655	1950	0.00009
Anthocerotibacter_panamensis	2857077	S	461	15	476	0.00002
Moorena_producens	1155739	S	887	17	904	0.00004
Oscillatoria_nigro-viridis	482564	S	229	127	356	0.00002
Oscillatoria_acuminata	118323	S	195	10	205	0.00001
Geitlerinema_sp._PCC_7407	1173025	S	927	99	1026	0.00005
Allocoleopsis_franciscana	2886352	S	227	19	246	0.00001
Oxynema_aestuarii	2874213	S	417	29	446	0.00002
Microcoleus_vaginatus	119532	S	270	109	379	0.00002
Planktothrix_agardhii	1160	S	23	36	59	0.00000
Planktothrix_rubescens	59512	S	14	16	30	0.00000
[Phormidium]_sp._ETS-05	222819	S	305	14	319	0.00002
Crinalium_epipsammum	241425	S	106	10	116	0.00001
Limnospira_indica	147322	S	10	73	83	0.00000
Microcystis_aeruginosa	1126	S	285	407	692	0.00003
Microcystis_sp._MC19	1967666	S	42	28	70	0.00000
Halothece_sp._PCC_7418	65093	S	117	28	145	0.00001
Euhalothece_natronophila	577489	S	33	3	36	0.00000
Gloeothece_citriformis	2546356	S	98	9	107	0.00001
Gloeothece_verrucosa	2546359	S	41	4	45	0.00000
Crocosphaera_subtropica	2546360	S	114	12	126	0.00001
Rippkaea_orientalis	2546366	S	80	10	90	0.00000
Candidatus_Atelocyanobacterium_thalassa	713887	S	19	4	23	0.00000
Gloeocapsa_sp._PCC_7428	1173026	S	175	14	189	0.00001
Geminocystis_herdmanii	669359	S	82	23	105	0.00001
Geminocystis_sp._NIES-3709	1617448	S	37	12	49	0.00000
Geminocystis_sp._NIES-3708	1615909	S	17	6	23	0.00000
Chondrocystis_sp._NIES-4102	2005460	S	127	15	142	0.00001
Cyanobacterium_aponinum	379064	S	55	27	82	0.00000
Chroococcidiopsis_sp._CCMEE_29	155894	S	440	55	495	0.00002
Chroococcidiopsis_sp._CCNUC1	2653189	S	105	127	232	0.00001
Chroococcidiopsis_thermalis	54299	S	114	150	264	0.00001
Pleurocapsa_sp._PCC_7327	118163	S	179	14	193	0.00001
Stanieria_cyanosphaera	102116	S	58	11	69	0.00000
Stanieria_sp._NIES-3757	1807358	S	44	6	50	0.00000
Gloeomargarita_lithophora	1188228	S	136	3	139	0.00001
Thermostichus_lividus	33070	S	97	9	106	0.00001
cyanobacterium_endosymbiont_of_Epithemia_turgida	718217	S	20	3	23	0.00000
cyanobacterium_endosymbiont_of_Rhopalodia_gibberula	1763363	S	18	2	20	0.00000
Deinococcus_sp._NW-56	2080419	S	2033	321	2354	0.00011
Deinococcus_sp._TS-293	2737050	S	1615	184	1799	0.00009
Deinococcus_sp._KNUC1210	2917691	S	1418	60	1478	0.00007
Deinococcus_sp._AJ005	2652443	S	1024	96	1120	0.00005
Deinococcus_sp._QL22	2939437	S	747	73	820	0.00004
Deinococcus_maricopensis	309887	S	2750	257	3007	0.00014
Deinococcus_gobiensis	502394	S	2485	364	2849	0.00014
Deinococcus_ficus	317577	S	2358	245	2603	0.00012
Deinococcus_metallilatus	1211322	S	2350	304	2654	0.00013
Deinococcus_actinosclerus	1768108	S	2235	1672	3907	0.00019
Deinococcus_irradiatisoli	2202254	S	1836	181	2017	0.00010
Deinococcus_peraridilitoris	432329	S	1705	87	1792	0.00009
Deinococcus_wulumuqiensis	980427	S	1589	748	2337	0.00011
Deinococcus_radiopugnans	57497	S	1421	198	1619	0.00008
Deinococcus_radiodurans	1299	S	1221	423	1644	0.00008
Deinococcus_geothermalis	68909	S	1218	219	1437	0.00007
Deinococcus_soli_(ex_Cha_et_al._2016)	1309411	S	1026	1211	2237	0.00011
Deinococcus_psychrotolerans	2489213	S	922	28	950	0.00005
Deinococcus_deserti	310783	S	814	64	878	0.00004
Deinococcus_proteolyticus	55148	S	780	205	985	0.00005
Deinococcus_radiophilus	32062	S	399	98	497	0.00002
Deinococcus_puniceus	1182568	S	386	72	458	0.00002
Thermus_thermophilus	274	S	1458	1498	2956	0.00014
Thermus_sp._CCB_US3_UF1	1111069	S	641	93	734	0.00003
Thermus_sp._NEB1569	2918899	S	165	279	444	0.00002
Thermus_oshimai	56957	S	729	134	863	0.00004
Thermus_aquaticus	271	S	679	95	774	0.00004
Thermus_brockianus	56956	S	540	101	641	0.00003
Thermus_caldilimi	2483360	S	328	77	405	0.00002
Thermus_scotoductus	37636	S	121	171	292	0.00001
Thermus_parvatiensis	456163	S	101	452	553	0.00003
Meiothermus_silvanus	52022	S	1321	222	1543	0.00007
Meiothermus_taiwanensis	172827	S	941	388	1329	0.00006
Meiothermus_ruber	277	S	817	355	1172	0.00006
Oceanithermus_profundus	187137	S	3674	391	4065	0.00019
Marinithermus_hydrothermalis	186192	S	2274	409	2683	0.00013
Truepera_radiovictrix	332249	S	2993	165	3158	0.00015
Sphaerobacter_thermophilus	2057	S	9549	572	10121	0.00048
Thermomicrobium_roseum	500	S	2163	49	2212	0.00011
Roseiflexus_sp._RS-1	357808	S	3226	563	3789	0.00018
Roseiflexus_castenholzii	120962	S	2921	563	3484	0.00017
Chloroflexus_aurantiacus	1108	S	1112	118	1230	0.00006
Chloroflexus_aggregans	152260	S	993	168	1161	0.00006
Tepidiforma_bonchosmolovskayae	2601677	S	6225	250	6475	0.00031
Candidatus_Promineofilum_breve	1806508	S	5565	107	5672	0.00027
Anaerolinea_thermophila	167964	S	1380	135	1515	0.00007
Pelolinea_submarina	913107	S	1074	50	1124	0.00005
Brevefilum_fermentans	1986204	S	418	15	433	0.00002
Caldilinea_aerophila	133453	S	2626	157	2783	0.00013
Ktedonosporobacter_rubrisoli	2509675	S	2515	70	2585	0.00012
Dehalogenimonas_formicexedens	1839801	S	581	138	719	0.00003
Dehalogenimonas_sp._GP	1536648	S	386	91	477	0.00002
Dehalococcoides_mccartyi	61435	S	154	317	471	0.00002
Thermobaculum_terrenum	166501	S	1089	148	1237	0.00006
Phototrophicus_methaneseepsis	2710758	S	1016	10	1026	0.00005
Fimbriimonas_ginsengisoli	1005039	S	3720	20	3740	0.00018
Chthonomonas_calidirosea	454171	S	887	7	894	0.00004
Mycoplasma_sp._(ex_Biomphalaria_glabrata)	1749074	S	17	0	17	0.00000
Mycoplasma_sp._SG1	2810348	S	14	0	14	0.00000
Mycoplasma_sp._Pen4	640330	S	13	10	23	0.00000
Mycoplasma_mycoides	2102	S	43	299	342	0.00002
Mycoplasma_genitalium	2097	S	35	0	35	0.00000
Mycoplasma_miroungigenitalium	754515	S	11	6	17	0.00000
Mycoplasmopsis_pulmonis	2107	S	17	1	18	0.00000
Mycoplasmopsis_cynos	171284	S	12	23	35	0.00000
Candidatus_Hepatoplasma_crinochetorum	295596	S	30	1	31	0.00000
Spiroplasma_endosymbiont_of_'Nebria_riversi'	2792084	S	12	45	57	0.00000
Mesoplasma_lactucae	138853	S	12	8	20	0.00000
Williamsoniiplasma_somnilux	215578	S	23	7	30	0.00000
Alteracholeplasma_palmae	38986	S	76	8	84	0.00000
Paracholeplasma_brassicae	61635	S	17	4	21	0.00000
Haploplasma_axanthum	29552	S	14	5	19	0.00000
Candidatus_Izimaplasma_sp._HR1	1541959	S	27	0	27	0.00000
Gemmata_obscuriglobus	114	S	52162	8912	61074	0.00290
Gemmata_massiliana	1210884	S	20432	8548	28980	0.00138
Gemmata_sp._SH-PL17	1630693	S	18869	8897	27766	0.00132
Urbifossiella_limnaea	2528023	S	94739	7999	102738	0.00488
Frigoriglobus_tundricola	2774151	S	61035	9327	70362	0.00334
Limnoglobus_roseus	2598579	S	46608	2113	48721	0.00231
Tuwongella_immobilis	692036	S	3416	141	3557	0.00017
Telmatocola_sphagniphila	1123043	S	3019	29	3048	0.00014
Tautonia_plasticadhaerens	2527974	S	50230	4385	54615	0.00259
Aquisphaera_giovannonii	406548	S	38925	6648	45573	0.00216
Paludisphaera_borealis	1387353	S	25165	5588	30753	0.00146
Singulisphaera_acidiphila	466153	S	19210	2846	22056	0.00105
Isosphaera_pallida	128	S	3809	277	4086	0.00019
Lacipirellula_parvula	2650471	S	10982	1336	12318	0.00058
Lacipirellula_limnantheis	2528024	S	10083	1421	11504	0.00055
Pirellulimonas_nuda	2528009	S	10038	1132	11170	0.00053
Botrimarina_mediterranea	2528022	S	8388	811	9199	0.00044
Aeoliella_mucimassa	2527972	S	2897	249	3146	0.00015
Adhaeretor_mobilis	1930276	S	1674	172	1846	0.00009
Bythopirellula_goksoeyrii	1400387	S	1433	108	1541	0.00007
Lignipirellula_cremea	2528010	S	6368	762	7130	0.00034
Stieleria_maiorica	2795974	S	3019	611	3630	0.00017
Stieleria_neptunia	2527979	S	2851	321	3172	0.00015
Anatilimnocola_aggregata	2528021	S	5385	610	5995	0.00028
Rosistilla_oblonga	2527990	S	1639	797	2436	0.00012
Rosistilla_carotiformis	2528017	S	1118	486	1604	0.00008
Rosistilla_ulvae	1930277	S	1077	646	1723	0.00008
Bremerella_volcania	2527984	S	3736	284	4020	0.00019
Pirellula_staleyi	125	S	2923	110	3033	0.00014
Pirellula_sp._SH-Sr6A	1632865	S	776	21	797	0.00004
Roseimaritima_ulvae	980254	S	2656	172	2828	0.00013
Roseimaritima_multifibrata	1930274	S	702	79	781	0.00004
Rubripirellula_lacrimiformis	1930273	S	1396	274	1670	0.00008
Mariniblastus_fucicola	980251	S	1055	20	1075	0.00005
Aureliella_helgolandensis	2527968	S	924	77	1001	0.00005
Rhodopirellula_baltica	265606	S	901	63	964	0.00005
Thermogutta_terrifontis	1331910	S	1157	38	1195	0.00006
Planctomyces_sp._SH-PL62	1636152	S	23474	8288	31762	0.00151
Planctomyces_sp._SH-PL14	1632864	S	13374	849	14223	0.00068
Caulifigura_coniformis	2527983	S	13300	865	14165	0.00067
Gimesia_panareensis	2527978	S	2617	305	2922	0.00014
Gimesia_chilikensis	2605989	S	1382	818	2200	0.00010
Gimesia_maris	122	S	927	141	1068	0.00005
Gimesia_alba	2527973	S	607	105	712	0.00003
Gimesia_algae	2527971	S	605	150	755	0.00004
Gimesia_fumaroli	2527976	S	574	113	687	0.00003
Gimesia_benthica	2608982	S	454	625	1079	0.00005
Gimesia_aquarii	2527964	S	406	26	432	0.00002
Maioricimonas_rarisocia	2528026	S	8695	1092	9787	0.00046
Alienimonas_californiensis	2527989	S	7993	583	8576	0.00041
Symmachiella_dynata	2527995	S	2964	175	3139	0.00015
Rubinisphaera_brasiliensis	119	S	1821	179	2000	0.00009
Fuerstiella_marisgermanici	1891926	S	1674	29	1703	0.00008
Planctopirus_ephydatiae	2528019	S	582	270	852	0.00004
Planctopirus_limnophila	120	S	536	233	769	0.00004
Calycomorphotria_hydatis	2528027	S	1529	57	1586	0.00008
Crateriforma_conspicua	2527996	S	1259	256	1515	0.00007
Polystyrenella_longa	2528007	S	590	51	641	0.00003
Thalassoglobus_polymorphus	2527994	S	549	29	578	0.00003
Humisphaera_borealis	2807512	S	16173	395	16568	0.00079
Phycisphaera_mikurensis	547188	S	5320	430	5750	0.00027
Mucisphaera_calidilacus	2527982	S	2691	157	2848	0.00014
Poriferisphaera_corsica	2528020	S	362	3	365	0.00002
Anaerohalosphaera_lusitana	1936003	S	533	16	549	0.00003
Limihaloglobus_sulfuriphilus	1851148	S	228	14	242	0.00001
Sedimentisphaera_cyanobacteriorum	1940790	S	90	103	193	0.00001
Sedimentisphaera_salicampi	1941349	S	74	14	88	0.00000
Candidatus_Kuenenia_stuttgartiensis	174633	S	220	0	220	0.00001
Candidatus_Uabimicrobium_amorphum	2596890	S	144	2	146	0.00001
Opitutus_terrae	107709	S	11912	551	12463	0.00059
Opitutus_sp._GAS368	1882749	S	10483	1517	12000	0.00057
Lacunisphaera_limnophila	1838286	S	7365	998	8363	0.00040
Oleiharenicola_sp._KSB-15	2862869	S	5422	280	5702	0.00027
Nibricoccus_aquaticus	2576891	S	4442	194	4636	0.00022
Ereboglobus_luteus	1796921	S	3185	153	3338	0.00016
Ruficoccus_sp._ZRK36	2866311	S	1222	172	1394	0.00007
Coraliomargarita_akajimensis	395922	S	286	7	293	0.00001
Verrucomicrobium_sp._GAS474	1882831	S	4029	408	4437	0.00021
Verrucomicrobium_spinosum	2736	S	2079	125	2204	0.00010
Luteolibacter_ambystomatis	2824561	S	2286	159	2445	0.00012
Luteolibacter_luteus	2728835	S	2036	96	2132	0.00010
Roseimicrobium_sp._ORNL1	2711231	S	3063	111	3174	0.00015
Sulfuriroseicoccus_oceanibius	2707525	S	692	75	767	0.00004
Akkermansia_muciniphila	239935	S	1400	165	1565	0.00007
Akkermansia_glycaniphila	1679444	S	481	37	518	0.00002
Methylacidimicrobium_sp._AP8	2730359	S	942	139	1081	0.00005
Methylacidimicrobium_sp._B4	2796139	S	859	169	1028	0.00005
Methylacidiphilum_sp._IT5	2795384	S	27	43	70	0.00000
Methylacidiphilum_sp._IT6	2795386	S	22	1	23	0.00000
Methylacidiphilum_kamchatkense	431057	S	34	1	35	0.00000
Methylacidiphilum_infernorum	511746	S	31	49	80	0.00000
Candidatus_Xiphinematobacter_sp._Idaho_Grape	1704307	S	157	11	168	0.00001
Kiritimatiella_glycovorans	1307763	S	1373	1590	2963	0.00014
Tichowtungia_aerotolerans	2697043	S	555	22	577	0.00003
Candidatus_Protochlamydia_naegleriophila	389348	S	85	52	137	0.00001
Candidatus_Protochlamydia_amoebophila	362787	S	35	20	55	0.00000
Neochlamydia_sp._S13	1353976	S	90	15	105	0.00001
Parachlamydia_acanthamoebae	83552	S	88	23	111	0.00001
Candidatus_Rhabdochlamydia_porcellionis	225148	S	54	63	117	0.00001
Candidatus_Rhabdochlamydia_oedothoracis	2720720	S	54	48	102	0.00000
Simkania_negevensis	83561	S	81	6	87	0.00000
Waddlia_chondrophila	71667	S	74	9	83	0.00000
Chlamydia_pecorum	85991	S	23	78	101	0.00000
Chlamydia_trachomatis	813	S	18	6	24	0.00000
Chlamydia_abortus	83555	S	14	14	28	0.00000
Chlamydiifrater_phoenicopteri	2681469	S	13	4	17	0.00000
Candidatus_Velamenicoccus_archaeovorus	1930593	S	428	1	429	0.00002
Gemmatirosa_kalamazoonesis	861299	S	179425	15716	195141	0.00926
Gemmatimonas_groenlandica	2732249	S	17931	2238	20169	0.00096
Gemmatimonas_aurantiaca	173480	S	13538	1512	15050	0.00071
Gemmatimonas_phototrophica	1379270	S	11390	1737	13127	0.00062
Hymenobacter_sp._PAMC_26628	1484118	S	1483	346	1829	0.00009
Hymenobacter_sp._5317J-9	2932250	S	1434	308	1742	0.00008
Hymenobacter_sp._PAMC_26554	1484116	S	1297	119	1416	0.00007
Hymenobacter_sp._APR13	1356852	S	1214	381	1595	0.00008
Hymenobacter_sp._BRD128	2675878	S	1124	137	1261	0.00006
Hymenobacter_sp._5116S-27	2932249	S	848	101	949	0.00005
Hymenobacter_sp._5116S-3	2932248	S	801	92	893	0.00004
Hymenobacter_sp._BT18	2835648	S	773	89	862	0.00004
Hymenobacter_sp._NBH84	2596915	S	677	77	754	0.00004
Hymenobacter_sp._DG01	2584940	S	650	126	776	0.00004
Hymenobacter_sp._5413J-13	2932251	S	637	72	709	0.00003
Hymenobacter_sp._5420S-77	2932254	S	619	84	703	0.00003
Hymenobacter_sp._S2-20-2	2761579	S	558	76	634	0.00003
Hymenobacter_sp._DG25B	1385664	S	512	121	633	0.00003
Hymenobacter_sp._BRD67	2675877	S	500	467	967	0.00005
Hymenobacter_sp._DG25A	1385663	S	358	87	445	0.00002
Hymenobacter_sp._HDW8	2714932	S	301	955	1256	0.00006
Hymenobacter_sp._5516J-16	2932253	S	171	423	594	0.00003
Hymenobacter_sp._5516S-25	2933777	S	146	341	487	0.00002
Hymenobacter_sp._5414T-23	2932252	S	14	1449	1463	0.00007
Hymenobacter_monticola	1705399	S	1456	267	1723	0.00008
Hymenobacter_busanensis	2607656	S	1376	151	1527	0.00007
Hymenobacter_sedentarius	1411621	S	1167	177	1344	0.00006
Hymenobacter_nivis	1850093	S	1036	263	1299	0.00006
Hymenobacter_jejuensis	2502781	S	954	74	1028	0.00005
Hymenobacter_oligotrophus	2319843	S	881	96	977	0.00005
Hymenobacter_swuensis	1446467	S	743	164	907	0.00004
Hymenobacter_tibetensis	497967	S	678	106	784	0.00004
Hymenobacter_baengnokdamensis	2615203	S	554	588	1142	0.00005
Hymenobacter_qilianensis	1385715	S	441	79	520	0.00002
Hymenobacter_radiodurans	2496028	S	228	757	985	0.00005
Pontibacter_russatus	2694929	S	1501	161	1662	0.00008
Pontibacter_pudoricolor	2694930	S	972	118	1090	0.00005
Pontibacter_actiniarum	323450	S	830	204	1034	0.00005
Pontibacter_akesuensis	388950	S	620	96	716	0.00003
Pontibacter_korlensis	400092	S	364	54	418	0.00002
Pontibacter_sp._SGAir0037	2571030	S	345	60	405	0.00002
Rufibacter_radiotolerans	1379910	S	550	65	615	0.00003
Rufibacter_tibetensis	512763	S	397	67	464	0.00002
Rufibacter_sp._DG15C	1379909	S	289	163	452	0.00002
Adhaeribacter_swui	2086471	S	355	47	402	0.00002
Adhaeribacter_radiodurans	2745197	S	228	26	254	0.00001
Nibribacter_ruber	2698458	S	246	137	383	0.00002
Spirosoma_sp._CJU-R4	2728024	S	886	69	955	0.00005
Spirosoma_sp._KUDC1026	2745947	S	538	49	587	0.00003
Spirosoma_sp._RHs26	2898794	S	439	33	472	0.00002
Spirosoma_sp._KCTC_42546	2520506	S	397	48	445	0.00002
Spirosoma_sp._KCTC_72228	2710596	S	282	34	316	0.00002
Spirosoma_rigui	564064	S	643	48	691	0.00003
Spirosoma_taeanense	2735870	S	581	55	636	0.00003
Spirosoma_montaniterrae	1178516	S	525	32	557	0.00003
Spirosoma_pollinicola	2057025	S	394	45	439	0.00002
Spirosoma_radiotolerans	1379870	S	364	28	392	0.00002
Spirosoma_aerolatum	1211326	S	351	17	368	0.00002
Spirosoma_endbachense	2666025	S	308	171	479	0.00002
Spirosoma_aureum	2692134	S	264	177	441	0.00002
Rhodocytophaga_rosea	2704465	S	335	12	347	0.00002
Aquirufa_nivalisilvae	2516557	S	59	15	74	0.00000
Aquirufa_sp._9H-EGSE	2696560	S	59	18	77	0.00000
Cytophaga_hutchinsonii	985	S	126	11	137	0.00001
Dyadobacter_fermentans	94254	S	937	94	1031	0.00005
Dyadobacter_sp._LJ419	2906456	S	274	23	297	0.00001
Dyadobacter_sp._NIV53	2861765	S	123	9	132	0.00001
Dyadobacter_sandarakinus	2747268	S	392	40	432	0.00002
Fibrella_aestuarina	651143	S	1194	102	1296	0.00006
Fibrella_sp._ES10-3-2-2	1834519	S	520	40	560	0.00003
Runella_slithyformis	106	S	429	38	467	0.00002
Runella_rosea	2259595	S	263	28	291	0.00001
Runella_sp._SP2	2268026	S	247	16	263	0.00001
Larkinella_sp._IE-0392	2907205	S	374	28	402	0.00002
Leadbetterella_byssophila	316068	S	81	48	129	0.00001
Arcticibacterium_luteifluviistationis	1784714	S	45	3	48	0.00000
Chryseolinea_soli	2321403	S	2882	90	2972	0.00014
Fulvivirga_sp._SS9-22	2904245	S	191	14	205	0.00001
Fulvivirga_sp._W9P-11	2904246	S	102	22	124	0.00001
Fulvivirga_sp._SW1-E11	2904247	S	73	22	95	0.00000
Fulvivirga_lutea	2810512	S	98	10	108	0.00001
Echinicola_vietnamensis	390884	S	146	70	216	0.00001
Echinicola_sp._20G	2781961	S	72	9	81	0.00000
Echinicola_sp._SCS_3-6	2859768	S	58	23	81	0.00000
Echinicola_strongylocentroti	1795355	S	132	20	152	0.00001
Echinicola_soli	2591634	S	126	11	137	0.00001
Echinicola_rosea	1807691	S	118	47	165	0.00001
Algoriphagus_sp._Y33	2772483	S	103	10	113	0.00001
Algoriphagus_sp._NBT04N3	2705473	S	63	21	84	0.00000
Algoriphagus_sanaruensis	1727163	S	116	16	132	0.00001
Algoriphagus_machipongonensis	388413	S	73	7	80	0.00000
Cyclobacterium_marinum	104	S	58	16	74	0.00000
Cyclobacterium_amurskyense	320787	S	50	6	56	0.00000
Aquiflexum_balticum	280473	S	109	16	125	0.00001
Belliella_baltica	232259	S	78	38	116	0.00001
Mongoliitalea_daihaiensis	2782006	S	59	6	65	0.00000
Flammeovirga_sp._MY04	1191459	S	27	28	55	0.00000
Flammeovirga_yaeyamensis	367791	S	16	16	32	0.00000
Flammeovirga_pectinis	2494373	S	16	3	19	0.00000
Flammeovirga_kamogawensis	373891	S	13	2	15	0.00000
Cardinium_endosymbiont_of_Encarsia_pergandiella	249402	S	12	4	16	0.00000
Cardinium_endosymbiont_of_Sogatella_furcifera	650378	S	12	5	17	0.00000
Candidatus_Cardinium_hertigii	247481	S	13	2	15	0.00000
Candidatus_Amoebophilus_asiaticus	281120	S	42	3	45	0.00000
Mangrovivirga_cuniculi	2715131	S	98	7	105	0.00000
Marivirga_tractuosa	1006	S	87	31	118	0.00001
Bernardetia_litoralis	999	S	51	4	55	0.00000
Niastella_koreensis	354356	S	8782	858	9640	0.00046
Chitinophaga_sp._XS-30	2604421	S	1052	358	1410	0.00007
Chitinophaga_sp._KRA15-503	2829818	S	613	310	923	0.00004
Chitinophaga_filiformis	104663	S	1599	231	1830	0.00009
Chitinophaga_oryzae	2725414	S	1024	138	1162	0.00006
Chitinophaga_alhagiae	2203219	S	627	12	639	0.00003
Chitinophaga_pinensis	79329	S	557	106	663	0.00003
Chitinophaga_agri	2703787	S	470	108	578	0.00003
Chitinophaga_caeni	2029983	S	338	57	395	0.00002
Flavisolibacter_ginsenosidimutans	661481	S	2515	143	2658	0.00013
Flavisolibacter_tropicus	1492898	S	1965	276	2241	0.00011
Paraflavitalea_soli	2315862	S	2131	152	2283	0.00011
Pseudocnuella_soli	2502779	S	2086	238	2324	0.00011
Panacibacter_ginsenosidivorans	1813871	S	1965	86	2051	0.00010
Flavihumibacter_sp._IMCC34838	2838156	S	908	83	991	0.00005
Flavihumibacter_sp._IMCC34837	2838157	S	703	50	753	0.00004
Niabella_ginsenosidivorans	1176587	S	794	72	866	0.00004
Niabella_soli	446683	S	776	84	860	0.00004
Pseudobacter_ginsenosidimutans	661488	S	1505	122	1627	0.00008
Arachidicoccus_sp._BS20	1850526	S	460	177	637	0.00003
Arachidicoccus_sp._5GH13-10	2875539	S	266	40	306	0.00001
Arachidicoccus_sp._B3-10	2545455	S	159	12	171	0.00001
Arachidicoccus_soli	2341117	S	305	31	336	0.00002
Arachidicoccus_ginsenosidivorans	496057	S	234	34	268	0.00001
Ferruginibacter_sp._KIS38-8	2875540	S	583	47	630	0.00003
Ferruginibacter_lapsinanis	563172	S	454	36	490	0.00002
Lacibacter_sp._S13-6-6	2760713	S	1029	44	1073	0.00005
Filimonas_lacunae	477680	S	792	89	881	0.00004
Phnomibacter_ginsenosidimutans	2676868	S	786	90	876	0.00004
Rhodocaloribacter_litoris	2558931	S	7646	774	8420	0.00040
Rhodothermus_marinus	29549	S	6499	353	6852	0.00033
Salinibacter_ruber	146919	S	3893	60	3953	0.00019
Alistipes_dispar	2585119	S	871	108	979	0.00005
Alistipes_communis	2585118	S	845	703	1548	0.00007
Alistipes_onderdonkii	328813	S	796	1037	1833	0.00009
Alistipes_senegalensis	1288121	S	774	163	937	0.00004
Alistipes_finegoldii	214856	S	716	708	1424	0.00007
Alistipes_megaguti	2364787	S	662	76	738	0.00004
Alistipes_shahii	328814	S	558	325	883	0.00004
Alistipes_sp._dk3624	2662363	S	554	132	686	0.00003
Alistipes_indistinctus	626932	S	522	121	643	0.00003
Prevotella_sp._oral_taxon_475	712471	S	112	10	122	0.00001
Prevotella_sp._Rep29	2691580	S	111	12	123	0.00001
Prevotella_sp._E13-17	2913616	S	110	5	115	0.00001
Prevotella_sp._E15-22	2937774	S	72	7	79	0.00000
Prevotella_sp._E9-3	2913621	S	48	10	58	0.00000
Prevotella_sp._E2-28	2913620	S	42	2	44	0.00000
Prevotella_sp._E13-3	2913617	S	15	63	78	0.00000
Prevotella_sp._E2-25	2913619	S	15	58	73	0.00000
Prevotella_sp._oral_taxon_299	652716	S	12	1	13	0.00000
Prevotella_dentalis	52227	S	365	73	438	0.00002
Prevotella_denticola	28129	S	143	48	191	0.00001
Prevotella_multiformis	282402	S	127	55	182	0.00001
Prevotella_melaninogenica	28132	S	121	44	165	0.00001
Prevotella_ruminicola	839	S	109	4	113	0.00001
Prevotella_intermedia	28131	S	97	48	145	0.00001
Prevotella_buccalis	28127	S	74	90	164	0.00001
Prevotella_copri	165179	S	72	37	109	0.00001
Prevotella_enoeca	76123	S	55	10	65	0.00000
Prevotella_fusca	589436	S	54	12	66	0.00000
Prevotella_nigrescens	28133	S	48	30	78	0.00000
Prevotella_oris	28135	S	46	5	51	0.00000
Prevotella_jejuni	1177574	S	33	13	46	0.00000
Prevotella_bryantii	77095	S	25	2	27	0.00000
Prevotella_veroralis	28137	S	16	3	19	0.00000
Prevotella_herbatica	2801997	S	16	0	16	0.00000
Prevotella_histicola	470565	S	14	2	16	0.00000
Paraprevotella_xylaniphila	454155	S	114	112	226	0.00001
Pseudoprevotella_muciniphila	2133944	S	99	12	111	0.00001
Bacteroides_sp._CBA7301	2715212	S	88	27	115	0.00001
Bacteroides_sp._M10	2763022	S	43	96	139	0.00001
Bacteroides_eggerthii	28111	S	127	147	274	0.00001
Bacteroides_thetaiotaomicron	818	S	123	82	205	0.00001
Bacteroides_cellulosilyticus	246787	S	120	45	165	0.00001
Bacteroides_fragilis	817	S	114	199	313	0.00001
Bacteroides_zoogleoformans	28119	S	99	25	124	0.00001
Bacteroides_heparinolyticus	28113	S	92	22	114	0.00001
Bacteroides_stercoris	46506	S	81	87	168	0.00001
Bacteroides_salyersiae	291644	S	77	81	158	0.00001
Bacteroides_helcogenes	290053	S	74	3	77	0.00000
Bacteroides_nordii	291645	S	74	61	135	0.00001
Bacteroides_uniformis	820	S	69	215	284	0.00001
Bacteroides_zhangwenhongii	2650157	S	66	44	110	0.00001
Bacteroides_faecis	674529	S	62	53	115	0.00001
Bacteroides_caccae	47678	S	60	15	75	0.00000
Bacteroides_xylanisolvens	371601	S	48	123	171	0.00001
Bacteroides_intestinalis	329854	S	31	5	36	0.00000
Bacteroides_ovatus	28116	S	29	57	86	0.00000
Bacteroides_caecimuris	1796613	S	29	42	71	0.00000
Bacteroides_coprosuis	151276	S	21	1	22	0.00000
Bacteroides_luhongzhouii	2650158	S	21	9	30	0.00000
Phocaeicola_salanitronis	376805	S	177	84	261	0.00001
Phocaeicola_coprophilus	387090	S	100	57	157	0.00001
Phocaeicola_dorei	357276	S	40	66	106	0.00001
Phocaeicola_vulgatus	821	S	36	48	84	0.00000
Tannerella_serpentiformis	712710	S	629	31	660	0.00003
Tannerella_forsythia	28112	S	165	10	175	0.00001
Parabacteroides_goldsteinii	328812	S	176	48	224	0.00001
Parabacteroides_merdae	46503	S	125	151	276	0.00001
Parabacteroides_johnsonii	387661	S	101	90	191	0.00001
Parabacteroides_distasonis	823	S	88	283	371	0.00002
Sodaliphilus_pleomorphus	2606626	S	425	235	660	0.00003
Duncaniella_dubosii	2518971	S	119	18	137	0.00001
Muribaculum_gordoncarteri	2530390	S	159	19	178	0.00001
Muribaculum_intestinale	1796646	S	132	14	146	0.00001
Porphyromonas_sp._oral_taxon_275	712435	S	435	45	480	0.00002
Porphyromonas_gingivalis	837	S	127	25	152	0.00001
Porphyromonas_asaccharolytica	28123	S	105	9	114	0.00001
Porphyromonas_somerae	322095	S	50	14	64	0.00000
Porphyromonas_cangingivalis	36874	S	44	7	51	0.00000
Porphyromonas_endodontalis	28124	S	31	3	34	0.00000
Porphyromonas_crevioricanis	393921	S	29	6	35	0.00000
Petrimonas_mucosa	1642646	S	204	17	221	0.00001
Proteiniphilum_saccharofermentans	1642647	S	107	8	115	0.00001
Proteiniphilum_sp._JNU-WLY501	2829812	S	64	2	66	0.00000
Dysgonomonas_sp._HDW5A	2714926	S	14	24	38	0.00000
Barnesiella_viscericola	397865	S	270	391	661	0.00003
Coprobacter_secundus	1501392	S	40	39	79	0.00000
Butyricimonas_faecalis	2093856	S	70	86	156	0.00001
Butyricimonas_virosa	544645	S	60	21	81	0.00000
Odoribacter_splanchnicus	28118	S	75	84	159	0.00001
Paludibacter_propionicigenes	185300	S	92	2	94	0.00000
Tenuifilum_thalassicum	2590900	S	57	1	58	0.00000
Salinivirga_cyanobacteriivorans	1307839	S	49	1	50	0.00000
Draconibacterium_orientale	1168034	S	103	11	114	0.00001
Draconibacterium_halophilum	2706887	S	93	8	101	0.00000
Maribellus_comscasis	2681766	S	107	6	113	0.00001
Alkalitalea_saponilacus	889453	S	67	7	74	0.00000
Labilibaculum_antarcticum	1717717	S	43	4	47	0.00000
Flavobacterium_sp._HJ-32-4	1160795	S	349	25	374	0.00002
Flavobacterium_sp._CJ74	2294119	S	92	7	99	0.00000
Flavobacterium_sp._CLA17	2724135	S	75	13	88	0.00000
Flavobacterium_sp._MDT1-60	1979344	S	65	12	77	0.00000
Flavobacterium_sp._IGB_4-14	1871076	S	64	6	70	0.00000
Flavobacterium_sp._F-323	2893885	S	61	13	74	0.00000
Flavobacterium_sp._F-29	2893883	S	61	13	74	0.00000
Flavobacterium_sp._B183	907046	S	50	11	61	0.00000
Flavobacterium_sp._M31R6	2739062	S	46	7	53	0.00000
Flavobacterium_sp._KBS0721	1179672	S	42	11	53	0.00000
Flavobacterium_sp._KSM-R2A25	2895947	S	42	10	52	0.00000
Flavobacterium_sp._SLB02	2665645	S	42	7	49	0.00000
Flavobacterium_sp._F-70	2893884	S	41	8	49	0.00000
Flavobacterium_sp._CS20	2775246	S	37	15	52	0.00000
Flavobacterium_sp._Sr18	935222	S	36	6	42	0.00000
Flavobacterium_sp._K5-23	2746225	S	33	8	41	0.00000
Flavobacterium_sp._LPB0248	2614441	S	32	18	50	0.00000
Flavobacterium_sp._KSM-R2A30	2897181	S	30	10	40	0.00000
Flavobacterium_sp._MMS21-Er5	2937442	S	29	13	42	0.00000
Flavobacterium_sp._xlx-214	2654325	S	28	6	34	0.00000
Flavobacterium_sp._WSW3-B6	2856519	S	28	3	31	0.00000
Flavobacterium_sp._I3-2	2748319	S	27	43	70	0.00000
Flavobacterium_sp._KK2020170	2830782	S	26	8	34	0.00000
Flavobacterium_sp._GENT5	1751095	S	25	5	30	0.00000
Flavobacterium_sp._F-340	2893886	S	23	7	30	0.00000
Flavobacterium_sp._140616W15	2478552	S	17	3	20	0.00000
Flavobacterium_sp._SHINM13	1751056	S	15	26	41	0.00000
Flavobacterium_sp._CECT_9288	2845819	S	14	11	25	0.00000
Flavobacterium_sp._CHNK8	2871165	S	12	9	21	0.00000
Flavobacterium_sp._GENT11	1751100	S	10	18	28	0.00000
Flavobacterium_album	2175091	S	218	16	234	0.00001
Flavobacterium_magnum	2162713	S	186	21	207	0.00001
Flavobacterium_pallidum	2172098	S	153	16	169	0.00001
Flavobacterium_nackdongense	2547394	S	105	9	114	0.00001
Flavobacterium_gilvum	1492737	S	69	11	80	0.00000
Flavobacterium_enshiense	1341165	S	68	8	76	0.00000
Flavobacterium_inviolabile	2748320	S	67	10	77	0.00000
Flavobacterium_commune	1306519	S	67	11	78	0.00000
Flavobacterium_johnsoniae	986	S	62	29	91	0.00000
Flavobacterium_anhuiense	459526	S	61	26	87	0.00000
Flavobacterium_alkalisoli	2602769	S	57	5	62	0.00000
Flavobacterium_endoglycinae	2816357	S	55	13	68	0.00000
Flavobacterium_sangjuense	2518177	S	54	6	60	0.00000
Flavobacterium_faecale	1355330	S	47	6	53	0.00000
Flavobacterium_kingsejongi	1678728	S	46	7	53	0.00000
Flavobacterium_crocinum	2183896	S	45	15	60	0.00000
Flavobacterium_fluviale	2249356	S	44	18	62	0.00000
Flavobacterium_sediminilitoris	2024526	S	36	5	41	0.00000
Flavobacterium_nitrogenifigens	1617283	S	36	20	56	0.00000
Flavobacterium_sediminis	2201181	S	34	36	70	0.00000
Flavobacterium_branchiophilum	55197	S	34	3	37	0.00000
Flavobacterium_davisii	2906077	S	33	14	47	0.00000
Flavobacterium_oreochromis	2906078	S	30	13	43	0.00000
Flavobacterium_jumunjinense	998845	S	28	4	32	0.00000
Flavobacterium_psychrophilum	96345	S	27	5	32	0.00000
Flavobacterium_arcticum	1784713	S	26	3	29	0.00000
Flavobacterium_covae	2906076	S	26	37	63	0.00000
Flavobacterium_columnare	996	S	25	32	57	0.00000
Flavobacterium_indicum	312277	S	23	3	26	0.00000
Flavobacterium_crassostreae	1763534	S	22	6	28	0.00000
Flavobacterium_haoranii	683124	S	20	9	29	0.00000
Capnocytophaga_sp._oral_taxon_878	1316596	S	29	12	41	0.00000
Capnocytophaga_sp._oral_taxon_902	2748316	S	25	52	77	0.00000
Capnocytophaga_sp._FDAARGOS_737	2545799	S	19	13	32	0.00000
Capnocytophaga_sp._oral_taxon_323	1705617	S	11	26	37	0.00000
Capnocytophaga_sp._oral_taxon_864	1316593	S	10	21	31	0.00000
Capnocytophaga_gingivalis	1017	S	119	16	135	0.00001
Capnocytophaga_haemolytica	45243	S	75	7	82	0.00000
Capnocytophaga_sputigena	1019	S	50	20	70	0.00000
Capnocytophaga_canimorsus	28188	S	45	17	62	0.00000
Capnocytophaga_leadbetteri	327575	S	21	14	35	0.00000
Capnocytophaga_stomatis	1848904	S	21	6	27	0.00000
Capnocytophaga_endodontalis	2708117	S	18	10	28	0.00000
Capnocytophaga_cynodegmi	28189	S	17	5	22	0.00000
Capnocytophaga_ochracea	1018	S	16	26	42	0.00000
Muricauda_sp._SCSIO_65647	2908843	S	108	4	112	0.00001
Muricauda_sp._SCSIO_64092	2908842	S	77	2	79	0.00000
Muricauda_aquimarina	254955	S	103	58	161	0.00001
Muricauda_oceani	2698672	S	103	59	162	0.00001
Muricauda_ruestringensis	111501	S	98	10	108	0.00001
Muricauda_lutaonensis	516051	S	94	24	118	0.00001
Muricauda_aurantiaca	1383885	S	35	3	38	0.00000
Gramella_sp._GC03-9	2920386	S	72	21	93	0.00000
Gramella_sp._MT6	2705471	S	52	8	60	0.00000
Gramella_sp._MAR_2010_147	1250205	S	38	6	44	0.00000
Gramella_fulva	2126553	S	110	10	120	0.00001
Gramella_flava	1486245	S	84	28	112	0.00001
Gramella_forsetii	411153	S	53	13	66	0.00000
Gramella_echinicola	279359	S	50	6	56	0.00000
Gramella_salexigens	1913577	S	27	3	30	0.00000
Robiginitalea_biformata	252307	S	428	26	454	0.00002
Polaribacter_sp._SM13	2818493	S	47	12	59	0.00000
Polaribacter_sp._Hel1_33_78	1336804	S	27	6	33	0.00000
Polaribacter_sp._KT25b	1855336	S	21	7	28	0.00000
Polaribacter_sp._SA4-10	754397	S	18	4	22	0.00000
Polaribacter_sp._G4M1	2808900	S	16	3	19	0.00000
Polaribacter_sp._MED152	313598	S	16	2	18	0.00000
Polaribacter_sp._L3A8	2686361	S	15	11	26	0.00000
Polaribacter_sp._ALD11	2058137	S	14	5	19	0.00000
Polaribacter_sp._Q13	2806551	S	13	8	21	0.00000
Polaribacter_sp._NJDZ03	2855841	S	11	13	24	0.00000
Polaribacter_litorisediminis	1908341	S	25	3	28	0.00000
Polaribacter_vadi	1774273	S	23	3	26	0.00000
Polaribacter_haliotis	1888915	S	16	8	24	0.00000
Polaribacter_reichenbachii	996801	S	14	2	16	0.00000
Polaribacter_sejongensis	985043	S	13	12	25	0.00000
Nonlabens_sp._Hel1_33_55	1336802	S	33	6	39	0.00000
Nonlabens_sp._MB-3u-79	2058134	S	17	5	22	0.00000
Nonlabens_sp._Ci31	2608253	S	17	4	21	0.00000
Nonlabens_spongiae	331648	S	76	40	116	0.00001
Nonlabens_ponticola	2496866	S	48	7	55	0.00000
Nonlabens_marinus	930802	S	37	14	51	0.00000
Nonlabens_dokdonensis	328515	S	22	5	27	0.00000
Winogradskyella_sp._PC-19	754417	S	33	10	43	0.00000
Winogradskyella_sp._J14-2	1936080	S	21	3	24	0.00000
Winogradskyella_sp._HaHa_3_26	2749995	S	19	10	29	0.00000
Winogradskyella_sp._MH6	2929510	S	17	3	20	0.00000
Winogradskyella_sp._PG-2	754409	S	15	1	16	0.00000
Winogradskyella_forsetii	2686077	S	58	23	81	0.00000
Winogradskyella_schleiferi	2686078	S	37	23	60	0.00000
Winogradskyella_helgolandensis	2697010	S	20	6	26	0.00000
Winogradskyella_sediminis	1382466	S	18	6	24	0.00000
Antarcticibacterium_sp._1MA-6-2	2908210	S	77	10	87	0.00000
Antarcticibacterium_flavum	2058175	S	70	16	86	0.00000
Antarcticibacterium_arcticum	2585771	S	70	9	79	0.00000
Sinomicrobium_sp._HD2P242	2900738	S	187	8	195	0.00001
Aequorivita_sublithincola	101385	S	64	56	120	0.00001
Aequorivita_sp._H23M31	2494375	S	48	19	67	0.00000
Tenacibaculum_sp._SZ-18	754423	S	19	24	43	0.00000
Tenacibaculum_dicentrarchi	669041	S	28	14	42	0.00000
Tenacibaculum_todarodis	1850252	S	27	10	37	0.00000
Tenacibaculum_maritimum	107401	S	24	9	33	0.00000
Tenacibaculum_jejuense	584609	S	15	1	16	0.00000
Tenacibaculum_mesophilum	104268	S	14	10	24	0.00000
Salegentibacter_salegens	143223	S	59	12	71	0.00000
Salegentibacter_mishustinae	270918	S	45	46	91	0.00000
Salegentibacter_sp._T436	1729720	S	38	44	82	0.00000
Maribacter_sp._MJ134	2496865	S	31	8	39	0.00000
Maribacter_sp._HTCC2170	313603	S	26	3	29	0.00000
Maribacter_cobaltidurans	1178778	S	41	40	81	0.00000
Maribacter_hydrothermalis	1836467	S	24	17	41	0.00000
Cellulophaga_sp._HaHaR_3_176	1942464	S	23	4	27	0.00000
Cellulophaga_sp._L1A9	2686362	S	13	4	17	0.00000
Cellulophaga_sp._HaHa_2_1	2749994	S	11	24	35	0.00000
Cellulophaga_lytica	979	S	29	20	49	0.00000
Cellulophaga_algicola	59600	S	28	5	33	0.00000
Cellulophaga_baltica	76594	S	25	9	34	0.00000
Formosa_sp._Hel1_33_131	1336794	S	41	4	45	0.00000
Formosa_sp._Hel1_31_208	1798225	S	33	4	37	0.00000
Formosa_sp._Hel3_A1_48	1336795	S	28	7	35	0.00000
Formosa_sp._L2A11	2686363	S	16	6	22	0.00000
Formosa_agariphila	320324	S	18	5	23	0.00000
Formosa_sediminum	2594004	S	18	5	23	0.00000
Kordia_antarctica	1218801	S	110	12	122	0.00001
Kordia_sp._SMS9	2282170	S	42	3	45	0.00000
Myroides_odoratus	256	S	29	4	33	0.00000
Myroides_fluvii	2572594	S	24	5	29	0.00000
Myroides_sp._ZB35	1458492	S	11	44	55	0.00000
Myroides_phaeus	702745	S	14	11	25	0.00000
Aquimarina_sp._TRL1	2736252	S	34	2	36	0.00000
Aquimarina_sp._BL5	1714860	S	31	2	33	0.00000
Aquimarina_sp._AD1	1714848	S	28	2	30	0.00000
Aquimarina_sp._AD10	1714849	S	25	1	26	0.00000
Flagellimonas_sp._CMM7	2654676	S	67	4	71	0.00000
Flagellimonas_sp._HMM57	2905121	S	43	3	46	0.00000
Leeuwenhoekiella_palythoae	573501	S	46	32	78	0.00000
Leeuwenhoekiella_sp._ZYFB001	2719912	S	34	17	51	0.00000
Zobellia_galactanivorans	63186	S	91	6	97	0.00000
Aggregatimonas_sangjinii	2583587	S	90	4	94	0.00000
Dokdonia_sp._4H-3-7-5	983548	S	26	18	44	0.00000
Dokdonia_sp._Dokd-P16	2173169	S	13	7	20	0.00000
Zunongwangia_sp._SCSIO_43204	2779359	S	41	30	71	0.00000
Zunongwangia_profunda	398743	S	38	32	70	0.00000
Arenibacter_algicola	616991	S	72	24	96	0.00000
Algibacter_sp._L1A34	2686365	S	25	11	36	0.00000
Algibacter_sp._L3A6	2686366	S	20	9	29	0.00000
Algibacter_alginicilyticus	1736674	S	22	6	28	0.00000
Lutibacter_sp._A64	2918526	S	18	5	23	0.00000
Lutibacter_sp._A80	2918453	S	17	5	22	0.00000
Lutibacter_profundi	1622118	S	26	3	29	0.00000
Euzebyella_marina	1761453	S	65	36	101	0.00000
Muriicola_soli	2507538	S	59	4	63	0.00000
Pukyongia_salina	2094025	S	58	4	62	0.00000
Gilvibacter_sp._SZ-19	754429	S	58	8	66	0.00000
Zhouia_spongiae	2202721	S	57	14	71	0.00000
Mariniflexile_sp._TRM1-10	2027857	S	53	5	58	0.00000
Constantimarinum_furrinae	2562285	S	52	5	57	0.00000
Lacinutrix_sp._WUR7	2653681	S	17	4	21	0.00000
Lacinutrix_sp._Bg11-31	2057808	S	11	2	13	0.00000
Lacinutrix_venerupis	1486034	S	16	4	20	0.00000
Tamlana_carrageenivorans	2069432	S	23	8	31	0.00000
Tamlana_sp._s12	1630406	S	21	8	29	0.00000
Sediminicola_sp._YIK13	1453352	S	50	5	55	0.00000
Flavobacteriaceae_bacterium_10Alg115	2584122	S	50	3	53	0.00000
Mesoflavibacter_sp._SCSIO_43206	2779362	S	24	32	56	0.00000
Croceibacter_atlanticus	313588	S	45	8	53	0.00000
Seonamhaeicola_sp._ML3	2937786	S	23	3	26	0.00000
Seonamhaeicola_sp._S2-3	1936081	S	20	5	25	0.00000
Psychroflexus_torquis	57029	S	22	1	23	0.00000
Psychroflexus_sp._ALD_RP9	2777186	S	22	2	24	0.00000
Galbibacter_sp._BG1	1170699	S	43	5	48	0.00000
Costertonia_aggregata	343403	S	39	8	47	0.00000
Marixanthomonas_sp._SCSIO_43207	2779360	S	38	11	49	0.00000
Changchengzhania_lutea	2049305	S	38	5	43	0.00000
Aegicerativicinus_sediminis	2893202	S	36	2	38	0.00000
Flavivirga_eckloniae	1803846	S	30	2	32	0.00000
Amniculibacterium_sp._G2-70	2767188	S	30	40	70	0.00000
Olleya_aquimaris	639310	S	11	5	16	0.00000
Siansivirga_zeaxanthinifaciens	762954	S	28	7	35	0.00000
Bizionia_sp._M204	2675331	S	28	6	34	0.00000
Sabulilitoribacter_sp._BrNp1-15	2916754	S	24	5	29	0.00000
Urechidicola_croceus	1850246	S	23	13	36	0.00000
Wenyingzhuangia_fucanilytica	1790137	S	21	3	24	0.00000
Gillisia_sp._Hel1_33_143	1336796	S	21	7	28	0.00000
Oceanihabitans_sp._IOP_32	2529032	S	19	8	27	0.00000
Chryseobacterium_sp._6424	2039166	S	117	35	152	0.00001
Chryseobacterium_sp.	1871047	S	70	34	104	0.00000
Chryseobacterium_sp._SC2-2	2929800	S	60	39	99	0.00000
Chryseobacterium_sp._F4	2852098	S	56	3	59	0.00000
Chryseobacterium_sp._cx-624	2758037	S	55	12	67	0.00000
Chryseobacterium_sp._POL2	2713414	S	48	39	87	0.00000
Chryseobacterium_sp._IHB_B_17019	1721091	S	47	9	56	0.00000
Chryseobacterium_sp._ZHDP1	2838877	S	46	51	97	0.00000
Chryseobacterium_sp._G0201	2487065	S	44	13	57	0.00000
Chryseobacterium_sp._C-17	2898076	S	44	26	70	0.00000
Chryseobacterium_sp._MEBOG06	2879938	S	44	12	56	0.00000
Chryseobacterium_sp._T16E-39	2015076	S	44	6	50	0.00000
Chryseobacterium_sp._Y16C	2920939	S	37	31	68	0.00000
Chryseobacterium_sp._LJ668	2864040	S	37	7	44	0.00000
Chryseobacterium_sp._G0186	2487064	S	34	27	61	0.00000
Chryseobacterium_sp._StRB126	878220	S	33	12	45	0.00000
Chryseobacterium_sp._PCH239	2825845	S	32	27	59	0.00000
Chryseobacterium_sp._DH-B6	2759528	S	32	16	48	0.00000
Chryseobacterium_sp._3008163	2478663	S	32	19	51	0.00000
Chryseobacterium_sp._SNU_WT5	2594269	S	30	12	42	0.00000
Chryseobacterium_sp._ADR-1	2929799	S	22	8	30	0.00000
Chryseobacterium_sp._G0162	2487063	S	17	21	38	0.00000
Chryseobacterium_sp._MEBOG07	2879939	S	13	4	17	0.00000
Chryseobacterium_taklimakanense	536441	S	158	112	270	0.00001
Chryseobacterium_indologenes	253	S	110	65	175	0.00001
Chryseobacterium_camelliae	1265445	S	91	73	164	0.00001
Chryseobacterium_shandongense	1493872	S	84	66	150	0.00001
Chryseobacterium_indoltheticum	254	S	72	19	91	0.00000
Chryseobacterium_carnipullorum	1124835	S	64	28	92	0.00000
Chryseobacterium_arthrosphaerae	651561	S	60	40	100	0.00000
Chryseobacterium_aureum	2497456	S	51	13	64	0.00000
Chryseobacterium_salivictor	2547600	S	47	7	54	0.00000
Chryseobacterium_nepalense	1854498	S	46	8	54	0.00000
Chryseobacterium_lactis	1241981	S	46	66	112	0.00001
Chryseobacterium_balustinum	246	S	45	18	63	0.00000
Chryseobacterium_gleum	250	S	42	68	110	0.00001
Chryseobacterium_gallinarum	1324352	S	40	18	58	0.00000
Chryseobacterium_daecheongense	192389	S	40	7	47	0.00000
Chryseobacterium_piperi	558152	S	38	5	43	0.00000
Chryseobacterium_manosquense	2754694	S	38	37	75	0.00000
Chryseobacterium_cucumeris	1813611	S	32	20	52	0.00000
Chryseobacterium_joostei	112234	S	26	11	37	0.00000
Chryseobacterium_nakagawai	1241982	S	22	42	64	0.00000
Chryseobacterium_bernardetii	1241978	S	17	170	187	0.00001
Chryseobacterium_glaciei	1685010	S	14	3	17	0.00000
Kaistella_sp._97-N-M2	2908645	S	99	15	114	0.00001
Kaistella_sp._GW4-15	2878534	S	25	3	28	0.00000
Kaistella_daneshvariae	2487074	S	73	8	81	0.00000
Kaistella_carnis	1241979	S	53	19	72	0.00000
Kaistella_jeonii	266749	S	47	4	51	0.00000
Kaistella_antarctica	266748	S	45	5	50	0.00000
Candidatus_Kaistella_beijingensis	2820270	S	40	17	57	0.00000
Kaistella_flava_(ex_Peng_et_al._2021)	2038776	S	22	4	26	0.00000
Epilithonimonas_vandammei	2487072	S	58	110	168	0.00001
Epilithonimonas_zeae	1416779	S	54	8	62	0.00000
Elizabethkingia_anophelis	1117645	S	73	114	187	0.00001
Elizabethkingia_meningoseptica	238	S	39	3	42	0.00000
Elizabethkingia_miricola	172045	S	36	28	64	0.00000
Elizabethkingia_sp._JS20170427COW	2583851	S	26	4	30	0.00000
Elizabethkingia_ursingii	1756150	S	20	5	25	0.00000
Cruoricaptor_ignavus	1118202	S	126	20	146	0.00001
Empedobacter_brevis	247	S	40	21	61	0.00000
Empedobacter_falsenii	343874	S	29	28	57	0.00000
Empedobacter_stercoris	1628248	S	19	10	29	0.00000
Apibacter_raozihei	2500547	S	46	17	63	0.00000
Cloacibacterium_caeni	2004710	S	50	58	108	0.00001
Cloacibacterium_normanense	237258	S	18	12	30	0.00000
Ornithobacterium_rhinotracheale	28251	S	80	78	158	0.00001
Bergeyella_cardium	1585976	S	63	15	78	0.00000
Riemerella_anatipestifer	34085	S	49	24	73	0.00000
Weeksella_virosa	1014	S	38	22	60	0.00000
Faecalibacter_bovis	2898187	S	29	5	34	0.00000
Blattabacterium_cuenoti	1653831	S	212	78	290	0.00001
Owenweeksia_hongkongensis	253245	S	90	7	97	0.00000
Croceimicrobium_hydrocarbonivorans	2761580	S	75	18	93	0.00000
Fluviicola_taffensis	191579	S	68	4	72	0.00000
Crocinitomix_sp._GM2_3_6_6	2862509	S	50	1	51	0.00000
Candidatus_Sulcia_muelleri	336810	S	30	8	38	0.00000
Candidatus_Walczuchella_monophlebidarum	1415657	S	11	0	11	0.00000
Ichthyobacterium_seriolicida	242600	S	15	0	15	0.00000
Mucilaginibacter_sp._SMC90	2929803	S	223	14	237	0.00001
Mucilaginibacter_sp._14171R-50	2703789	S	219	14	233	0.00001
Mucilaginibacter_sp._21P	2778902	S	171	11	182	0.00001
Mucilaginibacter_sp._F39-2	2728022	S	156	11	167	0.00001
Mucilaginibacter_mali	2740462	S	436	18	454	0.00002
Mucilaginibacter_ginsenosidivorans	398053	S	394	15	409	0.00002
Mucilaginibacter_daejeonensis	398049	S	368	24	392	0.00002
Mucilaginibacter_gotjawali	1550579	S	321	10	331	0.00002
Mucilaginibacter_celer	2305508	S	310	14	324	0.00002
Mucilaginibacter_ginsenosidivorax	862126	S	276	12	288	0.00001
Mucilaginibacter_paludis	423351	S	261	14	275	0.00001
Mucilaginibacter_xinganensis	1234841	S	205	11	216	0.00001
Mucilaginibacter_mallensis	652787	S	203	8	211	0.00001
Mucilaginibacter_rubeus	2027860	S	189	533	722	0.00003
Mucilaginibacter_ginkgonis	2682091	S	189	10	199	0.00001
Mucilaginibacter_gossypii	551996	S	98	84	182	0.00001
Pedobacter_sp._HDW13	2714940	S	149	20	169	0.00001
Pedobacter_sp._PACM_27299	1727164	S	129	20	149	0.00001
Pedobacter_sp._KBS0701	2578106	S	127	47	174	0.00001
Pedobacter_sp._G11	2482728	S	116	17	133	0.00001
Pedobacter_sp._SW-16	2766984	S	99	20	119	0.00001
Pedobacter_sp._D749	2856523	S	94	36	130	0.00001
Pedobacter_sp._Q8-18	2895286	S	91	8	99	0.00000
Pedobacter_heparinus	984	S	192	17	209	0.00001
Pedobacter_endophyticus	2789740	S	167	17	184	0.00001
Pedobacter_schmidteae	2201271	S	162	15	177	0.00001
Pedobacter_steynii	430522	S	122	12	134	0.00001
Pedobacter_roseus	336820	S	120	34	154	0.00001
Pedobacter_suwonensis	332999	S	113	24	137	0.00001
Pedobacter_cryoconitis	188932	S	96	10	106	0.00001
Pedobacter_ginsengisoli	363852	S	94	13	107	0.00001
Pedobacter_aquae	2605747	S	72	8	80	0.00000
Sphingobacterium_sp._DR205	2713573	S	71	9	80	0.00000
Sphingobacterium_sp._dk4302	2662364	S	67	9	76	0.00000
Sphingobacterium_sp._PCS056	2931400	S	63	14	77	0.00000
Sphingobacterium_sp._CZ-2	2557994	S	58	18	76	0.00000
Sphingobacterium_sp._UDSM-2020	2795738	S	58	23	81	0.00000
Sphingobacterium_sp._SRCM116780	2907623	S	47	8	55	0.00000
Sphingobacterium_sp._ML3W	1538644	S	37	14	51	0.00000
Sphingobacterium_sp._G1-14	2003121	S	10	60	70	0.00000
Sphingobacterium_spiritivorum	258	S	209	177	386	0.00002
Sphingobacterium_thalpophilum	259	S	158	214	372	0.00002
Sphingobacterium_lactis	797291	S	107	111	218	0.00001
Sphingobacterium_hotanense	649196	S	78	29	107	0.00001
Sphingobacterium_psychroaquaticum	561061	S	77	17	94	0.00000
Sphingobacterium_multivorum	28454	S	73	206	279	0.00001
Sphingobacterium_mizutaii	1010	S	72	12	84	0.00000
Sphingobacterium_daejeonense	371142	S	39	13	52	0.00000
Sphingobacterium_paramultivorum	2886510	S	12	17	29	0.00000
Anseongella_ginsenosidimutans	496056	S	381	16	397	0.00002
Olivibacter_sp._LS-1	2592345	S	158	11	169	0.00001
Olivibacter_sp._SDN3	2764720	S	114	21	135	0.00001
Solitalea_canadensis	995	S	122	9	131	0.00001
Solitalea_sp._S2-8	2911172	S	111	11	122	0.00001
Pseudopedobacter_saltans	151895	S	105	103	208	0.00001
Haliscomenobacter_hydrossis	2350	S	413	6	419	0.00002
Saprospira_grandis	1008	S	76	2	78	0.00000
Candidatus_Sulfidibacterium_hydrothermale	2875962	S	146	5	151	0.00001
Chlorobaculum_limnaeum	274537	S	1378	231	1609	0.00008
Chlorobaculum_tepidum	1097	S	721	209	930	0.00004
Chlorobaculum_parvum	274539	S	621	124	745	0.00004
Pelodictyon_luteolum	1100	S	621	103	724	0.00003
Pelodictyon_phaeoclathratiforme	34090	S	142	8	150	0.00001
Chlorobium_limicola	1092	S	273	19	292	0.00001
Chlorobium_phaeobacteroides	1096	S	183	22	205	0.00001
Chlorobium_phaeovibrioides	1094	S	144	30	174	0.00001
Prosthecochloris_sp._GSB1	281093	S	531	37	568	0.00003
Prosthecochloris_sp._HL-130-GSB	1974213	S	169	32	201	0.00001
Prosthecochloris_sp._CIB_2401	1868325	S	163	43	206	0.00001
Prosthecochloris_aestuarii	1102	S	167	17	184	0.00001
Chloroherpeton_thalassium	100716	S	254	4	258	0.00001
Candidatus_Cyclonatronum_proteinivorum	1457365	S	371	38	409	0.00002
Melioribacter_roseus	1134405	S	173	14	187	0.00001
Ignavibacterium_album	591197	S	113	11	124	0.00001
Fibrobacter_succinogenes	833	S	214	3	217	0.00001
Candidatus_Cloacimonas_acidaminovorans	456827	S	122	2	124	0.00001
Luteitalea_sp._TBR-22	2802971	S	60323	11397	71720	0.00340
Luteitalea_pratensis	1855912	S	52007	6421	58428	0.00277
Granulicella_sp._WH15	2602070	S	4983	955	5938	0.00028
Granulicella_sp._5B5	1617967	S	4303	746	5049	0.00024
Granulicella_mallensis	940614	S	3377	433	3810	0.00018
Granulicella_tundricola	940615	S	2678	378	3056	0.00015
Terriglobus_roseus	392734	S	4576	1033	5609	0.00027
Terriglobus_albidus	1592106	S	3331	340	3671	0.00017
Terriglobus_saanensis	870903	S	2198	309	2507	0.00012
Acidobacterium_capsulatum	33075	S	4695	640	5335	0.00025
Acidobacterium_sp._4Y35	2763107	S	3969	312	4281	0.00020
Candidatus_Koribacter_versatilis	658062	S	7628	276	7904	0.00038
Edaphobacter_sp._12200R-103	2703788	S	2795	546	3341	0.00016
Edaphobacter_sp._4G125	2763071	S	1626	272	1898	0.00009
Acidisarcina_polymorpha	2211140	S	2809	224	3033	0.00014
Paludibaculum_fermentans	1473598	S	11859	350	12209	0.00058
Chloracidobacterium_aggregatum	2851959	S	1928	1304	3232	0.00015
Chloracidobacterium_validum	2821543	S	1500	29	1529	0.00007
Chloracidobacterium_sp._D	2821536	S	153	820	973	0.00005
Chloracidobacterium_thermophilum	458033	S	108	532	640	0.00003
Sulfidibacter_corallicola	2818388	S	3202	63	3265	0.00015
Thermotomaculum_hydrothermale	981385	S	127	6	133	0.00001
Nitrospira_moscoviensis	42253	S	8760	816	9576	0.00045
Nitrospira_japonica	1325564	S	4849	629	5478	0.00026
Nitrospira_sp._KM1	1936990	S	3883	398	4281	0.00020
Candidatus_Nitrospira_inopinata	1715989	S	3281	305	3586	0.00017
Leptospirillum_ferrooxidans	180	S	191	4	195	0.00001
Leptospirillum_ferriphilum	178606	S	80	173	253	0.00001
Leptospirillum_sp._Group_II_'CF-1'	1660083	S	55	130	185	0.00001
Dissulfurispira_thermophila	2715679	S	155	12	167	0.00001
Thermodesulfovibrio_yellowstonii	28262	S	120	3	123	0.00001
Treponema_brennaborense	81028	S	239	76	315	0.00001
Treponema_azotonutricium	150829	S	191	7	198	0.00001
Treponema_primitia	88058	S	165	8	173	0.00001
Treponema_socranskii	53419	S	126	70	196	0.00001
Treponema_sp._Marseille-Q4132	2766701	S	77	43	120	0.00001
Treponema_sp._OMZ_838	1539298	S	35	42	77	0.00000
Treponema_caldarium	215591	S	98	11	109	0.00001
Treponema_vincentii	69710	S	69	84	153	0.00001
Treponema_succinifaciens	167	S	64	46	110	0.00001
Treponema_parvum	138851	S	64	3	67	0.00000
Treponema_phagedenis	162	S	38	15	53	0.00000
Treponema_medium	58231	S	35	52	87	0.00000
Treponema_denticola	158	S	34	4	38	0.00000
Treponema_peruense	2787628	S	31	4	35	0.00000
Treponema_pedis	409322	S	26	7	33	0.00000
Treponema_putidum	221027	S	13	11	24	0.00000
Spirochaeta_thermophila	154	S	898	21	919	0.00004
Spirochaeta_africana	46355	S	298	16	314	0.00001
Sediminispirochaeta_smaragdinae	55206	S	136	4	140	0.00001
Salinispira_pacifica	1307761	S	128	4	132	0.00001
Oceanispirochaeta_crateris	2518645	S	40	2	42	0.00000
Thiospirochaeta_perfilievii	252967	S	24	1	25	0.00000
Sphaerochaeta_associata	1129264	S	137	11	148	0.00001
Sphaerochaeta_coccoides	273376	S	121	5	126	0.00001
Sphaerochaeta_globosa	1131703	S	70	6	76	0.00000
Sphaerochaeta_pleomorpha	1131707	S	27	3	30	0.00000
Breznakiella_homolactica	2798577	S	211	17	228	0.00001
Borrelia_sp._HM	1882662	S	13	11	24	0.00000
Borrelia_coriaceae	144	S	15	3	18	0.00000
Borrelia_hermsii	140	S	11	11	22	0.00000
Borrelia_turicatae	142	S	10	56	66	0.00000
Leptospira_santarosai	28183	S	120	1	121	0.00001
Leptospira_kmetyi	408139	S	110	1	111	0.00001
Leptospira_weilii	28184	S	65	0	65	0.00000
Leptospira_tipperaryensis	2564040	S	59	0	59	0.00000
Leptospira_noguchii	28182	S	52	0	52	0.00000
Leptospira_kobayashii	1917830	S	44	0	44	0.00000
Leptospira_mayottensis	1137606	S	42	0	42	0.00000
Leptospira_borgpetersenii	174	S	32	0	32	0.00000
Leptospira_biflexa	172	S	25	0	25	0.00000
Leptospira_interrogans	173	S	16	231	247	0.00001
Turneriella_parva	29510	S	451	3	454	0.00002
Brachyspira_pilosicoli	52584	S	14	2	16	0.00000
Brachyspira_hyodysenteriae	159	S	11	25	36	0.00000
Pyramidobacter_piscolens	638849	S	873	50	923	0.00004
Aminomonas_paucivorans	81412	S	857	90	947	0.00004
Fretibacterium_fastidiosum	651822	S	835	11	846	0.00004
Thermanaerovibrio_acidaminovorans	81462	S	370	125	495	0.00002
Thermanaerovibrio_velox	108007	S	236	52	288	0.00001
Cloacibacillus_porcorum	1197717	S	560	107	667	0.00003
Jonquetella_anthropi	428712	S	378	54	432	0.00002
Acetomicrobium_mobile	97477	S	99	2	101	0.00000
Aminobacterium_colombiense	81468	S	90	5	95	0.00000
Thermovirga_lienii	336261	S	52	40	92	0.00000
Candidatus_Bipolaricaulis_anaerobius	2026885	S	897	35	932	0.00004
Candidatus_Nanosynbacter_featherlites	2572088	S	77	34	111	0.00001
Candidatus_Nanosynbacter_lyticus	2093824	S	38	82	120	0.00001
Nanosynbacter_sp._HMT-352	2899133	S	36	87	123	0.00001
Candidatus_Nanosynbacter_sp._HMT352	2902423	S	13	43	56	0.00000
Candidatus_Saccharimonas_aalborgensis	1332188	S	179	2	181	0.00001
Candidatus_Minimicrobia_vallesae	2841264	S	16	92	108	0.00001
Candidatus_Chazhemtobacterium_aquaticus	2715735	S	115	0	115	0.00001
Candidatus_Babela_massiliensis	673862	S	110	2	112	0.00001
Candidatus_Absconditicoccus_praedator	2735562	S	53	0	53	0.00000
Thermotoga_caldifontis	1508419	S	146	29	175	0.00001
Thermotoga_sp._2812B	1157948	S	11	86	97	0.00000
Thermotoga_profunda	1508420	S	21	3	24	0.00000
Thermotoga_petrophila	93929	S	10	149	159	0.00001
Pseudothermotoga_hypogea	57487	S	85	54	139	0.00001
Pseudothermotoga_thermarum	119394	S	22	9	31	0.00000
Fervidobacterium_pennivorans	93466	S	42	92	134	0.00001
Fervidobacterium_nodosum	2424	S	12	8	20	0.00000
Thermosipho_ferrireducens	2571116	S	23	13	36	0.00000
Kosmotoga_pacifica	1330330	S	25	70	95	0.00000
Kosmotoga_olearia	651457	S	19	50	69	0.00000
Mesotoga_infera	1236046	S	86	18	104	0.00000
Mesotoga_prima	1184387	S	29	7	36	0.00000
Defluviitoga_tunisiensis	1006576	S	20	33	53	0.00000
Tepiditoga_spiralis	2108365	S	14	4	18	0.00000
Petrotoga_mobilis	69499	S	12	13	25	0.00000
Athalassotoga_saccharophila	1441386	S	68	3	71	0.00000
Thermocrinis_minervae	381751	S	85	14	99	0.00000
Thermocrinis_albus	136094	S	30	4	34	0.00000
Thermocrinis_ruber	75906	S	29	5	34	0.00000
Hydrogenobacter_sp._T-8	1632019	S	57	15	72	0.00000
Hydrogenobacter_thermophilus	940	S	21	7	28	0.00000
Aquifex_aeolicus	63363	S	48	4	52	0.00000
Sulfurihydrogenibium_azorense	309806	S	132	19	151	0.00001
Persephonella_marina	309805	S	98	10	108	0.00001
Thermosulfidibacter_takaii	412593	S	149	5	154	0.00001
Thermovibrio_ammonificans	228745	S	152	28	180	0.00001
Desulfurobacterium_thermolithotrophum	64160	S	55	8	63	0.00000
Thermosulfurimonas_marina	2047767	S	279	23	302	0.00001
Thermosulfuriphilus_ammonigenes	1936021	S	158	5	163	0.00001
Thermodesulfobacterium_sp._TA1	2234087	S	43	12	55	0.00000
Thermodesulfobacterium_commune	1741	S	25	8	33	0.00000
Thermodesulfobacterium_geofontis	1295609	S	24	6	30	0.00000
Thermodesulfatator_indicus	171695	S	107	9	116	0.00001
Caldimicrobium_thiodismutans	1653476	S	32	3	35	0.00000
Geovibrio_thiophilus	139438	S	149	22	171	0.00001
Flexistipes_sinusarabici	2352	S	95	9	104	0.00000
Mucispirillum_schaedleri	248039	S	81	8	89	0.00000
Deferribacter_desulfuricans	197162	S	60	8	68	0.00000
Denitrovibrio_acetiphilus	118000	S	54	5	59	0.00000
Calditerrivibrio_nitroreducens	477976	S	44	5	49	0.00000
Caldithrix_abyssi	187145	S	521	4	525	0.00002
Desulfurispirillum_indicum	936456	S	389	172	561	0.00003
Fusobacterium_ulcerans	861	S	32	5	37	0.00000
Fusobacterium_nucleatum	851	S	26	54	80	0.00000
Fusobacterium_gonidiaformans	849	S	23	9	32	0.00000
Fusobacterium_pseudoperiodonticum	2663009	S	14	16	30	0.00000
Ilyobacter_polytropus	167642	S	10	0	10	0.00000
Leptotrichia_sp._oral_taxon_212	712357	S	14	15	29	0.00000
Leptotrichia_wadei	157687	S	10	44	54	0.00000
Pseudoleptotrichia_goodfellowii	157692	S	14	6	20	0.00000
Sebaldella_termitidis	826	S	12	1	13	0.00000
Endomicrobium_proavitum	1408281	S	72	27	99	0.00000
Candidatus_Endomicrobium_trichonymphae	1408204	S	30	11	41	0.00000
Elusimicrobium_minutum	423605	S	139	1	140	0.00001
Caldisericum_exile	693075	S	157	0	157	0.00001
Coprothermobacter_proteolyticus	35786	S	145	28	173	0.00001
Dictyoglomus_thermophilum	14	S	15	114	129	0.00001
Atribacter_laminatus	2847778	S	89	2	91	0.00000
Fusarium_sambucinum	5128	S	15101	1831	16932	0.00080
Fusarium_sporotrichioides	5514	S	181	9	190	0.00001
Fusarium_longipes	694270	S	170	8	178	0.00001
Fusarium_poae	36050	S	168	53	221	0.00001
Fusarium_pseudograminearum	101028	S	165	12	177	0.00001
Fusarium_graminearum	5518	S	82	264	346	0.00002
Fusarium_venenatum	56646	S	74	142	216	0.00001
Fusarium_culmorum	5516	S	57	7	64	0.00000
Fusarium_acuminatum	5515	S	5133	432	5565	0.00026
Fusarium_avenaceum	40199	S	152	9	161	0.00001
Fusarium_oxysporum	5507	S	953	542	1495	0.00007
Fusarium_nygamai	42673	S	243	99	342	0.00002
Fusarium_thapsinum	120644	S	162	47	209	0.00001
Fusarium_fujikuroi	5127	S	142	20	162	0.00001
Fusarium_pseudonygamai	47755	S	130	42	172	0.00001
Fusarium_verticillioides	117187	S	50	120	170	0.00001
Fusarium_decemcellulare	57161	S	736	22	758	0.00004
Fusarium_heterosporum	42747	S	218	56	274	0.00001
Fusarium_graminum	86546	S	181	47	228	0.00001
Fusarium_dimerum	57145	S	447	19	466	0.00002
Fusarium_scirpi	2211609	S	163	46	209	0.00001
Fusarium_equiseti	61235	S	134	41	175	0.00001
Fusarium_lateritium	5523	S	359	15	374	0.00002
Fusarium_chlamydosporum	86545	S	127	41	168	0.00001
Fusarium_nelsonii	77846	S	112	36	148	0.00001
Fusarium_musae	1042133	S	44	104	148	0.00001
Trichoderma_erinaceum	202914	S	1212	233	1445	0.00007
Trichoderma_citrinoviride	58853	S	665	96	761	0.00004
Trichoderma_reesei	51453	S	620	74	694	0.00003
Trichoderma_pleuroti	500994	S	424	58	482	0.00002
Trichoderma_atroviride	63577	S	302	93	395	0.00002
Trichoderma_asperellum	101201	S	266	25	291	0.00001
Trichoderma_hamatum	49224	S	265	27	292	0.00001
Trichoderma_afroharzianum	1567482	S	264	71	335	0.00002
Trichoderma_gamsii	398673	S	202	35	237	0.00001
Trichoderma_koningiopsis	337941	S	170	33	203	0.00001
Trichoderma_harzianum	5544	S	154	41	195	0.00001
Trichoderma_longibrachiatum	5548	S	53	682	735	0.00003
Trichoderma_virens	29875	S	43	560	603	0.00003
Trichoderma_koningii	97093	S	39	480	519	0.00002
Trichoderma_viride	5547	S	12	205	217	0.00001
Beauveria_pseudobassiana	931006	S	2361	365	2726	0.00013
Beauveria_felina	37994	S	1234	92	1326	0.00006
Beauveria_brongniartii	118266	S	413	107	520	0.00002
Beauveria_rudraprayagi	1481906	S	199	245	444	0.00002
Beauveria_bassiana	176275	S	167	215	382	0.00002
Cordyceps_fumosorosea	114497	S	1562	122	1684	0.00008
Metarhizium_rileyi	1649241	S	760	148	908	0.00004
Metarhizium_album	92629	S	738	30	768	0.00004
Metarhizium_guizhouense	169041	S	454	300	754	0.00004
Metarhizium_acridum	92637	S	282	234	516	0.00002
Metarhizium_majus	1650735	S	176	98	274	0.00001
Metarhizium_humberi	2596975	S	172	129	301	0.00001
Metarhizium_brunneum	500148	S	131	133	264	0.00001
Metarhizium_anisopliae	5530	S	130	242	372	0.00002
Metarhizium_robertsii	568076	S	73	64	137	0.00001
Ustilaginoidea_virens	1159556	S	1207	80	1287	0.00006
Pochonia_chlamydosporia	280754	S	375	31	406	0.00002
Purpureocillium_lilacinum	33203	S	1962	201	2163	0.00010
Drechmeria_coniospora	98403	S	1501	102	1603	0.00008
Clonostachys_rosea	29856	S	779	76	855	0.00004
Colletotrichum_higginsianum	80884	S	2004	597	2601	0.00012
Thermothelomyces_thermophilus	78579	S	11035	1225	12260	0.00058
Thermothielavioides_terrestris	2587410	S	10723	1643	12366	0.00059
Neurospora_crassa	5141	S	2925	321	3246	0.00015
Pyricularia_oryzae	318829	S	761	234	995	0.00005
Pyricularia_pennisetigena	1578925	S	628	113	741	0.00004
Pyricularia_grisea	148305	S	522	91	613	0.00003
Neopestalotiopsis_rosae	1562205	S	299	433	732	0.00003
Neopestalotiopsis_clavispora	289240	S	235	368	603	0.00003
Botrytis_cinerea	40559	S	272	1	273	0.00001
Aspergillus_chevalieri	182096	S	4212	460	4672	0.00022
Aspergillus_luchuensis	1069201	S	1145	98	1243	0.00006
Aspergillus_oryzae	5062	S	144	399	543	0.00003
Aspergillus_flavus	5059	S	35	104	139	0.00001
Aspergillus_puulaauensis	1220207	S	527	23	550	0.00003
Aspergillus_fumigatus	746128	S	415	27	442	0.00002
Penicillium_citrinum	5077	S	374	54	428	0.00002
Penicillium_chrysogenum	5076	S	313	64	377	0.00002
Penicillium_aurantiogriseum	36655	S	277	101	378	0.00002
Penicillium_expansum	27334	S	175	78	253	0.00001
Penicillium_italicum	40296	S	173	70	243	0.00001
Penicillium_digitatum	36651	S	143	31	174	0.00001
Paecilomyces_niveus	5093	S	307	11	318	0.00002
Paecilomyces_variotii	264951	S	222	20	242	0.00001
Talaromyces_rugulosus	121627	S	274	17	291	0.00001
Paraphaeosphaeria_minitans	565426	S	598	202	800	0.00004
Ampelomyces_quisqualis	50730	S	519	53	572	0.00003
Zymoseptoria_tritici	1047171	S	373	5	378	0.00002
Cercospora_beticola	122368	S	263	0	263	0.00001
Eremothecium_gossypii	33169	S	214	152	366	0.00002
Eremothecium_cymbalariae	45285	S	36	1	37	0.00000
Eremothecium_sinecaudum	45286	S	25	13	38	0.00000
Lachancea_thermotolerans	381046	S	117	6	123	0.00001
Naumovozyma_dairenensis	27289	S	44	2	46	0.00000
Naumovozyma_castellii	27288	S	42	4	46	0.00000
Saccharomyces_eubayanus	1080349	S	35	1	36	0.00000
Saccharomyces_cerevisiae	4932	S	26	4	30	0.00000
Saccharomyces_paradoxus	27291	S	19	1	20	0.00000
[Candida]_glabrata	5478	S	79	3	82	0.00000
Torulaspora_globosa	48254	S	57	3	60	0.00000
Torulaspora_delbrueckii	4950	S	14	1	15	0.00000
Kazachstania_naganishii	588726	S	57	2	59	0.00000
Tetrapisispora_phaffii	113608	S	33	0	33	0.00000
Tetrapisispora_blattae	1071379	S	29	1	30	0.00000
Kluyveromyces_marxianus	4911	S	43	7	50	0.00000
Kluyveromyces_lactis	28985	S	15	1	16	0.00000
Zygotorulaspora_mrakii	42260	S	34	3	37	0.00000
Zygosaccharomyces_rouxii	4956	S	28	1	29	0.00000
Candida_dubliniensis	42374	S	100	5	105	0.00001
Candida_orthopsilosis	273371	S	45	0	45	0.00000
Candida_albicans	5476	S	36	2	38	0.00000
Scheffersomyces_stipitis	4924	S	35	0	35	0.00000
Debaryomyces_hansenii	4959	S	27	0	27	0.00000
Brettanomyces_bruxellensis	5007	S	58	3	61	0.00000
Brettanomyces_nanus	13502	S	42	5	47	0.00000
Ogataea_parapolymorpha	1005962	S	72	1	73	0.00000
Pichia_kudriavzevii	4909	S	50	1	51	0.00000
Yarrowia_lipolytica	4952	S	155	1	156	0.00001
Sugiyamaella_lignohabitans	796027	S	77	5	82	0.00000
Saccharomycodes_ludwigii	36035	S	22	2	24	0.00000
Komagataella_phaffii	460519	S	17	0	17	0.00000
Schizosaccharomyces_pombe	4896	S	68	1	69	0.00000
Pseudozyma_flocculosa	84751	S	2093	16	2109	0.00010
Ustilago_maydis	5270	S	560	18	578	0.00003
Sporisorium_graminicola	280036	S	435	68	503	0.00002
Malassezia_restricta	76775	S	239	32	271	0.00001
Phlebiopsis_gigantea	82310	S	584	5	589	0.00003
Rhizoctonia_solani	456999	S	97	3	100	0.00000
Marasmius_oreades	181124	S	88	3	91	0.00000
Cryptococcus_neoformans	5207	S	141	4	145	0.00001
Cryptococcus_gattii_VGI	37769	S	58	26	84	0.00000
Encephalitozoon_cuniculi	6035	S	26	8	34	0.00000
Phytophthora_cryptogea	4786	S	10239	371	10610	0.00050
Phytophthora_cinnamomi	4785	S	1370	99	1469	0.00007
Phytophthora_fragariae	53985	S	937	58	995	0.00005
Phytophthora_infestans	4787	S	511	621	1132	0.00005
Phytophthora_cactorum	29920	S	377	24	401	0.00002
Phytophthora_boehmeriae	109152	S	306	16	322	0.00002
Phytophthora_parasitica	4792	S	250	14	264	0.00001
Pythium_aphanidermatum	65070	S	523	6	529	0.00003
