name	taxonomy_id	taxonomy_lvl	kraken_assigned_reads	added_reads	new_est_reads	fraction_total_reads
Bradyrhizobium_sp._200	2782665	S	9947	2378	12325	0.00079
Bradyrhizobium_sp._170	2782641	S	9005	2485	11490	0.00073
Bradyrhizobium_sp._CCBAU_051011	858422	S	8395	1727	10122	0.00065
Bradyrhizobium_sp._CCBAU_51753	1325100	S	8276	1946	10222	0.00065
Bradyrhizobium_sp._A19	2898149	S	6868	1297	8165	0.00052
Bradyrhizobium_sp._BTAi1	288000	S	6837	1357	8194	0.00052
Bradyrhizobium_sp._ORS_278	114615	S	6822	1689	8511	0.00054
Bradyrhizobium_sp._ORS_285	115808	S	6674	1628	8302	0.00053
Bradyrhizobium_sp._SK17	2057741	S	5610	1993	7603	0.00049
Bradyrhizobium_sp._186	2782654	S	5327	1530	6857	0.00044
Bradyrhizobium_sp._CCBAU_53421	1325120	S	4588	1533	6121	0.00039
Bradyrhizobium_sp._CCBAU_53351	1325114	S	4484	2388	6872	0.00044
Bradyrhizobium_sp._CCBAU_53338	1325111	S	4163	1798	5961	0.00038
Bradyrhizobium_sp._195	2782662	S	4088	1558	5646	0.00036
Bradyrhizobium_sp._CCBAU_53340	1325112	S	4033	1652	5685	0.00036
Bradyrhizobium_sp._1(2017)	1404888	S	3960	1314	5274	0.00034
Bradyrhizobium_sp._6(2017)	1197460	S	3229	1671	4900	0.00031
Bradyrhizobium_sp._CCGE-LA001	1223566	S	3112	1231	4343	0.00028
Bradyrhizobium_sp._S2-11-2	2840472	S	2998	2436	5434	0.00035
Bradyrhizobium_sp._CCBAU_51765	1325102	S	2649	2551	5200	0.00033
Bradyrhizobium_sp._41S5	1404443	S	2616	1872	4488	0.00029
Bradyrhizobium_sp._S2-20-1	2840469	S	2559	2210	4769	0.00030
Bradyrhizobium_sp._I71	2590772	S	2496	2309	4805	0.00031
Bradyrhizobium_sp._191	2782659	S	2489	2597	5086	0.00032
Bradyrhizobium_sp._S2-11-4	2840473	S	2388	2268	4656	0.00030
Bradyrhizobium_sp._C-145	574727	S	1705	1768	3473	0.00022
Bradyrhizobium_sp.	376	S	1374	4708	6082	0.00039
Bradyrhizobium_sp._40	2782674	S	1008	2389	3397	0.00022
Bradyrhizobium_sp._4	2782678	S	994	2642	3636	0.00023
Bradyrhizobium_sp._323S2	1404649	S	892	2344	3236	0.00021
Bradyrhizobium_sp._192	2782660	S	875	2211	3086	0.00020
Bradyrhizobium_sp._144S4	2823807	S	857	2208	3065	0.00020
Bradyrhizobium_sp._LCT2	2493093	S	532	1551	2083	0.00013
Bradyrhizobium_sp._187	2782655	S	338	1714	2052	0.00013
Bradyrhizobium_sp._TM102	2599819	S	323	2295	2618	0.00017
Bradyrhizobium_sp._SG09	2599805	S	321	2386	2707	0.00017
Bradyrhizobium_sp._38S5	2819348	S	189	2370	2559	0.00016
Bradyrhizobium_sp._1S5	2816456	S	175	2022	2197	0.00014
Bradyrhizobium_sp._172	2782643	S	163	2035	2198	0.00014
Bradyrhizobium_sp._131	2782609	S	146	2446	2592	0.00017
Bradyrhizobium_sp._CW1	2782686	S	135	2144	2279	0.00015
Bradyrhizobium_sp._155	2782629	S	81	1496	1577	0.00010
Bradyrhizobium_sp._CCBAU_21365	1325083	S	21	1061	1082	0.00007
Bradyrhizobium_erythrophlei	1437360	S	22203	1993	24196	0.00154
Bradyrhizobium_diazoefficiens	1355477	S	18449	30490	48939	0.00312
Bradyrhizobium_icense	1274631	S	8183	1271	9454	0.00060
Bradyrhizobium_paxllaeri	190148	S	7671	1547	9218	0.00059
Bradyrhizobium_lablabi	722472	S	7208	8797	16005	0.00102
Bradyrhizobium_canariense	255045	S	6603	10831	17434	0.00111
Bradyrhizobium_genosp._L	83637	S	6501	1427	7928	0.00051
Bradyrhizobium_japonicum	375	S	6099	9473	15572	0.00099
Bradyrhizobium_oligotrophicum	44255	S	5960	1139	7099	0.00045
Bradyrhizobium_arachidis	858423	S	4937	1507	6444	0.00041
Bradyrhizobium_guangdongense	1325090	S	4616	1814	6430	0.00041
Bradyrhizobium_guangxiense	1325115	S	4321	1985	6306	0.00040
Bradyrhizobium_vignae	1549949	S	4210	1064	5274	0.00034
Bradyrhizobium_genosp._B	83627	S	4024	925	4949	0.00032
Bradyrhizobium_quebecense	2748629	S	3924	2346	6270	0.00040
Bradyrhizobium_cosmicum	1404864	S	3854	1336	5190	0.00033
Bradyrhizobium_guangzhouense	1325095	S	3568	1435	5003	0.00032
Bradyrhizobium_septentrionale	1404411	S	3112	2004	5116	0.00033
Bradyrhizobium_amphicarpaeae	1404768	S	2595	1145	3740	0.00024
Bradyrhizobium_daqingense	993502	S	2594	1481	4075	0.00026
Bradyrhizobium_betae	244734	S	2533	1533	4066	0.00026
Bradyrhizobium_symbiodeficiens	1404367	S	2251	3530	5781	0.00037
Bradyrhizobium_zhanjiangense	1325107	S	1809	1889	3698	0.00024
Bradyrhizobium_elkanii	29448	S	958	3933	4891	0.00031
Bradyrhizobium_ottawaense	931866	S	831	5414	6245	0.00040
Rhodopseudomonas_palustris	1076	S	23653	8866	32519	0.00208
Rhodopseudomonas_sp._SK50-23	340268	S	3121	688	3809	0.00024
Rhodopseudomonas_boonkerdii	475937	S	3056	878	3934	0.00025
Nitrobacter_hamburgensis	912	S	8161	1512	9673	0.00062
Nitrobacter_winogradskyi	913	S	3713	686	4399	0.00028
Tardiphaga_sp._37S4	1404741	S	1601	1252	2853	0.00018
Tardiphaga_sp._vice154	2592814	S	123	1998	2121	0.00014
Tardiphaga_sp._vice278	2592815	S	60	1531	1591	0.00010
Tardiphaga_sp._vice304	2592817	S	44	875	919	0.00006
Tardiphaga_sp._vice352	2592816	S	31	986	1017	0.00006
Tardiphaga_robiniae	943830	S	1690	1178	2868	0.00018
Afipia_carboxidovorans	40137	S	4577	1163	5740	0.00037
Afipia_sp._GAS231	1882747	S	2903	2284	5187	0.00033
Variibacter_gotjawalensis	1333996	S	6730	588	7318	0.00047
Mesorhizobium_sp._8	2584466	S	10724	2884	13608	0.00087
Mesorhizobium_sp._DCY119	2108445	S	5333	1402	6735	0.00043
Mesorhizobium_sp._J8	2777475	S	4900	1787	6687	0.00043
Mesorhizobium_sp._B1-1-8	2589976	S	4462	1269	5731	0.00037
Mesorhizobium_sp._Pch-S	2082387	S	4351	669	5020	0.00032
Mesorhizobium_sp._M1B.F.Ca.ET.045.04.1.1	2493673	S	4296	1855	6151	0.00039
Mesorhizobium_sp._M3A.F.Ca.ET.080.04.2.1	2493676	S	4284	1468	5752	0.00037
Mesorhizobium_sp._B2-1-1	2589974	S	4196	1071	5267	0.00034
Mesorhizobium_sp._B2-8-5	2589903	S	4018	1503	5521	0.00035
Mesorhizobium_sp._M1A.F.Ca.IN.022.06.1.1	2493680	S	3953	1431	5384	0.00034
Mesorhizobium_sp._M1E.F.Ca.ET.045.02.1.1	2493672	S	3884	2189	6073	0.00039
Mesorhizobium_sp._M1D.F.Ca.ET.043.01.1.1	2493669	S	3767	2553	6320	0.00040
Mesorhizobium_sp._131-2-1	2744518	S	3672	2196	5868	0.00037
Mesorhizobium_sp._PAMC28654	2880934	S	3391	717	4108	0.00026
Mesorhizobium_sp._M4B.F.Ca.ET.058.02.1.1	2493675	S	3283	1564	4847	0.00031
Mesorhizobium_sp._INR15	2654248	S	3257	527	3784	0.00024
Mesorhizobium_sp._M9A.F.Ca.ET.002.03.1.2	2493668	S	3020	1565	4585	0.00029
Mesorhizobium_sp._L-2-11	2744521	S	2936	1274	4210	0.00027
Mesorhizobium_sp._B4-1-4	2589888	S	2824	768	3592	0.00023
Mesorhizobium_sp._B2-1-8	2589967	S	2723	942	3665	0.00023
Mesorhizobium_sp._M6A.T.Cr.TU.016.01.1.1	2493677	S	2615	987	3602	0.00023
Mesorhizobium_sp._M7D.F.Ca.US.005.01.1.1	2493678	S	2302	887	3189	0.00020
Mesorhizobium_sp._M2A.F.Ca.ET.043.05.1.1	2493671	S	2226	2156	4382	0.00028
Mesorhizobium_sp._M8A.F.Ca.ET.057.01.1.1	2493679	S	2224	958	3182	0.00020
Mesorhizobium_sp._113-3-3	2744516	S	1968	1227	3195	0.00020
Mesorhizobium_sp._NZP2077	2483404	S	1901	711	2612	0.00017
Mesorhizobium_sp._M7A.F.Ce.TU.012.03.2.1	2493681	S	1818	755	2573	0.00016
Mesorhizobium_sp._113-1-2	2744515	S	1738	969	2707	0.00017
Mesorhizobium_sp._NBSH29	2654249	S	1719	136	1855	0.00012
Mesorhizobium_sp._L-8-3	2744522	S	1704	6327	8031	0.00051
Mesorhizobium_sp._L-8-10	2744523	S	1656	5987	7643	0.00049
Mesorhizobium_sp._NZP2298	2483403	S	1375	930	2305	0.00015
Mesorhizobium_sp._113-3-9	2744517	S	1333	1130	2463	0.00016
Mesorhizobium_sp._M2A.F.Ca.ET.043.02.1.1	2493670	S	1205	3488	4693	0.00030
Mesorhizobium_sp._AA22	1854057	S	1183	843	2026	0.00013
Mesorhizobium_sp._M2A.F.Ca.ET.046.03.2.1	2493674	S	1168	3556	4724	0.00030
Mesorhizobium_sp._WSM1497	278153	S	545	1240	1785	0.00011
Mesorhizobium_sp._131-3-5	2744520	S	233	815	1048	0.00007
Mesorhizobium_sp._NZP2234	2483402	S	162	655	817	0.00005
Mesorhizobium_sp._131-2-5	2744519	S	139	1062	1201	0.00008
Mesorhizobium_terrae	2725666	S	4696	1755	6451	0.00041
Mesorhizobium_opportunistum	593909	S	3872	1800	5672	0.00036
Mesorhizobium_amorphae	71433	S	3072	832	3904	0.00025
Mesorhizobium_loti	381	S	2084	18994	21078	0.00135
Mesorhizobium_australicum	536018	S	2024	710	2734	0.00017
Mesorhizobium_ciceri	39645	S	1886	5382	7268	0.00046
Mesorhizobium_huakuii	28104	S	1812	1676	3488	0.00022
Mesorhizobium_erdmanii	1777866	S	1723	550	2273	0.00015
Mesorhizobium_japonicum	2066070	S	1708	1379	3087	0.00020
Aquibium_microcysteis	675281	S	7634	2482	10116	0.00065
Aquibium_oceanicum	1670800	S	5935	1603	7538	0.00048
Nitratireductor_sp._SY7	2599600	S	5345	1150	6495	0.00041
Nitratireductor_sp._OM-1	1756988	S	2469	514	2983	0.00019
Nitratireductor_kimnyeongensis	430679	S	1490	264	1754	0.00011
Aminobacter_sp._MSH1	374606	S	3632	2506	6138	0.00039
Aminobacter_sp._SR38	2774562	S	780	3528	4308	0.00028
Aminobacter_sp._MDW-2	2666139	S	586	2939	3525	0.00023
Aminobacter_aminovorans	83263	S	425	1494	1919	0.00012
Phyllobacterium_sp._T1018	555316	S	1550	228	1778	0.00011
Phyllobacterium_sp._628	2718938	S	765	124	889	0.00006
Phyllobacterium_sp._T1293	555317	S	656	93	749	0.00005
Phyllobacterium_zundukense	1867719	S	1461	240	1701	0.00011
Roseitalea_porphyridii	1852022	S	3791	731	4522	0.00029
Oricola_thermophila	2742145	S	2840	442	3282	0.00021
Hoeflea_sp._IMCC20628	1620421	S	1438	161	1599	0.00010
Hoeflea_phototrophica	244596	S	1249	173	1422	0.00009
Salaquimonas_pukyongi	2712698	S	1174	58	1232	0.00008
Lentilitoribacter_sp._Alg239-R112	2305987	S	82	1	83	0.00001
Rhizobium_sp._BG4	2613770	S	2480	517	2997	0.00019
Rhizobium_sp._WYJ-E13	2849093	S	2379	329	2708	0.00017
Rhizobium_sp._NXC24	2048897	S	1916	301	2217	0.00014
Rhizobium_sp._ACO-34A	1571470	S	1711	396	2107	0.00013
Rhizobium_sp._SL42	2806346	S	1632	322	1954	0.00012
Rhizobium_sp._WL3	2603277	S	1581	333	1914	0.00012
Rhizobium_sp._AB2/73	2795216	S	1478	844	2322	0.00015
Rhizobium_sp._11515TR	2028343	S	1348	329	1677	0.00011
Rhizobium_sp._NZLR1	2731096	S	1105	398	1503	0.00010
Rhizobium_sp._NXC14	1981173	S	1090	465	1555	0.00010
Rhizobium_sp._CIAT894	2020312	S	1035	474	1509	0.00010
Rhizobium_sp._NLR16a	2731112	S	1001	462	1463	0.00009
Rhizobium_sp._K102	2918527	S	870	613	1483	0.00009
Rhizobium_sp._C104	2917727	S	840	475	1315	0.00008
Rhizobium_sp._L51/94	2819999	S	646	802	1448	0.00009
Rhizobium_sp._X9	2815360	S	480	1090	1570	0.00010
Rhizobium_sp._TAL182	2020313	S	332	978	1310	0.00008
Rhizobium_sp._IE4771	1301032	S	322	669	991	0.00006
Rhizobium_sp._Kim5	2020311	S	313	708	1021	0.00007
Rhizobium_sp._007	2785056	S	293	541	834	0.00005
Rhizobium_sp._Y9	1914541	S	234	937	1171	0.00007
Rhizobium_sp._ZX09	2291939	S	140	643	783	0.00005
Rhizobium_sp._NIBRBAC000502774	2590777	S	131	630	761	0.00005
Rhizobium_sp._B230/85	2819994	S	77	805	882	0.00006
Rhizobium_sp._N324	1703969	S	52	1064	1116	0.00007
Rhizobium_sp._CCGE531	2364271	S	46	1592	1638	0.00010
Rhizobium_sp._T136	555319	S	28	823	851	0.00005
Rhizobium_sp._B21/90	2819993	S	26	886	912	0.00006
Rhizobium_sp._CCGE532	2364272	S	15	1097	1112	0.00007
Rhizobium_leguminosarum	384	S	10213	14228	24441	0.00156
Rhizobium_etli	29449	S	3131	3789	6920	0.00044
Rhizobium_jaguaris	1312183	S	2241	309	2550	0.00016
Rhizobium_pseudoryzae	379684	S	2144	499	2643	0.00017
Rhizobium_phaseoli	396	S	1857	4049	5906	0.00038
Rhizobium_gallicum	56730	S	1669	2300	3969	0.00025
Rhizobium_bangladeshense	1138189	S	1572	407	1979	0.00013
Rhizobium_rhizoryzae	451876	S	1331	198	1529	0.00010
Rhizobium_lentis	1138194	S	1253	418	1671	0.00011
Rhizobium_tropici	398	S	1246	355	1601	0.00010
Rhizobium_rosettiformans	1368430	S	1184	602	1786	0.00011
Rhizobium_daejeonense	240521	S	1108	407	1515	0.00010
Rhizobium_binae	1138190	S	1100	438	1538	0.00010
Rhizobium_pusense	648995	S	995	4143	5138	0.00033
Rhizobium_indicum	2583231	S	726	676	1402	0.00009
Rhizobium_acidisoli	1538158	S	618	539	1157	0.00007
Rhizobium_oryzihabitans	2267833	S	363	530	893	0.00006
Rhizobium_hidalgonense	1538159	S	289	700	989	0.00006
Rhizobium_laguerreae	1076926	S	241	436	677	0.00004
Rhizobium_ruizarguesonis	2081791	S	180	1394	1574	0.00010
Rhizobium_favelukesii	348824	S	24	849	873	0.00006
Agrobacterium_tumefaciens	358	S	4849	5049	9898	0.00063
Agrobacterium_fabrum	1176649	S	551	777	1328	0.00008
Agrobacterium_fabacearum	1183401	S	87	1199	1286	0.00008
Agrobacterium_vitis	373	S	2737	374	3111	0.00020
Agrobacterium_sp._T29	2580515	S	418	355	773	0.00005
Agrobacterium_sp._RAC06	1842536	S	307	623	930	0.00006
Agrobacterium_sp._MA01	2664893	S	284	565	849	0.00005
Agrobacterium_sp._CGMCC_11546	2579248	S	134	300	434	0.00003
Agrobacterium_sp._S7/73	2820002	S	67	387	454	0.00003
Agrobacterium_vaccinii	2735528	S	1081	163	1244	0.00008
Agrobacterium_larrymoorei	160699	S	768	142	910	0.00006
Agrobacterium_rubi	28099	S	710	220	930	0.00006
Agrobacterium_salinitolerans	1183413	S	593	240	833	0.00005
Agrobacterium_rhizogenes	359	S	485	1274	1759	0.00011
Neorhizobium_galegae	399	S	6656	2045	8701	0.00056
Neorhizobium_sp._SOG26	2060726	S	1928	432	2360	0.00015
Neorhizobium_sp._NCHU2750	1825976	S	1798	466	2264	0.00014
Pseudorhizobium_flavum	1335061	S	1177	810	1987	0.00013
Pseudorhizobium_banfieldiae	1125847	S	1107	688	1795	0.00011
Sinorhizobium_meliloti	382	S	8958	8178	17136	0.00109
Sinorhizobium_fredii	380	S	7551	10678	18229	0.00116
Sinorhizobium_americanum	194963	S	2501	1003	3504	0.00022
Sinorhizobium_medicae	110321	S	2495	334	2829	0.00018
Sinorhizobium_sp._BG8	2613773	S	2139	398	2537	0.00016
Sinorhizobium_sp._CCBAU_05631	794846	S	316	500	816	0.00005
Ensifer_adhaerens	106592	S	5652	3466	9118	0.00058
Ensifer_mexicanus	375549	S	3486	599	4085	0.00026
Ensifer_alkalisoli	1752398	S	2558	562	3120	0.00020
Ensifer_sojae	716925	S	2437	1029	3466	0.00022
Ensifer_sp._PDNC004	2811423	S	1833	862	2695	0.00017
Ensifer_sp._T173	555315	S	329	1564	1893	0.00012
Shinella_sp._HZN7	879274	S	3694	3521	7215	0.00046
Shinella_sp._PSBB067	2715959	S	3223	2711	5934	0.00038
Shinella_sp._XGS7	2877941	S	2230	2293	4523	0.00029
Shinella_sp._H4-D48	2925841	S	1329	574	1903	0.00012
Shinella_zoogloeoides	352475	S	3186	4992	8178	0.00052
Shinella_oryzae	2871820	S	1845	889	2734	0.00017
Ciceribacter_thiooxidans	1969821	S	2466	557	3023	0.00019
Georhizobium_profundi	2341112	S	2427	602	3029	0.00019
Peteryoungia_desertarenae	1813451	S	799	162	961	0.00006
Liberibacter_crescens	1273132	S	29	5	34	0.00000
Candidatus_Liberibacter_africanus	34020	S	23	32	55	0.00000
Candidatus_Liberibacter_americanus	309868	S	21	3	24	0.00000
Candidatus_Liberibacter_asiaticus	34021	S	19	37	56	0.00000
Candidatus_Liberibacter_solanacearum	556287	S	11	1	12	0.00000
Methylobacterium_nodulans	114616	S	9623	1410	11033	0.00070
Methylobacterium_sp._17Sr1-1	2202826	S	4161	2222	6383	0.00041
Methylobacterium_sp._WL1	2603276	S	3859	886	4745	0.00030
Methylobacterium_sp._C1	1479019	S	429	3458	3887	0.00025
Methylobacterium_sp._XJLW	739141	S	235	3256	3491	0.00022
Methylobacterium_aquaticum	270351	S	8141	4027	12168	0.00078
Methylobacterium_durans	2202825	S	5695	943	6638	0.00042
Methylobacterium_radiodurans	2202828	S	5213	1455	6668	0.00043
Methylobacterium_currus	2051553	S	5183	2442	7625	0.00049
Methylobacterium_organophilum	410	S	4314	2626	6940	0.00044
Methylobacterium_terrae	2202827	S	4185	2178	6363	0.00041
Methylobacterium_mesophilicum	39956	S	4074	958	5032	0.00032
Methylobacterium_tardum	374432	S	3768	1470	5238	0.00033
Methylobacterium_brachiatum	269660	S	3725	1503	5228	0.00033
Methylobacterium_indicum	1775910	S	3495	1950	5445	0.00035
Methylobacterium_oryzae	334852	S	3055	4313	7368	0.00047
Methylobacterium_radiotolerans	31998	S	1431	8168	9599	0.00061
Methylobacterium_phyllosphaerae	418223	S	543	2110	2653	0.00017
Microvirga_sp._VF16	2807101	S	10012	1765	11777	0.00075
Microvirga_sp._17_mud_1-3	2082949	S	6616	1568	8184	0.00052
Microvirga_ossetica	1882682	S	10456	2091	12547	0.00080
Microvirga_thermotolerans	2651334	S	7558	2349	9907	0.00063
Methylorubrum_populi	223967	S	7081	3562	10643	0.00068
Methylorubrum_extorquens	408	S	5172	8972	14144	0.00090
Methylorubrum_sp._B1-46	2897334	S	2512	1160	3672	0.00023
Methylorubrum_zatmanii	29429	S	140	755	895	0.00006
Pseudolabrys_taiwanensis	331696	S	20935	4220	25155	0.00161
Pseudolabrys_sp._FHR47	2562284	S	13258	2861	16119	0.00103
Xanthobacter_dioxanivorans	2528964	S	5773	2249	8022	0.00051
Xanthobacter_sp._YC-JY1	2419844	S	2004	2160	4164	0.00027
Xanthobacter_autotrophicus	280	S	1807	2099	3906	0.00025
Starkeya_sp._ORNL1	2709380	S	6588	1524	8112	0.00052
Starkeya_novella	921	S	5407	2303	7710	0.00049
Ancylobacter_sp._TS-1	1850374	S	4185	1999	6184	0.00039
Ancylobacter_polymorphus	223390	S	3948	2226	6174	0.00039
Ancylobacter_pratisalsi	1745854	S	3273	857	4130	0.00026
Labrys_sp._KNU-23	2789216	S	4430	528	4958	0.00032
Azorhizobium_caulinodans	7	S	4118	1007	5125	0.00033
Rhodoplanes_sp._Z2-YC6860	674703	S	39124	4438	43562	0.00278
Hyphomicrobium_denitrificans	53399	S	4845	613	5458	0.00035
Hyphomicrobium_nitrativorans	1427356	S	2937	273	3210	0.00020
Hyphomicrobium_sp._MC1	717785	S	2203	171	2374	0.00015
Methyloceanibacter_sp._wino2	2170729	S	2165	505	2670	0.00017
Methyloceanibacter_caenitepidi	1384459	S	2154	468	2622	0.00017
Aquabacter_sp._L1I39	2820278	S	3566	694	4260	0.00027
Methyloligella_sp._GL2	2742204	S	3315	442	3757	0.00024
Rhodomicrobium_vannielii	1069	S	2851	211	3062	0.00020
Caenibius_sp._WL	2872646	S	1366	279	1645	0.00011
Caenibius_tardaugens	169176	S	868	779	1647	0.00011
Candidatus_Filomicrobium_marinum	1608628	S	1036	30	1066	0.00007
Devosia_sp._A16	1736675	S	8330	1127	9457	0.00060
Devosia_sp._JXJ_CY_41	2917991	S	2374	488	2862	0.00018
Devosia_sp._1566	2499144	S	2319	277	2596	0.00017
Devosia_sp._SL43	2806348	S	2295	475	2770	0.00018
Devosia_sp._I507	2083786	S	1726	565	2291	0.00015
Devosia_sp._MC521	2759954	S	810	142	952	0.00006
Devosia_ginsengisoli	400770	S	2785	555	3340	0.00021
Devosia_salina	2860336	S	2562	923	3485	0.00022
Devosia_beringensis	2657486	S	2525	408	2933	0.00019
Devosia_oryziradicis	2801335	S	2318	467	2785	0.00018
Devosia_rhizoryzae	2774137	S	2197	258	2455	0.00016
Youhaiella_tibetensis	1447062	S	4279	1028	5307	0.00034
Paradevosia_shaoguanensis	1335043	S	4077	1684	5761	0.00037
Pelagibacterium_halotolerans	531813	S	1733	217	1950	0.00012
Maritalea_myrionectae	454601	S	351	12	363	0.00002
Bosea_sp._Tri-49	1867715	S	5687	1486	7173	0.00046
Bosea_sp._RAC05	1842539	S	5127	1879	7006	0.00045
Bosea_sp._F3-2	2599640	S	5093	1842	6935	0.00044
Bosea_sp._AS-1	2015316	S	4565	1633	6198	0.00040
Bosea_sp._ANAM02	2020412	S	4532	1906	6438	0.00041
Bosea_sp._PAMC_26642	1792307	S	3880	931	4811	0.00031
Bosea_vaviloviae	1526658	S	4559	1232	5791	0.00037
Aureimonas_sp._SA4125	2826993	S	4343	923	5266	0.00034
Aureimonas_sp._AU20	1349819	S	3971	656	4627	0.00030
Aureimonas_sp._OT7	2816454	S	1965	1838	3803	0.00024
Aureimonas_populi	1701758	S	3241	721	3962	0.00025
Aureimonas_mangrovi	2758041	S	3085	742	3827	0.00024
Aureimonas_altamirensis	370622	S	1826	705	2531	0.00016
Martelella_sp._AD-3	686597	S	1188	3359	4547	0.00029
Martelella_mediterranea	293089	S	2079	832	2911	0.00019
Martelella_endophytica	1486262	S	1869	467	2336	0.00015
Martelella_lutilitoris	2583532	S	1146	974	2120	0.00014
Aurantimonas_sp._HBX-1	2906072	S	5774	1983	7757	0.00050
Methylocystis_bryophila	655015	S	3063	346	3409	0.00022
Methylocystis_parvus	134	S	2879	378	3257	0.00021
Methylocystis_sp._SC2	187303	S	1921	534	2455	0.00016
Methylocystis_sp._SB2	743836	S	664	1070	1734	0.00011
Methylocystis_heyeri	391905	S	2560	316	2876	0.00018
Methylocystis_rosea	173366	S	1806	1419	3225	0.00021
Methylosinus_trichosporium	426	S	4028	902	4930	0.00031
Methylosinus_sp._C49	2699395	S	3081	675	3756	0.00024
Stappia_indica	538381	S	5139	1398	6537	0.00042
Stappia_sp._ES.058	1881061	S	2778	395	3173	0.00020
Roseibium_aggregatum	187304	S	2752	425	3177	0.00020
Roseibium_alexandrii	388408	S	724	67	791	0.00005
Pannonibacter_phragmitetus	121719	S	3442	2801	6243	0.00040
Labrenzia_sp._VG12	2021862	S	1382	172	1554	0.00010
Labrenzia_sp._PHM005	2590016	S	649	52	701	0.00004
Labrenzia_sp._THAF82	2587861	S	604	39	643	0.00004
Pseudovibrio_brasiliensis	1898042	S	256	97	353	0.00002
Pseudovibrio_sp._FO-BEG1	911045	S	224	86	310	0.00002
Pseudorhodoplanes_sinuspersici	1235591	S	8523	737	9260	0.00059
Nordella_sp._HKS_07	2712222	S	6537	422	6959	0.00044
Terrihabitans_soli	708113	S	3431	455	3886	0.00025
Candidatus_Hodgkinia_cicadicola	573658	S	33	0	33	0.00000
Phreatobacter_stygius	1940610	S	7034	1193	8227	0.00053
Phreatobacter_cathodiphilus	1868589	S	5979	1983	7962	0.00051
Phreatobacter_sp._NMCR1094	2570229	S	4106	862	4968	0.00032
Kaustia_mangrovi	2593653	S	7047	793	7840	0.00050
Parvibaculum_lavamentivorans	256618	S	3340	2685	6025	0.00038
Pyruvatibacter_mobilis	1712261	S	2093	301	2394	0.00015
Candidatus_Phaeomarinobacter_ectocarpi	1458461	S	868	50	918	0.00006
Chelatococcus_sp._CO-6	1702325	S	6263	4025	10288	0.00066
Chelatococcus_daeguensis	444444	S	3057	1907	4964	0.00032
Methylocella_silvestris	199596	S	2769	357	3126	0.00020
Methylocella_tundrae	227605	S	2529	275	2804	0.00018
Methylovirgula_ligni	569860	S	2382	324	2706	0.00017
Methylovirgula_sp._HY1	2822761	S	2016	134	2150	0.00014
Beijerinckia_indica	533	S	1203	104	1307	0.00008
Blastochloris_tepida	2233851	S	5378	2082	7460	0.00048
Blastochloris_viridis	1079	S	4757	1468	6225	0.00040
Brucella_intermedia	94625	S	2185	431	2616	0.00017
Brucella_anthropi	529	S	1194	818	2012	0.00013
Brucella_sp._BTU1	2840456	S	174	35	209	0.00001
Brucella_sp._10RB9215	1149953	S	78	90	168	0.00001
Brucella_sp._6810	2769351	S	75	129	204	0.00001
Brucella_sp._09RB8910	1844051	S	64	71	135	0.00001
Brucella_sp._BO3	2691913	S	54	94	148	0.00001
Brucella_sp._2280	2592625	S	40	86	126	0.00001
Brucella_sp._458	2821140	S	36	84	120	0.00001
Brucella_sp._BO2	693750	S	34	83	117	0.00001
Brucella_sp._09RB8471	1149952	S	32	62	94	0.00001
[Ochrobactrum]_quorumnocens	271865	S	396	66	462	0.00003
Brucella_pseudogrignonensis	419475	S	285	98	383	0.00002
Brucella_pituitosa	571256	S	131	50	181	0.00001
Brucella_melitensis	29459	S	66	2247	2313	0.00015
Brucella_inopinata	1218315	S	41	47	88	0.00001
Brucella_suis	29461	S	19	1080	1099	0.00007
Brucella_abortus	235	S	14	457	471	0.00003
Pseudochrobactrum_sp._Wa41.01b-1	2864102	S	113	109	222	0.00001
Pseudochrobactrum_sp._XF203	2879116	S	107	96	203	0.00001
Pseudochrobactrum_algeriensis	2834768	S	115	111	226	0.00001
Acuticoccus_sp._I52.16.1	2928472	S	6662	822	7484	0.00048
Kaistia_sp._32K	2795690	S	6211	1785	7996	0.00051
Hartmannibacter_diazotrophicus	1482074	S	4065	850	4915	0.00031
Lichenihabitans_psoromatis	2528642	S	1297	748	2045	0.00013
Lichenihabitans_sp._PAMC28606	2880932	S	1182	792	1974	0.00013
Breoghania_sp._L-A4	2304600	S	3712	566	4278	0.00027
Cohaesibacter_sp._ES.047	1798205	S	690	30	720	0.00005
Bartonella_apis	1686310	S	249	16	265	0.00002
Bartonella_sp._HY038	2759660	S	57	10	67	0.00000
Bartonella_sp._46A	2893471	S	28	27	55	0.00000
Bartonella_quintana	803	S	25	6	31	0.00000
Bartonella_australis	388640	S	24	3	27	0.00000
Bartonella_vinsonii	33047	S	19	9	28	0.00000
Bartonella_krasnovii	2267275	S	19	19	38	0.00000
Bartonella_ancashensis	1318743	S	17	2	19	0.00000
Bartonella_henselae	38323	S	15	4	19	0.00000
Bartonella_schoenbuchensis	165694	S	14	12	26	0.00000
Bartonella_bovis	155194	S	13	6	19	0.00000
Bartonella_tribocorum	85701	S	11	32	43	0.00000
Bartonella_alsatica	52764	S	10	2	12	0.00000
Sphingomonas_sp._S8-45	2938948	S	16122	2236	18358	0.00117
Sphingomonas_sp._HDW15A	2714942	S	14068	1264	15332	0.00098
Sphingomonas_sp._DM2-R-LB4	2899123	S	12248	4667	16915	0.00108
Sphingomonas_sp._CL5.1	2653203	S	7802	3018	10820	0.00069
Sphingomonas_sp._AK-PDB1-5	2872652	S	7569	1408	8977	0.00057
Sphingomonas_sp._MM-1	745310	S	7125	10104	17229	0.00110
Sphingomonas_sp._Cra20	1327635	S	6541	1181	7722	0.00049
Sphingomonas_sp._AP4-R1	2735134	S	6295	908	7203	0.00046
Sphingomonas_sp._LM7	1938607	S	5867	1471	7338	0.00047
Sphingomonas_sp._AAP5	1523415	S	5619	1668	7287	0.00047
Sphingomonas_sp._S2-65	2903960	S	5599	1264	6863	0.00044
Sphingomonas_sp._FARSPH	2219696	S	5409	5059	10468	0.00067
Sphingomonas_sp._NBWT7	2596913	S	5386	2031	7417	0.00047
Sphingomonas_sp._PAMC26645	2565555	S	4265	1625	5890	0.00038
Sphingomonas_sp._HMP9	1517554	S	4000	2022	6022	0.00038
Sphingomonas_sp._KC8	1030157	S	3612	512	4124	0.00026
Sphingomonas_sp._HMP6	1517551	S	3562	804	4366	0.00028
Sphingomonas_sp._LK11	1390395	S	2446	3084	5530	0.00035
Sphingomonas_sp._NIC1	1961362	S	2245	8861	11106	0.00071
Sphingomonas_sp._IC081	304378	S	636	4478	5114	0.00033
Sphingomonas_sabuli	2764186	S	44294	6232	50526	0.00323
Sphingomonas_lutea	1045317	S	43522	6469	49991	0.00319
Sphingomonas_sediminicola	386874	S	39607	4446	44053	0.00281
Sphingomonas_daechungensis	1176646	S	35870	4066	39936	0.00255
Sphingomonas_sinipercae	2714944	S	35524	5463	40987	0.00262
Sphingomonas_ginsengisoli_An_et_al._2013	363835	S	25089	3979	29068	0.00186
Sphingomonas_piscis	2714943	S	19284	2033	21317	0.00136
Sphingomonas_rhizophila	2071607	S	17097	5185	22282	0.00142
Sphingomonas_xanthus	2594473	S	11523	3055	14578	0.00093
Sphingomonas_alpina	653931	S	8674	844	9518	0.00061
Sphingomonas_profundi	2681549	S	8654	1608	10262	0.00066
Sphingomonas_sanxanigenens	397260	S	7572	4199	11771	0.00075
Sphingomonas_changnyeongensis	2698679	S	6834	1503	8337	0.00053
Sphingomonas_koreensis	93064	S	6080	5440	11520	0.00074
Sphingomonas_taxi	1549858	S	5854	2189	8043	0.00051
Sphingomonas_panacis	1560345	S	5710	986	6696	0.00043
Sphingomonas_panacisoli	1813879	S	5609	891	6500	0.00042
Sphingomonas_hengshuiensis	1609977	S	5366	825	6191	0.00040
Sphingomonas_radiodurans	2890321	S	4716	725	5441	0.00035
Sphingomonas_suaedae	2599297	S	4610	704	5314	0.00034
Sphingomonas_insulae	424800	S	3933	1349	5282	0.00034
Sphingomonas_aliaeris	2759526	S	3578	519	4097	0.00026
Sphingomonas_paucimobilis	13689	S	3139	2491	5630	0.00036
Sphingomonas_sanguinis	33051	S	2486	2758	5244	0.00033
Sphingomonas_melonis	152682	S	2340	10493	12833	0.00082
Sphingomonas_lacunae	2698828	S	1671	236	1907	0.00012
Sphingomonas_paeninsulae	2319844	S	1555	72	1627	0.00010
Sphingobium_sp._SYK-6	627192	S	4432	1307	5739	0.00037
Sphingobium_sp._Cam5-1	2789327	S	4274	1629	5903	0.00038
Sphingobium_sp._EP60837	1855519	S	2753	830	3583	0.00023
Sphingobium_sp._TKS	1315974	S	2486	3881	6367	0.00041
Sphingobium_sp._SCG-1	2072936	S	2261	179	2440	0.00016
Sphingobium_sp._YG1	2082188	S	2180	999	3179	0.00020
Sphingobium_sp._CAP-1	2676077	S	2162	1468	3630	0.00023
Sphingobium_sp._RAC03	1843368	S	1914	382	2296	0.00015
Sphingobium_sp._KCTC_72723	2733867	S	1670	311	1981	0.00013
Sphingobium_sp._MI1205	407020	S	1579	2390	3969	0.00025
Sphingobium_sp._PAMC28499	2565554	S	556	1122	1678	0.00011
Sphingobium_sp._RSMS	520734	S	298	1805	2103	0.00013
Sphingobium_sp._YBL2	484429	S	269	1813	2082	0.00013
Sphingobium_sp._LF-16	2185111	S	49	811	860	0.00005
Sphingobium_yanoikuyae	13690	S	3524	7031	10555	0.00067
Sphingobium_indicum	332055	S	3025	2449	5474	0.00035
Sphingobium_phenoxybenzoativorans	1592790	S	2894	1304	4198	0.00027
Sphingobium_amiense	135719	S	2735	3731	6466	0.00041
Sphingobium_cloacae	120107	S	2390	3862	6252	0.00040
Sphingobium_chlorophenolicum	46429	S	2033	1008	3041	0.00019
Sphingobium_xenophagum	121428	S	2000	1438	3438	0.00022
Sphingobium_baderi	1332080	S	1835	1997	3832	0.00024
Sphingobium_herbicidovorans	76947	S	1623	1557	3180	0.00020
Sphingobium_fuliginis	336203	S	911	3805	4716	0.00030
Sphingopyxis_sp._QXT-31	1357916	S	3763	1151	4914	0.00031
Sphingopyxis_sp._YF1	2482763	S	3635	916	4551	0.00029
Sphingopyxis_sp._113P3	292913	S	3315	1437	4752	0.00030
Sphingopyxis_sp._OPL5	2486273	S	3305	694	3999	0.00026
Sphingopyxis_sp._PAMC25046	2565556	S	3199	1588	4787	0.00031
Sphingopyxis_sp._BSN-002	2911495	S	3060	605	3665	0.00023
Sphingopyxis_sp._FD7	1914525	S	2863	1310	4173	0.00027
Sphingopyxis_sp._EG6	1874061	S	2491	1345	3836	0.00024
Sphingopyxis_sp._MG	1866325	S	197	1929	2126	0.00014
Sphingopyxis_macrogoltabida	33050	S	5840	3185	9025	0.00058
Sphingopyxis_terrae	33052	S	3699	2156	5855	0.00037
Sphingopyxis_lindanitolerans	2054227	S	3244	1724	4968	0.00032
Sphingopyxis_granuli	267128	S	2823	8314	11137	0.00071
Sphingopyxis_fribergensis	1515612	S	2725	1185	3910	0.00025
Sphingopyxis_alaskensis	117207	S	2561	641	3202	0.00020
Novosphingobium_sp._Gsoil_351	2675225	S	4860	443	5303	0.00034
Novosphingobium_sp._Sx8-5	2896849	S	4478	682	5160	0.00033
Novosphingobium_sp._EMRT-2	2571749	S	3927	2527	6454	0.00041
Novosphingobium_sp._P6W	1609758	S	3165	553	3718	0.00024
Novosphingobium_sp._ES2-1	2780074	S	2450	1355	3805	0.00024
Novosphingobium_sp._THN1	1016987	S	2290	875	3165	0.00020
Novosphingobium_sp._PP1Y	702113	S	1395	1857	3252	0.00021
Novosphingobium_sp._KA1	164608	S	764	4377	5141	0.00033
Novosphingobium_resinovorum	158500	S	3949	2149	6098	0.00039
Novosphingobium_decolorationis	2698673	S	3287	1954	5241	0.00033
Novosphingobium_aromaticivorans	48935	S	3247	1626	4873	0.00031
Novosphingobium_ginsenosidimutans	1176536	S	2559	282	2841	0.00018
Novosphingobium_pentaromativorans	205844	S	1243	2424	3667	0.00023
Rhizorhabdus_wittichii	160791	S	8943	5944	14887	0.00095
Rhizorhabdus_dicambivorans	1850238	S	5615	5242	10857	0.00069
Rhizorhabdus_phycosphaerae	2711156	S	4367	608	4975	0.00032
Allosphingosinicella_indica	941907	S	10518	1420	11938	0.00076
Sphingosinithalassobacter_sp._CS137	2762748	S	5192	1160	6352	0.00041
Sphingosinithalassobacter_tenebrarum	2711215	S	3667	1221	4888	0.00031
Parasphingopyxis_algicola	2026624	S	4537	320	4857	0.00031
Parasphingopyxis_sp._CP4	2724527	S	1271	60	1331	0.00008
Sphingorhabdus_sp._YGSMI21	2077182	S	1306	219	1525	0.00010
Sphingorhabdus_sp._SMR4y	2584094	S	1205	207	1412	0.00009
Sphingorhabdus_sp._M41	1806885	S	947	123	1070	0.00007
Sphingorhabdus_lacus	392610	S	789	36	825	0.00005
Sphingorhabdus_lutea	1913578	S	107	8	115	0.00001
Blastomonas_sp._RAC04	1842535	S	978	1510	2488	0.00016
Blastomonas_fulva	1550728	S	867	1736	2603	0.00017
Tardibacter_chloracetimidivorans	1921510	S	3320	2961	6281	0.00040
Hankyongella_ginsenosidimutans	1763828	S	3172	678	3850	0.00025
Citromicrobium_sp._JL477	1634516	S	2398	1169	3567	0.00023
Novosphingopyxis_iocasae	2762729	S	2263	1335	3598	0.00023
Aquisediminimonas_profunda	1550733	S	1328	54	1382	0.00009
Parasphingorhabdus_halotolerans	2725558	S	443	18	461	0.00003
Parasphingorhabdus_sp._JHSY0214	2806553	S	426	31	457	0.00003
Parasphingorhabdus_litoris	394733	S	348	26	374	0.00002
Erythrobacter_sp._HL-111	1798193	S	3274	665	3939	0.00025
Erythrobacter_sp._HKB08	2502843	S	2459	572	3031	0.00019
Erythrobacter_sp._JK5	2829500	S	2400	773	3173	0.00020
Erythrobacter_sp._SDW2	2907154	S	2245	625	2870	0.00018
Erythrobacter_sp._THAF29	2587851	S	1524	381	1905	0.00012
Erythrobacter_sp._LQ02-29	2920384	S	1138	1381	2519	0.00016
Erythrobacter_sp._3-20A1M	2653850	S	1125	1904	3029	0.00019
Erythrobacter_sp._KY5	2011159	S	1082	89	1171	0.00007
Erythrobacter_sp._A30-3	2785907	S	1047	876	1923	0.00012
Erythrobacter_sp._SCSIO_43205	2779361	S	561	113	674	0.00004
Erythrobacter_litoralis	39960	S	4288	1994	6282	0.00040
Erythrobacter_neustonensis	1112	S	1715	416	2131	0.00014
Erythrobacter_mangrovi	2739433	S	1636	630	2266	0.00014
Erythrobacter_aureus	2182384	S	1361	259	1620	0.00010
Porphyrobacter_sp._CACIAM_03H1	2003315	S	3186	984	4170	0.00027
Porphyrobacter_sp._LM_6	1896196	S	1710	641	2351	0.00015
Porphyrobacter_sp._HT-58-2	2023229	S	1609	403	2012	0.00013
Porphyrobacter_sp._GA68	2883480	S	1593	721	2314	0.00015
Qipengyuania_flava	192812	S	4582	2715	7297	0.00047
Qipengyuania_sediminis	1532023	S	2826	423	3249	0.00021
Qipengyuania_soli	2782568	S	1836	357	2193	0.00014
Qipengyuania_aurantiaca	2867233	S	1643	574	2217	0.00014
Qipengyuania_gelatinilytica	2867231	S	1391	282	1673	0.00011
Qipengyuania_seohaensis	266951	S	1038	237	1275	0.00008
Qipengyuania_psychrotolerans	2867238	S	845	112	957	0.00006
Qipengyuania_aquimaris	255984	S	844	927	1771	0.00011
Qipengyuania_xiapuensis	2867236	S	811	880	1691	0.00011
Tsuneonella_amylolytica	2338327	S	3818	1191	5009	0.00032
Tsuneonella_dongtanensis	692370	S	3665	791	4456	0.00028
Tsuneonella_mangrovi	1982042	S	2808	462	3270	0.00021
Tsuneonella_flava	2055955	S	1083	343	1426	0.00009
Altererythrobacter_sp._B11	2060312	S	3627	1825	5452	0.00035
Altererythrobacter_sp._TH136	2067415	S	3080	606	3686	0.00024
Altererythrobacter_sp._BO-6	2604537	S	1686	290	1976	0.00013
Altererythrobacter_sp._ZODW24	2185142	S	649	33	682	0.00004
Altererythrobacter_epoxidivorans	361183	S	1322	412	1734	0.00011
Altererythrobacter_ishigakiensis	476157	S	547	45	592	0.00004
Croceicoccus_sp._YJ47	2798724	S	2012	1195	3207	0.00020
Croceicoccus_sp._Ery5	1703340	S	792	928	1720	0.00011
Croceicoccus_sp._Ery15	1703338	S	538	917	1455	0.00009
Croceicoccus_marinus	450378	S	3575	2038	5613	0.00036
Croceicoccus_naphthovorans	1348774	S	1564	1969	3533	0.00023
Aurantiacibacter_gangjinensis	502682	S	1411	143	1554	0.00010
Aurantiacibacter_atlanticus	1648404	S	633	224	857	0.00005
Pelagerythrobacter_marensis	543877	S	2044	304	2348	0.00015
Paraurantiacibacter_namhicola	645517	S	1959	273	2232	0.00014
Croceibacterium_atlanticum	1267766	S	1636	748	2384	0.00015
Sphingosinicella_sp._BN140058	1892855	S	9741	937	10678	0.00068
Sphingosinicella_flava	2771430	S	4860	747	5607	0.00036
Sphingosinicella_microcystinivorans	335406	S	3763	512	4275	0.00027
Polymorphobacter_sp._PAMC_29334	2862331	S	2226	1502	3728	0.00024
Polymorphobacter_sp._PAMC_29362	2835787	S	2163	1414	3577	0.00023
Sandaracinobacter_sp._M6	2759707	S	2885	214	3099	0.00020
Zymomonas_mobilis	542	S	238	190	428	0.00003
Azospirillum_sp._B510	137722	S	3672	1457	5129	0.00033
Azospirillum_sp._TSH100	652764	S	3109	1513	4622	0.00030
Azospirillum_sp._TSA2s	709810	S	3016	2428	5444	0.00035
Azospirillum_sp._TSH58	664962	S	2054	2873	4927	0.00031
Azospirillum_brasilense	192	S	11558	10655	22213	0.00142
Azospirillum_thermophilum	2202148	S	9065	2218	11283	0.00072
Azospirillum_thiophilum	528244	S	4623	1608	6231	0.00040
Azospirillum_ramasamyi	682998	S	2736	1667	4403	0.00028
Azospirillum_lipoferum	193	S	2318	1808	4126	0.00026
Azospirillum_humicireducens	1226968	S	2200	1361	3561	0.00023
Azospirillum_oryzae	286727	S	2153	1963	4116	0.00026
Azospirillum_baldaniorum	1064539	S	1467	3123	4590	0.00029
Skermanella_mucosa	1789672	S	4199	3260	7459	0.00048
Skermanella_sp._TT6	2775420	S	4011	4584	8595	0.00055
Skermanella_pratensis	2233999	S	3758	2319	6077	0.00039
Skermanella_rosea	1817965	S	3673	3741	7414	0.00047
Nitrospirillum_amazonense	28077	S	5500	702	6202	0.00040
Indioceanicola_profundi	2220096	S	4398	664	5062	0.00032
Niveispirillum_cyanobacteriorum	1612173	S	2231	267	2498	0.00016
Roseomonas_sp._OT10	2897332	S	9041	2378	11419	0.00073
Roseomonas_sp._S08	1750527	S	7949	520	8469	0.00054
Roseomonas_sp._FDAARGOS_362	2018065	S	585	3213	3798	0.00024
Roseomonas_gilardii	257708	S	6621	3153	9774	0.00062
Roseomonas_haemaphysalidis	2768162	S	5587	660	6247	0.00040
Roseomonas_marmotae	2768161	S	5584	646	6230	0.00040
Roseomonas_mucosa	207340	S	516	3304	3820	0.00024
Rhodovastum_atsumiense	504468	S	8393	870	9263	0.00059
Komagataeibacter_xylinus	28448	S	1669	2978	4647	0.00030
Komagataeibacter_saccharivorans	265959	S	701	255	956	0.00006
Komagataeibacter_nataicola	265960	S	483	225	708	0.00005
Komagataeibacter_oboediens	65958	S	461	223	684	0.00004
Komagataeibacter_europaeus	33995	S	432	220	652	0.00004
Komagataeibacter_medellinensis	1177712	S	427	356	783	0.00005
Komagataeibacter_rhaeticus	215221	S	26	452	478	0.00003
Acidiphilium_multivorum	62140	S	1152	5326	6478	0.00041
Acidiphilium_cryptum	524	S	294	2095	2389	0.00015
Roseococcus_microcysteis	2771361	S	5400	511	5911	0.00038
Acidibrevibacterium_fodinaquatile	1969806	S	4301	413	4714	0.00030
Sediminicoccus_rosea	1225128	S	4115	215	4330	0.00028
Lichenicola_cladoniae	1484109	S	3775	185	3960	0.00025
Acetobacter_aceti	435	S	1484	569	2053	0.00013
Acetobacter_persici	1076596	S	326	48	374	0.00002
Acetobacter_sp._KACC_21233	2592655	S	291	64	355	0.00002
Acetobacter_ghanensis	431306	S	180	47	227	0.00001
Acetobacter_pasteurianus	438	S	101	278	379	0.00002
Acetobacter_ascendens	481146	S	84	118	202	0.00001
Acetobacter_senegalensis	446692	S	75	137	212	0.00001
Acetobacter_orientalis	146474	S	71	10	81	0.00001
Acetobacter_tropicalis	104102	S	67	119	186	0.00001
Acetobacter_oryzoeni	2500548	S	32	96	128	0.00001
Gluconacetobacter_diazotrophicus	33996	S	2542	541	3083	0.00020
Gluconobacter_oxydans	442	S	903	943	1846	0.00012
Gluconobacter_albidus	318683	S	389	69	458	0.00003
Gluconobacter_sphaericus	574987	S	301	70	371	0.00002
Gluconobacter_frateurii	38308	S	155	40	195	0.00001
Gluconobacter_thailandicus	257438	S	77	55	132	0.00001
Granulibacter_bethesdensis	364410	S	1699	153	1852	0.00012
Asaia_bogorensis	91915	S	1063	179	1242	0.00008
Neoasaia_chiangmaiensis	320497	S	984	203	1187	0.00008
Kozakia_baliensis	153496	S	757	271	1028	0.00007
Novacetimonas_hansenii	436	S	595	283	878	0.00006
Oecophyllibacter_saccharovorans	2558360	S	502	17	519	0.00003
Parasaccharibacter_apium	1510841	S	22	138	160	0.00001
Parasaccharibacter_sp._TMW_2.1888	2268025	S	18	116	134	0.00001
Swingsia_sp._F3b2	2558361	S	226	6	232	0.00001
Swingsia_samuiensis	1293412	S	29	4	33	0.00000
Neokomagataea_tanensis	661191	S	102	16	118	0.00001
Entomobacter_blattae	2762277	S	60	4	64	0.00000
Bombella_sp._KACC_21507	2697033	S	23	2	25	0.00000
Hypericibacter_adhaerens	2602016	S	14986	2944	17930	0.00114
Hypericibacter_terrae	2602015	S	11579	1798	13377	0.00085
Magnetospirillum_sp._XM-1	1663591	S	2694	957	3651	0.00023
Magnetospirillum_sp._ME-1	1639348	S	2313	891	3204	0.00020
Magnetospirillum_gryphiswaldense	55518	S	3253	264922	268175	0.01712
Magnetospirillum_magneticum	84159	S	2661	302	2963	0.00019
Rhodospirillum_centenum	34018	S	6062	913	6975	0.00045
Rhodospirillum_rubrum	1085	S	2971	232	3203	0.00020
Ferrovibrio_terrae	2594003	S	8084	558	8642	0.00055
Tistrella_mobilis	171437	S	5806	2944	8750	0.00056
Defluviicoccus_vanus	111831	S	3179	305	3484	0.00022
Pararhodospirillum_photometricum	1084	S	1773	140	1913	0.00012
Haematospirillum_jordaniae	1549855	S	294	25	319	0.00002
Candidatus_Endolissoclinum_faulkneri	1263979	S	116	1	117	0.00001
Stella_humosa	94	S	14133	1067	15200	0.00097
Elioraea_tepida	2843330	S	6394	338	6732	0.00043
Thalassospira_sp._A40-3	2785908	S	328	141	469	0.00003
Thalassospira_sp._B30-1	2785911	S	183	299	482	0.00003
Thalassospira_marina	2048283	S	440	28	468	0.00003
Thalassospira_indica	1891279	S	303	198	501	0.00003
Thalassospira_xiamenensis	220697	S	154	236	390	0.00002
Magnetospira_sp._QH-2	1288970	S	1264	43	1307	0.00008
Terasakiella_sp._SH-1	2560057	S	136	3	139	0.00001
Paracoccus_sp._MC1862	2760307	S	1889	222	2111	0.00013
Paracoccus_sp._MA	2895796	S	1618	925	2543	0.00016
Paracoccus_sp._AK26	2589076	S	1456	267	1723	0.00011
Paracoccus_sp._H4-D09	2812658	S	946	215	1161	0.00007
Paracoccus_sp._S8-55	2903900	S	913	132	1045	0.00007
Paracoccus_sp._Arc7-R13	2500532	S	562	608	1170	0.00007
Paracoccus_sanguinis	1545044	S	2984	856	3840	0.00025
Paracoccus_yeei	147645	S	1969	3292	5261	0.00034
Paracoccus_liaowanqingii	2560053	S	1935	242	2177	0.00014
Paracoccus_zhejiangensis	1077935	S	1782	474	2256	0.00014
Paracoccus_denitrificans	266	S	1779	897	2676	0.00017
Paracoccus_aminovorans	34004	S	1691	532	2223	0.00014
Paracoccus_pantotrophus	82367	S	1666	1010	2676	0.00017
Paracoccus_suum	2259340	S	1587	316	1903	0.00012
Paracoccus_jeotgali	2065379	S	1554	327	1881	0.00012
Paracoccus_contaminans	1945662	S	1481	366	1847	0.00012
Paracoccus_aminophilus	34003	S	1314	142	1456	0.00009
Paracoccus_tegillarcae	1529068	S	788	51	839	0.00005
Paracoccus_kondratievae	135740	S	760	161	921	0.00006
Paracoccus_marcusii	59779	S	561	536	1097	0.00007
Paracoccus_mutanolyticus	1499308	S	299	1052	1351	0.00009
Cereibacter_sphaeroides	1063	S	6191	2683	8874	0.00057
Cereibacter_azotoformans	43057	S	562	2188	2750	0.00018
Rhodobacter_sp._CZR27	2033869	S	2468	861	3329	0.00021
Rhodobacter_sp._N10	2807096	S	1974	263	2237	0.00014
Rhodobacter_sp._LPB0142	1850250	S	1930	1469	3399	0.00022
Rhodobacter_capsulatus	1061	S	2288	500	2788	0.00018
Rhodovulum_sp._MB263	308754	S	1243	515	1758	0.00011
Rhodovulum_sp._P5	1564506	S	1237	147	1384	0.00009
Rhodovulum_sulfidophilum	35806	S	1835	1197	3032	0.00019
Paroceanicella_profunda	2579971	S	4210	1210	5420	0.00035
Polymorphum_gilvum	991904	S	4086	1115	5201	0.00033
Pikeienuella_piscinae	2748098	S	3318	351	3669	0.00023
Thioclava_nitratireducens	1915078	S	1223	464	1687	0.00011
Thioclava_electrotropha	1549850	S	1192	332	1524	0.00010
Pontivivens_ytuae	2789856	S	2759	228	2987	0.00019
Silicimonas_algicola	1826607	S	2540	168	2708	0.00017
Pelagovum_pacificum	2588711	S	2304	318	2622	0.00017
Frigidibacter_mobilis	1335048	S	1833	866	2699	0.00017
Pukyongiella_litopenaei	2605946	S	1809	480	2289	0.00015
Brevirhabdus_pacifica	1267768	S	1694	877	2571	0.00016
Gymnodinialimonas_ceratoperidinii	2856823	S	1487	156	1643	0.00010
Haematobacter_massiliensis	195105	S	1304	581	1885	0.00012
Falsirhodobacter_sp._PG104	2692330	S	1259	199	1458	0.00009
Fuscovulum_blasticum	1075	S	1249	176	1425	0.00009
Gemmobacter_aquarius	2169400	S	1151	258	1409	0.00009
Pacificitalea_manganoxidans	1411902	S	1125	273	1398	0.00009
Pseudopuniceibacterium_antarcticum	2613965	S	1098	95	1193	0.00008
Tabrizicola_piscis	2494374	S	1014	102	1116	0.00007
Pseudooceanicola_algae	1537215	S	938	102	1040	0.00007
Monaibacterium_sp._h42	2758038	S	884	227	1111	0.00007
Roseicitreum_antarcticum	564137	S	866	49	915	0.00006
Yoonia_vestfoldensis	245188	S	661	165	826	0.00005
Qingshengfaniella_alkalisoli	2599296	S	583	34	617	0.00004
Tritonibacter_mobilis	379347	S	581	284	865	0.00006
Rhodophyticola_sp._CCM32	2916397	S	558	18	576	0.00004
Pseudohalocynthiibacter_aestuariivivens	1591409	S	511	113	624	0.00004
Rhodobaca_barguzinensis	441209	S	453	22	475	0.00003
Profundibacter_amoris	2171755	S	439	17	456	0.00003
Pseudorhodobacter_turbinis	2500533	S	337	23	360	0.00002
Parasedimentitalea_marina	2483033	S	296	15	311	0.00002
Aestuarium_zhoushanense	2820523	S	271	121	392	0.00003
Cognatishimia_activa	1715691	S	266	13	279	0.00002
Planktomarina_temperata	1284658	S	173	5	178	0.00001
Roseovarius_sp._SCSIO_43702	2823043	S	2200	186	2386	0.00015
Roseovarius_sp._THAF9	2587847	S	959	244	1203	0.00008
Roseovarius_sp._THAF8	2587846	S	403	622	1025	0.00007
Roseovarius_sp._THAF27	2587850	S	384	637	1021	0.00007
Roseovarius_sp._TM1035	391613	S	193	401	594	0.00004
Roseovarius_indicus	540747	S	2359	795	3154	0.00020
Roseovarius_faecimaris	2494550	S	914	42	956	0.00006
Roseovarius_mucosus	215743	S	162	341	503	0.00003
Sulfitobacter_sp._THAF37	2587855	S	1019	449	1468	0.00009
Sulfitobacter_sp._JK7-1	2829501	S	891	52	943	0.00006
Sulfitobacter_sp._D7	1968541	S	496	196	692	0.00004
Sulfitobacter_sp._JL08	2070369	S	426	10	436	0.00003
Sulfitobacter_sp._SK011	1389004	S	327	8	335	0.00002
Sulfitobacter_sp._BSw21498	664426	S	285	46	331	0.00002
Sulfitobacter_sp._DSM_110093	2883127	S	273	78	351	0.00002
Sulfitobacter_sp._SK012	1389005	S	226	4	230	0.00001
Sulfitobacter_sp._SK025	1389011	S	92	192	284	0.00002
Sulfitobacter_sp._CB2047	1525218	S	88	241	329	0.00002
Sulfitobacter_sp._B30-2	2785912	S	53	114	167	0.00001
Sulfitobacter_alexandrii	1917485	S	1472	784	2256	0.00014
Sulfitobacter_mediterraneus	83219	S	696	75	771	0.00005
Sulfitobacter_indolifex	225422	S	424	96	520	0.00003
Sulfitobacter_dubius	218673	S	330	145	475	0.00003
Sulfitobacter_pontiacus	60137	S	186	394	580	0.00004
Salipiger_profundus	1229727	S	2898	1364	4262	0.00027
Salipiger_abyssi	1250539	S	2024	863	2887	0.00018
Salipiger_sp._CCB-MM3	1792508	S	1699	255	1954	0.00012
Roseivivax_sp._THAF30	2587852	S	1435	322	1757	0.00011
Roseivivax_sp._THAF197b	2588299	S	40	635	675	0.00004
Roseivivax_sp._THAF40	2587858	S	34	698	732	0.00005
Roseivivax_marinus	1379903	S	2657	460	3117	0.00020
Celeribacter_indicus	1208324	S	2388	1243	3631	0.00023
Celeribacter_ethanolicus	1758178	S	852	311	1163	0.00007
Celeribacter_baekdonensis	875171	S	387	111	498	0.00003
Celeribacter_marinus	1397108	S	249	9	258	0.00002
Phaeobacter_gallaeciensis	60890	S	973	428	1401	0.00009
Phaeobacter_inhibens	221822	S	795	329	1124	0.00007
Phaeobacter_piscinae	1580596	S	433	367	800	0.00005
Phaeobacter_porticola	1844006	S	216	70	286	0.00002
Phaeobacter_sp._LSS9	681157	S	89	139	228	0.00001
Leisingera_aquaemixtae	1396826	S	1135	206	1341	0.00009
Leisingera_sp._NJS201	2508306	S	212	314	526	0.00003
Leisingera_sp._NJS204	2508307	S	184	288	472	0.00003
Leisingera_methylohalidivorans	133924	S	721	152	873	0.00006
Ruegeria_sp._TM1040	292414	S	417	75	492	0.00003
Ruegeria_sp._THAF33	2587853	S	395	121	516	0.00003
Ruegeria_sp._SCSIO_43209	2793010	S	295	64	359	0.00002
Ruegeria_sp._AD91A	2293862	S	269	37	306	0.00002
Ruegeria_pomeroyi	89184	S	1231	243	1474	0.00009
Yangia_pacifica	311180	S	2358	425	2783	0.00018
Sagittula_sp._P11	2009329	S	2325	1021	3346	0.00021
Sulfitobacter_pseudonitzschiae	1402135	S	1546	571	2117	0.00014
Pseudosulfitobacter_sp._DSM_107133	2883100	S	532	224	756	0.00005
Ponticoccus_alexandrii	1943633	S	1808	292	2100	0.00013
Mameliella_alba	561184	S	1529	302	1831	0.00012
Dinoroseobacter_shibae	215813	S	1510	583	2093	0.00013
Roseobacter_ponti	1891787	S	586	16	602	0.00004
Roseobacter_denitrificans	2434	S	431	52	483	0.00003
Roseobacter_litoralis	42443	S	367	49	416	0.00003
Ketogulonicigenium_vulgare	92945	S	730	198	928	0.00006
Ketogulonicigenium_robustum	92947	S	598	81	679	0.00004
Octadecabacter_sp._SW4	2602067	S	491	76	567	0.00004
Octadecabacter_arcticus	53946	S	295	54	349	0.00002
Octadecabacter_antarcticus	1217908	S	213	31	244	0.00002
Octadecabacter_temperatus	1458307	S	158	4	162	0.00001
Roseibacterium_elongatum	159346	S	1232	112	1344	0.00009
Actibacterium_sp._EMB200-NS6	1609966	S	1188	617	1805	0.00012
Oceanicola_sp._D3	2587163	S	1134	62	1196	0.00008
Maribius_sp._THAF1	2587842	S	940	52	992	0.00006
Thalassococcus_sp._S3	2017482	S	849	23	872	0.00006
Antarctobacter_heliothermus	74033	S	764	42	806	0.00005
Jannaschia_sp._CCS1	290400	S	764	22	786	0.00005
Tateyamaria_omphalii	299262	S	755	27	782	0.00005
Thalassobius_gelatinovorus	53501	S	400	23	423	0.00003
Falsihalocynthiibacter_arcticus	1579316	S	155	5	160	0.00001
Caulobacter_sp._S6	2823693	S	7827	880	8707	0.00056
Caulobacter_sp._FWC26	69665	S	2457	1166	3623	0.00023
Caulobacter_segnis	88688	S	9074	3327	12401	0.00079
Caulobacter_mirabilis	69666	S	6985	1345	8330	0.00053
Caulobacter_vibrioides	155892	S	5378	2390	7768	0.00050
Caulobacter_flavus	1679497	S	5260	1558	6818	0.00044
Caulobacter_rhizosphaerae	2010972	S	4677	1459	6136	0.00039
Caulobacter_soli	2708539	S	3756	1283	5039	0.00032
Caulobacter_henricii	69395	S	2147	387	2534	0.00016
Brevundimonas_sp._PAMC22021	2861285	S	1989	432	2421	0.00015
Brevundimonas_sp._LM2	1938605	S	1909	322	2231	0.00014
Brevundimonas_sp._M20	2591463	S	1900	294	2194	0.00014
Brevundimonas_sp._MF30-B	2561924	S	1840	290	2130	0.00014
Brevundimonas_sp._AJA228-03	2752515	S	1393	183	1576	0.00010
Brevundimonas_sp._SGAir0440	2579977	S	453	429	882	0.00006
Brevundimonas_sp._CS1	2813778	S	417	408	825	0.00005
Brevundimonas_sp._Bb-A	2560058	S	400	849	1249	0.00008
Brevundimonas_sp._DS20	1532555	S	369	943	1312	0.00008
Brevundimonas_sp._GW460-12-10-14-LB2	1827469	S	347	600	947	0.00006
Brevundimonas_sp._'scallop'	2562582	S	318	555	873	0.00006
Brevundimonas_naejangsanensis	588932	S	3579	1200	4779	0.00031
Brevundimonas_albigilva	1312364	S	2199	1227	3426	0.00022
Brevundimonas_goettingensis	2774190	S	2096	324	2420	0.00015
Brevundimonas_subvibrioides	74313	S	1780	314	2094	0.00013
Brevundimonas_diminuta	293	S	1445	2644	4089	0.00026
Brevundimonas_vitisensis	2800818	S	1416	173	1589	0.00010
Brevundimonas_pondensis	2774189	S	1332	405	1737	0.00011
Brevundimonas_mediterranea	74329	S	1198	451	1649	0.00011
Brevundimonas_nasdae	172043	S	1084	711	1795	0.00011
Brevundimonas_vancanneytii	1325724	S	367	1366	1733	0.00011
Brevundimonas_vesicularis	41276	S	366	795	1161	0.00007
Phenylobacterium_zucineum	284016	S	26558	5598	32156	0.00205
Phenylobacterium_parvum	2201350	S	4769	538	5307	0.00034
Asticcacaulis_excentricus	78587	S	1470	213	1683	0.00011
Asticcacaulis_sp._AND118	2840468	S	1327	186	1513	0.00010
Terricaulis_silvestris	2686094	S	2223	82	2305	0.00015
Marinicauda_algicola	2029849	S	3125	573	3698	0.00024
Maricaulis_maris	74318	S	1094	75	1169	0.00007
Glycocaulis_alkaliphilus	1434191	S	994	56	1050	0.00007
Hyphobacterium_sp._CCMP332	2749086	S	707	30	737	0.00005
Hyphomonas_sp._CACIAM_19H1	1873716	S	1073	146	1219	0.00008
Hyphomonas_sp._Mor2	1906738	S	607	13	620	0.00004
Hyphomonas_sp._KY3	2016196	S	562	69	631	0.00004
Hyphomonas_neptunium	81032	S	852	80	932	0.00006
Candidatus_Viadribacter_manganicus	1759059	S	1314	37	1351	0.00009
Hirschia_baltica	2724	S	63	1	64	0.00000
Aquisalinus_flavus	1526572	S	1209	62	1271	0.00008
Parvularcula_bermudensis	208216	S	501	65	566	0.00004
Rickettsia_tillamookensis	2761623	S	103	86	189	0.00001
Rickettsia_endosymbiont_of_Ixodes_scapularis	444612	S	15	28	43	0.00000
Rickettsia_helvetica	35789	S	11	47	58	0.00000
Rickettsia_australis	787	S	10	9	19	0.00000
Rickettsia_endosymbiont_of_Oedothorax_gibbosus	931099	S	29	7	36	0.00000
Rickettsia_endosymbiont_of_Bemisia_tabaci	337479	S	10	12	22	0.00000
Rickettsia_canadensis	788	S	14	3	17	0.00000
Rickettsia_bellii	33990	S	14	16	30	0.00000
Rickettsia_typhi	785	S	15	5	20	0.00000
Orientia_tsutsugamushi	784	S	22	1	23	0.00000
Candidatus_Sneabacter_namystus	2601646	S	15	2	17	0.00000
Candidatus_Phycorickettsia_trachydisci	2115978	S	67	4	71	0.00000
Anaplasma_ovis	142058	S	71	17	88	0.00001
Anaplasma_platys	949	S	43	10	53	0.00000
Anaplasma_marginale	770	S	26	36	62	0.00000
Anaplasma_phagocytophilum	948	S	26	6	32	0.00000
Anaplasma_centrale	769	S	17	19	36	0.00000
Wolbachia_endosymbiont_of_Folsomia_candida	169402	S	19	36	55	0.00000
Wolbachia_endosymbiont_of_Cruorifilaria_tuberocauda	1812111	S	13	19	32	0.00000
Ehrlichia_ruminantium	779	S	24	16	40	0.00000
Ehrlichia_canis	944	S	10	13	23	0.00000
Neorickettsia_helminthoeca	33994	S	12	18	30	0.00000
Candidatus_Midichloria_mitochondrii	234827	S	38	4	42	0.00000
Candidatus_Fokinia_solitaria	1802984	S	26	0	26	0.00000
Rickettsiales_endosymbiont_of_Stachyamoeba_lipophora	2486578	S	44	6	50	0.00000
Candidatus_Deianiraea_vastatrix	2163644	S	19	0	19	0.00000
Micavibrio_aeruginosavorus	349221	S	727	9	736	0.00005
Candidatus_Puniceispirillum_marinum	767892	S	141	4	145	0.00001
Luteithermobacter_gelatinilyticus	2582913	S	452	78	530	0.00003
Paremcibacter_congregatus	2043170	S	403	13	416	0.00003
Candidatus_Hydrogenosomobacter_endosymbioticus	2558174	S	53	1	54	0.00000
Candidatus_Cytomitobacter_indipagum	2601575	S	18	4	22	0.00000
Candidatus_Cytomitobacter_primus	2066024	S	17	4	21	0.00000
endosymbiont_of_Acanthamoeba_sp._UWC8	86106	S	36	0	36	0.00000
Candidatus_Gromoviella_agglomerans	2806609	S	27	1	28	0.00000
Candidatus_Nesciobacter_abundans	2601668	S	13	2	15	0.00000
Candidatus_Paracaedibacter_acanthamoebae	91604	S	124	6	130	0.00001
Candidatus_Nucleicultrix_amoebiphila	1509244	S	118	6	124	0.00001
Magnetococcus_marinus	1124597	S	213	5	218	0.00001
Candidatus_Pelagibacter_sp._RS40	1977865	S	23	11	34	0.00000
Candidatus_Pelagibacter_sp._IMCC9063	1002672	S	16	1	17	0.00000
Candidatus_Pelagibacter_sp._RS39	1977864	S	13	12	25	0.00000
Candidatus_Fonsibacter_ubiquis	1925548	S	97	4	101	0.00001
Kordiimonas_pumila	2161677	S	86	1	87	0.00001
Burkholderia_multivorans	87883	S	7202	3741	10943	0.00070
Burkholderia_ubonensis	101571	S	6605	5002	11607	0.00074
Burkholderia_cenocepacia	95486	S	5025	25837	30862	0.00197
Burkholderia_cepacia	292	S	4423	7305	11728	0.00075
Burkholderia_pyrrocinia	60550	S	2935	1997	4932	0.00031
Burkholderia_contaminans	488447	S	2479	1920	4399	0.00028
Burkholderia_stagnalis	1503054	S	2286	964	3250	0.00021
Burkholderia_ambifaria	152480	S	2178	4583	6761	0.00043
Burkholderia_anthina	179879	S	2157	2394	4551	0.00029
Burkholderia_dolosa	152500	S	2056	953	3009	0.00019
Burkholderia_lata	482957	S	1833	2008	3841	0.00025
Burkholderia_stabilis	95485	S	1819	1589	3408	0.00022
Burkholderia_territorii	1503055	S	1637	976	2613	0.00017
Burkholderia_seminalis	488731	S	1248	713	1961	0.00013
Burkholderia_vietnamiensis	60552	S	1152	3840	4992	0.00032
Burkholderia_metallica	488729	S	1030	606	1636	0.00010
Burkholderia_diffusa	488732	S	741	450	1191	0.00008
Burkholderia_pseudomultivorans	1207504	S	544	730	1274	0.00008
Burkholderia_latens	488446	S	379	992	1371	0.00009
Burkholderia_aenigmatica	2015348	S	260	680	940	0.00006
Burkholderia_pseudomallei	28450	S	3180	55971	59151	0.00378
Burkholderia_mayonis	1385591	S	2406	625	3031	0.00019
Burkholderia_thailandensis	57975	S	2235	8565	10800	0.00069
Burkholderia_oklahomensis	342113	S	1492	678	2170	0.00014
Burkholderia_savannae	1637837	S	347	394	741	0.00005
Burkholderia_sp._MSMB617WGS	1637831	S	137	308	445	0.00003
Burkholderia_sp._MSMB1588	1636423	S	135	389	524	0.00003
Burkholderia_mallei	13373	S	110	2590	2700	0.00017
Burkholderia_sp._DHOD12	2571746	S	3766	519	4285	0.00027
Burkholderia_sp._Bp7605	1740163	S	2173	370	2543	0.00016
Burkholderia_sp._NRF60-BP8	1637853	S	812	538	1350	0.00009
Burkholderia_sp._MSMB0856	1637869	S	702	497	1199	0.00008
Burkholderia_sp._LA-2-3-30-S1-D2	1637862	S	691	448	1139	0.00007
Burkholderia_sp._JP2-270	2217913	S	660	502	1162	0.00007
Burkholderia_sp._PAMC_26561	1795043	S	522	524	1046	0.00007
Burkholderia_sp._MS455	2811788	S	521	439	960	0.00006
Burkholderia_sp._PAMC_28687	1795874	S	417	638	1055	0.00007
Burkholderia_sp._IDO3	1705310	S	327	607	934	0.00006
Burkholderia_sp._KBS0801	1179675	S	136	363	499	0.00003
Burkholderia_sp._LAS2	2813843	S	134	820	954	0.00006
Burkholderia_sp._MBR-1	2732364	S	54	310	364	0.00002
Burkholderia_sp._KJ006	416344	S	48	427	475	0.00003
Burkholderia_sp._MS389	2811789	S	48	476	524	0.00003
Burkholderia_sp._B21-007	2890407	S	26	942	968	0.00006
Burkholderia_gladioli	28095	S	7994	3029	11023	0.00070
Burkholderia_glumae	337	S	3021	1415	4436	0.00028
Burkholderia_plantarii	41899	S	2232	1020	3252	0.00021
Burkholderia_perseverans	2615214	S	1870	920	2790	0.00018
Cupriavidus_taiwanensis	164546	S	12252	10399	22651	0.00145
Cupriavidus_pauculus	82633	S	10572	5154	15726	0.00100
Cupriavidus_basilensis	68895	S	5200	3260	8460	0.00054
Cupriavidus_oxalaticus	96344	S	5190	2543	7733	0.00049
Cupriavidus_sp._EM10	2839983	S	2331	1542	3873	0.00025
Cupriavidus_sp._MP-37	2884455	S	1015	1095	2110	0.00013
Cupriavidus_sp._ISTL7	2771360	S	487	3173	3660	0.00023
Cupriavidus_sp._KK10	1478019	S	353	1052	1405	0.00009
Cupriavidus_sp._USMAA2-4	876364	S	317	2305	2622	0.00017
Cupriavidus_sp._USMAHM13	1389192	S	224	1580	1804	0.00012
Cupriavidus_necator	106590	S	4939	4055	8994	0.00057
Cupriavidus_campinensis	151783	S	4401	1775	6176	0.00039
Cupriavidus_metallidurans	119219	S	3191	2308	5499	0.00035
Cupriavidus_pinatubonensis	248026	S	3017	592	3609	0.00023
Cupriavidus_gilardii	82541	S	1963	10676	12639	0.00081
Cupriavidus_neocaledonicus	1040979	S	906	1142	2048	0.00013
Cupriavidus_nantongensis	1796606	S	836	2444	3280	0.00021
Cupriavidus_malaysiensis	367825	S	361	2386	2747	0.00018
Paraburkholderia_sp._SOS3	1926494	S	3050	518	3568	0.00023
Paraburkholderia_sp._PGU16	2735433	S	1285	781	2066	0.00013
Paraburkholderia_sp._PGU19	2735434	S	1097	1023	2120	0.00014
Paraburkholderia_pallida	2547399	S	4005	846	4851	0.00031
Paraburkholderia_acidisoli	2571748	S	3277	699	3976	0.00025
Paraburkholderia_aromaticivorans	2026199	S	3236	1585	4821	0.00031
Paraburkholderia_caribensis	75105	S	3230	2625	5855	0.00037
Paraburkholderia_tropica	92647	S	3207	845	4052	0.00026
Paraburkholderia_acidiphila	2571747	S	2900	662	3562	0.00023
Paraburkholderia_edwinii	2861782	S	2620	417	3037	0.00019
Paraburkholderia_terricola	169427	S	2566	865	3431	0.00022
Paraburkholderia_sprentiae	948107	S	2437	610	3047	0.00019
Paraburkholderia_phytofirmans	261302	S	2425	1201	3626	0.00023
Paraburkholderia_atlantica	2654982	S	2421	679	3100	0.00020
Paraburkholderia_phenoliruptrix	252970	S	2322	748	3070	0.00020
Paraburkholderia_phymatum	148447	S	2292	651	2943	0.00019
Paraburkholderia_graminis	60548	S	2062	576	2638	0.00017
Paraburkholderia_megapolitana	420953	S	2062	235	2297	0.00015
Paraburkholderia_fungorum	134537	S	2052	541	2593	0.00017
Paraburkholderia_ginsengisoli	311231	S	1887	654	2541	0.00016
Paraburkholderia_terrae	311230	S	1846	2269	4115	0.00026
Paraburkholderia_caledonica	134536	S	1789	368	2157	0.00014
Paraburkholderia_dokdonella	2211211	S	1531	478	2009	0.00013
Paraburkholderia_hospita	169430	S	1481	1812	3293	0.00021
Paraburkholderia_caffeinilytica	1761016	S	1451	425	1876	0.00012
Paraburkholderia_xenovorans	36873	S	1373	1895	3268	0.00021
Paraburkholderia_dioscoreae	2604047	S	931	675	1606	0.00010
Ralstonia_solanacearum	305	S	7133	15964	23097	0.00147
Ralstonia_insidiosa	190721	S	2022	1716	3738	0.00024
Ralstonia_mannitolilytica	105219	S	1494	2082	3576	0.00023
Ralstonia_pickettii	329	S	1331	718	2049	0.00013
Ralstonia_sp._56D2	2842456	S	1290	242	1532	0.00010
Ralstonia_syzygii	28097	S	101	288	389	0.00002
Ralstonia_pseudosolanacearum	1310165	S	38	1163	1201	0.00008
Pandoraea_pnomenusa	93220	S	2882	1531	4413	0.00028
Pandoraea_thiooxydans	445709	S	2541	247	2788	0.00018
Pandoraea_pulmonicola	93221	S	2308	579	2887	0.00018
Pandoraea_vervacti	656178	S	1745	573	2318	0.00015
Pandoraea_sp._XY-2	2518599	S	1700	992	2692	0.00017
Pandoraea_faecigallinarum	656179	S	1678	508	2186	0.00014
Pandoraea_norimbergensis	93219	S	1589	287	1876	0.00012
Pandoraea_apista	93218	S	1398	882	2280	0.00015
Pandoraea_fibrosis	1891094	S	1224	451	1675	0.00011
Pandoraea_oxalativorans	573737	S	1169	613	1782	0.00011
Pandoraea_sputorum	93222	S	1088	530	1618	0.00010
Caballeronia_sp._Lep1P3	2878150	S	2513	724	3237	0.00021
Caballeronia_sp._TF1N1	2878153	S	1986	282	2268	0.00014
Caballeronia_sp._SL2Y3	2878151	S	1219	872	2091	0.00013
Caballeronia_sp._Sq4a	2878152	S	1069	983	2052	0.00013
Caballeronia_sp._M1242	2814653	S	1059	951	2010	0.00013
Caballeronia_sp._SBC2	2705547	S	111	1211	1322	0.00008
Caballeronia_sp._SBC1	2705548	S	70	1067	1137	0.00007
Caballeronia_zhejiangensis	871203	S	2811	804	3615	0.00023
Caballeronia_insecticola	758793	S	2675	689	3364	0.00021
Caballeronia_grimmiae	1071679	S	2298	1357	3655	0.00023
Polynucleobacter_sp._MWH-UH24A	2689110	S	215	15	230	0.00001
Polynucleobacter_sp._MWH-Spelu-300-X4	2689109	S	74	4	78	0.00001
Polynucleobacter_sp._TSB-Sco08W16	1758374	S	61	9	70	0.00000
Polynucleobacter_sp._MWH-CaK5	2689107	S	54	3	57	0.00000
Polynucleobacter_sp._MWH-UH35A	1855619	S	53	8	61	0.00000
Polynucleobacter_sp._AP-Nino-20-G2	2576917	S	51	12	63	0.00000
Polynucleobacter_sp._MWH-Svant-W18	1855909	S	51	9	60	0.00000
Polynucleobacter_sp._MWH-Aus1W21	1855880	S	48	10	58	0.00000
Polynucleobacter_sp._MWH-P3-07-1	1743173	S	39	6	45	0.00000
Polynucleobacter_sp._MWH-UH25E	1855616	S	39	6	45	0.00000
Polynucleobacter_sp._MG-6-Vaara-E2	2576932	S	38	6	44	0.00000
Polynucleobacter_sp._JS-JIR-II-b4	1758390	S	37	16	53	0.00000
Polynucleobacter_sp._LimPoW16	1743162	S	34	1	35	0.00000
Polynucleobacter_sp._AP-Ainpum-60-G11	2576926	S	33	7	40	0.00000
Polynucleobacter_sp._Adler-ghost	2770234	S	32	11	43	0.00000
Polynucleobacter_sp._JS-JIR-II-50	2576919	S	32	12	44	0.00000
Polynucleobacter_sp._MWH-UH2A	1855617	S	32	5	37	0.00000
Polynucleobacter_sp._MWH-UH21B	1743174	S	31	4	35	0.00000
Polynucleobacter_sp._AP-Kolm-20A-A1	2081041	S	31	18	49	0.00000
Polynucleobacter_sp._MWH-Braz-FAM2G	1855883	S	31	3	34	0.00000
Polynucleobacter_sp._AP-Titi-500A-B4	2576923	S	27	5	32	0.00000
Polynucleobacter_sp._es-MAR-2	1819725	S	27	5	32	0.00000
Polynucleobacter_sp._AP-Elch-400A-B2	2576930	S	25	9	34	0.00000
Polynucleobacter_sp._JS-Mosq-20-D10	2576922	S	23	7	30	0.00000
Polynucleobacter_sp._es-EL-1	1855652	S	22	3	25	0.00000
Polynucleobacter_sp._MG-Unter2-18	2081052	S	21	14	35	0.00000
Polynucleobacter_sp._MWH-S4W17	1855910	S	20	8	28	0.00000
Polynucleobacter_sp._AP-Jannik-300A-C4	2576928	S	18	14	32	0.00000
Polynucleobacter_sp._VK25	1758398	S	18	3	21	0.00000
Polynucleobacter_sp._AP-Sving-400A-A2	2081049	S	16	6	22	0.00000
Polynucleobacter_sp._AP-Melu-1000-A1	2081042	S	15	5	20	0.00000
Polynucleobacter_sp._JS-JIR-5-A7	1758395	S	12	22	34	0.00000
Polynucleobacter_sp._MG-5-Ahmo-C2	2081051	S	11	60	71	0.00000
Polynucleobacter_sp._AM-7D1	2689102	S	11	9	20	0.00000
Polynucleobacter_necessarius	576610	S	284	52	336	0.00002
Polynucleobacter_asymbioticus	576611	S	123	19	142	0.00001
Polynucleobacter_difficilis	556054	S	112	10	122	0.00001
Polynucleobacter_acidiphobus	556053	S	73	5	78	0.00001
Polynucleobacter_paneuropaeus	2527775	S	60	7	67	0.00000
Polynucleobacter_wuianus	1743168	S	32	10	42	0.00000
Polynucleobacter_duraquae	1835254	S	15	10	25	0.00000
Lautropia_mirabilis	47671	S	1856	404	2260	0.00014
Mycetohabitans_rhizoxinica	412963	S	1720	139	1859	0.00012
Chitinimonas_arctica	2594795	S	1293	125	1418	0.00009
Mycoavidus_sp._HKI	2840467	S	166	15	181	0.00001
Mycoavidus_sp._B2-EB	2651972	S	79	15	94	0.00001
Mycoavidus_cysteinexigens	1553431	S	123	16	139	0.00001
Limnobacter_sp._SAORIC-580	2732163	S	252	14	266	0.00002
Candidatus_Vallotia_lariciata	2018052	S	60	24	84	0.00001
Candidatus_Vallotia_cooleyia	1177211	S	53	7	60	0.00000
Candidatus_Vallotia_sp._(ex_Adelges_kitamiensis)	2864217	S	44	17	61	0.00000
Candidatus_Vallotia_tarda	1177213	S	36	6	42	0.00000
Ephemeroptericola_cinctiostellae	2268024	S	121	9	130	0.00001
Variovorax_sp._HW608	1034889	S	7962	1598	9560	0.00061
Variovorax_sp._PBS-H4	434008	S	4319	2961	7280	0.00046
Variovorax_sp._PBL-H6	434009	S	4198	4286	8484	0.00054
Variovorax_sp._RA8	662548	S	3903	3347	7250	0.00046
Variovorax_sp._WDL1	207745	S	3754	6597	10351	0.00066
Variovorax_sp._PAMC_28711	1795631	S	3260	652	3912	0.00025
Variovorax_sp._RKNM96	2681552	S	3036	1295	4331	0.00028
Variovorax_sp._PAMC28562	2762323	S	2549	260	2809	0.00018
Variovorax_sp._PAMC26660	2762322	S	2371	675	3046	0.00019
Variovorax_sp._SRS16	282217	S	2048	4785	6833	0.00044
Variovorax_sp._38R	2774875	S	1785	2403	4188	0.00027
Variovorax_sp._PBL-E5	434014	S	1745	4730	6475	0.00041
Variovorax_sp._PDNC026	2811425	S	52	2024	2076	0.00013
Variovorax_sp._PMC12	2126319	S	47	2350	2397	0.00015
Variovorax_paradoxus	34073	S	15927	16255	32182	0.00205
Variovorax_boronicumulans	436515	S	2333	1895	4228	0.00027
Hydrogenophaga_sp._BA0156	2716225	S	3974	3283	7257	0.00046
Hydrogenophaga_sp._YM1	2806262	S	3631	2198	5829	0.00037
Hydrogenophaga_sp._BPS33	2651974	S	3354	2844	6198	0.00040
Hydrogenophaga_sp._PBC	795665	S	3222	4268	7490	0.00048
Hydrogenophaga_sp._SL48	2806347	S	2643	755	3398	0.00022
Hydrogenophaga_sp._RAC07	1842537	S	2166	845	3011	0.00019
Hydrogenophaga_sp._PBL-H3	434010	S	2014	2074	4088	0.00026
Hydrogenophaga_sp._PAMC20947	2565558	S	1093	88	1181	0.00008
Hydrogenophaga_sp._NH-16	2184519	S	1030	2505	3535	0.00023
Hydrogenophaga_taeniospiralis	65656	S	2275	824	3099	0.00020
Hydrogenophaga_pseudoflava	47421	S	1142	2141	3283	0.00021
Hydrogenophaga_crassostreae	1763535	S	1031	78	1109	0.00007
Acidovorax_sp._YS12	2738413	S	2292	2376	4668	0.00030
Acidovorax_sp._KKS102	358220	S	2119	1802	3921	0.00025
Acidovorax_sp._JMULE5	2518343	S	1538	491	2029	0.00013
Acidovorax_sp._RAC01	1842533	S	1493	1394	2887	0.00018
Acidovorax_sp._HDW3	2714923	S	1256	1081	2337	0.00015
Acidovorax_sp._1608163	2478662	S	1021	253	1274	0.00008
Acidovorax_sp._T1	1858609	S	881	3773	4654	0.00030
Acidovorax_avenae	80867	S	4779	3672	8451	0.00054
Acidovorax_monticola	1926868	S	2939	1390	4329	0.00028
Acidovorax_antarcticus	2743470	S	2437	2258	4695	0.00030
Acidovorax_carolinensis	553814	S	1531	1464	2995	0.00019
Acidovorax_citrulli	80869	S	1310	1459	2769	0.00018
Acidovorax_cattleyae	80868	S	1202	1012	2214	0.00014
Acidovorax_radicis	758826	S	1057	260	1317	0.00008
Ramlibacter_tataouinensis	94132	S	20413	9755	30168	0.00193
Comamonas_sp._NLF-7-7	2597701	S	1995	1778	3773	0.00024
Comamonas_sp._NLF-1-9	2853163	S	1741	1156	2897	0.00018
Comamonas_sp._B21-038	2918299	S	808	237	1045	0.00007
Comamonas_sp._Y33R10-2	2853257	S	285	64	349	0.00002
Comamonas_serinivorans	1082851	S	2167	738	2905	0.00019
Comamonas_aquatica	225991	S	1985	2269	4254	0.00027
Comamonas_testosteroni	285	S	1340	2240	3580	0.00023
Comamonas_koreensis	160825	S	881	606	1487	0.00009
Comamonas_odontotermitis	379895	S	855	204	1059	0.00007
Comamonas_piscis	1562974	S	696	162	858	0.00005
Comamonas_thiooxydans	363952	S	613	1532	2145	0.00014
Comamonas_kerstersii	225992	S	455	286	741	0.00005
Comamonas_fluminis	2796366	S	412	211	623	0.00004
Rhodoferax_sp._BAB1	2741720	S	2607	862	3469	0.00022
Rhodoferax_sp._AJA081-3	2752316	S	735	64	799	0.00005
Rhodoferax_sp._PAMC_29310	2822760	S	614	84	698	0.00004
Rhodoferax_sp._MIZ03	2798804	S	474	60	534	0.00003
Rhodoferax_koreense	1842727	S	3885	2428	6313	0.00040
Rhodoferax_sediminis	2509614	S	3265	604	3869	0.00025
Rhodoferax_ferrireducens	192843	S	1324	109	1433	0.00009
Rhodoferax_saidenbachensis	1484693	S	930	123	1053	0.00007
Rhodoferax_antarcticus	81479	S	641	59	700	0.00004
Rhodoferax_aquaticus	2527691	S	327	39	366	0.00002
Schlegelella_thermodepolymerans	215580	S	6637	3882	10519	0.00067
Schlegelella_brevitalea	413882	S	5716	993	6709	0.00043
Diaphorobacter_sp._HDW4A	2714924	S	1663	1833	3496	0.00022
Diaphorobacter_sp._HDW4B	2714925	S	1436	216	1652	0.00011
Diaphorobacter_sp._MNS-0	2866628	S	170	1557	1727	0.00011
Diaphorobacter_sp._JS3050	2735554	S	165	1981	2146	0.00014
Diaphorobacter_sp._JS3051	2792224	S	157	2845	3002	0.00019
Diaphorobacter_ruginosibacter	1715720	S	1964	428	2392	0.00015
Diaphorobacter_aerolatus	1288495	S	1567	2904	4471	0.00029
[Acidovorax]_ebreus	721785	S	285	1876	2161	0.00014
Diaphorobacter_nitroreducens	164759	S	260	756	1016	0.00006
Delftia_tsuruhatensis	180282	S	1738	5292	7030	0.00045
Delftia_acidovorans	80866	S	1501	5873	7374	0.00047
Delftia_lacustris	558537	S	548	3451	3999	0.00026
Delftia_sp._Cs1-4	742013	S	213	504	717	0.00005
Delftia_sp._HK171	1920191	S	108	295	403	0.00003
Polaromonas_sp._JS666	296591	S	2540	2471	5011	0.00032
Polaromonas_naphthalenivorans	216465	S	1970	367	2337	0.00015
Polaromonas_vacuolata	37448	S	256	32	288	0.00002
Kinneretia_sp._DAIF2	2714952	S	5221	2313	7534	0.00048
Kinneretia_sp._XES5	2877940	S	1783	2701	4484	0.00029
Ottowia_sp._27C	2816950	S	2440	559	2999	0.00019
Ottowia_sp._oral_taxon_894	1658672	S	1028	177	1205	0.00008
Ottowia_oryzae	2109914	S	1734	448	2182	0.00014
Alicycliphilus_denitrificans	179636	S	4539	8489	13028	0.00083
Melaminivora_sp._SC2-9	2109913	S	2125	2854	4979	0.00032
Melaminivora_jejuensis	1267217	S	1681	1504	3185	0.00020
Serpentinimonas_maccroryi	1458426	S	1466	543	2009	0.00013
Serpentinimonas_raichei	1458425	S	1234	508	1742	0.00011
Verminephrobacter_eiseniae	364317	S	2359	341	2700	0.00017
Pulveribacter_suum	2116657	S	1918	1164	3082	0.00020
Hylemonella_gracilis	80880	S	1861	321	2182	0.00014
Simplicispira_suum	2109915	S	1523	644	2167	0.00014
Limnohabitans_sp._63ED37-2	1678128	S	626	80	706	0.00005
Limnohabitans_sp._103DPR2	1678129	S	234	20	254	0.00002
Candidatus_Symbiobacter_mobilis	1436290	S	652	27	679	0.00004
Curvibacter_sp._AEP1-3	1844971	S	641	54	695	0.00004
Massilia_sp._WG5	1707785	S	7042	3575	10617	0.00068
Massilia_sp._HC52	2852099	S	4357	1407	5764	0.00037
Massilia_sp._DM-R-R2A-13	2899220	S	4321	1137	5458	0.00035
Massilia_sp._LPB0304	2769491	S	4086	1194	5280	0.00034
Massilia_sp._YMA4	1593482	S	3092	1798	4890	0.00031
Massilia_sp._NP310	2861282	S	3079	2280	5359	0.00034
Massilia_sp._PAMC28688	2861283	S	2292	403	2695	0.00017
Massilia_sp._NR_4-1	1678028	S	531	1777	2308	0.00015
Massilia_sp._MB5	2919578	S	471	1630	2101	0.00013
Massilia_sp._Dwa41.01b	2709302	S	66	2311	2377	0.00015
Massilia_sp._Se16.2.3	2709303	S	57	2014	2071	0.00013
Massilia_putida	1141883	S	6691	2456	9147	0.00058
Massilia_violaceinigra	2045208	S	5272	1668	6940	0.00044
Massilia_flava	871742	S	5239	1472	6711	0.00043
Massilia_albidiflava	321983	S	3218	1444	4662	0.00030
Massilia_umbonata	864828	S	3152	1429	4581	0.00029
Massilia_lutea	321985	S	3144	1090	4234	0.00027
Massilia_plicata	321984	S	2871	863	3734	0.00024
Massilia_armeniaca	2072590	S	2784	1639	4423	0.00028
Massilia_oculi	945844	S	2600	1846	4446	0.00028
Massilia_antarctica	2765360	S	2201	909	3110	0.00020
Duganella_sp._GN2-R2	2728020	S	4320	2074	6394	0.00041
Duganella_sp._AF9R3	2728021	S	2553	612	3165	0.00020
Herbaspirillum_robiniae	2014887	S	2743	1207	3950	0.00025
Herbaspirillum_seropedicae	964	S	1814	777	2591	0.00017
Herbaspirillum_hiltneri	341045	S	1779	359	2138	0.00014
Herbaspirillum_frisingense	92645	S	1743	650	2393	0.00015
Herbaspirillum_rubrisubalbicans	80842	S	1481	763	2244	0.00014
Herbaspirillum_huttiense	863372	S	1129	534	1663	0.00011
Herbaspirillum_sp._meg3	2025949	S	1002	137	1139	0.00007
Janthinobacterium_sp._17J80-10	2497863	S	1696	298	1994	0.00013
Janthinobacterium_sp._1_2014MBL_MicDiv	1644131	S	1467	591	2058	0.00013
Janthinobacterium_sp._LM6	1938606	S	732	488	1220	0.00008
Janthinobacterium_sp._Marseille	375286	S	537	157	694	0.00004
Janthinobacterium_sp._PAMC25594	2861284	S	536	354	890	0.00006
Janthinobacterium_sp._HH102	1537274	S	322	535	857	0.00005
Janthinobacterium_sp._B9-8	1236179	S	133	49	182	0.00001
Janthinobacterium_agaricidamnosum	55508	S	2208	3655	5863	0.00037
Janthinobacterium_lividum	29581	S	498	528	1026	0.00007
Janthinobacterium_tructae	2590869	S	466	257	723	0.00005
Janthinobacterium_svalbardensis	368607	S	436	234	670	0.00004
Collimonas_fungivorans	158899	S	2121	656	2777	0.00018
Collimonas_arenae	279058	S	1543	225	1768	0.00011
Collimonas_pratensis	279113	S	1522	350	1872	0.00012
Noviherbaspirillum_sp._UKPF54	2601898	S	4375	885	5260	0.00034
Undibacterium_sp._YM2	2058625	S	207	88	295	0.00002
Undibacterium_sp._KW1	2058624	S	155	66	221	0.00001
Undibacterium_parvum	401471	S	257	38	295	0.00002
Herminiimonas_arsenitoxidans	1809410	S	323	55	378	0.00002
Glaciimonas_sp._PAMC28666	2807626	S	271	19	290	0.00002
Oxalobacter_formigenes	847	S	231	25	256	0.00002
Bordetella_sp._H567	1697043	S	3079	433	3512	0.00022
Bordetella_sp._N	1746199	S	2467	335	2802	0.00018
Bordetella_petrii	94624	S	4954	8187	13141	0.00084
Bordetella_bronchialis	463025	S	3853	613	4466	0.00029
Bordetella_genomosp._13	463040	S	3604	3125	6729	0.00043
Bordetella_genomosp._8	1416806	S	3230	455	3685	0.00024
Bordetella_genomosp._9	1416803	S	3052	949	4001	0.00026
Bordetella_flabilis	463014	S	2994	303	3297	0.00021
Bordetella_hinzii	103855	S	2408	1237	3645	0.00023
Bordetella_trematum	123899	S	1879	956	2835	0.00018
Bordetella_pseudohinzii	1331258	S	1344	706	2050	0.00013
Bordetella_bronchiseptica	518	S	1278	4799	6077	0.00039
Bordetella_holmesii	35814	S	851	303	1154	0.00007
Bordetella_avium	521	S	831	225	1056	0.00007
Bordetella_genomosp._6	463024	S	398	748	1146	0.00007
Bordetella_pertussis	520	S	258	15038	15296	0.00098
Bordetella_parapertussis	519	S	138	1588	1726	0.00011
Achromobacter_xylosoxidans	85698	S	8216	15821	24037	0.00153
Achromobacter_sp._AONIH1	1758194	S	3032	4675	7707	0.00049
Achromobacter_sp._MFA1_R4	1881016	S	2248	767	3015	0.00019
Achromobacter_sp._77	2756133	S	616	1609	2225	0.00014
Achromobacter_sp._B7	2282475	S	344	944	1288	0.00008
Achromobacter_sp._ES-001	2860286	S	259	976	1235	0.00008
Achromobacter_spanius	217203	S	4306	2056	6362	0.00041
Achromobacter_denitrificans	32002	S	4034	3321	7355	0.00047
Achromobacter_deleyi	1353891	S	2917	2306	5223	0.00033
Achromobacter_insolitus	217204	S	2000	636	2636	0.00017
Achromobacter_pestifer	1353889	S	1616	1269	2885	0.00018
Achromobacter_mucicolens	1389922	S	841	1347	2188	0.00014
Achromobacter_ruhlandii	72557	S	18	861	879	0.00006
Pigmentiphaga_sp._H8	2488560	S	4897	772	5669	0.00036
Pigmentiphaga_aceris	1940612	S	1332	113	1445	0.00009
Castellaniella_defragrans	75697	S	3085	2554	5639	0.00036
Orrella_dioscoreae	1851544	S	2497	1082	3579	0.00023
Orrella_marina	2163011	S	314	68	382	0.00002
Orrella_sp._f23	2782176	S	184	16	200	0.00001
Alcaligenes_faecalis	511	S	565	480	1045	0.00007
Alcaligenes_sp._SORT26	2813780	S	169	31	200	0.00001
Alcaligenes_sp._DN25	1367435	S	40	82	122	0.00001
Alcaligenes_aquatilis	323284	S	137	484	621	0.00004
Alcaligenes_ammonioxydans	2582914	S	16	162	178	0.00001
Pusillimonas_thiosulfatoxidans	2028345	S	726	220	946	0.00006
Pusillimonas_sp._T7-7	1007105	S	457	86	543	0.00003
Pusillimonas_sp._DMV24BSW_D	2716226	S	211	17	228	0.00001
Paralcaligenes_sp._KSB-10	2901142	S	933	45	978	0.00006
Kerstersia_gyiorum	206506	S	840	216	1056	0.00007
Advenella_mimigardefordensis	302406	S	386	24	410	0.00003
Advenella_kashmirensis	310575	S	340	21	361	0.00002
Oligella_urethralis	90245	S	65	10	75	0.00000
Oligella_ureolytica	90244	S	61	48	109	0.00001
Paenalcaligenes_hominis	643674	S	105	6	111	0.00001
Taylorella_equigenitalis	29575	S	22	3	25	0.00000
Taylorella_asinigenitalis	84590	S	15	2	17	0.00000
Basilea_psittacipulmonis	1472345	S	29	3	32	0.00000
Pelistega_ratti	2652177	S	28	4	32	0.00000
Rhizobacter_sp._AJA081-3	2753607	S	8011	2617	10628	0.00068
Rhizobacter_gummiphilus	946333	S	6934	1748	8682	0.00055
Sphaerotilus_sp._FB-5	2914710	S	4732	3705	8437	0.00054
Sphaerotilus_natans	34103	S	4161	2047	6208	0.00040
Rubrivivax_gelatinosus	28068	S	7426	2944	10370	0.00066
Methylibium_sp._Pch-M	2082386	S	2503	2524	5027	0.00032
Methylibium_petroleiphilum	105560	S	2369	2654	5023	0.00032
Mitsuaria_sp._7	1658665	S	7244	1831	9075	0.00058
Thiomonas_sp._X19	1050370	S	2337	949	3286	0.00021
Thiomonas_intermedia	926	S	1709	282	1991	0.00013
Thiomonas_arsenitoxydans	426114	S	604	1138	1742	0.00011
Aquincola_tertiaricarbonis	391953	S	5813	2570	8383	0.00054
Leptothrix_cholodnii	34029	S	4907	1996	6903	0.00044
Xylophilus_rhododendri	2697032	S	3508	1332	4840	0.00031
Tepidimonas_taiwanensis	307486	S	2980	1371	4351	0.00028
Ideonella_dechloratans	36863	S	2886	2250	5136	0.00033
Aquabacterium_olei	1296669	S	2688	917	3605	0.00023
Roseateles_depolymerans	76731	S	2395	586	2981	0.00019
Inhella_inkyongensis	392593	S	1800	367	2167	0.00014
Paucibacter_sp._KCTC_42545	1768242	S	1228	273	1501	0.00010
Candidatus_Ichthyocystis_hellenicum	1561003	S	43	1	44	0.00000
Sutterella_megalosphaeroides	2494234	S	995	234	1229	0.00008
Sutterella_faecalis	2584944	S	714	138	852	0.00005
Sutterella_wadsworthensis	40545	S	282	46	328	0.00002
Turicimonas_muris	1796652	S	103	10	113	0.00001
Thauera_sp._MZ1T	85643	S	4633	5733	10366	0.00066
Thauera_sp._K11	2005884	S	4038	2916	6954	0.00044
Thauera_humireducens	1134435	S	2841	1951	4792	0.00031
Thauera_chlorobenzoica	96773	S	2183	2300	4483	0.00029
Thauera_aromatica	59405	S	2079	3360	5439	0.00035
Thauera_hydrothermalis	2184083	S	1117	401	1518	0.00010
Azoarcus_sp._KH32C	748247	S	4796	1072	5868	0.00037
Azoarcus_sp._DD4	2027405	S	3329	2622	5951	0.00038
Azoarcus_olearius	418699	S	4012	1815	5827	0.00037
Azoarcus_communis	41977	S	2852	1330	4182	0.00027
Nitrogeniibacter_mangrovi	2016596	S	3264	815	4079	0.00026
Nitrogeniibacter_aestuarii	2815343	S	1318	168	1486	0.00009
Aromatoleum_petrolei	76116	S	4618	1403	6021	0.00038
Aromatoleum_aromaticum	551760	S	3638	2898	6536	0.00042
Aromatoleum_pumilum	2067960	S	3117	1372	4489	0.00029
Aromatoleum_bremense	76115	S	3067	2003	5070	0.00032
Azospira_restricta	404405	S	7874	4949	12823	0.00082
Azospira_inquinata	2785627	S	684	70	754	0.00005
Azospira_sp._I09	1765049	S	459	1514	1973	0.00013
Azospira_oryzae	146939	S	426	1133	1559	0.00010
Niveibacterium_microcysteis	2811415	S	2549	441	2990	0.00019
Oryzomicrobium_terrae	1735038	S	1852	597	2449	0.00016
Rugosibacter_aromaticivorans	1565605	S	523	113	636	0.00004
Dechloromonas_denitrificans	281362	S	2731	755	3486	0.00022
Dechloromonas_sp._HYN0024	2231055	S	822	192	1014	0.00006
Dechloromonas_sp._TW-R-39-2	2654218	S	548	248	796	0.00005
Ferribacterium_limneticum	76259	S	3609	726	4335	0.00028
Quatrionicoccus_australiensis	138118	S	1739	612	2351	0.00015
Fluviibacter_phosphoraccumulans	1751046	S	279	106	385	0.00002
Usitatibacter_rugosus	2732067	S	18212	2527	20739	0.00132
Usitatibacter_palustris	2732487	S	13701	2021	15722	0.00100
Denitratisoma_sp._DHT3	1981880	S	2686	2516	5202	0.00033
Denitratisoma_oestradiolicum	311182	S	1257	261	1518	0.00010
Sulfuritalea_hydrogenivorans	748811	S	3337	647	3984	0.00025
Methyloversatilis_sp._RAC08	1842540	S	2752	469	3221	0.00021
Sterolibacterium_denitrificans	157592	S	2281	798	3079	0.00020
Thiobacillus_denitrificans	36861	S	4425	1070	5495	0.00035
Sulfuritortus_calidifontis	1914471	S	2887	1577	4464	0.00029
Nitrosospira_multiformis	1231	S	2948	115	3063	0.00020
Nitrosospira_lacus	1288494	S	1112	46	1158	0.00007
Nitrosospira_briensis	35799	S	468	376	844	0.00005
Nitrosospira_sp._NRS527	155925	S	406	304	710	0.00005
Nitrosomonas_ureae	44577	S	415	17	432	0.00003
Nitrosomonas_communis	44574	S	263	14	277	0.00002
Nitrosomonas_europaea	915	S	217	49	266	0.00002
Nitrosomonas_eutropha	916	S	166	127	293	0.00002
Nitrosomonas_stercoris	1444684	S	71	54	125	0.00001
Sideroxydans_sp._MIZ01	2764705	S	1494	388	1882	0.00012
Sideroxydans_lithotrophicus	63745	S	1129	214	1343	0.00009
Ferrigenium_kumadai	1682490	S	1910	492	2402	0.00015
Ferriphaselus_amnicola	1188319	S	656	108	764	0.00005
Gallionella_capsiferriformans	370405	S	470	52	522	0.00003
Candidatus_Nitrotoga_arctica	453162	S	209	69	278	0.00002
Candidatus_Nitrotoga_sp._AM1P	2559597	S	156	55	211	0.00001
Sulfuriferula_plumbiphila	171865	S	1322	305	1627	0.00010
Sulfuriferula_sp._AH1	1985873	S	688	179	867	0.00006
Sulfuriferula_nivalis	2675298	S	99	10	109	0.00001
Sulfurimicrobium_lacus	2715678	S	2128	360	2488	0.00016
Sulfuricella_denitrificans	649841	S	979	119	1098	0.00007
Methylovorus_glucosotrophus	266009	S	211	186	397	0.00003
Methylovorus_sp._MP688	887061	S	149	145	294	0.00002
Methylobacillus_flagellatus	405	S	621	191	812	0.00005
Methylophilus_sp._TWE2	1662285	S	401	37	438	0.00003
Methylophilus_medardicus	2588534	S	111	13	124	0.00001
Candidatus_Methylopumilus_rimovensis	2588535	S	62	11	73	0.00000
Candidatus_Methylopumilus_universalis	2588536	S	52	24	76	0.00000
Candidatus_Methylopumilus_turicensis	1581680	S	49	8	57	0.00000
Candidatus_Methylopumilus_planktonicus	1581557	S	35	18	53	0.00000
Methylotenera_mobilis	359408	S	80	10	90	0.00001
Methylotenera_versatilis	1055487	S	54	7	61	0.00000
Methyloradius_palustris	2778876	S	130	13	143	0.00001
Chromobacterium_sp._ATCC_53434	2059672	S	1807	737	2544	0.00016
Chromobacterium_sp._Rain0013	2292447	S	317	416	733	0.00005
Chromobacterium_sp._Beijing	2735795	S	223	668	891	0.00006
Chromobacterium_violaceum	536	S	1734	1166	2900	0.00019
Chromobacterium_vaccinii	1108595	S	1650	823	2473	0.00016
Chromobacterium_phragmitis	2202141	S	1036	525	1561	0.00010
Chromobacterium_paludis	2605945	S	926	426	1352	0.00009
Chromobacterium_rhizoryzae	1778675	S	241	1341	1582	0.00010
Chromobacterium_haemolyticum	394935	S	182	1255	1437	0.00009
Iodobacter_fluviatilis	537	S	111	42	153	0.00001
Iodobacter_ciconiae	2496266	S	108	36	144	0.00001
Jeongeupia_sp._USM3	1906741	S	2998	922	3920	0.00025
Jeongeupia_sp._HS-3	1009682	S	1098	247	1345	0.00009
Paludibacterium_yongneupense	400061	S	1219	203	1422	0.00009
Paludibacterium_paludis	1225769	S	1211	281	1492	0.00010
Paludibacterium_sp._B53371	2806263	S	738	175	913	0.00006
Pseudogulbenkiania_sp._NH8B	748280	S	2324	940	3264	0.00021
Vogesella_sp._LIG4	1192162	S	1398	465	1863	0.00012
Vogesella_sp._XCS3	2877939	S	612	205	817	0.00005
Microvirgula_aerodenitrificans	57480	S	1725	399	2124	0.00014
Aquitalea_aquatilis	1537400	S	481	170	651	0.00004
Aquitalea_magnusonii	332411	S	281	170	451	0.00003
Aquitalea_denitrificans	519081	S	269	147	416	0.00003
Aquitalea_sp._USM4	1590041	S	265	154	419	0.00003
Laribacter_hongkongensis	168471	S	1239	1307	2546	0.00016
Aquaspirillum_sp._LM1	1938604	S	807	145	952	0.00006
Chitinibacter_bivalviorum	2739434	S	178	156	334	0.00002
Chitinibacter_fontanus	1737446	S	142	23	165	0.00001
Deefgea_sp._D25	2865840	S	118	19	137	0.00001
Deefgea_sp._D17	2739061	S	96	35	131	0.00001
Deefgea_sp._D13	2864875	S	67	20	87	0.00001
Neisseria_sp._KEM232	655307	S	285	43	328	0.00002
Neisseria_sp._oral_taxon_014	641148	S	133	59	192	0.00001
Neisseria_sp._ZJ785	2709396	S	85	11	96	0.00001
Neisseria_sp._Dent_CA1/247	2912675	S	75	34	109	0.00001
Neisseria_bacilliformis	267212	S	368	95	463	0.00003
Neisseria_shayeganii	607712	S	285	46	331	0.00002
Neisseria_meningitidis	487	S	250	1508	1758	0.00011
Neisseria_chenwenguii	1853278	S	233	31	264	0.00002
Neisseria_elongata	495	S	231	128	359	0.00002
Neisseria_dentiae	194197	S	225	29	254	0.00002
Neisseria_musculi	1815583	S	162	16	178	0.00001
Neisseria_animalis	492	S	133	22	155	0.00001
Neisseria_gonorrhoeae	485	S	127	156	283	0.00002
Neisseria_animaloris	326522	S	106	24	130	0.00001
Neisseria_sicca	490	S	100	212	312	0.00002
Neisseria_lactamica	486	S	91	111	202	0.00001
Neisseria_weaveri	28091	S	77	32	109	0.00001
Neisseria_dumasiana	1931275	S	75	31	106	0.00001
Neisseria_arctica	1470200	S	74	8	82	0.00001
Neisseria_wadsworthii	607711	S	73	16	89	0.00001
Neisseria_brasiliensis	2666100	S	69	72	141	0.00001
Neisseria_canis	493	S	67	16	83	0.00001
Neisseria_mucosa	488	S	58	130	188	0.00001
Neisseria_weixii	1853276	S	54	6	60	0.00000
Neisseria_zalophi	640030	S	49	5	54	0.00000
Neisseria_zoodegmatis	326523	S	38	24	62	0.00000
Neisseria_macacae	496	S	32	70	102	0.00001
Neisseria_cinerea	483	S	31	19	50	0.00000
Neisseria_flavescens	484	S	24	19	43	0.00000
Neisseria_subflava	28449	S	23	18	41	0.00000
Crenobacter_cavernae	2290923	S	3179	1261	4440	0.00028
Chitinolyticbacter_meiyuanensis	682798	S	1892	286	2178	0.00014
Vitreoscilla_filiformis	63	S	793	187	980	0.00006
Vitreoscilla_massiliensis	1689272	S	106	72	178	0.00001
Kingella_potus	265175	S	229	33	262	0.00002
Kingella_denitrificans	502	S	206	143	349	0.00002
Kingella_oralis	505	S	139	24	163	0.00001
Kingella_kingae	504	S	53	9	62	0.00000
Eikenella_corrodens	539	S	351	243	594	0.00004
Eikenella_exigua	2528037	S	97	74	171	0.00001
Uruburuella_suis	252130	S	294	53	347	0.00002
Uruburuella_testudinis	1282863	S	233	51	284	0.00002
Paralysiella_testudinis	2809020	S	237	61	298	0.00002
Alysiella_crassa	153491	S	66	20	86	0.00001
Alysiella_filiformis	194196	S	41	12	53	0.00000
Conchiformibius_steedae	153493	S	75	13	88	0.00001
Neisseriaceae_bacterium_CCUG_44465	2917790	S	62	11	73	0.00000
Snodgrassella_alvi	1196083	S	57	20	77	0.00000
Aquella_oligotrophica	2067065	S	37	1	38	0.00000
Morococcus_cerebrosus	1056807	S	30	157	187	0.00001
Simonsiella_muelleri	72	S	17	3	20	0.00000
Casimicrobium_huifangae	2591109	S	2198	1268	3466	0.00022
Candidatus_Kinetoplastibacterium_sorsogonicusi	1576550	S	24	7	31	0.00000
Candidatus_Kinetoplastibacterium_crithidii	33056	S	14	0	14	0.00000
Candidatus_Kinetoplastibacterium_blastocrithidii	233181	S	13	0	13	0.00000
Candidatus_Kinetoplastibacterium_oncopeltii	994696	S	10	4	14	0.00000
Candidatus_Profftella_armatura	669502	S	21	10	31	0.00000
Lysobacter_sp._KIS68-7	2904252	S	7249	1525	8774	0.00056
Lysobacter_sp._TY2-98	2290922	S	7224	1246	8470	0.00054
Lysobacter_sp._5GHs7-4	2904253	S	4432	1456	5888	0.00038
Lysobacter_sp._CECT_30171	2822368	S	4367	1141	5508	0.00035
Lysobacter_sp._S4-A87	2925843	S	4167	1470	5637	0.00036
Lysobacter_sp._CW239	2762611	S	3223	1948	5171	0.00033
Lysobacter_sp._K5869	2820808	S	2646	1352	3998	0.00026
Lysobacter_sp._H21R4	2781021	S	841	1702	2543	0.00016
Lysobacter_sp._CJ11	2764185	S	705	63	768	0.00005
Lysobacter_sp._HDW10	2714936	S	471	139	610	0.00004
Lysobacter_sp._H23M47	2781024	S	442	2260	2702	0.00017
Lysobacter_soli	453783	S	21667	4917	26584	0.00170
Lysobacter_enzymogenes	69	S	10881	4262	15143	0.00097
Lysobacter_solisilvae_(ex_Woo_and_Kim_2022)	2865112	S	10456	3357	13813	0.00088
Lysobacter_capsici	435897	S	6717	7395	14112	0.00090
Lysobacter_lycopersici	1324796	S	6220	1456	7676	0.00049
Lysobacter_solisilvae_(ex_Kim_et_al._2021)	2763317	S	5935	1300	7235	0.00046
Lysobacter_maris	1605891	S	4531	1192	5723	0.00037
Lysobacter_antibioticus	84531	S	4077	920	4997	0.00032
Lysobacter_arenosi	2795387	S	3984	1383	5367	0.00034
Lysobacter_oculi	2698682	S	3318	1004	4322	0.00028
Lysobacter_alkalisoli	2591633	S	3302	647	3949	0.00025
Lysobacter_ciconiae	2781022	S	791	1498	2289	0.00015
Lysobacter_gummosus	262324	S	533	4580	5113	0.00033
Lysobacter_avium	2781023	S	466	2185	2651	0.00017
Stenotrophomonas_maltophilia	40324	S	11300	16834	28134	0.00180
Stenotrophomonas_sp._ESTM1D_MKCIP4_1	2072414	S	649	292	941	0.00006
Stenotrophomonas_sp._SAU14A_NAIMI4_5	2072413	S	646	446	1092	0.00007
Stenotrophomonas_sp._ZAC14D2_NAIMI4_7	2072405	S	292	351	643	0.00004
Stenotrophomonas_sp._ZAC14A_NAIMI4_1	2072412	S	232	487	719	0.00005
Stenotrophomonas_sp._YAU14D1_LEIMI4_1	2072407	S	223	431	654	0.00004
Stenotrophomonas_sp._ZAC14D2_NAIMI4_6	2072406	S	188	413	601	0.00004
Stenotrophomonas_sp._SAU14A_NAIMI4_8	2072409	S	80	513	593	0.00004
Stenotrophomonas_sp._YAU14A_MKIMI4_1	2072408	S	53	340	393	0.00003
Stenotrophomonas_sp._LM091	1904944	S	1254	522	1776	0.00011
Stenotrophomonas_sp._169	2770322	S	1227	217	1444	0.00009
Stenotrophomonas_sp._364	2691571	S	835	341	1176	0.00008
Stenotrophomonas_sp._NA06056	2742129	S	455	233	688	0.00004
Stenotrophomonas_sp._WZN-1	2005046	S	224	275	499	0.00003
Stenotrophomonas_sp._DR822	2871174	S	175	302	477	0.00003
Stenotrophomonas_sp._pho	2211160	S	104	522	626	0.00004
Stenotrophomonas_sp._Pemsol	2040586	S	96	309	405	0.00003
Stenotrophomonas_sp._ASS1	2282124	S	81	384	465	0.00003
Stenotrophomonas_sp._MYb57	1827305	S	79	351	430	0.00003
Stenotrophomonas_sp._G4	2303750	S	76	351	427	0.00003
Stenotrophomonas_sp._CW117	2775920	S	72	1733	1805	0.00012
Stenotrophomonas_sp._NY11291	2939415	S	59	688	747	0.00005
Stenotrophomonas_sp._SI-NJAU-1	2886359	S	48	228	276	0.00002
Stenotrophomonas_sp._SXG-1	2682487	S	32	371	403	0.00003
Stenotrophomonas_rhizophila	216778	S	3998	1269	5267	0.00034
Stenotrophomonas_acidaminiphila	128780	S	2568	6430	8998	0.00057
Stenotrophomonas_indicatrix	2045451	S	128	522	650	0.00004
Xanthomonas_translucens	343	S	4237	5807	10044	0.00064
Xanthomonas_campestris	339	S	3198	4305	7503	0.00048
Xanthomonas_sacchari	56458	S	2526	966	3492	0.00022
Xanthomonas_sp._GW	2724121	S	422	658	1080	0.00007
Xanthomonas_sp._SI	2724123	S	361	659	1020	0.00007
Xanthomonas_sp._SS	2724122	S	346	626	972	0.00006
Xanthomonas_sp._MLO165	2081477	S	125	210	335	0.00002
Xanthomonas_arboricola	56448	S	1892	2203	4095	0.00026
Xanthomonas_theicola	56464	S	1695	618	2313	0.00015
Xanthomonas_oryzae	347	S	1406	13725	15131	0.00097
Xanthomonas_citri	346	S	1211	6193	7404	0.00047
Xanthomonas_hyacinthi	56455	S	1099	757	1856	0.00012
Xanthomonas_albilineans	29447	S	1057	180	1237	0.00008
Xanthomonas_vesicatoria	56460	S	936	593	1529	0.00010
Xanthomonas_cucurbitae	56453	S	929	190	1119	0.00007
Xanthomonas_hortorum	56454	S	907	908	1815	0.00012
Xanthomonas_fragariae	48664	S	899	203	1102	0.00007
Xanthomonas_vasicola	56459	S	669	281	950	0.00006
Xanthomonas_cassavae	56450	S	589	171	760	0.00005
Xanthomonas_euroxanthea	2259622	S	530	707	1237	0.00008
Xanthomonas_hydrangeae	2775159	S	494	197	691	0.00004
Xanthomonas_axonopodis	53413	S	419	209	628	0.00004
Xanthomonas_phaseoli	1985254	S	303	812	1115	0.00007
Xanthomonas_euvesicatoria	456327	S	250	1562	1812	0.00012
Xanthomonas_perforans	442694	S	41	254	295	0.00002
Luteimonas_sp._MC1750	2799326	S	3454	1395	4849	0.00031
Luteimonas_sp._S4-F44	2925842	S	3208	687	3895	0.00025
Luteimonas_sp._YGD11-2	2508168	S	3000	1410	4410	0.00028
Luteimonas_sp._JM171	1896164	S	2904	652	3556	0.00023
Luteimonas_sp._MC1572	2799325	S	2736	1463	4199	0.00027
Luteimonas_sp._D4P002	2901869	S	2719	798	3517	0.00022
Luteimonas_sp._MC1825	2761107	S	2607	1433	4040	0.00026
Luteimonas_granuli	1176533	S	3459	1316	4775	0.00030
Luteimonas_yindakuii	2565782	S	2902	1229	4131	0.00026
Luteimonas_chenhongjianii	2006110	S	2431	577	3008	0.00019
Pseudoxanthomonas_suwonensis	314722	S	6367	3576	9943	0.00063
Pseudoxanthomonas_mexicana	128785	S	5056	6246	11302	0.00072
Pseudoxanthomonas_sp._X-1	2571115	S	3120	3201	6321	0.00040
Pseudoxanthomonas_sp._F37	2932492	S	19	1027	1046	0.00007
Pseudoxanthomonas_daejeonensis	266062	S	2337	640	2977	0.00019
Pseudoxanthomonas_spadix	415229	S	1835	755	2590	0.00017
Thermomonas_sp._XSG	2771436	S	2785	1327	4112	0.00026
Thermomonas_sp._HDW16	2714945	S	1838	540	2378	0.00015
Thermomonas_brevis	215691	S	4424	1954	6378	0.00041
Thermomonas_aquatica	2202149	S	3635	2048	5683	0.00036
Thermomonas_carbonis	1463158	S	2563	590	3153	0.00020
Arenimonas_daejeonensis	370777	S	3402	766	4168	0.00027
Pseudolysobacter_antarcticus	2511995	S	2350	70	2420	0.00015
Xylella_fastidiosa	2371	S	285	74	359	0.00002
Xylella_taiwanensis	1444770	S	232	11	243	0.00002
Frateuria_sp._5GH9-34	2898793	S	16937	5109	22046	0.00141
Frateuria_sp._5GH9-11	1542730	S	15472	5929	21401	0.00137
Frateuria_aurantia	81475	S	984	132	1116	0.00007
Rhodanobacter_denitrificans	666685	S	5939	2465	8404	0.00054
Rhodanobacter_sp._FDAARGOS_1247	2778082	S	3866	1350	5216	0.00033
Rhodanobacter_thiooxydans	416169	S	3489	1792	5281	0.00034
Rhodanobacter_glycinis	582702	S	3315	606	3921	0.00025
Luteibacter_sp._321	2911537	S	2969	921	3890	0.00025
Luteibacter_sp._EIF3	2780091	S	2217	358	2575	0.00016
Luteibacter_sp._335	2911538	S	1915	443	2358	0.00015
Luteibacter_sp._353	2911539	S	1734	565	2299	0.00015
Luteibacter_rhizovicinus	242606	S	2304	335	2639	0.00017
Luteibacter_pinisoli	2589080	S	2239	611	2850	0.00018
Luteibacter_anthropi	564369	S	1818	344	2162	0.00014
Dyella_thiooxydans	445710	S	4663	1428	6091	0.00039
Dyella_japonica	231455	S	2429	800	3229	0.00021
Dyella_telluris	2763498	S	2261	660	2921	0.00019
Dyella_terrae	522259	S	1772	274	2046	0.00013
Dyella_caseinilytica	1849581	S	1387	112	1499	0.00010
Dyella_sp._M7H15-1	2501295	S	1011	112	1123	0.00007
Dokdonella_koreensis	323415	S	6034	1129	7163	0.00046
Aerosticca_soli	2010829	S	3887	5805	9692	0.00062
Ahniella_affigens	2021234	S	1509	42	1551	0.00010
Pseudomonas_sp._SK	2729423	S	1247	1300	2547	0.00016
Pseudomonas_sp._ATCC_13867	1294143	S	1127	433	1560	0.00010
Pseudomonas_sp._SCB32	2653853	S	1095	252	1347	0.00009
Pseudomonas_sp._PDNC002	2811422	S	1078	275	1353	0.00009
Pseudomonas_sp._TCU-HL1	1856685	S	1054	164	1218	0.00008
Pseudomonas_sp._KNUC1026	2893890	S	1019	107	1126	0.00007
Pseudomonas_sp._Marseille-Q3773	2866592	S	924	349	1273	0.00008
Pseudomonas_sp._DY-1	1755504	S	906	126	1032	0.00007
Pseudomonas_sp._LPB0260	2614442	S	858	190	1048	0.00007
Pseudomonas_sp._CC6-YY-74	1930532	S	822	107	929	0.00006
Pseudomonas_sp._Ost2	2678260	S	820	136	956	0.00006
Pseudomonas_sp._MM211	2866808	S	672	68	740	0.00005
Pseudomonas_sp._MTM4	2705472	S	668	133	801	0.00005
Pseudomonas_sp._ABC1	2748080	S	663	105	768	0.00005
Pseudomonas_sp._StFLB209	1028989	S	636	181	817	0.00005
Pseudomonas_sp._OIL-1	2706126	S	632	128	760	0.00005
Pseudomonas_sp._7SR1	1881017	S	614	129	743	0.00005
Pseudomonas_sp._p1(2021b)	2874628	S	608	373	981	0.00006
Pseudomonas_sp._Pc102	2678261	S	567	371	938	0.00006
Pseudomonas_sp._L5B5	2883205	S	537	109	646	0.00004
Pseudomonas_sp._CMR5c	658630	S	518	168	686	0.00004
Pseudomonas_sp._HN2-3	2886360	S	517	133	650	0.00004
Pseudomonas_sp._gcc21	2726989	S	466	222	688	0.00004
Pseudomonas_sp._B11D7D	2735906	S	444	97	541	0.00003
Pseudomonas_sp._MSPm1	2726956	S	408	104	512	0.00003
Pseudomonas_sp._MPC6	2498848	S	398	100	498	0.00003
Pseudomonas_sp._URMO17WK12:I11	1283291	S	389	318	707	0.00005
Pseudomonas_sp._LAB-08	143813	S	386	82	468	0.00003
Pseudomonas_sp._Leaf58	1736226	S	375	82	457	0.00003
Pseudomonas_sp._ADAK13	2730847	S	372	102	474	0.00003
Pseudomonas_sp._HLS-6	2049589	S	365	121	486	0.00003
Pseudomonas_sp._ADPe	2774873	S	329	942	1271	0.00008
Pseudomonas_sp._DG56-2	2320270	S	329	40	369	0.00002
Pseudomonas_sp._MM213	2866807	S	326	82	408	0.00003
Pseudomonas_sp._M1	95619	S	304	840	1144	0.00007
Pseudomonas_sp._15A4	2804761	S	304	94	398	0.00003
Pseudomonas_sp._S09G_359	2054919	S	294	83	377	0.00002
Pseudomonas_sp._S35	1573719	S	290	90	380	0.00002
Pseudomonas_sp._NIBR-H-19	2901380	S	286	72	358	0.00002
Pseudomonas_sp._S34	1573718	S	284	77	361	0.00002
Pseudomonas_sp._RtIB026	2749999	S	276	184	460	0.00003
Pseudomonas_sp._2hn	2866626	S	274	212	486	0.00003
Pseudomonas_sp._LS.1a	2920387	S	272	137	409	0.00003
Pseudomonas_sp._31-12	2201356	S	268	79	347	0.00002
Pseudomonas_sp._Tri1	2823875	S	266	77	343	0.00002
Pseudomonas_sp._DTU12.3	2073078	S	262	76	338	0.00002
Pseudomonas_sp._Seg1	2678259	S	256	68	324	0.00002
Pseudomonas_sp._RC3H12	2834406	S	249	175	424	0.00003
Pseudomonas_sp._OE_28.3	2745519	S	246	69	315	0.00002
Pseudomonas_sp._M30-35	1981174	S	234	15	249	0.00002
Pseudomonas_sp._LG1E9	2219057	S	228	78	306	0.00002
Pseudomonas_sp._HS6	2850559	S	221	72	293	0.00002
Pseudomonas_sp._DR48	2871095	S	218	162	380	0.00002
Pseudomonas_sp._ACM7	2052956	S	215	45	260	0.00002
Pseudomonas_sp._HN11	1344094	S	212	57	269	0.00002
Pseudomonas_sp._ADAK18	2730848	S	204	42	246	0.00002
Pseudomonas_sp._R2A2	2213057	S	204	280	484	0.00003
Pseudomonas_sp._NS1(2017)	2025658	S	201	64	265	0.00002
Pseudomonas_sp._DNDY-54	2870860	S	195	119	314	0.00002
Pseudomonas_sp._R5-89-07	658644	S	192	68	260	0.00002
Pseudomonas_sp._PP3	2815936	S	192	86	278	0.00002
Pseudomonas_sp._St316	2678257	S	190	76	266	0.00002
Pseudomonas_sp._MRSN12121	1611770	S	189	327	516	0.00003
Pseudomonas_sp._SCA2728.1_7	2825975	S	189	118	307	0.00002
Pseudomonas_sp._HS-18	2879114	S	182	462	644	0.00004
Pseudomonas_sp._R84	1573712	S	172	91	263	0.00002
Pseudomonas_sp._14181154	2662033	S	170	223	393	0.00003
Pseudomonas_sp._CCOS_191	1649877	S	170	165	335	0.00002
Pseudomonas_sp._SK3(2021)	2841064	S	169	136	305	0.00002
Pseudomonas_sp._SDM007	2812000	S	163	115	278	0.00002
Pseudomonas_sp._LPH1	1898684	S	159	181	340	0.00002
Pseudomonas_sp._NIBRBAC000502773	2590776	S	158	99	257	0.00002
Pseudomonas_sp._FIT81	2837969	S	157	114	271	0.00002
Pseudomonas_sp._CYM-20-01	2870750	S	155	94	249	0.00002
Pseudomonas_sp._IzPS59	2774459	S	149	86	235	0.00002
Pseudomonas_sp._Z003-0.4C(8344-21)	1855380	S	144	128	272	0.00002
Pseudomonas_sp._FGI182	1259844	S	143	196	339	0.00002
Pseudomonas_sp._RBPA9	2746321	S	133	356	489	0.00003
Pseudomonas_sp._AO-1	2855434	S	133	144	277	0.00002
Pseudomonas_sp._LTJR-52	2479392	S	133	55	188	0.00001
Pseudomonas_sp._R76	1573711	S	131	79	210	0.00001
Pseudomonas_sp._BIGb0427	2724470	S	124	297	421	0.00003
Pseudomonas_sp._B10	118613	S	122	111	233	0.00001
Pseudomonas_sp._UW4	1207075	S	117	95	212	0.00001
Pseudomonas_sp._HN2	2884805	S	109	121	230	0.00001
Pseudomonas_sp._Cab53	2678258	S	107	215	322	0.00002
Pseudomonas_sp._SORT22	2813842	S	106	270	376	0.00002
Pseudomonas_sp._THAF7b	2587845	S	105	247	352	0.00002
Pseudomonas_sp._02C_26	2054914	S	103	240	343	0.00002
Pseudomonas_sp._S07E_245	2866278	S	102	251	353	0.00002
Pseudomonas_sp._MPFS	2795724	S	89	182	271	0.00002
Pseudomonas_sp._C27(2019)	2604941	S	88	14	102	0.00001
Pseudomonas_sp._phDV1	253237	S	86	354	440	0.00003
Pseudomonas_sp._3-2	2867408	S	86	132	218	0.00001
Pseudomonas_sp._09C_129	2054915	S	79	123	202	0.00001
Pseudomonas_sp._SC3(2021)	2871493	S	77	104	181	0.00001
Pseudomonas_sp._LBUM920	2126069	S	76	203	279	0.00002
Pseudomonas_sp._BIOMIG1BAC	1758730	S	74	281	355	0.00002
Pseudomonas_sp._PONIH3	1636610	S	73	481	554	0.00004
Pseudomonas_sp._Y5-11	2749808	S	73	247	320	0.00002
Pseudomonas_sp._RU47	2005388	S	73	203	276	0.00002
Pseudomonas_sp._FDAARGOS_380	2018067	S	71	71	142	0.00001
Pseudomonas_sp._AN-B15	2697023	S	68	209	277	0.00002
Pseudomonas_sp._DR_5-09	1534110	S	67	108	175	0.00001
Pseudomonas_sp._MYb193	1827300	S	65	80	145	0.00001
Pseudomonas_sp._ADAK22	2730851	S	64	172	236	0.00002
Pseudomonas_sp._GR_6-02	1659194	S	63	173	236	0.00002
Pseudomonas_sp._S150	2559074	S	62	122	184	0.00001
Pseudomonas_sp._ArH3a	2862945	S	60	162	222	0.00001
Pseudomonas_sp._LG1D9	2083054	S	58	229	287	0.00002
Pseudomonas_sp._ATCC_43928	676210	S	57	158	215	0.00001
Pseudomonas_sp._S49	1573720	S	57	160	217	0.00001
Pseudomonas_sp._St29	1500687	S	54	238	292	0.00002
Pseudomonas_sp._SXM-1	2169583	S	52	183	235	0.00002
Pseudomonas_sp._BC42	2933816	S	48	257	305	0.00002
Pseudomonas_sp._BYT-1	2816906	S	47	475	522	0.00003
Pseudomonas_sp._J380	2605424	S	46	68	114	0.00001
Pseudomonas_sp._A2	107445	S	42	270	312	0.00002
Pseudomonas_sp._SWI44	2083053	S	41	358	399	0.00003
Pseudomonas_sp._DTU12.1	2654238	S	40	168	208	0.00001
Pseudomonas_sp._Y39-6	2749807	S	39	158	197	0.00001
Pseudomonas_sp._7-41	2898483	S	38	211	249	0.00002
Pseudomonas_sp._B14-6	2738843	S	38	129	167	0.00001
Pseudomonas_sp._CFSAN084952	2664899	S	38	143	181	0.00001
Pseudomonas_sp._IAC-BECa141	2793103	S	37	96	133	0.00001
Pseudomonas_sp._DR208	2870840	S	36	109	145	0.00001
Pseudomonas_sp._R3-18-08	1173283	S	34	105	139	0.00001
Pseudomonas_sp._R1-43-08	1173270	S	33	205	238	0.00002
Pseudomonas_sp._Os17	1500686	S	33	176	209	0.00001
Pseudomonas_sp._SWI36	2083052	S	33	111	144	0.00001
Pseudomonas_sp._HN8-3	2886361	S	32	80	112	0.00001
Pseudomonas_sp._TMW_2.1634	1886807	S	31	101	132	0.00001
Pseudomonas_sp._CIP-10	2892442	S	30	325	355	0.00002
Pseudomonas_sp._MPDS	2762896	S	29	136	165	0.00001
Pseudomonas_sp._Colony2	2861799	S	29	140	169	0.00001
Pseudomonas_sp._TKP	1415630	S	28	122	150	0.00001
Pseudomonas_sp._R2-60-08W	1173280	S	27	197	224	0.00001
Pseudomonas_sp._XWY-1	2069256	S	25	166	191	0.00001
Pseudomonas_sp._A214	1855331	S	25	88	113	0.00001
Pseudomonas_sp._R32	1573704	S	25	81	106	0.00001
Pseudomonas_sp._NC02	2067572	S	25	94	119	0.00001
Pseudomonas_sp._BJP69	2597770	S	24	170	194	0.00001
Pseudomonas_sp._PS1(2021)	2866282	S	24	850	874	0.00006
Pseudomonas_sp._R2-37-08W	1173273	S	24	119	143	0.00001
Pseudomonas_sp._LH1G9	2083055	S	24	104	128	0.00001
Pseudomonas_sp._R4-34-07	658642	S	23	139	162	0.00001
Pseudomonas_sp._IB20	1702250	S	23	143	166	0.00001
Pseudomonas_sp._R3-52-08	1173284	S	23	146	169	0.00001
Pseudomonas_sp._R4-39-08	1173288	S	21	129	150	0.00001
Pseudomonas_sp._So3.2b	2864101	S	21	86	107	0.00001
Pseudomonas_sp._SW-3	147212	S	20	94	114	0.00001
Pseudomonas_sp._CFA	2651048	S	19	105	124	0.00001
Pseudomonas_sp._R2-7-07	658641	S	17	167	184	0.00001
Pseudomonas_sp._OST1909	2777367	S	17	66	83	0.00001
Pseudomonas_sp._SK2	2841063	S	16	300	316	0.00002
Pseudomonas_sp._VLB120	69328	S	16	234	250	0.00002
Pseudomonas_sp._I3-I5	2926671	S	15	72	87	0.00001
Pseudomonas_sp._R4-35-07	658643	S	15	106	121	0.00001
Pseudomonas_sp._Eqa60	2799184	S	15	109	124	0.00001
Pseudomonas_sp._R11-23-07	658632	S	15	140	155	0.00001
Pseudomonas_sp._JY-Q	1338689	S	15	147	162	0.00001
Pseudomonas_sp._KUIN-1	2609418	S	14	105	119	0.00001
Pseudomonas_sp._13159349	2662034	S	13	154	167	0.00001
Pseudomonas_sp._St386	2678256	S	13	137	150	0.00001
Pseudomonas_sp._St290	1602166	S	13	64	77	0.00000
Pseudomonas_sp._SWI7	2587597	S	12	92	104	0.00001
Pseudomonas_sp._SWI6	2083051	S	11	190	201	0.00001
Pseudomonas_sp._bs2935	1761895	S	10	386	396	0.00003
Pseudomonas_aeruginosa	287	S	6027	49944	55971	0.00357
Pseudomonas_mendocina	300	S	4574	2111	6685	0.00043
Pseudomonas_furukawaii	1149133	S	3152	1034	4186	0.00027
Pseudomonas_oleovorans	301	S	264	996	1260	0.00008
Pseudomonas_alcaligenes	43263	S	2393	1738	4131	0.00026
Pseudomonas_resinovorans	53412	S	1342	321	1663	0.00011
Pseudomonas_multiresinivorans	95301	S	723	264	987	0.00006
Pseudomonas_nitroreducens	46680	S	184	447	631	0.00004
Pseudomonas_citronellolis	53408	S	736	1255	1991	0.00013
Pseudomonas_fluorescens	294	S	5807	5713	11520	0.00074
Pseudomonas_protegens	380021	S	1313	7257	8570	0.00055
Pseudomonas_orientalis	76758	S	978	294	1272	0.00008
Pseudomonas_azotoformans	47878	S	769	344	1113	0.00007
Pseudomonas_synxantha	47883	S	683	508	1191	0.00008
Pseudomonas_rhodesiae	76760	S	571	247	818	0.00005
Pseudomonas_poae	200451	S	518	293	811	0.00005
Pseudomonas_trivialis	200450	S	490	191	681	0.00004
Pseudomonas_tolaasii	29442	S	417	87	504	0.00003
Pseudomonas_mediterranea	183795	S	416	113	529	0.00003
Pseudomonas_corrugata	47879	S	415	95	510	0.00003
Pseudomonas_mucidolens	46679	S	325	51	376	0.00002
Pseudomonas_cedrina	651740	S	312	88	400	0.00003
Pseudomonas_migulae	78543	S	304	174	478	0.00003
Pseudomonas_congelans	200452	S	249	87	336	0.00002
Pseudomonas_brenneri	129817	S	218	88	306	0.00002
Pseudomonas_libanensis	75588	S	169	202	371	0.00002
Pseudomonas_mandelii	75612	S	153	503	656	0.00004
Pseudomonas_veronii	76761	S	142	442	584	0.00004
Pseudomonas_ogarae	1114970	S	113	97	210	0.00001
Pseudomonas_extremorientalis	169669	S	29	82	111	0.00001
Pseudomonas_putida	303	S	7758	11552	19310	0.00123
Pseudomonas_oryzihabitans	47885	S	2274	557	2831	0.00018
Pseudomonas_fulva	47880	S	1535	4557	6092	0.00039
Pseudomonas_plecoglossicida	70775	S	469	425	894	0.00006
Pseudomonas_monteilii	76759	S	276	483	759	0.00005
Pseudomonas_mosselii	78327	S	268	553	821	0.00005
Pseudomonas_sp._SGAir0191	2217867	S	140	104	244	0.00002
Pseudomonas_stutzeri	316	S	9550	6844	16394	0.00105
Pseudomonas_chloritidismutans	203192	S	117	180	297	0.00002
Pseudomonas_balearica	74829	S	1749	2467	4216	0.00027
Pseudomonas_xanthomarina	271420	S	544	98	642	0.00004
Pseudomonas_luteola	47886	S	130	69	199	0.00001
Pseudomonas_syringae	317	S	1857	2673	4530	0.00029
Pseudomonas_viridiflava	33069	S	1214	159	1373	0.00009
Pseudomonas_cichorii	36746	S	622	61	683	0.00004
Pseudomonas_asturiensis	1190415	S	370	42	412	0.00003
Pseudomonas_amygdali	47877	S	167	835	1002	0.00006
Pseudomonas_savastanoi	29438	S	52	213	265	0.00002
Pseudomonas_syringae_group_genomosp._7	251699	S	328	33	361	0.00002
Pseudomonas_avellanae	46257	S	226	356	582	0.00004
Pseudomonas_fuscovaginae	50340	S	204	140	344	0.00002
Pseudomonas_coronafaciens	53409	S	63	195	258	0.00002
Pseudomonas_syringae_group_genomosp._3	251701	S	47	635	682	0.00004
Pseudomonas_sp._Lz4W	1206777	S	30	64	94	0.00001
Pseudomonas_tremae	200454	S	20	48	68	0.00000
Pseudomonas_chlororaphis	587753	S	3396	3956	7352	0.00047
Pseudomonas_lundensis	86185	S	422	58	480	0.00003
Pseudomonas_fragi	296	S	266	250	516	0.00003
Pseudomonas_oryzae	1392877	S	4048	1428	5476	0.00035
Pseudomonas_otitidis	319939	S	2542	638	3180	0.00020
Pseudomonas_knackmussii	65741	S	2441	2436	4877	0.00031
Pseudomonas_psychrotolerans	237610	S	2198	551	2749	0.00018
Pseudomonas_entomophila	312306	S	1700	843	2543	0.00016
Pseudomonas_guangdongensis	1245526	S	1546	553	2099	0.00013
Pseudomonas_cavernae	2320867	S	1438	253	1691	0.00011
Pseudomonas_lalkuanensis	2604832	S	1276	265	1541	0.00010
Pseudomonas_parafulva	157782	S	925	300	1225	0.00008
Pseudomonas_nanhaiensis	2830842	S	858	100	958	0.00006
Pseudomonas_qingdaonensis	2056231	S	851	195	1046	0.00007
Pseudomonas_eucalypticola	2599595	S	794	112	906	0.00006
Pseudomonas_vanderleydeniana	2745495	S	788	123	911	0.00006
Pseudomonas_campi	2731681	S	767	119	886	0.00006
Pseudomonas_rhizosphaerae	216142	S	647	87	734	0.00005
Pseudomonas_frederiksbergensis	104087	S	636	216	852	0.00005
Pseudomonas_brassicacearum	930166	S	614	1350	1964	0.00013
Pseudomonas_zhaodongensis	1176257	S	604	312	916	0.00006
Pseudomonas_anuradhapurensis	485870	S	592	608	1200	0.00008
Pseudomonas_muyukensis	2842357	S	592	197	789	0.00005
Pseudomonas_argentinensis	289370	S	590	153	743	0.00005
Pseudomonas_tohonis	2725477	S	577	527	1104	0.00007
Pseudomonas_alkylphenolica	237609	S	570	126	696	0.00004
Pseudomonas_cremoricolorata	157783	S	569	95	664	0.00004
Pseudomonas_saudiphocaensis	1499686	S	545	125	670	0.00004
Pseudomonas_pohangensis	364197	S	529	43	572	0.00004
Pseudomonas_yamanorum	515393	S	522	132	654	0.00004
Pseudomonas_umsongensis	198618	S	516	92	608	0.00004
Pseudomonas_koreensis	198620	S	505	226	731	0.00005
Pseudomonas_alvandae	2842348	S	501	89	590	0.00004
Pseudomonas_phragmitis	1931241	S	489	42	531	0.00003
Pseudomonas_palleroniana	191390	S	474	86	560	0.00004
Pseudomonas_vancouverensis	95300	S	448	79	527	0.00003
Pseudomonas_fakonensis	2842355	S	447	159	606	0.00004
Pseudomonas_xantholysinigenes	2745490	S	445	137	582	0.00004
Pseudomonas_xanthosomae	2842356	S	427	155	582	0.00004
Pseudomonas_prosekii	1148509	S	415	76	491	0.00003
Pseudomonas_tructae	2518644	S	406	79	485	0.00003
Pseudomonas_granadensis	1421430	S	369	202	571	0.00004
Pseudomonas_hamedanensis	2745504	S	359	74	433	0.00003
Pseudomonas_promysalinigenes	485898	S	345	58	403	0.00003
Pseudomonas_extremaustralis	359110	S	342	85	427	0.00003
Pseudomonas_marincola	437900	S	342	58	400	0.00003
Pseudomonas_thivervalensis	86265	S	337	83	420	0.00003
Pseudomonas_agarici	46677	S	337	18	355	0.00002
Pseudomonas_sediminis	1691904	S	336	108	444	0.00003
Pseudomonas_wenzhouensis	2906062	S	335	144	479	0.00003
Pseudomonas_antarctica	219572	S	334	95	429	0.00003
Pseudomonas_graminis	158627	S	329	104	433	0.00003
Pseudomonas_arsenicoxydans	702115	S	329	81	410	0.00003
Pseudomonas_silesiensis	1853130	S	327	78	405	0.00003
Pseudomonas_lurida	244566	S	302	78	380	0.00002
Pseudomonas_maumuensis	2842354	S	274	150	424	0.00003
Pseudomonas_versuta	1788301	S	259	45	304	0.00002
Pseudomonas_asgharzadehiana	2842349	S	256	67	323	0.00002
Pseudomonas_taetrolens	47884	S	246	34	280	0.00002
Pseudomonas_lini	163011	S	244	54	298	0.00002
Pseudomonas_simiae	321846	S	242	68	310	0.00002
Pseudomonas_viciae	2505979	S	233	64	297	0.00002
Pseudomonas_reinekei	395598	S	233	75	308	0.00002
Pseudomonas_kribbensis	1628086	S	201	223	424	0.00003
Pseudomonas_allokribbensis	2774460	S	189	84	273	0.00002
Pseudomonas_psychrophila	122355	S	188	28	216	0.00001
Pseudomonas_chengduensis	489632	S	180	409	589	0.00004
Pseudomonas_alcaliphila	101564	S	170	211	381	0.00002
Pseudomonas_asplenii	53407	S	168	120	288	0.00002
Pseudomonas_moraviensis	321662	S	166	339	505	0.00003
Pseudomonas_sihuiensis	1274359	S	164	249	413	0.00003
Pseudomonas_gozinkensis	2774461	S	159	85	244	0.00002
Pseudomonas_zeae	2745510	S	158	92	250	0.00002
Pseudomonas_kunmingensis	1211807	S	156	264	420	0.00003
Pseudomonas_toyotomiensis	554344	S	156	166	322	0.00002
Pseudomonas_tritici	2745518	S	155	56	211	0.00001
Pseudomonas_atacamensis	2565368	S	153	174	327	0.00002
Pseudomonas_khazarica	2502979	S	151	215	366	0.00002
Pseudomonas_oryziphila	2894079	S	149	136	285	0.00002
Pseudomonas_germanica	2815720	S	121	76	197	0.00001
Pseudomonas_azerbaijanoriens	2842350	S	110	84	194	0.00001
Pseudomonas_iranensis	2745503	S	110	97	207	0.00001
Pseudomonas_tensinigenes	2745511	S	103	64	167	0.00001
Pseudomonas_zarinae	2745498	S	91	79	170	0.00001
Pseudomonas_lactis	1615674	S	78	66	144	0.00001
Pseudomonas_salmasensis	2745514	S	77	57	134	0.00001
Pseudomonas_juntendi	2666183	S	68	687	755	0.00005
Pseudomonas_soli	1306993	S	64	277	341	0.00002
Pseudomonas_monsensis	2745509	S	62	77	139	0.00001
Pseudomonas_bijieensis	2681983	S	49	216	265	0.00002
Pseudomonas_asiatica	2219225	S	47	305	352	0.00002
Pseudomonas_rhizophila	2045200	S	43	133	176	0.00001
Pseudomonas_sessilinigenes	658629	S	40	120	160	0.00001
Pseudomonas_glycinae	1785145	S	39	80	119	0.00001
Pseudomonas_donghuensis	1163398	S	30	97	127	0.00001
Pseudomonas_taiwanensis	470150	S	17	244	261	0.00002
Candidatus_Pseudomonas_adelgestsugas	1302376	S	17	0	17	0.00000
Pseudomonas_cerasi	1583341	S	15	36	51	0.00000
Pseudomonas_shahriarae	2745512	S	15	68	83	0.00001
Azotobacter_chroococcum	353	S	1861	852	2713	0.00017
Azotobacter_vinelandii	354	S	1293	4987	6280	0.00040
Azotobacter_salinestris	69964	S	1089	369	1458	0.00009
Halopseudomonas_xinjiangensis	487184	S	659	65	724	0.00005
Halopseudomonas_sp._RR6	2918528	S	506	73	579	0.00004
Halopseudomonas_sabulinigri	472181	S	497	45	542	0.00003
Halopseudomonas_aestusnigri	857252	S	458	331	789	0.00005
Halopseudomonas_litoralis	797277	S	386	96	482	0.00003
Halopseudomonas_salegens	1434072	S	296	23	319	0.00002
Permianibacter_aggregans	1510150	S	581	19	600	0.00004
Thiopseudomonas_alkaliphila	1697053	S	60	13	73	0.00000
Entomomonas_sp._F2A	2785331	S	34	5	39	0.00000
Entomomonas_moraniae	2213226	S	20	3	23	0.00000
Marinobacter_sp._CA1	2817656	S	624	53	677	0.00004
Marinobacter_sp._NP-4(2019)	2488665	S	362	78	440	0.00003
Marinobacter_sp._Arc7-DN-1	2304594	S	354	56	410	0.00003
Marinobacter_sp._LPB0319	2769486	S	354	25	379	0.00002
Marinobacter_sp._LV10R510-11A	1415568	S	178	9	187	0.00001
Marinobacter_sp._LQ44	1749259	S	173	295	468	0.00003
Marinobacter_sp._JH2	2547598	S	164	52	216	0.00001
Marinobacter_sp._es.042	1761794	S	128	148	276	0.00002
Marinobacter_sp._BSs20148	490759	S	121	91	212	0.00001
Marinobacter_sp._CP1	1671721	S	103	235	338	0.00002
Marinobacter_fonticola	2603215	S	526	30	556	0.00004
Marinobacter_salarius	1420917	S	397	61	458	0.00003
Marinobacter_nauticus	2743	S	378	137	515	0.00003
Marinobacter_similis	1420916	S	326	33	359	0.00002
Marinobacter_salsuginis	418719	S	318	55	373	0.00002
Marinobacter_salinus	1874317	S	279	21	300	0.00002
Marinobacter_adhaerens	1033846	S	90	222	312	0.00002
Marinobacter_psychrophilus	330734	S	82	62	144	0.00001
Klebsiella_pneumoniae	573	S	969	45360	46329	0.00296
Klebsiella_quasipneumoniae	1463165	S	652	2228	2880	0.00018
Klebsiella_aerogenes	548	S	390	243	633	0.00004
Klebsiella_sp._A52	2834819	S	16	19	35	0.00000
Klebsiella_sp._CTHL.F3a	2873296	S	10	335	345	0.00002
Klebsiella_oxytoca	571	S	352	260	612	0.00004
Klebsiella_michiganensis	1134687	S	257	1048	1305	0.00008
Klebsiella_variicola	244366	S	206	820	1026	0.00007
Klebsiella_africana	2489010	S	107	71	178	0.00001
Klebsiella_huaxiensis	2153354	S	106	109	215	0.00001
Klebsiella_quasivariicola	2026240	S	86	102	188	0.00001
Klebsiella_grimontii	2058152	S	55	408	463	0.00003
Raoultella_sp._HC6	2923366	S	208	164	372	0.00002
Raoultella_planticola	575	S	174	203	377	0.00002
Raoultella_terrigena	577	S	130	314	444	0.00003
Raoultella_ornithinolytica	54291	S	99	877	976	0.00006
Raoultella_electrica	1259973	S	47	140	187	0.00001
Enterobacter_cloacae	550	S	1316	2910	4226	0.00027
Enterobacter_hormaechei	158836	S	320	5115	5435	0.00035
Enterobacter_cancerogenus	69218	S	307	117	424	0.00003
Enterobacter_asburiae	61645	S	259	1602	1861	0.00012
Enterobacter_roggenkampii	1812935	S	183	829	1012	0.00006
Enterobacter_ludwigii	299767	S	139	365	504	0.00003
Enterobacter_chengduensis	2494701	S	120	92	212	0.00001
Enterobacter_chuandaensis	2497875	S	109	79	188	0.00001
Enterobacter_cloacae_complex_sp.	2027919	S	22	626	648	0.00004
Enterobacter_sp._BIDMC_29	1329841	S	16	61	77	0.00000
Enterobacter_kobei	208224	S	66	831	897	0.00006
Enterobacter_sichuanensis	2071710	S	52	52	104	0.00001
Enterobacter_sp._SA187	1914861	S	236	48	284	0.00002
Enterobacter_sp._JUb54	2724468	S	231	53	284	0.00002
Enterobacter_sp._E76	2596949	S	103	233	336	0.00002
Enterobacter_sp._RHBSTW-00994	2742676	S	92	26	118	0.00001
Enterobacter_sp._JBIWA008	2831892	S	77	55	132	0.00001
Enterobacter_sp._RHBSTW-00175	2742639	S	65	70	135	0.00001
Enterobacter_sp._SGAir0187	2836161	S	52	68	120	0.00001
Enterobacter_sp._Colony194	2866201	S	48	70	118	0.00001
Enterobacter_sp._SES19	2705458	S	28	30	58	0.00000
Enterobacter_sp._JBIWA003	2831890	S	25	36	61	0.00000
Enterobacter_sp._N18-03635	2500132	S	15	43	58	0.00000
Enterobacter_sp._E20	1560339	S	13	128	141	0.00001
Enterobacter_sp._JBIWA005	2831891	S	11	23	34	0.00000
Enterobacter_huaxiensis	2494702	S	170	57	227	0.00001
Enterobacter_mori	539813	S	107	153	260	0.00002
Enterobacter_oligotrophicus	2478464	S	88	30	118	0.00001
Enterobacter_bugandensis	881260	S	79	158	237	0.00002
Enterobacter_soli	885040	S	68	20	88	0.00001
Citrobacter_freundii	546	S	227	1261	1488	0.00010
Citrobacter_werkmanii	67827	S	55	169	224	0.00001
Citrobacter_freundii_complex_sp._CFNIH2	2066049	S	35	52	87	0.00001
Citrobacter_portucalensis	1639133	S	42	536	578	0.00004
Citrobacter_sedlakii	67826	S	34	124	158	0.00001
Citrobacter_braakii	57706	S	27	288	315	0.00002
Citrobacter_youngae	133448	S	10	42	52	0.00000
Citrobacter_sp._RHB25-C09	2742624	S	134	44	178	0.00001
Citrobacter_sp._R56	1573676	S	129	45	174	0.00001
Citrobacter_sp._BDA59-3	2781952	S	26	13	39	0.00000
Citrobacter_sp._MGH_55	1439319	S	11	65	76	0.00000
Citrobacter_rodentium	67825	S	255	0	255	0.00002
Citrobacter_farmeri	67824	S	125	72	197	0.00001
Citrobacter_amalonaticus	35703	S	116	742	858	0.00005
Citrobacter_koseri	545	S	109	192	301	0.00002
Citrobacter_tructae	2562449	S	72	38	110	0.00001
Citrobacter_pasteurii	1563222	S	45	49	94	0.00001
Citrobacter_arsenatis	2546350	S	30	13	43	0.00000
Citrobacter_cronae	1748967	S	12	128	140	0.00001
Cronobacter_sakazakii	28141	S	372	321	693	0.00004
Cronobacter_dublinensis	413497	S	339	140	479	0.00003
Cronobacter_condimenti	1163710	S	208	67	275	0.00002
Cronobacter_universalis	535744	S	192	158	350	0.00002
Cronobacter_malonaticus	413503	S	134	155	289	0.00002
Cronobacter_sp._JZ38	1906275	S	44	149	193	0.00001
Cronobacter_muytjensii	413501	S	33	145	178	0.00001
Kosakonia_cowanii	208223	S	326	267	593	0.00004
Kosakonia_sp._SMBL-WEM22	2725560	S	126	57	183	0.00001
Kosakonia_sp._CCTCC_M2018092	2492396	S	103	98	201	0.00001
Kosakonia_sp._MUSA4	2067958	S	66	33	99	0.00001
Kosakonia_sacchari	1158459	S	247	121	368	0.00002
Kosakonia_radicincitans	283686	S	109	80	189	0.00001
Kosakonia_pseudosacchari	1646340	S	88	48	136	0.00001
Kosakonia_arachidis	551989	S	82	23	105	0.00001
Kosakonia_oryzae	497725	S	76	54	130	0.00001
Leclercia_adecarboxylata	83655	S	476	996	1472	0.00009
Leclercia_sp._29361	2714951	S	144	65	209	0.00001
Leclercia_sp._W17	2282309	S	43	133	176	0.00001
Leclercia_sp._J807	2681307	S	26	43	69	0.00000
Leclercia_sp._119287	2681308	S	25	88	113	0.00001
Leclercia_sp._G3L	2898725	S	20	114	134	0.00001
Leclercia_sp._W6	2282310	S	19	39	58	0.00000
Leclercia_pneumoniae	2815358	S	145	73	218	0.00001
Salmonella_enterica	28901	S	1002	49855	50857	0.00325
Salmonella_bongori	54736	S	105	78	183	0.00001
Pluralibacter_gergoviae	61647	S	872	252	1124	0.00007
[Enterobacter]_lignolyticus	1334193	S	447	125	572	0.00004
Escherichia_coli	562	S	735	18257	18992	0.00121
Escherichia_albertii	208962	S	109	98	207	0.00001
Escherichia_marmotae	1499973	S	59	35	94	0.00001
Escherichia_fergusonii	564	S	57	94	151	0.00001
Escherichia_sp._E4742	2044467	S	35	24	59	0.00000
Cedecea_neteri	158822	S	582	145	727	0.00005
Cedecea_lapagei	158823	S	186	60	246	0.00002
Cedecea_sp._FDAARGOS_727	2545798	S	138	33	171	0.00001
Lelliottia_amnigena	61646	S	399	122	521	0.00003
Lelliottia_sp._AC1	2067959	S	54	82	136	0.00001
Lelliottia_sp._WB101	2153385	S	39	67	106	0.00001
Kluyvera_ascorbata	51288	S	154	118	272	0.00002
Kluyvera_intermedia	61648	S	116	93	209	0.00001
Kluyvera_sp._CRP	2873269	S	43	107	150	0.00001
Kluyvera_genomosp._3	2774055	S	22	49	71	0.00000
Candidatus_Symbiopectobacterium_sp._SyEd1	2871826	S	174	23	197	0.00001
Candidatus_Hamiltonella_defensa	138072	S	55	4	59	0.00000
secondary_endosymbiont_of_Ctenarytaina_eucalypti	1199245	S	25	1	26	0.00000
secondary_endosymbiont_of_Heteropsylla_cubana	134287	S	11	0	11	0.00000
Blochmannia_endosymbiont_of_Colobopsis_nipponica	2681987	S	12	1	13	0.00000
Blochmannia_endosymbiont_of_Camponotus_sp.	700220	S	11	11	22	0.00000
Blochmannia_endosymbiont_of_Polyrhachis_(Hedomyrma)_turneri	1505596	S	11	0	11	0.00000
Candidatus_Doolittlea_endobia	1778262	S	29	2	31	0.00000
Candidatus_Gullanella_endobia	1070130	S	18	1	19	0.00000
Candidatus_Hoaglandella_endobia	1778263	S	14	1	15	0.00000
Pseudescherichia_vulneris	566	S	290	19	309	0.00002
Jejubacter_calystegiae	2579935	S	246	30	276	0.00002
Scandinavium_goeteborgense	1851514	S	225	46	271	0.00002
Buttiauxella_agrestis	82977	S	86	17	103	0.00001
Buttiauxella_sp._3AFRM03	2479367	S	27	56	83	0.00001
Buttiauxella_ferragutiae	82989	S	20	45	65	0.00000
Plesiomonas_shigelloides	703	S	217	76	293	0.00002
Atlantibacter_hermannii	565	S	216	50	266	0.00002
Shimwellia_blattae	563	S	188	1428	1616	0.00010
Yokenella_regensburgei	158877	S	178	82	260	0.00002
Pseudocitrobacter_sp._G163CM	2891570	S	175	48	223	0.00001
Phytobacter_ursingii	1972431	S	139	201	340	0.00002
Enterobacteriaceae_endosymbiont_of_Donacia_tomentosa	2675787	S	12	24	36	0.00000
Shigella_flexneri	623	S	19	2371	2390	0.00015
Shigella_boydii	621	S	14	259	273	0.00002
Candidatus_Profftia_lariciata	1987921	S	19	1	20	0.00000
Candidatus_Profftia_tarda	1177216	S	12	0	12	0.00000
Candidatus_Ishikawaella_capsulata	168169	S	27	2	29	0.00000
Candidatus_Moranella_endobia	1048758	S	18	0	18	0.00000
Candidatus_Schneideria_nysicola	1081631	S	11	0	11	0.00000
Serratia_marcescens	615	S	1577	3414	4991	0.00032
Serratia_sp._FDAARGOS_506	2420306	S	136	138	274	0.00002
Serratia_sp._ATCC_39006	104623	S	100	12	112	0.00001
Serratia_sp._FGI94	671990	S	98	109	207	0.00001
Serratia_sp._1D1416	2447890	S	49	166	215	0.00001
Serratia_sp._3ACOL1	2448483	S	28	41	69	0.00000
Serratia_sp._MYb239	2033438	S	23	203	226	0.00001
Serratia_sp._FS14	1327989	S	21	105	126	0.00001
Serratia_sp._SCBI	488142	S	18	160	178	0.00001
Serratia_sp._P2ACOL2	2482769	S	18	56	74	0.00000
Serratia_sp._Tan611	2773264	S	11	75	86	0.00001
Serratia_plymuthica	82996	S	557	321	878	0.00006
Serratia_rubidaea	61652	S	410	478	888	0.00006
Serratia_entomophila	42906	S	394	107	501	0.00003
Serratia_odorifera	618	S	252	47	299	0.00002
Serratia_proteamaculans	28151	S	243	58	301	0.00002
Serratia_surfactantfaciens	2741499	S	199	118	317	0.00002
Serratia_fonticola	47917	S	159	142	301	0.00002
Serratia_liquefaciens	614	S	145	228	373	0.00002
Serratia_quinivorans	137545	S	109	43	152	0.00001
Serratia_ureilytica	300181	S	100	1319	1419	0.00009
Serratia_inhibens	2338073	S	89	50	139	0.00001
Serratia_symbiotica	138074	S	87	15	102	0.00001
Serratia_rhizosphaerae	2597702	S	85	81	166	0.00001
Serratia_grimesii	82995	S	76	9	85	0.00001
Serratia_ficaria	61651	S	28	129	157	0.00001
Serratia_nematodiphila	458197	S	11	110	121	0.00001
Rahnella_aquatilis	34038	S	234	340	574	0.00004
Rahnella_victoriana	1510570	S	202	34	236	0.00002
Rahnella_inusitata	58169	S	181	53	234	0.00001
Rahnella_sp._ERMR1:05	1805933	S	167	26	193	0.00001
Rahnella_aceris	2703885	S	36	79	115	0.00001
Yersinia_pseudotuberculosis	633	S	57	190	247	0.00002
Yersinia_pestis	632	S	22	1194	1216	0.00008
Yersinia_similis	367190	S	16	3	19	0.00000
Yersinia_ruckeri	29486	S	99	20	119	0.00001
Yersinia_enterocolitica	630	S	83	127	210	0.00001
Yersinia_mollaretii	33060	S	56	12	68	0.00000
Yersinia_entomophaga	935293	S	53	10	63	0.00000
Yersinia_rohdei	29485	S	49	10	59	0.00000
Yersinia_frederiksenii	29484	S	45	38	83	0.00001
Yersinia_aleksiciae	263819	S	44	11	55	0.00000
Yersinia_aldovae	29483	S	34	7	41	0.00000
Yersinia_kristensenii	28152	S	33	86	119	0.00001
Yersinia_canariae	2607663	S	20	7	27	0.00000
Yersinia_intermedia	631	S	19	57	76	0.00000
Yersinia_hibernica	2339259	S	10	15	25	0.00000
Nissabacter_sp._SGAir0207	2126321	S	672	112	784	0.00005
Gibbsiella_quercinecans	929813	S	352	53	405	0.00003
Ewingella_americana	41202	S	256	40	296	0.00002
Rouxiella_badensis	1646377	S	227	23	250	0.00002
Chania_multitudinisentens	1639108	S	105	13	118	0.00001
Candidatus_Fukatsuia_symbiotica	1878942	S	72	4	76	0.00000
Pantoea_sp._Z09	2886821	S	581	198	779	0.00005
Pantoea_sp._SO10	2575375	S	268	56	324	0.00002
Pantoea_sp._At-9b	592316	S	185	45	230	0.00001
Pantoea_sp._MSR2	2052056	S	181	28	209	0.00001
Pantoea_sp._CCBC3-3-1	2490851	S	124	26	150	0.00001
Pantoea_sp._MT58	2768165	S	11	75	86	0.00001
Pantoea_sp._SM3640	2787629	S	11	70	81	0.00001
Pantoea_agglomerans	549	S	1180	365	1545	0.00010
Pantoea_dispersa	59814	S	924	262	1186	0.00008
Pantoea_deleyi	470932	S	284	68	352	0.00002
Pantoea_vagans	470934	S	281	377	658	0.00004
Pantoea_ananatis	553	S	272	78	350	0.00002
Pantoea_alhagi	1891675	S	221	75	296	0.00002
Pantoea_stewartii	66269	S	183	48	231	0.00001
Pantoea_cypripedii	55209	S	170	10	180	0.00001
Pantoea_rwandensis	1076550	S	123	28	151	0.00001
Pantoea_eucalypti	470933	S	46	289	335	0.00002
Candidatus_Pantoea_carbekii	1235990	S	13	1	14	0.00000
Erwinia_sp._E602	2675378	S	526	105	631	0.00004
Erwinia_sp._J780	2681984	S	132	27	159	0.00001
Erwinia_sp._QL-Z3	2547962	S	28	78	106	0.00001
Erwinia_sp._Ejp617	215689	S	23	38	61	0.00000
Erwinia_gerundensis	1619313	S	297	60	357	0.00002
Erwinia_persicina	55211	S	224	49	273	0.00002
Erwinia_rhapontici	55212	S	178	36	214	0.00001
Erwinia_tasmaniensis	338565	S	156	34	190	0.00001
Erwinia_amylovora	552	S	132	59	191	0.00001
Erwinia_billingiae	182337	S	132	268	400	0.00003
Erwinia_tracheiphila	65700	S	105	15	120	0.00001
Candidatus_Erwinia_haradaeae	1922217	S	82	1	83	0.00001
[Pantoea]_beijingensis	1324864	S	72	15	87	0.00001
Erwinia_pyrifoliae	79967	S	22	35	57	0.00000
Mixta_gaviniae	665914	S	412	177	589	0.00004
Mixta_calida	665913	S	332	198	530	0.00003
Mixta_theicola	1458355	S	327	118	445	0.00003
Mixta_intestinalis	1615494	S	149	47	196	0.00001
Mixta_sp._X22927	2872648	S	142	81	223	0.00001
Buchnera_aphidicola	9	S	262	34	296	0.00002
Tatumella_ptyseos	82987	S	90	18	108	0.00001
Tatumella_citrea	53336	S	48	8	56	0.00000
Wigglesworthia_glossinidia	51229	S	43	4	47	0.00000
Dickeya_dadantii	204038	S	402	145	547	0.00003
Dickeya_dianthicola	204039	S	251	64	315	0.00002
Dickeya_chrysanthemi	556	S	245	119	364	0.00002
Dickeya_zeae	204042	S	230	97	327	0.00002
Dickeya_fangzhongdai	1778540	S	148	173	321	0.00002
Dickeya_poaceiphila	568768	S	108	12	120	0.00001
Dickeya_solani	1089444	S	103	6373	6476	0.00041
Dickeya_sp._NCPPB_3274	568766	S	92	13	105	0.00001
Dickeya_parazeae	2893572	S	12	12	24	0.00000
Dickeya_oryzae	1240404	S	11	4	15	0.00000
Pectobacterium_carotovorum	554	S	194	452	646	0.00004
Pectobacterium_brasiliense	180957	S	147	181	328	0.00002
Pectobacterium_sp._LJ1	2878098	S	103	29	132	0.00001
Pectobacterium_sp._PL64	2738983	S	26	19	45	0.00000
Pectobacterium_atrosepticum	29471	S	97	32	129	0.00001
Pectobacterium_parmentieri	1905730	S	88	34	122	0.00001
Pectobacterium_polaris	2042057	S	79	59	138	0.00001
Pectobacterium_punjabense	2108399	S	46	11	57	0.00000
Pectobacterium_wasabiae	55208	S	42	13	55	0.00000
Pectobacterium_parvum	2778550	S	36	54	90	0.00001
Pectobacterium_versatile	2488639	S	35	83	118	0.00001
Pectobacterium_odoriferum	78398	S	31	24	55	0.00000
Pectobacterium_quasiaquaticum	2774015	S	18	18	36	0.00000
Pectobacterium_aquaticum	2204145	S	14	18	32	0.00000
Pectobacterium_aroidearum	1201031	S	12	19	31	0.00000
Brenneria_izadpanahii	2722756	S	244	291	535	0.00003
Brenneria_goodwinii	1109412	S	232	269	501	0.00003
Brenneria_rubrifaciens	55213	S	191	79	270	0.00002
Lonsdalea_britannica	1082704	S	273	65	338	0.00002
Lonsdalea_populi	1172565	S	266	66	332	0.00002
Musicola_paradisiaca	69223	S	326	0	326	0.00002
Edwardsiella_tarda	636	S	403	302	705	0.00005
Edwardsiella_hoshinae	93378	S	227	59	286	0.00002
Edwardsiella_ictaluri	67780	S	180	112	292	0.00002
Edwardsiella_piscicida	1263550	S	51	696	747	0.00005
Edwardsiella_sp._EA181011	1578828	S	11	170	181	0.00001
Hafnia_alvei	569	S	86	112	198	0.00001
Hafnia_paralvei	546367	S	40	18	58	0.00000
Obesumbacterium_proteus	82983	S	30	26	56	0.00000
Morganella_morganii	582	S	487	502	989	0.00006
Providencia_alcalifaciens	126385	S	80	38	118	0.00001
Providencia_rettgeri	587	S	67	136	203	0.00001
Providencia_heimbachae	333962	S	28	12	40	0.00000
Providencia_sp._R33	2828763	S	27	7	34	0.00000
Providencia_sneebia	516075	S	22	2	24	0.00000
Providencia_rustigianii	158850	S	19	7	26	0.00000
Providencia_vermicola	333965	S	12	68	80	0.00001
Xenorhabdus_doucetiae	351671	S	75	12	87	0.00001
Xenorhabdus_bovienii	40576	S	73	19	92	0.00001
Xenorhabdus_hominickii	351679	S	39	7	46	0.00000
Xenorhabdus_nematophila	628	S	37	7	44	0.00000
Xenorhabdus_budapestensis	290110	S	32	4	36	0.00000
Xenorhabdus_poinarii	40577	S	28	6	34	0.00000
Proteus_mirabilis	584	S	154	247	401	0.00003
Proteus_vulgaris	585	S	38	90	128	0.00001
Proteus_hauseri	183417	S	22	4	26	0.00000
Proteus_penneri	102862	S	11	12	23	0.00000
Photorhabdus_thracensis	230089	S	172	38	210	0.00001
Photorhabdus_akhurstii	171438	S	31	7	38	0.00000
Photorhabdus_asymbiotica	291112	S	29	4	33	0.00000
Photorhabdus_laumondii	2218628	S	27	7	34	0.00000
Arsenophonus_endosymbiont_of_Aleurodicus_dispersus	235559	S	25	1	26	0.00000
Arsenophonus_endosymbiont_of_Apis_mellifera	1541805	S	21	6	27	0.00000
Arsenophonus_endosymbiont_of_Aphis_craccivora	1231049	S	13	3	16	0.00000
Arsenophonus_nasoniae	638	S	29	8	37	0.00000
Moellerella_wisconsensis	158849	S	27	22	49	0.00000
Sodalis_sp._dw_23	2697027	S	535	40	575	0.00004
Sodalis_endosymbiont_of_Henestaris_halophilus	1929246	S	20	0	20	0.00000
Sodalis_praecaptivus	1239307	S	205	139	344	0.00002
Sodalis_glossinidius	63612	S	184	28	212	0.00001
Candidatus_Sodalis_pierantonius	1486991	S	141	102	243	0.00002
Leminorella_richardii	158841	S	153	22	175	0.00001
Pragia_fontium	82985	S	48	7	55	0.00000
Jinshanibacter_zhutongyuii	2498113	S	41	6	47	0.00000
Limnobaculum_parvum	2172103	S	28	4	32	0.00000
Thioalkalivibrio_paradoxus	108010	S	2153	712	2865	0.00018
Thioalkalivibrio_sulfidiphilus	1033854	S	1981	1337	3318	0.00021
Thioalkalivibrio_nitratireducens	186931	S	1953	585	2538	0.00016
Thioalkalivibrio_versutus	106634	S	1485	221	1706	0.00011
Thioalkalivibrio_sp._K90mix	396595	S	1448	206	1654	0.00011
Spiribacter_sp._E85	2182432	S	3960	424	4384	0.00028
Spiribacter_sp._2438	2666185	S	813	88	901	0.00006
Spiribacter_curvatus	1335757	S	960	60	1020	0.00007
Spiribacter_salinus	1335746	S	684	58	742	0.00005
Acidihalobacter_aeolianus	2792603	S	1661	269	1930	0.00012
Acidihalobacter_ferrooxydans	1765967	S	1483	179	1662	0.00011
Acidihalobacter_yilgarnensis	2819280	S	1001	79	1080	0.00007
Halorhodospira_halophila	1053	S	1725	238	1963	0.00013
Halorhodospira_halochloris	1052	S	275	16	291	0.00002
Aquisalimonas_sp._2447	2740807	S	1947	156	2103	0.00013
Alkalilimnicola_ehrlichii	351052	S	1732	252	1984	0.00013
Ectothiorhodospira_haloalkaliphila	421628	S	659	232	891	0.00006
Ectothiorhodospira_sp._BSL-9	1442136	S	625	211	836	0.00005
Ectothiorhodosinus_mongolicus	233100	S	293	22	315	0.00002
Allochromatium_tepidum	553982	S	1462	795	2257	0.00014
Allochromatium_vinosum	1049	S	1433	634	2067	0.00013
Candidatus_Thiodictyon_syntrophicum	1166950	S	3055	182	3237	0.00021
Thioflavicoccus_mobilis	80679	S	3045	308	3353	0.00021
Marichromatium_purpuratum	37487	S	2756	591	3347	0.00021
Thiocapsa_bogorovii	521689	S	2185	129	2314	0.00015
Thiocystis_violascens	73141	S	1703	159	1862	0.00012
Thermochromatium_tepidum	1050	S	1139	291	1430	0.00009
Nitrosococcus_wardiae	1814290	S	217	33	250	0.00002
Nitrosococcus_halophilus	133539	S	195	31	226	0.00001
Nitrosococcus_watsonii	473531	S	155	47	202	0.00001
Nitrosococcus_oceani	1229	S	149	42	191	0.00001
Caldichromatium_japonicum	2699430	S	753	91	844	0.00005
Rheinheimera_mangrovi	2498451	S	296	31	327	0.00002
Rheinheimera_sp._F8	1763998	S	116	6	122	0.00001
Rheinheimera_sp._D18	2545632	S	47	44	91	0.00001
Candidatus_Nitrosoglobus_terrae	1630141	S	47	3	50	0.00000
Candidatus_Nitrosacidococcus_tergens	553981	S	40	2	42	0.00000
Wenzhouxiangella_marina	1579979	S	1839	147	1986	0.00013
Wenzhouxiangella_sp._AB-CW3	2771012	S	1240	69	1309	0.00008
Thiohalobacter_sp._COW1	2795687	S	407	989	1396	0.00009
Thiohalobacter_thiocyanaticus	585455	S	342	1029	1371	0.00009
Guyparkeria_halophila	47960	S	2109	558	2667	0.00017
Sulfurivermis_fontis	1972068	S	1915	853	2768	0.00018
Halothiobacillus_sp._LS2	1860122	S	890	88	978	0.00006
Halothiobacillus_neapolitanus	927	S	324	39	363	0.00002
Woeseia_oceani	1548547	S	992	19	1011	0.00006
Sulfuriflexus_mobilis	1811807	S	377	12	389	0.00002
Granulosicoccus_antarcticus	437505	S	342	6	348	0.00002
Halomonas_sp._THAF5a	2587844	S	1613	673	2286	0.00015
Halomonas_sp._1513	1883416	S	1147	278	1425	0.00009
Halomonas_sp._THAF12	2587849	S	1071	723	1794	0.00011
Halomonas_sp._MCCC_1A13316	2733487	S	1025	147	1172	0.00007
Halomonas_sp._HG01	1609967	S	1003	478	1481	0.00009
Halomonas_sp._YLGW01	2773308	S	970	180	1150	0.00007
Halomonas_sp._JS92-SW72	2306583	S	954	1172	2126	0.00014
Halomonas_sp._PGE1	2730360	S	700	1051	1751	0.00011
Halomonas_sp._Y2R2	2562282	S	327	19	346	0.00002
Halomonas_sp._A40-4	2785909	S	257	73	330	0.00002
Halomonas_sp._SH5A2	2749040	S	230	44	274	0.00002
Halomonas_sp._KO116	1504981	S	173	76	249	0.00002
Halomonas_sp._R57-5	1610576	S	166	74	240	0.00002
Halomonas_sp._FeN2	2832500	S	155	71	226	0.00001
Halomonas_sp._SS10-MC5	2854257	S	140	1291	1431	0.00009
Halomonas_sp._18071143	2855441	S	138	326	464	0.00003
Halomonas_sp._GFAJ-1	1118153	S	106	21	127	0.00001
Halomonas_sp._SF2003	2136172	S	93	451	544	0.00003
Halomonas_sp._TD01	999141	S	86	49	135	0.00001
Halomonas_sp._GT	1971364	S	70	53	123	0.00001
Halomonas_sp._NyZ770	2883106	S	70	309	379	0.00002
Halomonas_sp._N3-2A	2014541	S	65	84	149	0.00001
Halomonas_sp._hl-4	1761789	S	53	362	415	0.00003
Halomonas_sp._HL-93	1666906	S	49	346	395	0.00003
Halomonas_sp._A3H3	1346287	S	17	467	484	0.00003
Halomonas_beimenensis	475662	S	1664	359	2023	0.00013
Halomonas_aestuarii	1897729	S	1433	328	1761	0.00011
Halomonas_sulfidivorans	2733488	S	1098	241	1339	0.00009
Halomonas_socia	1081866	S	1011	209	1220	0.00008
Halomonas_elongata	2746	S	950	107	1057	0.00007
Halomonas_tianxiuensis	2497861	S	885	209	1094	0.00007
Halomonas_chromatireducens	507626	S	796	69	865	0.00006
Halomonas_subglaciescola	29571	S	581	70	651	0.00004
Halomonas_meridiana	29570	S	516	451	967	0.00006
Halomonas_huangheensis	1178482	S	426	26	452	0.00003
Halomonas_piezotolerans	2609667	S	346	197	543	0.00003
Halomonas_profundi	2852117	S	154	24	178	0.00001
Halomonas_sulfidoxydans	2733484	S	139	1260	1399	0.00009
Halomonas_titanicae	664683	S	106	554	660	0.00004
Halomonas_hydrothermalis	115561	S	99	298	397	0.00003
Halomonas_venusta	44935	S	62	81	143	0.00001
Halomonas_campaniensis	213554	S	16	78	94	0.00001
Halomonas_alkaliphila	272774	S	14	74	88	0.00001
Cobetia_sp._L2A1	2686360	S	351	47	398	0.00003
Cobetia_sp._cqz5-12	2609415	S	182	267	449	0.00003
Cobetia_sp._AM6	2661553	S	95	572	667	0.00004
Cobetia_sp._4B	2758724	S	86	394	480	0.00003
Cobetia_pacifica	1055101	S	122	369	491	0.00003
Cobetia_amphilecti	1055104	S	60	387	447	0.00003
Cobetia_marina	28258	S	17	223	240	0.00002
Halotalea_alkalilenta	376489	S	1687	378	2065	0.00013
Salinicola_tamaricis	1771309	S	1562	198	1760	0.00011
Kushneria_phosphatilytica	657387	S	474	20	494	0.00003
Kushneria_konosiri	698828	S	362	90	452	0.00003
Kushneria_marisflavi	157779	S	325	78	403	0.00003
Chromohalobacter_salexigens	158080	S	1136	137	1273	0.00008
Pistricoccus_aurantiacus	1883414	S	818	61	879	0.00006
Zymobacter_palmae	33074	S	229	34	263	0.00002
Candidatus_Portiera_aleyrodidarum	91844	S	48	6	54	0.00000
Candidatus_Carsonella_ruddii	114186	S	15	18	33	0.00000
Alcanivorax_sp._N3-2A	2014542	S	1289	1427	2716	0.00017
Alcanivorax_pacificus	1306787	S	988	396	1384	0.00009
Alcanivorax_dieselolei	285091	S	548	281	829	0.00005
Alcanivorax_xenomutans	1094342	S	543	398	941	0.00006
Ketobacter_alkanivorans	1917421	S	186	16	202	0.00001
Marinobacterium_aestuarii	1821621	S	594	50	644	0.00004
Marinobacterium_sediminicola	518898	S	283	55	338	0.00002
Marinobacterium_georgiense	48076	S	262	98	360	0.00002
Marinobacterium_sp._LSUCC0821	2668067	S	51	4	55	0.00000
Marinomonas_sp._CT5	2066133	S	49	4	53	0.00000
Marinomonas_sp._FW-1	2071621	S	29	7	36	0.00000
Marinomonas_sp._A3A	2065312	S	22	3	25	0.00000
Marinomonas_algicola	2773454	S	77	16	93	0.00001
Marinomonas_profundi	2726122	S	66	20	86	0.00001
Marinomonas_primoryensis	178399	S	51	7	58	0.00000
Marinomonas_posidonica	936476	S	44	6	50	0.00000
Marinomonas_mediterranea	119864	S	38	3	41	0.00000
Marinomonas_arctica	383750	S	33	7	40	0.00000
Marinomonas_foliarum	491950	S	25	8	33	0.00000
Thalassolituus_sp._C2-1	2597518	S	146	10	156	0.00001
Thalassolituus_oleivorans	187493	S	75	21	96	0.00001
Venatorbacter_cucullus	2661630	S	193	49	242	0.00002
Bacterioplanes_sanyensis	1249553	S	157	9	166	0.00001
Neptunomonas_concharum	1031538	S	54	5	59	0.00000
Neptunomonas_japonica	417574	S	52	4	56	0.00000
Neptunomonas_phycophila	1572645	S	44	4	48	0.00000
Nitrincola_iocasae	2614693	S	104	20	124	0.00001
Amphritea_japonica	452627	S	80	7	87	0.00001
Bermanella_marisrubri	207949	S	51	2	53	0.00000
Hahella_sp._KA22	1628392	S	397	76	473	0.00003
Hahella_chejuensis	158327	S	366	61	427	0.00003
Saccharospirillum_mangrovi	2161747	S	465	30	495	0.00003
Reinekea_forsetii	1336806	S	174	9	183	0.00001
Gynuella_sunshinyii	1445505	S	131	4	135	0.00001
Litoricola_lipolytica	418701	S	275	14	289	0.00002
Oleiphilus_messinensis	141451	S	101	8	109	0.00001
Endozoicomonas_montiporae	1027273	S	95	6	101	0.00001
Spartinivicinus_ruber	2683272	S	46	1	47	0.00000
Methylococcus_sp._EFPC2	2812648	S	1709	131	1840	0.00012
Methylococcus_sp._Mc7	2860258	S	1398	526	1924	0.00012
Methylococcus_capsulatus	414	S	1416	428	1844	0.00012
Methylococcus_geothermalis	2681310	S	1256	408	1664	0.00011
Methylomonas_sp._LL1	2785785	S	452	22	474	0.00003
Methylomonas_sp._DH-1	1727196	S	226	429	655	0.00004
Methylomonas_sp._EFPC1	2812647	S	180	119	299	0.00002
Methylomonas_sp._LW13	107637	S	167	103	270	0.00002
Methylomonas_koyamae	702114	S	462	472	934	0.00006
Methylomonas_rhizoryzae	2608981	S	409	17	426	0.00003
Methylomonas_denitrificans	1538553	S	389	28	417	0.00003
Methylomonas_methanica	421	S	377	20	397	0.00003
Methylomonas_paludis	1173101	S	111	5	116	0.00001
Methylomagnum_ishizawai	1760988	S	1867	91	1958	0.00013
Methylomicrobium_album	39775	S	1572	71	1643	0.00010
Methylomicrobium_sp._wino1	2049332	S	288	267	555	0.00004
Methylocaldum_marinum	1432792	S	1748	116	1864	0.00012
Methylogaea_oryzae	1295382	S	1653	143	1796	0.00011
Candidatus_Methylospira_mobilis	1808979	S	532	25	557	0.00004
Methylotuvimicrobium_buryatense	95641	S	176	216	392	0.00003
Methylotuvimicrobium_alcaliphilum	271065	S	148	213	361	0.00002
Methylovulum_psychrotolerans	1704499	S	226	6	232	0.00001
Methylobacter_sp._S3L5C	2839024	S	107	7	114	0.00001
Aeromonas_hydrophila	644	S	1344	3659	5003	0.00032
Aeromonas_sp._FDAARGOS_1415	2778064	S	272	177	449	0.00003
Aeromonas_sp._CA23	2033032	S	231	116	347	0.00002
Aeromonas_sp._CU5	2033033	S	142	70	212	0.00001
Aeromonas_sp._FDAARGOS_1409	2778058	S	128	220	348	0.00002
Aeromonas_sp._FDAARGOS_1410	2778059	S	48	134	182	0.00001
Aeromonas_sp._1805	2560028	S	46	154	200	0.00001
Aeromonas_sp._ASNIH4	1636609	S	40	225	265	0.00002
Aeromonas_sp._FDAARGOS_1407	2778056	S	40	142	182	0.00001
Aeromonas_sp._FDAARGOS_1405	2778054	S	30	60	90	0.00001
Aeromonas_sp._FDAARGOS_1403	2778052	S	29	105	134	0.00001
Aeromonas_sp._2692-1	2560029	S	27	157	184	0.00001
Aeromonas_sp._FDAARGOS_1408	2778057	S	25	169	194	0.00001
Aeromonas_sp._ASNIH5	1758179	S	22	431	453	0.00003
Aeromonas_sp._FDAARGOS_1414	2778063	S	22	85	107	0.00001
Aeromonas_sp._FDAARGOS_1417	2778066	S	20	68	88	0.00001
Aeromonas_sp._FDAARGOS_1411	2778060	S	20	77	97	0.00001
Aeromonas_sp._FDAARGOS_1419	2778068	S	20	71	91	0.00001
Aeromonas_sp._FDAARGOS_1402	2778051	S	19	225	244	0.00002
Aeromonas_sp._FDAARGOS_1416	2778065	S	16	56	72	0.00000
Aeromonas_sp._ASNIH2	1636607	S	16	245	261	0.00002
Aeromonas_sp._ASNIH1	1636606	S	13	291	304	0.00002
Aeromonas_sp._FDAARGOS_1406	2778055	S	11	124	135	0.00001
Aeromonas_veronii	654	S	845	2120	2965	0.00019
Aeromonas_media	651	S	691	1521	2212	0.00014
Aeromonas_salmonicida	645	S	598	929	1527	0.00010
Aeromonas_simiae	218936	S	596	637	1233	0.00008
Aeromonas_schubertii	652	S	594	195	789	0.00005
Aeromonas_encheleia	73010	S	566	225	791	0.00005
Aeromonas_rivuli	648794	S	379	120	499	0.00003
Aeromonas_caviae	648	S	354	3283	3637	0.00023
Aeromonas_enteropelogenes	29489	S	327	312	639	0.00004
Aeromonas_dhakensis	196024	S	271	640	911	0.00006
Aeromonas_jandaei	650	S	260	312	572	0.00004
Aeromonas_sanarellii	633415	S	90	513	603	0.00004
Aeromonas_allosaccharophila	656	S	80	148	228	0.00001
Aeromonas_rivipollensis	948519	S	64	119	183	0.00001
Zobellella_denitrificans	347534	S	1240	307	1547	0.00010
Oceanimonas_sp._GK1	511062	S	556	124	680	0.00004
Dongshaea_marina	2047966	S	153	16	169	0.00001
Oceanisphaera_profunda	1416627	S	80	13	93	0.00001
Oceanisphaera_avium	1903694	S	58	11	69	0.00000
Tolumonas_auensis	43948	S	94	45	139	0.00001
Succinivibrio_dextrinosolvens	83771	S	25	1	26	0.00000
Sulfurifustis_variabilis	1675686	S	8681	619	9300	0.00059
Sulfuricaulis_limicola	1620215	S	3318	288	3606	0.00023
Acidiferrobacter_sp._SPIII_3	1281578	S	947	251	1198	0.00008
Acidiferrobacter_thiooxydans	163359	S	848	226	1074	0.00007
Solimonas_sp._K1W22B-7	2303331	S	6365	725	7090	0.00045
Flagellatimonas_centrodinii	2806210	S	1811	133	1944	0.00012
Sinimarinibacterium_sp._NLF-5-8	2698684	S	888	558	1446	0.00009
Steroidobacter_denitrificans	465721	S	4336	1410	5746	0.00037
Microbulbifer_sp._YPW16	2904242	S	693	67	760	0.00005
Microbulbifer_sp._SH-1	2681547	S	589	93	682	0.00004
Microbulbifer_sp._YPW1	2745199	S	420	76	496	0.00003
Microbulbifer_sp._ALW1	1516059	S	362	62	424	0.00003
Microbulbifer_sp._THAF38	2587856	S	145	49	194	0.00001
Microbulbifer_sp._GL-2	2591606	S	131	22	153	0.00001
Microbulbifer_sp._A4B17	359370	S	98	22	120	0.00001
Microbulbifer_aggregans	1769779	S	450	56	506	0.00003
Microbulbifer_hydrolyticus	48074	S	427	79	506	0.00003
Microbulbifer_thermotolerans	252514	S	384	25	409	0.00003
Microbulbifer_celer	435905	S	344	43	387	0.00002
Microbulbifer_elongatus	86173	S	324	54	378	0.00002
Microbulbifer_agarilyticus	260552	S	241	27	268	0.00002
Microbulbifer_variabilis	266805	S	89	32	121	0.00001
Cellvibrio_sp._PSBB023	1945512	S	588	62	650	0.00004
Cellvibrio_sp._KY-GH-1	2303332	S	510	44	554	0.00004
Cellvibrio_sp._PSBB006	1987723	S	376	15	391	0.00002
Cellvibrio_sp._KY-YJ-3	454662	S	239	35	274	0.00002
Cellvibrio_japonicus	155077	S	265	23	288	0.00002
Teredinibacter_turnerae	2426	S	175	8	183	0.00001
Teredinibacter_haidensis	2731755	S	100	7	107	0.00001
Teredinibacter_purpureus	2731756	S	78	2	80	0.00001
Simiduia_agarivorans	447471	S	313	17	330	0.00002
Saccharophagus_degradans	86304	S	77	2	79	0.00001
Marinagarivorans_sp._GE09	2721545	S	63	6	69	0.00000
Agarilytica_rhodophyticola	1737490	S	48	1	49	0.00000
Kineobactrum_salinum	2708301	S	1038	43	1081	0.00007
Halioglobus_maricola	2601894	S	342	18	360	0.00002
Halioglobus_japonicus	930805	S	320	20	340	0.00002
Congregibacter_litoralis	393662	S	364	159	523	0.00003
Aequoribacter_fuscus	2518989	S	122	17	139	0.00001
Spongiibacter_nanhainus	2794344	S	269	33	302	0.00002
Spongiibacter_taiwanensis	1748242	S	256	12	268	0.00002
Spongiibacter_sp._IMCC21906	1620392	S	86	24	110	0.00001
Zhongshania_aliphaticivorans	1470434	S	127	9	136	0.00001
Oceanicoccus_sagamiensis	716816	S	104	2	106	0.00001
Shewanella_sp._FJAT-51860	2864212	S	66	10	76	0.00000
Shewanella_sp._FJAT-54031	2864209	S	52	79	131	0.00001
Shewanella_sp._FJAT-53532	2864203	S	51	88	139	0.00001
Shewanella_sp._FJAT-53555	2864204	S	49	43	92	0.00001
Shewanella_sp._FJAT-53681	2864205	S	48	78	126	0.00001
Shewanella_sp._Scap07	2589987	S	42	5	47	0.00000
Shewanella_sp._FJAT-52076	2864202	S	40	56	96	0.00001
Shewanella_sp._SNU_WT4	2590015	S	40	11	51	0.00000
Shewanella_sp._FJAT-53764	2864207	S	39	61	100	0.00001
Shewanella_sp._FJAT-52072	2864213	S	36	48	84	0.00001
Shewanella_sp._FJAT-53870	2864208	S	32	5	37	0.00000
Shewanella_sp._KX20019	2803864	S	29	3	32	0.00000
Shewanella_sp._OM3-2	2908650	S	28	4	32	0.00000
Shewanella_sp._WE21	2029986	S	25	13	38	0.00000
Shewanella_sp._FJAT-53749	2864206	S	25	5	30	0.00000
Shewanella_sp._FJAT-51754	2864211	S	22	32	54	0.00000
Shewanella_sp._MR-4	60480	S	13	14	27	0.00000
Shewanella_sp._Pdp11	2059264	S	13	38	51	0.00000
Shewanella_sp._Arc9-LZ	2698686	S	11	4	15	0.00000
Shewanella_algae	38313	S	192	171	363	0.00002
Shewanella_cyperi	2814292	S	179	99	278	0.00002
Shewanella_khirikhana	1965282	S	178	29	207	0.00001
Shewanella_litorisediminis	1173586	S	127	32	159	0.00001
Shewanella_putrefaciens	24	S	106	360	466	0.00003
Shewanella_baltica	62322	S	102	223	325	0.00002
Shewanella_marisflavi	260364	S	102	21	123	0.00001
Shewanella_sedimentimangrovi	2814293	S	90	69	159	0.00001
Shewanella_amazonensis	60478	S	87	22	109	0.00001
Shewanella_yunxiaonensis	2829809	S	79	13	92	0.00001
Shewanella_dokdonensis	712036	S	72	7	79	0.00001
Shewanella_avicenniae	2814294	S	70	12	82	0.00001
Shewanella_sediminis	271097	S	66	9	75	0.00000
Shewanella_pealeana	70864	S	52	9	61	0.00000
Shewanella_psychrophila	225848	S	49	7	56	0.00000
Shewanella_loihica	359303	S	48	82	130	0.00001
Shewanella_violacea	60217	S	47	9	56	0.00000
Shewanella_oneidensis	70863	S	43	13	56	0.00000
Shewanella_decolorationis	256839	S	42	50	92	0.00001
Shewanella_benthica	43661	S	41	9	50	0.00000
Shewanella_woodyi	60961	S	41	4	45	0.00000
Shewanella_aestuarii	1028752	S	40	15	55	0.00000
Shewanella_livingstonensis	150120	S	40	9	49	0.00000
Shewanella_inventionis	1738770	S	35	18	53	0.00000
Shewanella_carassii	1987584	S	34	38	72	0.00000
Shewanella_piezotolerans	404011	S	33	3	36	0.00000
Shewanella_maritima	2520507	S	33	3	36	0.00000
Shewanella_denitrificans	192073	S	32	5	37	0.00000
Shewanella_halifaxensis	271098	S	32	4	36	0.00000
Shewanella_psychropiezotolerans	2593655	S	31	5	36	0.00000
Shewanella_xiamenensis	332186	S	26	139	165	0.00001
Shewanella_donghaensis	238836	S	24	3	27	0.00000
Shewanella_psychromarinicola	2487742	S	22	3	25	0.00000
Shewanella_chilikensis	558541	S	21	66	87	0.00001
Shewanella_indica	768528	S	21	29	50	0.00000
Shewanella_glacialimarina	2590884	S	20	2	22	0.00000
Shewanella_vesiculosa	518738	S	19	5	24	0.00000
Shewanella_bicestrii	2018305	S	18	75	93	0.00001
Shewanella_frigidimarina	56812	S	12	6	18	0.00000
Shewanella_japonica	93973	S	10	25	35	0.00000
Parashewanella_spongiae	342950	S	32	2	34	0.00000
Parashewanella_tropica	2547970	S	23	2	25	0.00000
Alteromonas_sp._RKMC-009	2267264	S	83	11	94	0.00001
Alteromonas_sp._BL110	1714845	S	26	4	30	0.00000
Alteromonas_sp._76-1	2358187	S	17	5	22	0.00000
Alteromonas_sp._RW2A1	1917158	S	11	102	113	0.00001
Alteromonas_macleodii	28108	S	131	51	182	0.00001
Alteromonas_pelagimontana	1858656	S	72	10	82	0.00001
Alteromonas_mediterranea	314275	S	71	23	94	0.00001
Alteromonas_australica	589873	S	35	51	86	0.00001
Alteromonas_stellipolaris	233316	S	18	49	67	0.00000
Alteromonas_naphthalenivorans	715451	S	16	8	24	0.00000
Salinimonas_marina	2785918	S	90	9	99	0.00001
Salinimonas_lutimaris	914153	S	83	17	100	0.00001
Salinimonas_sediminis	2303538	S	64	17	81	0.00001
Salinimonas_iocasae	2572577	S	60	14	74	0.00000
Hydrocarboniclastica_marina	2259620	S	462	70	532	0.00003
Agarivorans_gilvus	680279	S	54	6	60	0.00000
Agarivorans_sp._TSD2052	2937286	S	29	4	33	0.00000
Agarivorans_sp._B2Z047	2652721	S	22	22	44	0.00000
Agarivorans_aestuarii	1563703	S	20	9	29	0.00000
Lacimicrobium_alkaliphilum	1526571	S	158	11	169	0.00001
Paraglaciecola_sp._L1A13	2686359	S	38	3	41	0.00000
Paraglaciecola_sp._L3A3	2686358	S	29	2	31	0.00000
Paraglaciecola_psychrophila	326544	S	42	3	45	0.00000
Paraglaciecola_mesophila	197222	S	37	3	40	0.00000
Saliniradius_amylolyticus	2183582	S	121	12	133	0.00001
Saccharobesus_litoralis	2172099	S	62	4	66	0.00000
Paraneptunicella_aestuarii	2831148	S	59	3	62	0.00000
Catenovulum_sediminis	1740262	S	56	4	60	0.00000
Glaciecola_nitratireducens	300231	S	45	3	48	0.00000
Pseudoalteromonas_sp._R3	1709477	S	40	14	54	0.00000
Pseudoalteromonas_sp._A25	116092	S	17	10	27	0.00000
Pseudoalteromonas_sp._THAF3	2587843	S	12	19	31	0.00000
Pseudoalteromonas_rubra	43658	S	140	18	158	0.00001
Pseudoalteromonas_viridis	339617	S	84	27	111	0.00001
Pseudoalteromonas_luteoviolacea	43657	S	77	12	89	0.00001
Pseudoalteromonas_piscicida	43662	S	61	68	129	0.00001
Pseudoalteromonas_shioyasakiensis	1190813	S	57	26	83	0.00001
Pseudoalteromonas_xiamenensis	882626	S	44	5	49	0.00000
Pseudoalteromonas_spongiae	298657	S	42	11	53	0.00000
Pseudoalteromonas_ulvae	107327	S	33	3	36	0.00000
Pseudoalteromonas_prydzensis	182141	S	32	5	37	0.00000
Pseudoalteromonas_tunicata	314281	S	29	4	33	0.00000
Pseudoalteromonas_piratica	1348114	S	28	4	32	0.00000
Pseudoalteromonas_undina	43660	S	25	44	69	0.00000
Pseudoalteromonas_mariniglutinosa	206042	S	24	55	79	0.00001
Pseudoalteromonas_phenolica	161398	S	23	3	26	0.00000
Pseudoalteromonas_translucida	166935	S	23	96	119	0.00001
Pseudoalteromonas_espejiana	28107	S	22	6	28	0.00000
Pseudoalteromonas_aliena	247523	S	19	7	26	0.00000
Pseudoalteromonas_agarivorans	176102	S	19	57	76	0.00000
Pseudoalteromonas_ruthenica	151081	S	14	17	31	0.00000
Pseudoalteromonas_carrageenovora	227	S	13	4	17	0.00000
Psychrosphaera_ytuae	2820710	S	26	11	37	0.00000
Psychrosphaera_aestuarii	1266052	S	14	5	19	0.00000
Flocculibacter_collagenilyticus	2744479	S	47	5	52	0.00000
Ferrimonas_balearica	44012	S	417	57	474	0.00003
Ferrimonas_lipolytica	2724191	S	74	11	85	0.00001
Colwellia_sp._PAMC_20917	1816218	S	31	3	34	0.00000
Colwellia_sp._Arc7-635	2497879	S	31	7	38	0.00000
Colwellia_sp._MT41	58049	S	29	4	33	0.00000
Colwellia_sp._20A7	2689569	S	18	2	20	0.00000
Colwellia_sp._Arc7-D	2161872	S	13	4	17	0.00000
Colwellia_psychrerythraea	28229	S	21	2	23	0.00000
Thalassotalea_sp._PS06	2594005	S	49	9	58	0.00000
Thalassotalea_sp._HSM_43	2552945	S	31	6	37	0.00000
Thalassotalea_sp._LPB0316	2769490	S	29	10	39	0.00000
Thalassotalea_crassostreae	1763536	S	24	2	26	0.00000
Cognaticolwellia_beringensis	1967665	S	28	5	33	0.00000
Litorilituus_sediminis	718192	S	21	2	23	0.00000
Idiomarina_sp._OT37-5b	2100422	S	88	21	109	0.00001
Idiomarina_sp._X4	2055892	S	44	20	64	0.00000
Idiomarina_loihiensis	135577	S	45	0	45	0.00000
Idiomarina_abyssalis	86102	S	40	5	45	0.00000
Idiomarina_piscisalsi	1096243	S	38	17	55	0.00000
Moritella_sp._24	2746230	S	14	4	18	0.00000
Moritella_sp._36	2746233	S	13	43	56	0.00000
Moritella_yayanosii	69539	S	40	14	54	0.00000
Moritella_marina	90736	S	34	10	44	0.00000
Psychromonas_ingrahamii	357794	S	68	8	76	0.00000
Psychromonas_sp._CNPT3	314282	S	26	5	31	0.00000
Vibrio_parahaemolyticus	670	S	156	1338	1494	0.00010
Vibrio_harveyi	669	S	56	15	71	0.00000
Vibrio_alginolyticus	663	S	43	64	107	0.00001
Vibrio_owensii	696485	S	40	20	60	0.00000
Vibrio_diabolicus	50719	S	27	27	54	0.00000
Vibrio_campbellii	680	S	36	32	68	0.00000
Vibrio_rotiferianus	190895	S	28	10	38	0.00000
Vibrio_azureus	512649	S	28	3	31	0.00000
Vibrio_natriegens	691	S	27	25	52	0.00000
Vibrio_jasicida	766224	S	20	19	39	0.00000
Vibrio_sp._OG9-811	2841925	S	133	22	155	0.00001
Vibrio_sp._B1FLJ16	2751178	S	51	12	63	0.00000
Vibrio_sp._HDW18	2714948	S	39	7	46	0.00000
Vibrio_sp._VB16	2785746	S	27	2	29	0.00000
Vibrio_sp._SS-MA-C1-2	2908646	S	23	4	27	0.00000
Vibrio_sp._Scap24	2589990	S	22	14	36	0.00000
Vibrio_sp._THAF190c	2587865	S	20	3	23	0.00000
Vibrio_sp._SCSIO_43132	2779363	S	20	7	27	0.00000
Vibrio_sp._B1REV9	2751179	S	16	8	24	0.00000
Vibrio_sp._ED004	2785124	S	10	6	16	0.00000
Vibrio_vulnificus	672	S	257	55	312	0.00002
Vibrio_fluvialis	676	S	244	46	290	0.00002
Vibrio_furnissii	29494	S	232	87	319	0.00002
Vibrio_sinaloensis	379097	S	73	12	85	0.00001
Vibrio_tubiashii	29498	S	26	37	63	0.00000
Vibrio_europaeus	300876	S	20	24	44	0.00000
Vibrio_navarrensis	29495	S	128	37	165	0.00001
Vibrio_mimicus	674	S	119	30	149	0.00001
Vibrio_cholerae	666	S	108	1294	1402	0.00009
Vibrio_anguillarum	55601	S	84	17	101	0.00001
Vibrio_alfacsensis	1074311	S	62	32	94	0.00001
Vibrio_cyclitrophicus	47951	S	61	16	77	0.00000
Vibrio_metoecus	1481663	S	58	20	78	0.00001
Vibrio_maritimus	990268	S	58	6	64	0.00000
Vibrio_gazogenes	687	S	56	6	62	0.00000
Vibrio_coralliilyticus	190893	S	55	21	76	0.00000
Vibrio_neptunius	170651	S	51	8	59	0.00000
Vibrio_spartinae	1918945	S	50	5	55	0.00000
Vibrio_scophthalmi	45658	S	50	9	59	0.00000
Vibrio_nigripulchritudo	28173	S	48	10	58	0.00000
Vibrio_zhugei	2479546	S	45	11	56	0.00000
Vibrio_mediterranei	689	S	43	4	47	0.00000
Vibrio_penaeicida	104609	S	41	5	46	0.00000
Vibrio_breoganii	553239	S	40	4	44	0.00000
Vibrio_splendidus	29497	S	39	12	51	0.00000
Vibrio_tapetis	52443	S	37	2	39	0.00000
Vibrio_astriarenae	1481923	S	37	5	42	0.00000
Vibrio_cidicii	1763883	S	35	13	48	0.00000
Vibrio_metschnikovii	28172	S	34	6	40	0.00000
Vibrio_algicola	2662262	S	34	6	40	0.00000
Vibrio_taketomensis	2572923	S	33	4	37	0.00000
Vibrio_cincinnatiensis	675	S	33	7	40	0.00000
Vibrio_kanaloae	170673	S	33	8	41	0.00000
Vibrio_aphrogenes	1891186	S	30	4	34	0.00000
Vibrio_ziniensis	2711221	S	29	3	32	0.00000
Vibrio_rumoiensis	76258	S	29	19	48	0.00000
Vibrio_ponticus	265668	S	27	2	29	0.00000
Vibrio_gigantis	296199	S	27	7	34	0.00000
Vibrio_tritonius	1435069	S	26	3	29	0.00000
Vibrio_chagasii	170679	S	24	4	28	0.00000
Vibrio_casei	673372	S	24	7	31	0.00000
Vibrio_crassostreae	246167	S	23	9	32	0.00000
Vibrio_atlanticus	693153	S	23	5	28	0.00000
Vibrio_panuliri	1381081	S	21	2	23	0.00000
Vibrio_bathopelagicus	2777577	S	19	4	23	0.00000
Vibrio_aquimaris	2587862	S	18	2	20	0.00000
Vibrio_hyugaensis	1534743	S	14	5	19	0.00000
Vibrio_qinghaiensis	2025808	S	13	6	19	0.00000
Photobacterium_sp._GJ3	2829502	S	133	20	153	0.00001
Photobacterium_sp._TLY01	2907534	S	91	17	108	0.00001
Photobacterium_gaetbulicola	1295392	S	197	21	218	0.00001
Photobacterium_damselae	38293	S	185	98	283	0.00002
Photobacterium_ganghwense	320778	S	124	29	153	0.00001
Photobacterium_profundum	74109	S	31	4	35	0.00000
Salinivibrio_kushneri	1908198	S	50	8	58	0.00000
Salinivibrio_costicola	51367	S	17	30	47	0.00000
Salinivibrio_sp._YCSC6	2003370	S	17	30	47	0.00000
Grimontia_hollisae	673	S	104	14	118	0.00001
Aliivibrio_fischeri	668	S	37	12	49	0.00000
Thaumasiovibrio_subtropicus	1891207	S	49	6	55	0.00000
Paraphotobacterium_marinum	1755811	S	16	3	19	0.00000
Candidatus_Enterovibrio_luxaltus	1927128	S	14	0	14	0.00000
Legionella_pneumophila	446	S	523	269	792	0.00005
Legionella_sp._PC1000	2746060	S	215	31	246	0.00002
Legionella_sp._MW5194	2662448	S	131	22	153	0.00001
Legionella_sp._PC997	2755562	S	75	11	86	0.00001
Legionella_anisa	28082	S	286	62	348	0.00002
Legionella_longbeachae	450	S	161	67	228	0.00001
Legionella_geestiana	45065	S	155	12	167	0.00001
Legionella_spiritensis	452	S	130	12	142	0.00001
Legionella_sainthelensi	28087	S	125	18	143	0.00001
Legionella_fallonii	96230	S	103	7	110	0.00001
Legionella_israelensis	454	S	102	4	106	0.00001
Legionella_oakridgensis	29423	S	91	8	99	0.00001
Legionella_antarctica	2708020	S	84	4	88	0.00001
Legionella_lansingensis	45067	S	82	5	87	0.00001
Legionella_jordanis	456	S	79	9	88	0.00001
Legionella_hackeliae	449	S	76	12	88	0.00001
Legionella_waltersii	66969	S	68	11	79	0.00001
Legionella_cherrii	28084	S	64	3	67	0.00000
Legionella_clemsonensis	1867846	S	64	9	73	0.00000
Legionella_adelaidensis	45056	S	52	4	56	0.00000
Fluoribacter_dumoffii	463	S	100	41	141	0.00001
Tatlockia_micdadei	451	S	67	3	70	0.00000
Aquicella_siphonis	254247	S	534	79	613	0.00004
Aquicella_lusitana	254246	S	333	55	388	0.00002
Coxiella_burnetii	777	S	163	68	231	0.00001
Coxiella_endosymbiont_of_Amblyomma_nuttalli	2749996	S	36	5	41	0.00000
Coxiella_endosymbiont_of_Amblyomma_sculptum	2487929	S	22	10	32	0.00000
Candidatus_Coxiella_mudrowiae	2054173	S	52	7	59	0.00000
Candidatus_Rickettsiella_viridis	676208	S	46	13	59	0.00000
Rickettsiella_endosymbiont_of_Dermanyssus_gallinae	2856608	S	45	12	57	0.00000
Acinetobacter_sp._WCHAc010034	1879049	S	203	94	297	0.00002
Acinetobacter_sp._10FS3-1	2563897	S	30	22	52	0.00000
Acinetobacter_sp._TTH0-4	1646498	S	28	5	33	0.00000
Acinetobacter_sp._CS-2	2798861	S	24	14	38	0.00000
Acinetobacter_sp._LoGeW2-3	1808001	S	20	2	22	0.00000
Acinetobacter_sp._Marseille-Q1620	2714110	S	20	1	21	0.00000
Acinetobacter_sp._TGL-Y2	1407071	S	15	1	16	0.00000
Acinetobacter_sp._SCLZS86	2908637	S	14	20	34	0.00000
Acinetobacter_sp._NCu2D-2	1608473	S	13	3	16	0.00000
Acinetobacter_sp._WCHAc010052	2004647	S	12	8	20	0.00000
Acinetobacter_sp._ASP199	2773709	S	12	4	16	0.00000
Acinetobacter_sp._NyZ410	2929509	S	11	6	17	0.00000
Acinetobacter_sp._ACNIH2	1758189	S	11	17	28	0.00000
Acinetobacter_sp._WCHA55	2004646	S	11	12	23	0.00000
Acinetobacter_sp._PK01	2930198	S	10	11	21	0.00000
Acinetobacter_sp._YH12138	2601122	S	10	16	26	0.00000
Acinetobacter_baumannii	470	S	218	1181	1399	0.00009
Acinetobacter_pittii	48296	S	41	71	112	0.00001
Acinetobacter_calcoaceticus	471	S	33	5	38	0.00000
Acinetobacter_nosocomialis	106654	S	28	14	42	0.00000
Acinetobacter_seifertii	1530123	S	23	11	34	0.00000
Acinetobacter_indicus	756892	S	114	104	218	0.00001
Acinetobacter_johnsonii	40214	S	81	89	170	0.00001
Acinetobacter_junii	40215	S	54	25	79	0.00001
Acinetobacter_schindleri	108981	S	49	50	99	0.00001
Acinetobacter_larvae	1789224	S	43	3	46	0.00000
Acinetobacter_radioresistens	40216	S	38	7	45	0.00000
Acinetobacter_lwoffii	28090	S	36	60	96	0.00001
Acinetobacter_soli	487316	S	35	4	39	0.00000
Acinetobacter_bouvetii	202951	S	32	7	39	0.00000
Acinetobacter_baylyi	202950	S	32	3	35	0.00000
Acinetobacter_haemolyticus	29430	S	30	19	49	0.00000
Acinetobacter_shaoyimingii	2715164	S	25	2	27	0.00000
Acinetobacter_wuhouensis	1879050	S	22	12	34	0.00000
Acinetobacter_piscicola	2006115	S	18	11	29	0.00000
Acinetobacter_variabilis	70346	S	18	29	47	0.00000
Acinetobacter_dispersus	70348	S	17	1	18	0.00000
Acinetobacter_cumulans	2136182	S	16	7	23	0.00000
Acinetobacter_tandoii	202954	S	15	1	16	0.00000
Acinetobacter_lanii	2715163	S	14	1	15	0.00000
Acinetobacter_gyllenbergii	134534	S	13	1	14	0.00000
Acinetobacter_towneri	202956	S	13	34	47	0.00000
Acinetobacter_chinensis	2004650	S	13	10	23	0.00000
Acinetobacter_ursingii	108980	S	12	14	26	0.00000
Acinetobacter_defluvii	1871111	S	12	10	22	0.00000
Acinetobacter_equi	1324350	S	11	1	12	0.00000
Acinetobacter_venetianus	52133	S	11	3	14	0.00000
Acinetobacter_bereziniae	106648	S	10	9	19	0.00000
Psychrobacter_sp._P11F6	1699621	S	34	43	77	0.00000
Psychrobacter_sp._DAB_AL43B	1028416	S	26	5	31	0.00000
Psychrobacter_sp._P11G3	1699623	S	16	11	27	0.00000
Psychrobacter_sp._28M-43	2772254	S	15	11	26	0.00000
Psychrobacter_sp._P11G5	1699624	S	12	44	56	0.00000
Psychrobacter_sp._WY6	2708350	S	11	13	24	0.00000
Psychrobacter_arenosus	256326	S	34	2	36	0.00000
Psychrobacter_urativorans	45610	S	23	4	27	0.00000
Psychrobacter_arcticus	334543	S	20	9	29	0.00000
Psychrobacter_sanguinis	861445	S	14	6	20	0.00000
Psychrobacter_cryohalolentis	330922	S	13	80	93	0.00001
Moraxella_osloensis	34062	S	154	24	178	0.00001
Moraxella_bovis	476	S	48	12	60	0.00000
Moraxella_catarrhalis	480	S	42	8	50	0.00000
Moraxella_cuniculi	34061	S	40	4	44	0.00000
Moraxella_bovoculi	386891	S	37	56	93	0.00001
Moraxella_sp._ZY201115	2904121	S	21	2	23	0.00000
Moraxella_nonliquefaciens	478	S	18	4	22	0.00000
Aquirhabdus_parva	2283318	S	86	4	90	0.00001
Immundisolibacter_cernigliae	1810504	S	3120	659	3779	0.00024
Candidatus_Endoriftia_persephone	393765	S	882	49	931	0.00006
Bathymodiolus_thermophilus_thioautotrophic_gill_symbiont	2360	S	22	1	23	0.00000
Candidatus_Ruthia_endofausta	2738852	S	12	4	16	0.00000
Bathymodiolus_septemdierum_thioautotrophic_gill_symbiont	113267	S	11	1	12	0.00000
Sedimenticola_thiotaurini	1543721	S	555	27	582	0.00004
Candidatus_Reidiella_endopervernicosa	2738883	S	438	10	448	0.00003
Thiolapillus_brandeum	1076588	S	364	10	374	0.00002
Pseudohongiella_spirulinae	1249552	S	186	5	191	0.00001
Gallaecimonas_mangrovi	2291597	S	140	12	152	0.00001
Celerinatantimonas_diazotrophica	412034	S	58	4	62	0.00000
Ignatzschineria_sp._HR5S32	2923279	S	43	4	47	0.00000
Candidatus_Thioglobus_sp._NP1	2508687	S	18	5	23	0.00000
Candidatus_Thioglobus_autotrophicus	1705394	S	17	1	18	0.00000
Candidatus_Steffania_adelgidicola	1076626	S	16	0	16	0.00000
Candidatus_Pseudothioglobus_singularis	1427364	S	14	8	22	0.00000
Thiomicrorhabdus_xiamenensis	2739063	S	108	6	114	0.00001
Thiomicrorhabdus_sediminis	2580412	S	70	3	73	0.00000
Thiomicrorhabdus_aquaedulcis	2211106	S	55	2	57	0.00000
Thiomicrorhabdus_sp._Am19	2791037	S	36	1	37	0.00000
Thiomicrorhabdus_indica	2267253	S	30	1	31	0.00000
Methylophaga_frappieri	754477	S	98	59	157	0.00001
Methylophaga_sp._TMB456	2881052	S	81	39	120	0.00001
Methylophaga_nitratireducenticrescens	754476	S	75	21	96	0.00001
Thiomicrospira_sp._S5	1803865	S	64	55	119	0.00001
Thiomicrospira_aerophila	92245	S	57	6	63	0.00000
Thiomicrospira_microaerophila	406020	S	43	6	49	0.00000
Thiomicrospira_cyclica	147268	S	38	2	40	0.00000
Hydrogenovibrio_thermophilus	265883	S	58	50	108	0.00001
Hydrogenovibrio_marinus	28885	S	47	2	49	0.00000
Hydrogenovibrio_crunogenus	39765	S	33	1	34	0.00000
Piscirickettsia_salmonis	1238	S	87	6	93	0.00001
Thiosulfatimonas_sediminis	2675054	S	65	4	69	0.00000
Thiosulfativibrio_zosterae	2675053	S	49	2	51	0.00000
Thiothrix_litoralis	2891210	S	250	20	270	0.00002
Thiothrix_sp._CT3	96472	S	167	63	230	0.00001
Thiothrix_subterranea	2735563	S	153	48	201	0.00001
Candidatus_Thiothrix_anitrata	2823902	S	120	81	201	0.00001
Thiothrix_unzii	111769	S	103	62	165	0.00001
Beggiatoa_leptomitoformis	288004	S	101	2	103	0.00001
Francisella_tularensis	263	S	24	246	270	0.00002
Francisella_philomiragia	28110	S	18	2	20	0.00000
Francisella_frigiditurris	1542390	S	12	0	12	0.00000
Francisella_halioticida	549298	S	11	0	11	0.00000
Francisella_uliginis	573570	S	11	0	11	0.00000
Salinisphaera_sp._LB1	2183911	S	2067	94	2161	0.00014
endosymbiont_of_unidentified_scaly_snail_isolate_Monju	1248727	S	1584	150	1734	0.00011
Isorropodon_fossajaponicum_symbiont	883811	S	15	3	18	0.00000
Abyssogena_phaseoliformis_symbiont	596095	S	13	4	17	0.00000
Pasteurella_multocida	747	S	151	390	541	0.00003
Pasteurella_canis	753	S	22	5	27	0.00000
Pasteurella_atlantica	2827233	S	11	1	12	0.00000
Aggregatibacter_actinomycetemcomitans	714	S	102	98	200	0.00001
Aggregatibacter_aphrophilus	732	S	59	25	84	0.00001
Aggregatibacter_segnis	739	S	11	12	23	0.00000
Haemophilus_parainfluenzae	729	S	65	24	89	0.00001
Haemophilus_influenzae	727	S	43	36	79	0.00001
Haemophilus_haemolyticus	726	S	25	14	39	0.00000
Haemophilus_parahaemolyticus	735	S	23	5	28	0.00000
[Haemophilus]_ducreyi	730	S	19	10	29	0.00000
Haemophilus_pittmaniae	249188	S	16	3	19	0.00000
Actinobacillus_sp._GY-402	2774188	S	76	42	118	0.00001
Actinobacillus_pleuropneumoniae	715	S	26	39	65	0.00000
Actinobacillus_porcitonsillarum	189834	S	16	7	23	0.00000
Actinobacillus_indolicus	51049	S	12	11	23	0.00000
Actinobacillus_equuli	718	S	11	6	17	0.00000
Mannheimia_granulomatis	85402	S	60	11	71	0.00000
Mannheimia_haemolytica	75985	S	40	143	183	0.00001
Mannheimia_varigena	85404	S	33	17	50	0.00000
Avibacterium_paragallinarum	728	S	27	11	38	0.00000
Avibacterium_volantium	762	S	14	7	21	0.00000
Glaesserella_parasuis	738	S	31	21	52	0.00000
Glaesserella_sp._15-184	2030797	S	13	3	16	0.00000
Rodentibacter_heylii	1906744	S	20	2	22	0.00000
Rodentibacter_haemolyticus	2778911	S	16	1	17	0.00000
Histophilus_somni	731	S	29	9	38	0.00000
Gallibacterium_anatis	750	S	24	8	32	0.00000
Bibersteinia_trehalosi	47735	S	24	11	35	0.00000
Frederiksenia_canicola	123824	S	16	4	20	0.00000
Otariodibacter_oris	1032623	S	14	2	16	0.00000
Bisgaardia_hudsonensis	109472	S	12	1	13	0.00000
Vespertiliibacter_pulmonis	1443036	S	10	1	11	0.00000
Cardiobacterium_hominis	2718	S	584	128	712	0.00005
Cardiobacterium_sp._Marseille-Q4385	2866573	S	357	68	425	0.00003
Suttonella_sp._R2A3	2908648	S	78	5	83	0.00001
Dichelobacter_nodosus	870	S	50	17	67	0.00000
Kangiella_koreensis	261964	S	68	9	77	0.00000
Kangiella_profundi	1561924	S	49	10	59	0.00000
Kangiella_sediminilitoris	1144748	S	44	3	47	0.00000
Kangiella_geojedonensis	914150	S	38	3	41	0.00000
Gilliamella_sp._ESL0405	2704653	S	25	4	29	0.00000
Gilliamella_sp._ESL0441	2704654	S	13	10	23	0.00000
Gilliamella_sp._ESL0443	2704655	S	11	2	13	0.00000
Gilliamella_apicola	1196095	S	40	9	49	0.00000
Zophobihabitans_entericus	1635327	S	17	1	18	0.00000
Frischella_perrara	1267021	S	12	2	14	0.00000
Archangium_violaceum	83451	S	44576	7986	52562	0.00336
Archangium_gephyra	48	S	14574	2919	17493	0.00112
Stigmatella_aurantiaca	41	S	9968	981	10949	0.00070
Cystobacter_fuscus	43	S	9810	2445	12255	0.00078
Melittangium_boletus	83453	S	7163	1649	8812	0.00056
Myxococcus_xanthus	34	S	8937	34115	43052	0.00275
Myxococcus_hansupus	1297742	S	5242	578	5820	0.00037
Myxococcus_stipitatus	83455	S	4449	700	5149	0.00033
Myxococcus_sp._SCHIC003	2813577	S	3945	623	4568	0.00029
Corallococcus_coralloides	184914	S	8984	3914	12898	0.00082
Corallococcus_macrosporus	35	S	6042	1386	7428	0.00047
Corallococcus_sp._EGB	1521117	S	5902	2417	8319	0.00053
Pyxidicoccus_sp._SCPEA002	2813578	S	15344	919	16263	0.00104
Anaeromyxobacter_sp._Red232	2918170	S	18800	2239	21039	0.00134
Anaeromyxobacter_sp._Fw109-5	404589	S	15813	2278	18091	0.00116
Anaeromyxobacter_sp._Red630	2918171	S	13386	1949	15335	0.00098
Anaeromyxobacter_sp._K	447217	S	3299	6971	10270	0.00066
Anaeromyxobacter_dehalogenans	161493	S	10735	8203	18938	0.00121
Vulgatibacter_incomptus	1391653	S	7760	669	8429	0.00054
Sorangium_cellulosum	56	S	121402	15813	137215	0.00876
Polyangium_aurulentum	2567896	S	30390	3100	33490	0.00214
Chondromyces_crocatus	52	S	13092	633	13725	0.00088
Pajaroellobacter_abortibovis	1882918	S	175	5	180	0.00001
Sandaracinus_amylolyticus	927083	S	39802	2336	42138	0.00269
Labilithrix_luteola	1391654	S	22358	1087	23445	0.00150
Haliangium_ochraceum	80816	S	19569	1169	20738	0.00132
Geomonas_sp._RF6	2897342	S	2874	388	3262	0.00021
Geomonas_paludis	2740185	S	2118	1092	3210	0.00020
Geomonas_nitrogeniifigens	2847991	S	2019	1075	3094	0.00020
Geomonas_subterranea	2847989	S	1775	851	2626	0.00017
Geomonas_oryzisoli	2847992	S	1519	854	2373	0.00015
Geobacter_sp._FeAm09	2597769	S	1837	254	2091	0.00013
Geobacter_sp._SVR	2495594	S	1346	210	1556	0.00010
Geobacter_sp._DSM_9736	1277350	S	734	55	789	0.00005
Geobacter_sulfurreducens	35554	S	2021	465	2486	0.00016
Geobacter_pickeringii	345632	S	2004	527	2531	0.00016
Geobacter_metallireducens	28232	S	1356	325	1681	0.00011
Geobacter_benzoatilyticus	2815309	S	759	173	932	0.00006
Citrifermentans_bremense	60035	S	1646	703	2349	0.00015
Citrifermentans_bemidjiense	225194	S	1632	639	2271	0.00015
Geotalea_uraniireducens	351604	S	1013	79	1092	0.00007
Geotalea_daltonii	1203471	S	546	45	591	0.00004
Geoalkalibacter_subterraneus	483547	S	882	900	1782	0.00011
Trichlorobacter_lovleyi	313985	S	468	68	536	0.00003
Desulfuromonas_versatilis	2802975	S	3146	589	3735	0.00024
Desulfuromonas_sp._DDH964	1823759	S	2110	424	2534	0.00016
Desulfuromonas_sp._AOP6	1566351	S	713	83	796	0.00005
Desulfuromonas_soudanensis	1603606	S	1935	231	2166	0.00014
Pelobacter_propionicus	29543	S	1314	497	1811	0.00012
Syntrophotalea_acetylenica	29542	S	610	130	740	0.00005
Syntrophotalea_carbinolica	19	S	443	37	480	0.00003
Syntrophotalea_acetylenivorans	1842532	S	386	63	449	0.00003
Desulfovibrio_sp._IOR2	2583823	S	955	200	1155	0.00007
Desulfovibrio_sp._86	2666132	S	294	75	369	0.00002
Desulfovibrio_sp._G11	631220	S	274	177	451	0.00003
Desulfovibrio_vulgaris	881	S	1295	52	1347	0.00009
Desulfovibrio_sulfodismutans	63561	S	961	267	1228	0.00008
Desulfovibrio_desulfuricans	876	S	877	190	1067	0.00007
Desulfovibrio_piger	901	S	757	157	914	0.00006
Desulfovibrio_fairfieldensis	44742	S	685	62	747	0.00005
Desulfovibrio_ferrophilus	241368	S	447	40	487	0.00003
Candidatus_Desulfovibrio_trichonymphae	1725232	S	164	14	178	0.00001
Pseudodesulfovibrio_mercurii	641491	S	1368	366	1734	0.00011
Pseudodesulfovibrio_indicus	1716143	S	1344	324	1668	0.00011
Pseudodesulfovibrio_aespoeensis	182210	S	992	806	1798	0.00011
Pseudodesulfovibrio_cashew	2678688	S	756	164	920	0.00006
Pseudodesulfovibrio_tunisiensis	463192	S	716	80	796	0.00005
Pseudodesulfovibrio_sp._SF6	2810563	S	349	39	388	0.00002
Pseudodesulfovibrio_sp._zrk46	2725288	S	314	60	374	0.00002
Pseudodesulfovibrio_profundus	57320	S	227	260	487	0.00003
Pseudodesulfovibrio_piezophilus	879567	S	109	16	125	0.00001
Solidesulfovibrio_carbinoliphilus	345370	S	1840	253	2093	0.00013
Solidesulfovibrio_magneticus	184917	S	746	469	1215	0.00008
Solidesulfovibrio_carbinolicus	296842	S	721	615	1336	0.00009
Oceanidesulfovibrio_marinus	370038	S	2052	142	2194	0.00014
Desulfocurvibacter_africanus	873	S	1465	119	1584	0.00010
Desulfolutivibrio_sulfoxidireducens	2773299	S	1243	378	1621	0.00010
Megalodesulfovibrio_gigas	879	S	1138	62	1200	0.00008
Oleidesulfovibrio_alaskensis	58180	S	317	507	824	0.00005
Paradesulfovibrio_bizertensis	376490	S	190	21	211	0.00001
Maridesulfovibrio_salexigens	880	S	121	13	134	0.00001
Maridesulfovibrio_hydrothermalis	191026	S	59	6	65	0.00000
Lawsonia_intracellularis	29546	S	27	0	27	0.00000
Desulfomicrobium_baculatum	899	S	978	82	1060	0.00007
Desulfomicrobium_orale	132132	S	545	160	705	0.00005
Desulfohalobium_retbaense	45663	S	345	19	364	0.00002
Desulfosarcina_ovata	83564	S	1094	55	1149	0.00007
Desulfosarcina_alkanivorans	571177	S	1008	487	1495	0.00010
Desulfosarcina_widdelii	947919	S	821	99	920	0.00006
Desulfococcus_multivorans	897	S	763	152	915	0.00006
Desulfatibacillum_aliphaticivorans	218208	S	613	20	633	0.00004
Desulfoluna_sp._ASN36	2810562	S	573	29	602	0.00004
Desulfonema_magnum	45655	S	219	6	225	0.00001
Desulfonema_limicola	45656	S	51	3	54	0.00000
Desulfobacter_postgatei	2293	S	125	19	144	0.00001
Desulfobacter_hydrogenophilus	2291	S	121	19	140	0.00001
Desulforapulum_autotrophicum	2296	S	192	20	212	0.00001
Desulfobacula_toluolica	28223	S	66	5	71	0.00000
Desulfobulbus_propionicus	894	S	903	54	957	0.00006
Desulfobulbus_oralis	1986146	S	693	172	865	0.00006
Desulfobulbus_oligotrophicus	1909699	S	184	182	366	0.00002
Desulfurivibrio_alkaliphilus	427923	S	706	36	742	0.00005
Desulfomarina_profundi	2772557	S	60	6	66	0.00000
Desulfosudis_oleivorans	181663	S	740	55	795	0.00005
Desulfosediminicola_ganghwensis	2569540	S	165	22	187	0.00001
Desulfosediminicola_flagellatus	2569541	S	58	7	65	0.00000
Desulfotalea_psychrophila	84980	S	112	21	133	0.00001
Desulfocapsa_sulfexigens	65555	S	60	4	64	0.00000
Persicimonas_caeni	2292766	S	5575	175	5750	0.00037
Bradymonas_sediminis	1548548	S	1760	125	1885	0.00012
Bradymonadales_bacterium_V1718	2600177	S	675	35	710	0.00005
Syntrophobacter_fumaroxidans	119484	S	1337	647	1984	0.00013
Desulfoglaeba_alkanexedens	361111	S	1200	73	1273	0.00008
Desulfarculus_baarsii	453230	S	2067	1395	3462	0.00022
Desulfomonile_tiedjei	2358	S	448	4	452	0.00003
Desulfobacca_acetoxidans	60893	S	444	11	455	0.00003
Syntrophus_aciditrophicus	316277	S	411	27	438	0.00003
Dissulfurimicrobium_hydrothermale	1750598	S	304	20	324	0.00002
Candidatus_Desulfofervidus_auxilii	1621989	S	114	2	116	0.00001
Hippea_maritima	84405	S	55	2	57	0.00000
Campylobacter_showae	204	S	209	16	225	0.00001
Campylobacter_gracilis	824	S	131	7	138	0.00001
Campylobacter_curvus	200	S	119	9	128	0.00001
Campylobacter_concisus	199	S	98	11	109	0.00001
Campylobacter_sp._CCUG_57310	2517362	S	20	2	22	0.00000
Campylobacter_sp._RM6914	1032243	S	15	1	16	0.00000
Campylobacter_sp._19-13652	2840180	S	14	1	15	0.00000
Campylobacter_rectus	203	S	40	5	45	0.00000
Candidatus_Campylobacter_infans	2561898	S	18	1	19	0.00000
Campylobacter_fetus	196	S	17	10	27	0.00000
Campylobacter_hominis	76517	S	17	6	23	0.00000
Campylobacter_jejuni	197	S	17	210	227	0.00001
Campylobacter_geochelonis	1780362	S	15	1	16	0.00000
Campylobacter_sputorum	206	S	14	1	15	0.00000
Campylobacter_corcagiensis	1448857	S	12	1	13	0.00000
Campylobacter_cuniculorum	374106	S	12	0	12	0.00000
Campylobacter_coli	195	S	10	8	18	0.00000
Sulfurimonas_sp._HSL-3221	2894755	S	537	66	603	0.00004
Sulfurimonas_paralvinellae	317658	S	18	18	36	0.00000
Sulfuricurvum_kujiense	148813	S	58	3	61	0.00000
Helicobacter_pylori	210	S	158	57	215	0.00001
Helicobacter_sp._NHP19-0012	2849642	S	37	10	47	0.00000
Helicobacter_sp._NHP19-0003	2849641	S	27	4	31	0.00000
Helicobacter_cinaedi	213	S	28	7	35	0.00000
Helicobacter_felis	214	S	24	2	26	0.00000
Helicobacter_heilmannii	35817	S	22	7	29	0.00000
Helicobacter_canis	29419	S	18	4	22	0.00000
Helicobacter_bizzozeronii	56877	S	18	1	19	0.00000
Helicobacter_mustelae	217	S	16	2	18	0.00000
Helicobacter_cetorum	138563	S	14	1	15	0.00000
Helicobacter_bilis	37372	S	13	6	19	0.00000
Helicobacter_suis	104628	S	13	3	16	0.00000
Helicobacter_enhydrae	222136	S	11	1	12	0.00000
Helicobacter_pullorum	35818	S	10	2	12	0.00000
Helicobacter_himalayensis	1591088	S	10	1	11	0.00000
Wolinella_succinogenes	844	S	57	12	69	0.00000
Nitratifractor_salsuginis	269261	S	334	23	357	0.00002
Sulfurovum_sp._NBC37-1	387093	S	38	18	56	0.00000
Sulfurovum_sp._HSL1-3	2893889	S	36	8	44	0.00000
Sulfurovum_sp._XGS-02	2925411	S	16	1	17	0.00000
Sulfurovum_indicum	2779528	S	59	6	65	0.00000
Sulfurovum_lithotrophicum	206403	S	36	20	56	0.00000
Hydrogenimonas_urashimensis	2740515	S	289	24	313	0.00002
Arcobacter_sp._FWKO_B	2593672	S	11	3	14	0.00000
Arcobacter_defluvii	873191	S	10	18	28	0.00000
Arcobacter_aquimarinus	1315211	S	10	22	32	0.00000
Sulfurospirillum_cavolei	366522	S	70	7	77	0.00000
Sulfurospirillum_sp._UCH001	1581011	S	11	26	37	0.00000
Sulfurospirillum_barnesii	44674	S	14	1	15	0.00000
Sulfurospirillum_multivorans	66821	S	13	18	31	0.00000
Sulfurospirillum_halorespirans	194424	S	11	14	25	0.00000
Sulfurospirillum_deleyianum	65553	S	10	1	11	0.00000
Nitrosophilus_alvini	2714855	S	79	19	98	0.00001
Nitrosophilus_labii	2706014	S	30	12	42	0.00000
Nitratiruptor_sp._YY09-18	2724901	S	35	26	61	0.00000
Nitratiruptor_sp._SB155-2	387092	S	23	27	50	0.00000
Caminibacter_mediatlanticus	291048	S	53	27	80	0.00001
Caminibacter_pacificus	1424653	S	28	11	39	0.00000
Nautilia_profundicola	244787	S	16	10	26	0.00000
Nautilia_sp._PV-1	2579250	S	14	8	22	0.00000
Acidithiobacillus_caldus	33059	S	560	96	656	0.00004
Acidithiobacillus_ferrivorans	160808	S	374	76	450	0.00003
Acidithiobacillus_ferrooxidans	920	S	288	283	571	0.00004
Acidithiobacillus_thiooxidans	930	S	184	11	195	0.00001
Acidithiobacillus_ferriphilus	1689834	S	154	33	187	0.00001
Acidithiobacillus_sp._'AMD_consortium'	2614801	S	14	201	215	0.00001
Acidithiobacillus_ferridurans	1232575	S	13	119	132	0.00001
Bdellovibrio_bacteriovorus	959	S	419	76	495	0.00003
Bdellovibrio_sp._LBG001	2835041	S	93	16	109	0.00001
Bdellovibrio_sp._NC01	2220073	S	90	15	105	0.00001
Bdellovibrio_sp._ZAP7	2231053	S	67	33	100	0.00001
Bdellovibrio_sp._KM01	2748865	S	56	29	85	0.00001
Pseudobdellovibrio_exovorus	453816	S	73	7	80	0.00001
Bacteriovorax_stolpii	960	S	89	26	115	0.00001
Halobacteriovorax_marinus	97084	S	27	14	41	0.00000
Halobacteriovorax_sp._BALOs_7	2109558	S	25	8	33	0.00000
Fluviispira_sanaruensis	2493639	S	31	11	42	0.00000
Silvanigrella_aquatica	1915309	S	22	8	30	0.00000
Hydrogenophilus_thermoluteolus	297	S	858	176	1034	0.00007
Mariprofundus_ferrinatatus	1921087	S	297	23	320	0.00002
Mariprofundus_aestuarium	1921086	S	180	17	197	0.00001
Streptomyces_sp._WAC_01438	2203204	S	14611	5184	19795	0.00126
Streptomyces_sp._SCSIO_64649	2878388	S	13536	2643	16179	0.00103
Streptomyces_sp._CdTB01	1725411	S	10562	3171	13733	0.00088
Streptomyces_sp._BJ20	2930049	S	10416	4412	14828	0.00095
Streptomyces_sp._NHF165	2175864	S	9817	1827	11644	0.00074
Streptomyces_sp._DSM_40868	2721173	S	9036	3422	12458	0.00080
Streptomyces_sp._P3	2135430	S	8988	2369	11357	0.00073
Streptomyces_sp._3025	2923272	S	8877	1685	10562	0.00067
Streptomyces_sp._CCM_MD2014	1561022	S	8611	7358	15969	0.00102
Streptomyces_sp._3214.6	1882757	S	8520	2610	11130	0.00071
Streptomyces_sp._SN-593	659352	S	8084	2059	10143	0.00065
Streptomyces_sp._891-h	2720714	S	7992	1557	9549	0.00061
Streptomyces_sp._MA3_2.13	2867410	S	7862	1092	8954	0.00057
Streptomyces_sp._Z423-1	2730915	S	7260	2215	9475	0.00060
Streptomyces_sp._ST1015	1848900	S	6940	1535	8475	0.00054
Streptomyces_sp._So13.3	2136173	S	6894	1383	8277	0.00053
Streptomyces_sp._ZYC-3	2797636	S	6735	1403	8138	0.00052
Streptomyces_sp._SAT1	1849967	S	6650	2595	9245	0.00059
Streptomyces_sp._SYP-A7193	2662065	S	6597	3864	10461	0.00067
Streptomyces_sp._CB01881	2078691	S	6548	1333	7881	0.00050
Streptomyces_sp._BH-MK-02	2880933	S	6512	1487	7999	0.00051
Streptomyces_sp._NA02950	2742137	S	6010	1269	7279	0.00046
Streptomyces_sp._SCUT-3	2684469	S	6007	2534	8541	0.00055
Streptomyces_sp._A2-16	2781734	S	5935	1924	7859	0.00050
Streptomyces_sp._HM190	2695266	S	5611	1867	7478	0.00048
Streptomyces_sp._LRE541	2931983	S	5423	1298	6721	0.00043
Streptomyces_sp._JB150	2714844	S	5391	1887	7278	0.00046
Streptomyces_sp._Go-475	2072505	S	5381	2548	7929	0.00051
Streptomyces_sp._NEAU-sy36	2751189	S	5242	2039	7281	0.00046
Streptomyces_sp._CB09001	2083284	S	5100	3302	8402	0.00054
Streptomyces_sp._Go_40/10	2825844	S	5096	2305	7401	0.00047
Streptomyces_sp._GQFP	2907545	S	5025	908	5933	0.00038
Streptomyces_sp._MST-110588	2833628	S	4963	1287	6250	0.00040
Streptomyces_sp._MG62	2838015	S	4887	1886	6773	0.00043
Streptomyces_sp._NA04227	2742136	S	4759	1168	5927	0.00038
Streptomyces_sp._AMCC400023	2056258	S	4753	1962	6715	0.00043
Streptomyces_sp._C8S0	2585716	S	4730	1434	6164	0.00039
Streptomyces_sp._GMY02	1333528	S	4574	862	5436	0.00035
Streptomyces_sp._YIM_121038	2136401	S	4502	1381	5883	0.00038
Streptomyces_sp._GS7	2692234	S	4457	1262	5719	0.00037
Streptomyces_sp._MBT27	1488356	S	4445	1375	5820	0.00037
Streptomyces_sp._HP-A2021	2927875	S	4389	2453	6842	0.00044
Streptomyces_sp._RPA4-2	2721244	S	4321	1314	5635	0.00036
Streptomyces_sp._MG28	2865673	S	4298	1563	5861	0.00037
Streptomyces_sp._RTd22	1841249	S	4153	1691	5844	0.00037
Streptomyces_sp._W1SF4	2305220	S	4056	1505	5561	0.00036
Streptomyces_sp._QHH-9511	2684468	S	4039	1170	5209	0.00033
Streptomyces_sp._jing01	2726118	S	4022	2267	6289	0.00040
Streptomyces_sp._Rer75	2750011	S	3980	1782	5762	0.00037
Streptomyces_sp._BHT-5-2	2866715	S	3866	1256	5122	0.00033
Streptomyces_sp._HSG2	2797167	S	3844	893	4737	0.00030
Streptomyces_sp._SM18	1736046	S	3729	1070	4799	0.00031
Streptomyces_sp._SirexAA-E	862751	S	3674	1134	4808	0.00031
Streptomyces_sp._CMB-StM0423	2059884	S	3634	1666	5300	0.00034
Streptomyces_sp._135	2838850	S	3547	1190	4737	0.00030
Streptomyces_sp._Tu_2975	2676871	S	3305	1090	4395	0.00028
Streptomyces_sp._WAC_06738	2203210	S	3238	2961	6199	0.00040
Streptomyces_sp._WAC_01529	2203205	S	3146	1144	4290	0.00027
Streptomyces_sp._fd1-xmd	1812480	S	2875	1261	4136	0.00026
Streptomyces_sp._S4.7	2705439	S	2768	943	3711	0.00024
Streptomyces_sp._INR7	2607753	S	2736	1372	4108	0.00026
Streptomyces_sp._TN58	234612	S	2722	1243	3965	0.00025
Streptomyces_sp._SUK_48	2582831	S	2489	1523	4012	0.00026
Streptomyces_sp._S1D4-11	2721246	S	2460	1712	4172	0.00027
Streptomyces_sp._CNQ-509	444103	S	2336	2097	4433	0.00028
Streptomyces_sp._NA02536	2742133	S	2146	5498	7644	0.00049
Streptomyces_sp._HF10	2692233	S	2113	1449	3562	0.00023
Streptomyces_sp._WY228	2855836	S	2035	1067	3102	0.00020
Streptomyces_sp._YPW6	2840373	S	1925	978	2903	0.00019
Streptomyces_sp._ADI95-16	1522758	S	1790	1483	3273	0.00021
Streptomyces_sp._V17-9	2831149	S	1767	8148	9915	0.00063
Streptomyces_sp._Mg1	465541	S	1667	1471	3138	0.00020
Streptomyces_sp._769	1262452	S	1651	1209	2860	0.00018
Streptomyces_sp._2323.1	1938841	S	1646	984	2630	0.00017
Streptomyces_sp._AgN23	1188315	S	1639	1407	3046	0.00019
Streptomyces_sp._RPA4-5	2721245	S	1638	1031	2669	0.00017
Streptomyces_sp._BSE6.1	2605730	S	1630	7165	8795	0.00056
Streptomyces_sp._EAS-AB2608	2779671	S	1580	2411	3991	0.00025
Streptomyces_sp._NA03103	2742134	S	1544	9718	11262	0.00072
Streptomyces_sp._PBH53	1577075	S	1448	2054	3502	0.00022
Streptomyces_sp._SS52	2563602	S	1386	6471	7857	0.00050
Streptomyces_sp._NEAU-S7GS2	2202000	S	1356	1075	2431	0.00016
Streptomyces_sp._SGAir0924	2109593	S	1331	6435	7766	0.00050
Streptomyces_sp._A144	2871487	S	1314	5844	7158	0.00046
Streptomyces_sp._XC_2026	2782004	S	1298	1099	2397	0.00015
Streptomyces_sp._S063	2005885	S	1262	845	2107	0.00013
Streptomyces_sp._S8	1837283	S	1213	1005	2218	0.00014
Streptomyces_sp._ID38640	1265399	S	1159	792	1951	0.00012
Streptomyces_sp._3211	1964449	S	1133	1380	2513	0.00016
Streptomyces_sp._KPB2	2305221	S	1109	8829	9938	0.00063
Streptomyces_sp._WA6-1-16	2879427	S	1079	1051	2130	0.00014
Streptomyces_sp._MOE7	1961713	S	1052	1225	2277	0.00015
Streptomyces_sp._Sge12	1972846	S	969	1452	2421	0.00015
Streptomyces_sp._HNA39	2850561	S	945	1032	1977	0.00013
Streptomyces_sp._RLB1-33	2721243	S	917	2588	3505	0.00022
Streptomyces_sp._11-1-2	1851167	S	862	1556	2418	0.00015
Streptomyces_sp._Tue_6075	1661694	S	832	914	1746	0.00011
Streptomyces_sp._CRSS-Y-16	2906474	S	769	4302	5071	0.00032
Streptomyces_sp._CFMR_7	1649184	S	768	1265	2033	0.00013
Streptomyces_sp._M2	646637	S	751	3971	4722	0.00030
Streptomyces_sp._CB00271	2750025	S	735	961	1696	0.00011
Streptomyces_sp._CLI2509	1984801	S	721	2433	3154	0.00020
Streptomyces_sp._CB09030	2913412	S	653	2123	2776	0.00018
Streptomyces_sp._M56	1495638	S	630	1620	2250	0.00014
Streptomyces_sp._WAC00303	2933779	S	605	838	1443	0.00009
Streptomyces_sp._CB04723	2748873	S	560	964	1524	0.00010
Streptomyces_sp._Tu6071	355249	S	558	1681	2239	0.00014
Streptomyces_sp._VN1	1821625	S	538	2213	2751	0.00018
Streptomyces_sp._PAMC_26508	1265601	S	500	1757	2257	0.00014
Streptomyces_sp._endophyte_N2	2153485	S	467	1314	1781	0.00011
Streptomyces_sp._HU2014	2939414	S	457	1524	1981	0.00013
Streptomyces_sp._S501	2420135	S	390	1480	1870	0.00012
Streptomyces_sp._WAC00288	2094021	S	387	1566	1953	0.00012
Streptomyces_sp._WA1-19	2884220	S	376	1952	2328	0.00015
Streptomyces_sp._2114.2	1881022	S	374	2257	2631	0.00017
Streptomyces_sp._LBUM_1480	2609808	S	328	3215	3543	0.00023
Streptomyces_sp._R527F	1664033	S	324	1789	2113	0.00013
Streptomyces_sp._A1-5	2738410	S	320	1450	1770	0.00011
Streptomyces_sp._S1A1-7	2594459	S	307	2884	3191	0.00020
Streptomyces_sp._CA-256286	2801033	S	273	1642	1915	0.00012
Streptomyces_sp._GF20	2692235	S	227	1243	1470	0.00009
Streptomyces_sp._LBUM_1482	2609809	S	196	4956	5152	0.00033
Streptomyces_sp._FR-008	206662	S	183	1457	1640	0.00010
Streptomyces_sp._NBU3104	2911367	S	181	1159	1340	0.00009
Streptomyces_sp._CC0208	2306165	S	165	4339	4504	0.00029
Streptomyces_sp._RLB3-17	2594455	S	162	2534	2696	0.00017
Streptomyces_sp._LBUM_1475	2609807	S	162	4805	4967	0.00032
Streptomyces_sp._RLB3-6	2594457	S	159	4996	5155	0.00033
Streptomyces_sp._604F	1476754	S	152	1343	1495	0.00010
Streptomyces_sp._OUCMDZ-3434	1535304	S	143	1466	1609	0.00010
Streptomyces_sp._S1D4-20	2594462	S	126	3429	3555	0.00023
Streptomyces_sp._PLM4	2929798	S	119	958	1077	0.00007
Streptomyces_sp._A10(2020)	2782013	S	95	1080	1175	0.00008
Streptomyces_sp._PVA_94-07	1225337	S	89	1284	1373	0.00009
Streptomyces_sp._GBA_94-10	1218177	S	74	923	997	0.00006
Streptomyces_sp._S1D4-23	2594463	S	72	3859	3931	0.00025
Streptomyces_sp._S1D4-14	2594461	S	63	4118	4181	0.00027
Streptomyces_sp._RLB1-9	2594454	S	49	2703	2752	0.00018
Streptomyces_sp._ICC4	2099584	S	25	1679	1704	0.00011
Streptomyces_sp._ICC1	2099583	S	24	1393	1417	0.00009
Streptomyces_sp._SM17	565560	S	21	842	863	0.00006
Streptomyces_venezuelae	54571	S	22828	8285	31113	0.00199
Streptomyces_bathyalis	2710756	S	21991	3594	25585	0.00163
Streptomyces_hygroscopicus	1912	S	9830	13661	23491	0.00150
Streptomyces_rapamycinicus	1226757	S	4908	1088	5996	0.00038
Streptomyces_yatensis	155177	S	1815	1228	3043	0.00019
Streptomyces_violaceusniger	68280	S	1788	1093	2881	0.00018
Streptomyces_malaysiensis	92644	S	447	1265	1712	0.00011
Streptomyces_cadmiisoli	2184053	S	5539	1343	6882	0.00044
Streptomyces_aurantiacus	47760	S	4478	1040	5518	0.00035
Streptomyces_qaidamensis	1783515	S	3876	1554	5430	0.00035
Streptomyces_alboniger	132473	S	2622	936	3558	0.00023
Streptomyces_koyangensis	188770	S	1963	1879	3842	0.00025
Streptomyces_actuosus	1885	S	15911	6489	22400	0.00143
Streptomyces_chartreusis	1969	S	12752	5407	18159	0.00116
Streptomyces_calvus	67282	S	12159	4531	16690	0.00107
Streptomyces_albus	1888	S	11559	5556	17115	0.00109
Streptomyces_armeniacus	83291	S	9925	1394	11319	0.00072
Streptomyces_cyaneochromogenes	2496836	S	8980	2531	11511	0.00073
Streptomyces_griseus	1911	S	3426	2837	6263	0.00040
Streptomyces_sp._M54	2759525	S	349	846	1195	0.00008
Streptomyces_anulatus	1892	S	2487	2437	4924	0.00031
Streptomyces_microflavus	1919	S	1241	5088	6329	0.00040
Streptomyces_globisporus	1908	S	1027	7046	8073	0.00052
Streptomyces_ferrugineus	1413221	S	8691	2682	11373	0.00073
Streptomyces_lydicus	47763	S	8559	5502	14061	0.00090
Streptomyces_viridosporus	67581	S	8406	3264	11670	0.00075
Streptomyces_capitiformicae	2014920	S	8129	1223	9352	0.00060
Streptomyces_griseorubiginosus	67304	S	7958	2516	10474	0.00067
Streptomyces_cyanogenus	80860	S	7899	3338	11237	0.00072
Streptomyces_formicae	1616117	S	7851	2401	10252	0.00065
Streptomyces_bingchenggensis	379067	S	7739	1439	9178	0.00059
Streptomyces_buecherae	2763006	S	7561	1874	9435	0.00060
Streptomyces_aquilus	2548456	S	7239	2060	9299	0.00059
Streptomyces_tendae	1932	S	6904	2742	9646	0.00062
Streptomyces_lincolnensis	1915	S	6875	1912	8787	0.00056
Streptomyces_seoulensis	73044	S	6836	2530	9366	0.00060
Streptomyces_ambofaciens	1889	S	6796	3878	10674	0.00068
Streptomyces_tsukubensis	83656	S	6694	1570	8264	0.00053
Streptomyces_pactum	68249	S	6526	2526	9052	0.00058
Streptomyces_spectabilis	68270	S	6384	2002	8386	0.00054
Streptomyces_cattleya	29303	S	6358	1805	8163	0.00052
Streptomyces_niveus	193462	S	6212	2698	8910	0.00057
Streptomyces_griseochromogenes	68214	S	6120	1634	7754	0.00050
Streptomyces_davaonensis	348043	S	6111	1647	7758	0.00050
Streptomyces_harbinensis	1176198	S	5864	1562	7426	0.00047
Streptomyces_asoensis	249586	S	5757	1647	7404	0.00047
Streptomyces_nigra	1827580	S	5738	2168	7906	0.00050
Streptomyces_prasinus	67345	S	5737	1802	7539	0.00048
Streptomyces_roseirectus	2768066	S	5734	1350	7084	0.00045
Streptomyces_rimosus	1927	S	5653	8819	14472	0.00092
Streptomyces_xinghaiensis	1038928	S	5605	1657	7262	0.00046
Streptomyces_xanthii	2768069	S	5502	1612	7114	0.00045
Streptomyces_antibioticus	1890	S	5300	1819	7119	0.00045
Streptomyces_parvulus	146923	S	5257	2230	7487	0.00048
Streptomyces_collinus	42684	S	5186	3137	8323	0.00053
Streptomyces_griseoviridis	45398	S	5177	1617	6794	0.00043
Streptomyces_nodosus	40318	S	4854	1199	6053	0.00039
Streptomyces_durmitorensis	319947	S	4846	1013	5859	0.00037
Streptomyces_albulus	68570	S	4804	1407	6211	0.00040
Streptomyces_avermitilis	33903	S	4776	1322	6098	0.00039
Streptomyces_glaucescens	1907	S	4748	1971	6719	0.00043
Streptomyces_dengpaensis	2049881	S	4655	1248	5903	0.00038
Streptomyces_genisteinicus	2768068	S	4654	1421	6075	0.00039
Streptomyces_vietnamensis	362257	S	4640	1496	6136	0.00039
Streptomyces_incarnatus	665007	S	4556	1268	5824	0.00037
Streptomyces_broussonetiae	2686304	S	4551	1321	5872	0.00037
Streptomyces_galilaeus	33899	S	4548	1473	6021	0.00038
Streptomyces_phaeolivaceus	2653200	S	4495	1189	5684	0.00036
Streptomyces_rectiverticillatus	173860	S	4495	1401	5896	0.00038
Streptomyces_olivoreticuli	68246	S	4444	1221	5665	0.00036
Streptomyces_liangshanensis	2717324	S	4438	1090	5528	0.00035
Streptomyces_luteoverticillatus	66425	S	4432	1429	5861	0.00037
Streptomyces_paludis	2282738	S	4406	935	5341	0.00034
Streptomyces_roseochromogenus	285450	S	4372	1316	5688	0.00036
Streptomyces_alboflavus	67267	S	4348	1165	5513	0.00035
Streptomyces_griseocarneus	51201	S	4338	1475	5813	0.00037
Streptomyces_globosus	68209	S	4332	1537	5869	0.00037
Streptomyces_chromofuscus	42881	S	4326	1602	5928	0.00038
Streptomyces_clavuligerus	1901	S	4312	1015	5327	0.00034
Streptomyces_ficellus	1977088	S	4249	1474	5723	0.00037
Streptomyces_aureoverticillatus	66871	S	4228	1102	5330	0.00034
Streptomyces_dangxiongensis	1442032	S	4170	1386	5556	0.00035
Streptomyces_fodineus	1904616	S	4142	1402	5544	0.00035
Streptomyces_lunaelactis	1535768	S	4131	837	4968	0.00032
Streptomyces_exfoliatus	1905	S	3880	1282	5162	0.00033
Streptomyces_coeruleorubidus	116188	S	3784	1721	5505	0.00035
Streptomyces_gobiensis	2875706	S	3735	691	4426	0.00028
Streptomyces_pluripotens	1355015	S	3703	824	4527	0.00029
Streptomyces_peucetius	1950	S	3675	972	4647	0.00030
Streptomyces_hundungensis	1077946	S	3617	1095	4712	0.00030
Streptomyces_lavendulae	1914	S	3604	1208	4812	0.00031
Streptomyces_hawaiiensis	67305	S	3588	1492	5080	0.00032
Streptomyces_atratus	1893	S	3558	698	4256	0.00027
Streptomyces_deccanensis	424188	S	3549	1402	4951	0.00032
Streptomyces_pristinaespiralis	38300	S	3455	1283	4738	0.00030
Streptomyces_inhibens	2293571	S	3437	999	4436	0.00028
Streptomyces_subrutilus	36818	S	3416	1223	4639	0.00030
Streptomyces_gilvosporeus	553510	S	3406	1048	4454	0.00028
Streptomyces_kanamyceticus	1967	S	3377	1090	4467	0.00029
Streptomyces_katrae	68223	S	3361	1218	4579	0.00029
Streptomyces_vinaceus	1960	S	3347	1156	4503	0.00029
Streptomyces_tirandamycinicus	2174846	S	3244	1040	4284	0.00027
Streptomyces_angustmyceticus	285578	S	3215	1253	4468	0.00029
Streptomyces_tuirus	68278	S	3206	1547	4753	0.00030
Streptomyces_mobaraensis	35621	S	3206	117769	120975	0.00772
Streptomyces_spongiicola	1690221	S	3105	1240	4345	0.00028
Streptomyces_nitrosporeus	28894	S	3094	844	3938	0.00025
Streptomyces_fagopyri	2662397	S	2961	968	3929	0.00025
Streptomyces_finlayi	67296	S	2943	649	3592	0.00023
Streptomyces_pratensis	1169025	S	2908	683	3591	0.00023
Streptomyces_gardneri	66892	S	2883	1113	3996	0.00026
Streptomyces_rutgersensis	53451	S	2839	1332	4171	0.00027
Streptomyces_huasconensis	1854574	S	2820	1054	3874	0.00025
Streptomyces_qinzhouensis	2599401	S	2588	598	3186	0.00020
Streptomyces_leeuwenhoekii	1437453	S	2537	1675	4212	0.00027
Streptomyces_nojiriensis	66374	S	2371	970	3341	0.00021
Streptomyces_cyaneogriseus	68192	S	2361	1734	4095	0.00026
Streptomyces_fungicidicus	68203	S	1937	5355	7292	0.00047
Streptomyces_decoyicus	249567	S	1535	809	2344	0.00015
Streptomyces_lydicamycinicus	1546107	S	1396	791	2187	0.00014
Streptomyces_auratus	114687	S	1371	861	2232	0.00014
Streptomyces_antimycoticus	68175	S	1359	1313	2672	0.00017
Streptomyces_platensis	58346	S	1214	856	2070	0.00013
Streptomyces_xiamenensis	408015	S	1194	967	2161	0.00014
Streptomyces_coelicolor	1902	S	443	4838	5281	0.00034
Streptomyces_albidoflavus	1886	S	338	4832	5170	0.00033
Streptomyces_sampsonii	42239	S	168	1286	1454	0.00009
Streptomyces_olivaceus	47716	S	852	2966	3818	0.00024
Streptomyces_alfalfae	1642299	S	782	4200	4982	0.00032
Streptomyces_filamentosus	67294	S	709	839	1548	0.00010
Streptomyces_cavourensis	67258	S	667	1149	1816	0.00012
Streptomyces_californicus	67351	S	607	1873	2480	0.00016
Streptomyces_griseofuscus	146922	S	523	2227	2750	0.00018
Streptomyces_fradiae	1906	S	507	7114	7621	0.00049
Streptomyces_mirabilis	68239	S	501	2841	3342	0.00021
Streptomyces_murinus	33900	S	473	1278	1751	0.00011
Streptomyces_autolyticus	75293	S	432	1378	1810	0.00012
Streptomyces_lividans	1916	S	358	4620	4978	0.00032
Streptomyces_scabiei	1930	S	354	2961	3315	0.00021
Streptomyces_noursei	1971	S	338	1260	1598	0.00010
Streptomyces_albireticuli	1940	S	320	1285	1605	0.00010
Streptomyces_cinereoruber	67260	S	271	1347	1618	0.00010
Streptomyces_rochei	1928	S	217	1548	1765	0.00011
Streptomyces_violaceoruber	1935	S	200	834	1034	0.00007
Streptomyces_rubrolavendulae	285473	S	199	1377	1576	0.00010
Streptomyces_violascens	67381	S	14	1308	1322	0.00008
Streptomyces_sviceus	285530	S	14	1154	1168	0.00007
Kitasatospora_sp._MMS16-BH015	2018025	S	4681	1549	6230	0.00040
Kitasatospora_sp._NA04385	2742135	S	3885	2131	6016	0.00038
Kitasatospora_setae	2066	S	3851	2034	5885	0.00038
Kitasatospora_aureofaciens	1894	S	3227	1324	4551	0.00029
Kitasatospora_albolonga	68173	S	1259	932	2191	0.00014
Streptacidiphilus_sp._P02-A3a	2704468	S	4372	1364	5736	0.00037
Streptacidiphilus_sp._PB12-B1b	2705012	S	4007	1600	5607	0.00036
Streptacidiphilus_bronchialis	2126346	S	3875	1254	5129	0.00033
Yinghuangia_sp._ASG_101	2896848	S	7117	1194	8311	0.00053
Microbacterium_sp._No._7	1714373	S	3453	1568	5021	0.00032
Microbacterium_sp._4R-513	2567934	S	2769	520	3289	0.00021
Microbacterium_sp._JZ31	1906274	S	2520	716	3236	0.00021
Microbacterium_sp._10M-3C3	2483401	S	2464	728	3192	0.00020
Microbacterium_sp._SSW1-51	2851650	S	2168	538	2706	0.00017
Microbacterium_sp._YJN-G	2763257	S	2012	664	2676	0.00017
Microbacterium_sp._ABRD_28	2268461	S	1763	244	2007	0.00013
Microbacterium_sp._XT11	367477	S	1652	355	2007	0.00013
Microbacterium_sp._SSW1-36	2851648	S	1638	357	1995	0.00013
Microbacterium_sp._NIBRBAC000506063	2734618	S	1636	682	2318	0.00015
Microbacterium_sp._BH-3-3-3	1906742	S	1568	382	1950	0.00012
Microbacterium_sp._H1-D42	2925844	S	1534	257	1791	0.00011
Microbacterium_sp._cx-55	2875948	S	1510	227	1737	0.00011
Microbacterium_sp._PM5	2014534	S	1509	285	1794	0.00011
Microbacterium_sp._A18JL241	2782166	S	1500	348	1848	0.00012
Microbacterium_sp._LKL04	912630	S	1498	363	1861	0.00012
Microbacterium_sp._Y-01	2048898	S	1455	570	2025	0.00013
Microbacterium_sp._1S1	2606451	S	1232	500	1732	0.00011
Microbacterium_sp._CBA3102	2603598	S	1224	293	1517	0.00010
Microbacterium_sp._TPU_3598	1938334	S	1138	290	1428	0.00009
Microbacterium_sp._Nx66	2766784	S	987	616	1603	0.00010
Microbacterium_sp._RG1	2489212	S	662	516	1178	0.00008
Microbacterium_sp._CGR1	1696072	S	287	865	1152	0.00007
Microbacterium_sp._1.5R	1916917	S	275	796	1071	0.00007
Microbacterium_sp._SGAir0570	2070348	S	250	901	1151	0.00007
Microbacterium_sp._PAMC22086	2861281	S	238	501	739	0.00005
Microbacterium_sp._str._'China'	2103230	S	151	767	918	0.00006
Microbacterium_sp._PAMC_28756	1795053	S	67	1062	1129	0.00007
Microbacterium_sp._KUDC0406	2909588	S	26	1713	1739	0.00011
Microbacterium_sp._PAMC21962	2861280	S	18	753	771	0.00005
Microbacterium_sp._Se5.02b	2864103	S	15	997	1012	0.00006
Microbacterium_sp._Se63.02b	2709304	S	14	971	985	0.00006
Microbacterium_sp._KUDC0405	2909587	S	10	656	666	0.00004
Microbacterium_cremeum	2782169	S	3881	847	4728	0.00030
Microbacterium_foliorum	104336	S	3673	788	4461	0.00028
Microbacterium_hominis	162426	S	3203	9091	12294	0.00078
Microbacterium_oleivorans	273677	S	3151	633	3784	0.00024
Microbacterium_atlanticum	2782168	S	2857	651	3508	0.00022
Microbacterium_resistens	156977	S	2466	469	2935	0.00019
Microbacterium_sediminis	904291	S	2381	1101	3482	0.00022
Microbacterium_lemovicicum	1072463	S	2304	540	2844	0.00018
Microbacterium_oryzae	743009	S	2103	644	2747	0.00018
Microbacterium_testaceum	2033	S	1975	372	2347	0.00015
Microbacterium_pygmaeum	370764	S	1845	238	2083	0.00013
Microbacterium_wangchenii	2541726	S	1828	427	2255	0.00014
Microbacterium_protaetiae	2509458	S	1798	422	2220	0.00014
Microbacterium_caowuchunii	2614638	S	1790	351	2141	0.00014
Microbacterium_aurum	36805	S	1723	555	2278	0.00015
Microbacterium_esteraromaticum	57043	S	1685	386	2071	0.00013
Microbacterium_chocolatum	84292	S	1672	386	2058	0.00013
Microbacterium_oxydans	82380	S	1594	1253	2847	0.00018
Microbacterium_luteum	2782167	S	1580	674	2254	0.00014
Microbacterium_lushaniae	2614639	S	1553	369	1922	0.00012
Microbacterium_hydrocarbonoxydans	273678	S	1285	239	1524	0.00010
Microbacterium_schleiferi	69362	S	1004	340	1344	0.00009
Microbacterium_fandaimingii	2708079	S	860	74	934	0.00006
Microbacterium_binotii	462710	S	698	536	1234	0.00008
Microbacterium_chengjingii	2769067	S	625	34	659	0.00004
Microbacterium_amylolyticum	936337	S	595	130	725	0.00005
Microbacterium_endophyticum	1526412	S	405	29	434	0.00003
Microbacterium_paraoxydans	199592	S	229	1571	1800	0.00011
Microbacterium_paludicola	300019	S	224	845	1069	0.00007
Agromyces_sp._H17E-10	2932244	S	3435	1224	4659	0.00030
Agromyces_sp._LHK192	2498704	S	2969	936	3905	0.00025
Agromyces_sp._CFWR-12	2929802	S	2224	1351	3575	0.00023
Agromyces_flavus	589382	S	3402	1169	4571	0.00029
Agromyces_soli	659012	S	3371	1335	4706	0.00030
Agromyces_aureus	453304	S	2738	845	3583	0.00023
Agromyces_protaetiae	2509455	S	2622	814	3436	0.00022
Agromyces_marinus	1389020	S	2461	975	3436	0.00022
Agromyces_archimandritae	2781962	S	2402	752	3154	0.00020
Agromyces_intestinalis	2592652	S	2237	1285	3522	0.00022
Agromyces_badenianii	2080742	S	2017	716	2733	0.00017
Agromyces_laixinhei	2585717	S	1890	471	2361	0.00015
Curtobacterium_sp._L6-1	2841594	S	1863	646	2509	0.00016
Curtobacterium_sp._BH-2-1-1	1905847	S	1838	646	2484	0.00016
Curtobacterium_sp._MR_MD2014	1561023	S	1411	687	2098	0.00013
Curtobacterium_sp._YC1	2795488	S	1333	644	1977	0.00013
Curtobacterium_sp._TC1	2862880	S	1282	685	1967	0.00013
Curtobacterium_sp._24E2	2804758	S	1105	627	1732	0.00011
Curtobacterium_sp._SGAir0471	2070337	S	927	768	1695	0.00011
Curtobacterium_sp._TXMA1	2876939	S	896	768	1664	0.00011
Curtobacterium_sp._C1	2898151	S	366	1135	1501	0.00010
Curtobacterium_sp._Csp2	2495430	S	362	1269	1631	0.00010
Curtobacterium_sp._Csp1	2495429	S	60	1372	1432	0.00009
Curtobacterium_flaccumfaciens	2035	S	2856	1398	4254	0.00027
Curtobacterium_luteum	33881	S	1793	686	2479	0.00016
Rathayibacter_sp._VKM_Ac-2759	2609252	S	2466	932	3398	0.00022
Rathayibacter_sp._VKM_Ac-2760	2609253	S	2269	1219	3488	0.00022
Rathayibacter_sp._VKM_Ac-2804	2609257	S	1630	1219	2849	0.00018
Rathayibacter_sp._VKM_Ac-2801	2609255	S	895	856	1751	0.00011
Rathayibacter_sp._VKM_Ac-2762	2609254	S	424	1160	1584	0.00010
Rathayibacter_sp._VKM_Ac-2805	2609258	S	392	1106	1498	0.00010
Rathayibacter_festucae	110937	S	2412	2648	5060	0.00032
Rathayibacter_tanaceti	1671680	S	1501	414	1915	0.00012
Rathayibacter_iranicus	59737	S	936	134	1070	0.00007
Rathayibacter_tritici	33888	S	912	290	1202	0.00008
Rathayibacter_rathayi	33887	S	805	228	1033	0.00007
Rathayibacter_toxicus	145458	S	350	32	382	0.00002
Leucobacter_sp._H25R-14	2932245	S	1878	336	2214	0.00014
Leucobacter_sp._NB_10	2873270	S	1780	527	2307	0.00015
Leucobacter_sp._Psy1	2875729	S	1429	193	1622	0.00010
Leucobacter_sp._CX169	2813744	S	1085	311	1396	0.00009
Leucobacter_sp._H21R-36	2932246	S	569	1523	2092	0.00013
Leucobacter_sp._H21R-40	2932247	S	461	1236	1697	0.00011
Leucobacter_triazinivorans	1784719	S	1861	1145	3006	0.00019
Leucobacter_muris	1935379	S	1860	710	2570	0.00016
Leucobacter_luti	340320	S	631	63	694	0.00004
Leucobacter_insecticola	2714934	S	466	42	508	0.00003
Leucobacter_viscericola	2714935	S	437	45	482	0.00003
Leucobacter_denitrificans	683042	S	373	59	432	0.00003
Leucobacter_coleopterorum	2714933	S	321	34	355	0.00002
Leifsonia_sp._ZF2019	2781978	S	2519	779	3298	0.00021
Leifsonia_sp._PS1209	2724914	S	2409	740	3149	0.00020
Leifsonia_sp._21MFCrub1.1	1798223	S	2383	3113	5496	0.00035
Leifsonia_shinshuensis	150026	S	3242	1045	4287	0.00027
Leifsonia_xyli	1575	S	1913	298	2211	0.00014
Agrococcus_sp._SGAir0287	2070347	S	2823	987	3810	0.00024
Agrococcus_sp._SCSIO52902	2933290	S	2779	1552	4331	0.00028
Agrococcus_sp._Marseille-Q4369	2810513	S	2759	1111	3870	0.00025
Agrococcus_jejuensis	399736	S	3083	1123	4206	0.00027
Agrococcus_carbonis	684552	S	2772	1471	4243	0.00027
Clavibacter_michiganensis	28447	S	10568	12424	22992	0.00147
Clavibacter_zhangzhiyongii	2768071	S	1372	742	2114	0.00013
Clavibacter_sp._A6099	2860285	S	800	576	1376	0.00009
Protaetiibacter_sp._SSC-01	2759943	S	2598	1120	3718	0.00024
Protaetiibacter_intestinalis	2419774	S	2530	1063	3593	0.00023
Protaetiibacter_larvae	2592654	S	1862	690	2552	0.00016
Salinibacterium_sp._ZJ450	2708338	S	1671	292	1963	0.00013
Salinibacterium_sp._ZJ70	2708084	S	1658	481	2139	0.00014
Salinibacterium_sp._dk2585	2603292	S	1183	220	1403	0.00009
Salinibacterium_sp._M195	2583374	S	430	55	485	0.00003
Salinibacterium_sp._UTAS2018	2508880	S	426	46	472	0.00003
Salinibacterium_hongtaonis	2079791	S	642	74	716	0.00005
Cryobacterium_sp._LW097	1978566	S	1332	316	1648	0.00011
Cryobacterium_sp._PAMC25264	2861288	S	672	446	1118	0.00007
Cryobacterium_soli	2220095	S	969	558	1527	0.00010
Cryobacterium_arcticum	670052	S	780	653	1433	0.00009
Frondihabitans_sp._PAMC_28766	1795630	S	2347	357	2704	0.00017
Frondihabitans_sp._762G35	1446794	S	2147	524	2671	0.00017
Microterricola_viridarii	412690	S	3907	1102	5009	0.00032
Plantibacter_sp._M259	2583822	S	730	709	1439	0.00009
Plantibacter_sp._PA-3-X8	2480625	S	729	731	1460	0.00009
Plantibacter_flavus	150123	S	787	720	1507	0.00010
Microcella_flavibacter	1804990	S	2216	1201	3417	0.00022
Microcella_alkaliphila	279828	S	1397	278	1675	0.00011
Cnuibacter_physcomitrellae	1619308	S	2814	701	3515	0.00022
Gryllotalpicola_protaetiae	2419771	S	2745	603	3348	0.00021
Herbiconiux_sp._SALV-R1	2735133	S	2550	586	3136	0.00020
Frigoribacterium_sp._NBH87	2596916	S	2495	842	3337	0.00021
Mycetocola_sp._JXN-3	2116510	S	888	143	1031	0.00007
Mycetocola_zhujimingii	2079792	S	878	117	995	0.00006
Mycetocola_spongiae	2859226	S	628	88	716	0.00005
Humibacter_sp._WJ7-1	2599293	S	2295	584	2879	0.00018
Subtercola_sp._AK-R2A1-2	2895559	S	1337	133	1470	0.00009
Subtercola_sp._PAMC28395	2846775	S	907	95	1002	0.00006
Chryseoglobus_indicus	2750620	S	434	980	1414	0.00009
Chryseoglobus_sp._28M-23	2772253	S	391	840	1231	0.00008
Amnibacterium_sp._L3-i23	2905871	S	2115	581	2696	0.00017
Gulosibacter_sediminis	1729695	S	1841	591	2432	0.00016
Marisediminicola_antarctica	674079	S	1696	240	1936	0.00012
Diaminobutyricimonas_sp._LJ205	2683590	S	1342	287	1629	0.00010
Agreia_sp._COWG	2773266	S	1258	173	1431	0.00009
Glaciihabitans_sp._INWT7	2596912	S	1195	108	1303	0.00008
Aquiluna_borgnonia	2499157	S	127	11	138	0.00001
Candidatus_Aquiluna_sp._UB-MaderosW2red	1855377	S	86	4	90	0.00001
Rhodoluna_limnophila	232537	S	69	8	77	0.00000
Candidatus_Rhodoluna_planktonica	535712	S	54	3	57	0.00000
Rhodoluna_lacicola	529884	S	47	6	53	0.00000
Pseudoclavibacter_sp._Marseille-Q3772	2866588	S	322	67	389	0.00002
Aurantimicrobium_photophilum	1987356	S	97	8	105	0.00001
Aurantimicrobium_minutum	708131	S	61	16	77	0.00000
Aurantimicrobium_sp._MWH-Uga1	2079575	S	37	10	47	0.00000
Pontimonas_salivibrio	1159327	S	123	6	129	0.00001
Arthrobacter_sp._NicSoilC5	2831000	S	2165	1288	3453	0.00022
Arthrobacter_sp._QL17	2895818	S	1924	483	2407	0.00015
Arthrobacter_sp._QXT-31	1357915	S	1618	501	2119	0.00014
Arthrobacter_sp._PM3	2017685	S	1523	273	1796	0.00011
Arthrobacter_sp._FW305-BF8	2879617	S	1477	453	1930	0.00012
Arthrobacter_sp._NicSoilB8	2830998	S	1410	410	1820	0.00012
Arthrobacter_sp._24S4-2	2575374	S	1231	313	1544	0.00010
Arthrobacter_sp._U41	1849032	S	1218	391	1609	0.00010
Arthrobacter_sp._UKPF54-2	2600159	S	1194	560	1754	0.00011
Arthrobacter_sp._KBS0702	2578107	S	1158	512	1670	0.00011
Arthrobacter_sp._PAMC25564	2565366	S	1133	344	1477	0.00009
Arthrobacter_sp._NicSoilB4	2830997	S	1121	394	1515	0.00010
Arthrobacter_sp._ERGS1:01	1704044	S	1100	231	1331	0.00009
Arthrobacter_sp._FB24	290399	S	1094	407	1501	0.00010
Arthrobacter_sp._Helios	2828862	S	984	175	1159	0.00007
Arthrobacter_sp._PAMC25284	2861279	S	956	278	1234	0.00008
Arthrobacter_sp._FW306-2-2C-D06B	2879618	S	875	189	1064	0.00007
Arthrobacter_sp._PGP41	2079227	S	866	355	1221	0.00008
Arthrobacter_sp._zg-Y462	2886936	S	805	178	983	0.00006
Arthrobacter_sp._PAMC_25486	1494608	S	722	128	850	0.00005
Arthrobacter_sp._zg-Y809	2886940	S	669	241	910	0.00006
Arthrobacter_sp._StoSoilB5	2830992	S	497	161	658	0.00004
Arthrobacter_sp._NtRootA1	2830983	S	492	168	660	0.00004
Arthrobacter_sp._StoSoilB20	2830995	S	485	156	641	0.00004
Arthrobacter_sp._D5-1	1477518	S	402	304	706	0.00005
Arthrobacter_sp._YN	2020486	S	365	170	535	0.00003
Arthrobacter_sp._FW306-06-A	2879621	S	331	1223	1554	0.00010
Arthrobacter_sp._FW306-07-I	2879622	S	283	1668	1951	0.00012
Arthrobacter_sp._C1-1	2813727	S	282	42	324	0.00002
Arthrobacter_sp._NicSoilB11	2830999	S	238	1001	1239	0.00008
Arthrobacter_sp._FW306-05-C	2879620	S	224	1232	1456	0.00009
Arthrobacter_sp._StoSoilB19	2830994	S	223	1079	1302	0.00008
Arthrobacter_sp._StoSoilB13	2830993	S	156	303	459	0.00003
Arthrobacter_sp._StoSoilA2	2830990	S	122	230	352	0.00002
Arthrobacter_sp._AQ5-05	2184581	S	37	581	618	0.00004
Arthrobacter_agilis	37921	S	3085	488	3573	0.00023
Arthrobacter_crystallopoietes	37928	S	2764	543	3307	0.00021
Arthrobacter_sulfonylureivorans	2486855	S	1557	269	1826	0.00012
Arthrobacter_woluwensis	156980	S	1304	321	1625	0.00010
Arthrobacter_dokdonellae	2211210	S	1257	229	1486	0.00009
Arthrobacter_jiangjiafuii	2817475	S	932	268	1200	0.00008
Arthrobacter_alpinus	656366	S	720	987	1707	0.00011
Arthrobacter_sunyaminii	2816859	S	606	202	808	0.00005
Kocuria_rosea	1275	S	2955	984	3939	0.00025
Kocuria_flava	446860	S	2478	1312	3790	0.00024
Kocuria_turfanensis	388357	S	2424	875	3299	0.00021
Kocuria_palustris	71999	S	1497	623	2120	0.00014
Kocuria_rhizophila	72000	S	1107	1679	2786	0.00018
Kocuria_varians	1272	S	939	676	1615	0.00010
Kocuria_sp._TGY1127_2	2711328	S	417	73	490	0.00003
Kocuria_sp._KD4	2719588	S	235	385	620	0.00004
Kocuria_sp._BT304	1702043	S	120	591	711	0.00005
Kocuria_indica	1049583	S	195	378	573	0.00004
Pseudarthrobacter_sp._BIM_B-2242	2772401	S	851	238	1089	0.00007
Pseudarthrobacter_sp._L1SW	2851598	S	786	359	1145	0.00007
Pseudarthrobacter_sp._NIBRBAC000502772	2590775	S	506	391	897	0.00006
Pseudarthrobacter_sp._NBSH8	2596911	S	462	190	652	0.00004
Pseudarthrobacter_sp._SSS035	2931399	S	404	370	774	0.00005
Pseudarthrobacter_sp._NIBRBAC000502771	2590774	S	337	1151	1488	0.00010
Pseudarthrobacter_sp._NIBRBAC000502770	2590785	S	269	810	1079	0.00007
Pseudarthrobacter_phenanthrenivorans	361575	S	845	458	1303	0.00008
Pseudarthrobacter_chlorophenolicus	85085	S	825	335	1160	0.00007
Pseudarthrobacter_equi	728066	S	791	336	1127	0.00007
Pseudarthrobacter_psychrotolerans	2697569	S	710	312	1022	0.00007
Pseudarthrobacter_sulfonivorans	121292	S	371	411	782	0.00005
Micrococcus_luteus	1270	S	3260	5599	8859	0.00057
Micrococcus_sp._KD337-16	2856555	S	1372	885	2257	0.00014
Micrococcus_sp._KBS0714	1179670	S	56	476	532	0.00003
Micrococcus_yunnanensis	566027	S	40	320	360	0.00002
Sinomonas_atrocyanea	37927	S	3345	1156	4501	0.00029
Sinomonas_sp._R1AF57	2020377	S	2936	727	3663	0.00023
Glutamicibacter_protophormiae	37930	S	972	635	1607	0.00010
Glutamicibacter_creatinolyticus	162496	S	926	237	1163	0.00007
Glutamicibacter_halophytocola	1933880	S	461	90	551	0.00004
Glutamicibacter_mishrai	1775880	S	393	91	484	0.00003
Glutamicibacter_arilaitensis	256701	S	344	136	480	0.00003
Glutamicibacter_nicotianae	37929	S	270	796	1066	0.00007
Glutamicibacter_sp._ZJUTW	1155384	S	85	354	439	0.00003
Rothia_kristinae	37923	S	1630	1015	2645	0.00017
Rothia_mucilaginosa	43675	S	478	102	580	0.00004
Rothia_nasimurium	85336	S	222	115	337	0.00002
Rothia_aeria	172042	S	219	91	310	0.00002
Rothia_dentocariosa	2047	S	146	66	212	0.00001
Rothia_terrae	396015	S	99	42	141	0.00001
Rothia_sp._ZJ932	2810516	S	93	15	108	0.00001
Rothia_amarae	169480	S	78	35	113	0.00001
Paenarthrobacter_ureafaciens	37931	S	664	1230	1894	0.00012
Paenarthrobacter_aurescens	43663	S	640	454	1094	0.00007
Paenarthrobacter_sp._YJN-5	2735316	S	189	487	676	0.00004
Paenarthrobacter_sp._YJN-D	2735317	S	95	225	320	0.00002
Paenarthrobacter_nicotinovorans	29320	S	127	263	390	0.00002
Citricoccus_sp._SGAir0253	2567881	S	2501	745	3246	0.00021
Nesterenkonia_sp._NBAIMH1	2600320	S	967	68	1035	0.00007
Paeniglutamicibacter_sp._Y32M11	2853258	S	426	72	498	0.00003
Psychromicrobium_lacuslunae	1618207	S	337	50	387	0.00002
Neomicrococcus_aestuarii	556325	S	300	141	441	0.00003
Auritidibacter_sp._NML130574	2170745	S	259	29	288	0.00002
Renibacterium_salmoninarum	1646	S	188	12	200	0.00001
Cellulomonas_sp._Y8	2591145	S	4515	2291	6806	0.00043
Cellulomonas_sp._H30R-01	2704467	S	4383	2031	6414	0.00041
Cellulomonas_sp._JZ18	2654191	S	3816	1933	5749	0.00037
Cellulomonas_sp._C5510	2871170	S	3751	1790	5541	0.00035
Cellulomonas_sp._zg-ZUI188	2819978	S	3372	1113	4485	0.00029
Cellulomonas_sp._zg-ZUI157	2819979	S	3121	1279	4400	0.00028
Cellulomonas_sp._zg-ZUI222	2816956	S	3059	1356	4415	0.00028
Cellulomonas_sp._EW123	2608402	S	2935	2023	4958	0.00032
Cellulomonas_sp._PSBB021	2003551	S	2679	2530	5209	0.00033
Cellulomonas_fimi	1708	S	3980	3329	7309	0.00047
Cellulomonas_iranensis	76862	S	3522	1944	5466	0.00035
Cellulomonas_flavigena	1711	S	3356	1507	4863	0.00031
Cellulomonas_shaoxiangyii	2566013	S	3325	1626	4951	0.00032
Cellulomonas_gilvus	11	S	2903	1514	4417	0.00028
Cellulomonas_taurus	2729175	S	2239	836	3075	0.00020
Actinotalea_sp._JY-7876	2758442	S	3656	1558	5214	0.00033
Pseudactinotalea_sp._HY158	2654547	S	2949	499	3448	0.00022
Oerskovia_sp._KBS0722	1179673	S	2830	1074	3904	0.00025
Paraoerskovia_marina	545619	S	2108	643	2751	0.00018
Janibacter_melonis	262209	S	3940	1519	5459	0.00035
Janibacter_limosus	53458	S	2745	830	3575	0.00023
Janibacter_indicus	857417	S	1426	2249	3675	0.00023
Janibacter_sp._YB324	2761047	S	915	1934	2849	0.00018
Phycicoccus_sp._HDW14	2714941	S	4931	1865	6796	0.00043
Phycicoccus_endophyticus	1690220	S	4409	1488	5897	0.00038
Pedococcus_dokdonensis	443156	S	6966	2327	9293	0.00059
Tetrasphaera_sp._HKS02	1813880	S	5444	1609	7053	0.00045
Intrasporangium_calvum	53358	S	4924	1505	6429	0.00041
Arsenicicoccus_sp._oral_taxon_190	1658671	S	3816	1678	5494	0.00035
Cellulosimicrobium_cellulans	1710	S	6944	8275	15219	0.00097
Cellulosimicrobium_sp._BI34T	2587808	S	2947	1577	4524	0.00029
Cellulosimicrobium_sp._JZ28	1906273	S	676	1766	2442	0.00016
Cellulosimicrobium_sp._72-3	2731680	S	346	1721	2067	0.00013
Cellulosimicrobium_sp._TH-20	1980001	S	288	1477	1765	0.00011
Xylanimonas_protaetiae	2509457	S	3121	1601	4722	0.00030
Xylanimonas_allomyrinae	2509459	S	2807	1032	3839	0.00025
Xylanimonas_cellulosilytica	186189	S	2685	1117	3802	0.00024
Isoptericola_variabilis	139208	S	3584	2216	5800	0.00037
Isoptericola_dokdonensis	372663	S	3009	1365	4374	0.00028
Ornithinimicrobium_avium	2283195	S	3825	1151	4976	0.00032
Ornithinimicrobium_flavum	1288636	S	3040	1114	4154	0.00027
Ornithinimicrobium_sp._HY006	2508882	S	2533	975	3508	0.00022
Ornithinimicrobium_sp._INDO-MA30-4	2908651	S	490	98	588	0.00004
Ornithinimicrobium_ciconiae	2594265	S	2420	427	2847	0.00018
Ornithinimicrobium_pratense	2593973	S	1924	630	2554	0.00016
Serinicoccus_chungangensis	767452	S	2814	1077	3891	0.00025
Serinicoccus_hydrothermalis	1758689	S	2584	1323	3907	0.00025
Serinicoccus_profundi	1078471	S	2451	990	3441	0.00022
Serinicoccus_marinus	247333	S	2172	1175	3347	0.00021
Brachybacterium_sp._CBA3105	2887346	S	2820	722	3542	0.00023
Brachybacterium_sp._SGAir0954	2571029	S	2553	785	3338	0.00021
Brachybacterium_sp._P6-10-X1	1903186	S	2107	408	2515	0.00016
Brachybacterium_faecium	43669	S	2136	723	2859	0.00018
Brachybacterium_ginsengisoli	1331682	S	1995	643	2638	0.00017
Brachybacterium_saurashtrense	556288	S	1991	632	2623	0.00017
Brachybacterium_vulturis	2017484	S	1506	607	2113	0.00013
Brachybacterium_avium	2017485	S	1256	506	1762	0.00011
Dermabacter_vaginalis	1630135	S	700	509	1209	0.00008
Dermabacter_jinjuensis	1667168	S	584	539	1123	0.00007
Devriesea_agamarum	472569	S	305	19	324	0.00002
Brevibacterium_sp._CS2	2575923	S	2470	1125	3595	0.00023
Brevibacterium_sp._SMBL_HHYL_HB1	2777556	S	1033	261	1294	0.00008
Brevibacterium_sp._HY170	2898795	S	441	145	586	0.00004
Brevibacterium_sp._'Marine'	2725563	S	369	272	641	0.00004
Brevibacterium_sp._W7.2	2823518	S	346	1830	2176	0.00014
Brevibacterium_casei	33889	S	2558	1944	4502	0.00029
Brevibacterium_luteolum	199591	S	1319	593	1912	0.00012
Brevibacterium_linens	1703	S	1246	822	2068	0.00013
Brevibacterium_aurantiacum	273384	S	798	578	1376	0.00009
Brevibacterium_atlanticum	2697563	S	768	179	947	0.00006
Brevibacterium_oceani	358099	S	748	185	933	0.00006
Brevibacterium_sandarakinum	629680	S	698	140	838	0.00005
Brevibacterium_limosum	2697565	S	670	272	942	0.00006
Brevibacterium_siliguriense	1136497	S	476	154	630	0.00004
Brevibacterium_pigmentatum	1496080	S	369	300	669	0.00004
Georgenia_yuyongxinii	2589797	S	4075	1148	5223	0.00033
Georgenia_sp._TF02-10	2917725	S	4037	1716	5753	0.00037
Georgenia_wutianyii	2585135	S	3514	1402	4916	0.00031
Georgenia_faecalis	2483799	S	3106	993	4099	0.00026
Dermacoccus_nishinomiyaensis	1274	S	2602	1304	3906	0.00025
Dermacoccus_sp._PAMC28757	2762331	S	1861	778	2639	0.00017
Luteipulveratus_mongoliensis	571913	S	3443	557	4000	0.00026
Allobranchiibius_sp._GilTou73	2904523	S	2856	726	3582	0.00023
Yimella_sp._cx-51	2770551	S	1586	365	1951	0.00012
Haloactinobacterium_kanbiaonis	2675754	S	3560	600	4160	0.00027
Ruania_sp._LR1S40	2897774	S	2193	527	2720	0.00017
Ruania_sp._M4N3S171	2897773	S	1308	212	1520	0.00010
Ruania_zhangjianzhongii	2603206	S	2298	263	2561	0.00016
Ruania_alkalisoli	2779775	S	1478	290	1768	0.00011
Pengzhenrongella_sicca	2819238	S	4481	1461	5942	0.00038
Luteimicrobium_xylanilyticum	1133546	S	3697	1343	5040	0.00032
Beutenbergia_cavernae	84757	S	4780	931	5711	0.00036
Miniimonas_sp._S16	2171623	S	3344	2082	5426	0.00035
Sanguibacter_keddieii	60920	S	2722	948	3670	0.00023
Sanguibacter_sp._HDW7	2714931	S	2715	995	3710	0.00024
Kytococcus_sedentarius	1276	S	2362	984	3346	0.00021
Gephyromycinifex_aptenodytis	2716227	S	1180	159	1339	0.00009
Austwickia_chelonae	100225	S	847	76	923	0.00006
Dermatophilus_congolensis	1863	S	260	27	287	0.00002
Demequina_sp._TMPB413	2881056	S	879	78	957	0.00006
Jonesia_denitrificans	43674	S	158	31	189	0.00001
Tropheryma_whipplei	2039	S	50	0	50	0.00000
Mycolicibacterium_fortuitum	1766	S	8329	3099	11428	0.00073
Mycolicibacterium_smegmatis	1772	S	5986	2622	8608	0.00055
Mycolicibacterium_litorale	758802	S	5518	1414	6932	0.00044
Mycolicibacterium_rutilum	370526	S	4673	1279	5952	0.00038
Mycolicibacterium_sp._YH-1	2908837	S	2422	1414	3836	0.00024
Mycolicibacterium_celeriflavum	1249101	S	3423	607	4030	0.00026
Mycolicibacterium_phlei	1771	S	3393	1081	4474	0.00029
Mycolicibacterium_chubuense	1800	S	3287	678	3965	0.00025
Mycolicibacterium_sediminis	1286180	S	3277	562	3839	0.00025
Mycolicibacterium_pulveris	36813	S	3276	515	3791	0.00024
Mycolicibacterium_madagascariense	212765	S	3231	465	3696	0.00024
Mycolicibacterium_mageritense	53462	S	3184	497	3681	0.00024
Mycolicibacterium_hassiacum	46351	S	3158	813	3971	0.00025
Mycolicibacterium_neoaurum	1795	S	3155	653	3808	0.00024
Mycolicibacterium_arabiense	1286181	S	3142	458	3600	0.00023
Mycolicibacterium_moriokaense	39691	S	3108	359	3467	0.00022
Mycolicibacterium_parafortuitum	39692	S	2928	554	3482	0.00022
Mycolicibacterium_rhodesiae	36814	S	2914	440	3354	0.00021
Mycolicibacterium_vaccae	1810	S	2789	520	3309	0.00021
Mycolicibacterium_psychrotolerans	216929	S	2709	565	3274	0.00021
Mycolicibacterium_gadium	1794	S	2699	340	3039	0.00019
Mycolicibacterium_chitae	1792	S	2681	604	3285	0.00021
Mycolicibacterium_thermoresistibile	1797	S	2635	559	3194	0.00020
Mycolicibacterium_monacense	85693	S	2550	762	3312	0.00021
Mycolicibacterium_duvalii	39688	S	2479	463	2942	0.00019
Mycolicibacterium_gilvum	1804	S	2455	817	3272	0.00021
Mycolicibacterium_poriferae	39694	S	2398	470	2868	0.00018
Mycolicibacterium_fluoranthenivorans	258505	S	2333	287	2620	0.00017
Mycolicibacterium_baixiangningiae	2761578	S	2259	348	2607	0.00017
Mycolicibacterium_aurum	1791	S	2249	279	2528	0.00016
Mycolicibacterium_phocaicum	319706	S	2214	1106	3320	0.00021
Mycolicibacterium_confluentis	28047	S	2149	309	2458	0.00016
Mycolicibacterium_tokaiense	39695	S	2131	316	2447	0.00016
Mycolicibacterium_fallax	1793	S	2106	774	2880	0.00018
Mycolicibacterium_boenickei	146017	S	1791	2326	4117	0.00026
Mycolicibacterium_mengxianglii	2736649	S	1779	181	1960	0.00013
Mycolicibacterium_anyangense	1431246	S	1776	272	2048	0.00013
Mycolicibacterium_aichiense	1799	S	1766	280	2046	0.00013
Mycolicibacterium_insubricum	444597	S	1743	449	2192	0.00014
Mycolicibacterium_austroafricanum	39687	S	1737	6666	8403	0.00054
Mycolicibacterium_helvum	1534349	S	1549	175	1724	0.00011
Mycobacterium_doricum	126673	S	1547	337	1884	0.00012
Mycolicibacterium_mucogenicum	56689	S	1442	569	2011	0.00013
Mycolicibacterium_alvei	67081	S	1258	312	1570	0.00010
Mycolicibacterium_sarraceniae	1534348	S	1210	147	1357	0.00009
Mycolicibacterium_septicum	98668	S	895	583	1478	0.00009
Mycolicibacterium_farcinogenes	1802	S	651	1828	2479	0.00016
Mycolicibacterium_vanbaalenii	110539	S	326	4969	5295	0.00034
Mycolicibacterium_nivoides	2487344	S	212	979	1191	0.00008
Mycobacterium_sp._JS623	212767	S	7730	601	8331	0.00053
Mycobacterium_sp._IDR2000157661	2867005	S	2952	487	3439	0.00022
Mycobacterium_sp._YC-RL4	1682113	S	1816	584	2400	0.00015
Mycobacterium_sp._MS1601	1936029	S	1758	227	1985	0.00013
Mycobacterium_sp._DL592	2675524	S	1755	264	2019	0.00013
Mycobacterium_sp._EPa45	1545728	S	1677	253	1930	0.00012
Mycobacterium_sp._DL440	2675523	S	1266	245	1511	0.00010
Mycobacterium_sp._TY59	2775496	S	1219	175	1394	0.00009
Mycobacterium_sp._WY10	1920667	S	244	540	784	0.00005
Mycobacterium_sp._PYR15	2051552	S	98	620	718	0.00005
Mycobacterium_sp._20KCMC460	2903536	S	75	1473	1548	0.00010
Mycobacterium_sp._MOTT36Y	1168287	S	57	518	575	0.00004
Mycobacterium_sp._IWGMT90018-18076	2871094	S	18	643	661	0.00004
Mycobacterium_saskatchewanense	220927	S	2337	426	2763	0.00018
Mycobacterium_parmense	185642	S	2276	370	2646	0.00017
Mycobacterium_kubicae	120959	S	1919	263	2182	0.00014
Mycobacterium_shigaense	722731	S	1641	219	1860	0.00012
Mycobacterium_simiae	1784	S	1601	130	1731	0.00011
Mycobacterium_heidelbergense	53376	S	1500	312	1812	0.00012
Mycobacterium_florentinum	292462	S	1473	306	1779	0.00011
Mycobacterium_stomatepiae	470076	S	1457	272	1729	0.00011
Mycobacterium_lentiflavum	141349	S	1444	312	1756	0.00011
Mycobacterium_avium	1764	S	3304	2501	5805	0.00037
Mycobacterium_intracellulare	1767	S	2594	17912	20506	0.00131
Mycobacterium_colombiense	339268	S	1586	242	1828	0.00012
Mycobacterium_mantenii	560555	S	1530	169	1699	0.00011
Mycobacterium_marseillense	701042	S	1451	296	1747	0.00011
Mycobacterium_paraintracellulare	1138383	S	527	2750	3277	0.00021
Mycobacterium_goodii	134601	S	11613	3611	15224	0.00097
Mycobacterium_grossiae	1552759	S	3308	896	4204	0.00027
Mycobacterium_rufum	318424	S	3008	792	3800	0.00024
Mycobacterium_holsaticum	152142	S	2890	415	3305	0.00021
Mycobacterium_dioxanotrophicus	482462	S	2556	554	3110	0.00020
Mycobacterium_branderi	43348	S	2308	252	2560	0.00016
Mycobacterium_diernhoferi	1801	S	2178	397	2575	0.00016
Mycobacterium_frederiksbergense	117567	S	2046	550	2596	0.00017
Mycobacterium_conspicuum	44010	S	2019	218	2237	0.00014
Mycobacterium_canettii	78331	S	685	414	1099	0.00007
Mycobacterium_tuberculosis	1773	S	413	9495	9908	0.00063
Mycobacterium_paragordonae	1389713	S	1970	205	2175	0.00014
Mycobacterium_cookii	1775	S	1854	173	2027	0.00013
Mycobacterium_paraterrae	577492	S	1715	171	1886	0.00012
Mycobacterium_noviomagense	459858	S	1715	127	1842	0.00012
Mycobacterium_gordonae	1778	S	1662	123	1785	0.00011
Mycobacterium_koreense	1069220	S	1619	427	2046	0.00013
Mycobacterium_heckeshornense	110505	S	1563	108	1671	0.00011
Mycobacterium_kansasii	1768	S	1547	10811	12358	0.00079
Mycobacterium_paraseoulense	590652	S	1409	234	1643	0.00010
Mycobacterium_virginiense	1795032	S	1398	327	1725	0.00011
Mycobacterium_vicinigordonae	1719132	S	1390	68	1458	0.00009
Mycobacterium_xenopi	1789	S	1350	134	1484	0.00009
Mycobacterium_riyadhense	486698	S	1334	51	1385	0.00009
Mycobacterium_shinjukuense	398694	S	1324	115	1439	0.00009
Mycobacterium_lacus	169765	S	1307	88	1395	0.00009
Mycobacterium_seoulense	386911	S	1229	238	1467	0.00009
Mycobacterium_malmoense	1780	S	1219	166	1385	0.00009
Mycobacterium_ostraviense	2738409	S	1189	96	1285	0.00008
Mycobacterium_basiliense	2094119	S	1076	36	1112	0.00007
Mycobacterium_spongiae	886343	S	975	25	1000	0.00006
Mycobacterium_crocinum	388459	S	838	365	1203	0.00008
Mycobacterium_haemophilum	29311	S	723	32	755	0.00005
Mycobacterium_marinum	1781	S	314	834	1148	0.00007
Mycobacterium_senegalense	1796	S	264	1198	1462	0.00009
Mycobacterium_leprae	1769	S	177	4	181	0.00001
Mycobacterium_lepromatosis	480418	S	165	3	168	0.00001
Mycobacterium_ulcerans	1809	S	158	546	704	0.00005
Mycobacterium_novum	2492438	S	156	1771	1927	0.00012
Mycobacterium_pallens	370524	S	79	544	623	0.00004
Mycobacterium_shottsii	133549	S	73	90	163	0.00001
Mycobacterium_pseudoshottsii	265949	S	35	148	183	0.00001
Mycolicibacter_sp._MYC340	2855503	S	1095	259	1354	0.00009
Mycolicibacter_sp._MYC098	2872309	S	961	230	1191	0.00008
Mycolicibacter_sp._MYC017	2875777	S	715	527	1242	0.00008
Mycolicibacter_sp._MYC123	2855502	S	219	847	1066	0.00007
Mycolicibacter_sp._MYC101	2872311	S	197	747	944	0.00006
Mycolicibacter_terrae	1788	S	1452	430	1882	0.00012
Mycolicibacter_hiberniae	29314	S	1371	283	1654	0.00011
Mycolicibacter_minnesotensis	1118379	S	864	146	1010	0.00006
Mycolicibacter_sinensis	875328	S	183	1699	1882	0.00012
Mycobacteroides_abscessus	36809	S	2102	1665	3767	0.00024
Mycobacteroides_chelonae	1774	S	1380	452	1832	0.00012
Mycobacteroides_immunogenum	83262	S	845	176	1021	0.00007
Mycobacteroides_saopaulense	1578165	S	805	118	923	0.00006
Mycobacteroides_salmoniphilum	404941	S	705	79	784	0.00005
[Mycobacterium]_stephanolepidis	1520670	S	435	155	590	0.00004
Mycolicibacillus_parakoreensis	1069221	S	1842	481	2323	0.00015
Hoyosella_subflava	639313	S	864	49	913	0.00006
Nocardia_asteroides	1824	S	14997	5252	20249	0.00129
Nocardia_farcinica	37329	S	8862	6043	14905	0.00095
Nocardia_brasiliensis	37326	S	8123	2276	10399	0.00066
Nocardia_cyriacigeorgica	135487	S	7034	3105	10139	0.00065
Nocardia_terpenica	455432	S	5336	979	6315	0.00040
Nocardia_gipuzkoensis	2749991	S	3784	1431	5215	0.00033
Nocardia_arthritidis	228602	S	3472	448	3920	0.00025
Nocardia_wallacei	480035	S	3416	1002	4418	0.00028
Nocardia_huaxiensis	2755382	S	3106	628	3734	0.00024
Nocardia_nova	37330	S	2863	414	3277	0.00021
Nocardia_sp._CS682	1047172	S	2811	696	3507	0.00022
Nocardia_yamanashiensis	209247	S	2795	574	3369	0.00022
Nocardia_otitidiscaviarum	1823	S	2729	554	3283	0.00021
Nocardia_tengchongensis	2055889	S	2668	687	3355	0.00021
Nocardia_yunnanensis	2382165	S	2617	660	3277	0.00021
Nocardia_iowensis	204891	S	2574	575	3149	0.00020
Nocardia_seriolae	37332	S	2527	701	3228	0.00021
Nocardia_mangyaensis	2213200	S	2485	679	3164	0.00020
Rhodococcus_sp._X156	2499145	S	3479	1234	4713	0.00030
Rhodococcus_sp._MTM3W5.2	1805827	S	2923	722	3645	0.00023
Rhodococcus_sp._SGAir0479	2567884	S	2570	777	3347	0.00021
Rhodococcus_sp._W8901	2742603	S	2443	667	3110	0.00020
Rhodococcus_sp._PBTS_1	1653478	S	2209	590	2799	0.00018
Rhodococcus_sp._ABRD24	2507582	S	1538	281	1819	0.00012
Rhodococcus_sp._R79	2811421	S	1439	929	2368	0.00015
Rhodococcus_sp._USK10	2789739	S	1146	776	1922	0.00012
Rhodococcus_sp._B7740	1564114	S	1124	160	1284	0.00008
Rhodococcus_sp._WMMA185	679318	S	1034	137	1171	0.00007
Rhodococcus_sp._P1Y	1302308	S	985	94	1079	0.00007
Rhodococcus_sp._RDE2	2885078	S	762	731	1493	0.00010
Rhodococcus_sp._USK13	2806442	S	679	494	1173	0.00007
Rhodococcus_sp._WAY2	2663121	S	666	600	1266	0.00008
Rhodococcus_sp._WB9	2594007	S	405	536	941	0.00006
Rhodococcus_sp._DMU1	2722825	S	379	1390	1769	0.00011
Rhodococcus_sp._ZPP	2749906	S	372	1071	1443	0.00009
Rhodococcus_sp._S2-17	1990687	S	328	981	1309	0.00008
Rhodococcus_sp._M8	1925550	S	280	849	1129	0.00007
Rhodococcus_sp._WB1	1033922	S	161	1348	1509	0.00010
Rhodococcus_sp._21391	2683591	S	141	640	781	0.00005
Rhodococcus_sp._P-2	2795031	S	127	152	279	0.00002
Rhodococcus_sp._2G	1570939	S	126	504	630	0.00004
Rhodococcus_sp._p52	935199	S	89	468	557	0.00004
Rhodococcus_sp._DMF-1	2907624	S	75	581	656	0.00004
Rhodococcus_sp._PSBB049	2812863	S	68	957	1025	0.00007
Rhodococcus_sp._LW-XY12	2856851	S	65	564	629	0.00004
Rhodococcus_sp._AQ5-07	2054902	S	61	209	270	0.00002
Rhodococcus_sp._YL-1	1045808	S	57	246	303	0.00002
Rhodococcus_sp._008	1723645	S	42	255	297	0.00002
Rhodococcus_sp._NJ-530	2490853	S	41	231	272	0.00002
Rhodococcus_sp._BH4	1807790	S	37	238	275	0.00002
Rhodococcus_sp._H-CA8f	1727214	S	33	141	174	0.00001
Rhodococcus_sp._C1	644410	S	21	244	265	0.00002
Rhodococcus_opacus	37919	S	6583	6601	13184	0.00084
Rhodococcus_equi	43767	S	3825	1452	5277	0.00034
Rhodococcus_fascians	1828	S	2998	669	3667	0.00023
Rhodococcus_rhodochrous	1829	S	2624	1510	4134	0.00026
Rhodococcus_triatomae	300028	S	2012	601	2613	0.00017
Rhodococcus_koreensis	99653	S	1701	504	2205	0.00014
Rhodococcus_coprophilus	38310	S	1544	279	1823	0.00012
Rhodococcus_pyridinivorans	103816	S	1286	4820	6106	0.00039
Rhodococcus_jostii	132919	S	1194	490	1684	0.00011
Rhodococcus_qingshengii	334542	S	531	3004	3535	0.00023
Rhodococcus_erythropolis	1833	S	474	1960	2434	0.00016
Rhodococcus_ruber	1830	S	1059	3342	4401	0.00028
Rhodococcus_globerulus	33008	S	836	98	934	0.00006
Rhodococcus_aetherivorans	191292	S	318	2866	3184	0.00020
Corynebacterium_cyclohexanicum	322009	S	2627	1009	3636	0.00023
Corynebacterium_bovis	36808	S	1770	389	2159	0.00014
Corynebacterium_frankenforstense	1230998	S	1762	510	2272	0.00015
Corynebacterium_sphenisci	191493	S	1747	509	2256	0.00014
Corynebacterium_xerosis	1725	S	1637	883	2520	0.00016
Corynebacterium_halotolerans	225326	S	1340	299	1639	0.00010
Corynebacterium_nuruki	1032851	S	1213	277	1490	0.00010
Corynebacterium_sp._CNCTC7651	2815361	S	546	103	649	0.00004
Corynebacterium_sp._NML98-0116	702967	S	374	131	505	0.00003
Corynebacterium_sp._1864	2820399	S	84	177	261	0.00002
Corynebacterium_sp._FDAARGOS_1242	2778078	S	74	191	265	0.00002
Corynebacterium_sp._4H37-19	2684405	S	60	6	66	0.00000
Corynebacterium_sp._sy039	2599641	S	26	2	28	0.00000
Corynebacterium_freneyi	134034	S	1120	427	1547	0.00010
Corynebacterium_vitaeruminis	38305	S	1114	321	1435	0.00009
Corynebacterium_maris	575200	S	1037	161	1198	0.00008
Corynebacterium_humireducens	1223514	S	975	275	1250	0.00008
Corynebacterium_variabile	1727	S	932	516	1448	0.00009
Corynebacterium_timonense	441500	S	895	208	1103	0.00007
Corynebacterium_doosanense	1121358	S	892	400	1292	0.00008
Corynebacterium_mycetoides	38302	S	840	393	1233	0.00008
Corynebacterium_yudongzhengii	2080740	S	829	151	980	0.00006
Corynebacterium_marinum	349751	S	826	305	1131	0.00007
Corynebacterium_liangguodongii	2079535	S	782	170	952	0.00006
Corynebacterium_comes	2675218	S	748	183	931	0.00006
Corynebacterium_provencense	1737425	S	702	157	859	0.00005
Corynebacterium_uterequi	1072256	S	696	115	811	0.00005
Corynebacterium_terpenotabidum	89154	S	672	187	859	0.00005
Corynebacterium_atypicum	191610	S	628	177	805	0.00005
Corynebacterium_glyciniphilum	1404244	S	627	76	703	0.00004
Corynebacterium_sanguinis	2594913	S	620	403	1023	0.00007
Corynebacterium_jeikeium	38289	S	586	1448	2034	0.00013
Corynebacterium_imitans	156978	S	548	330	878	0.00006
Corynebacterium_ureicelerivorans	401472	S	529	170	699	0.00004
Corynebacterium_urealyticum	43771	S	519	616	1135	0.00007
Corynebacterium_uberis	2883169	S	515	61	576	0.00004
Corynebacterium_qintianiae	2709392	S	510	141	651	0.00004
Corynebacterium_lujinxingii	2763010	S	510	168	678	0.00004
Corynebacterium_falsenii	108486	S	495	198	693	0.00004
Corynebacterium_efficiens	152794	S	456	82	538	0.00003
Corynebacterium_glaucum	187491	S	433	90	523	0.00003
Corynebacterium_glucuronolyticum	39791	S	417	96	513	0.00003
Corynebacterium_testudinoris	136857	S	404	81	485	0.00003
Corynebacterium_kroppenstedtii	161879	S	386	37	423	0.00003
Corynebacterium_coyleae	53374	S	371	93	464	0.00003
Corynebacterium_genitalium	38288	S	367	78	445	0.00003
Corynebacterium_lactis	1231000	S	362	56	418	0.00003
Corynebacterium_incognita	2754725	S	360	80	440	0.00003
Corynebacterium_occultum	2675219	S	335	57	392	0.00003
Corynebacterium_aurimucosum	169292	S	334	155	489	0.00003
Corynebacterium_striatum	43770	S	328	272	600	0.00004
Corynebacterium_riegelii	156976	S	322	81	403	0.00003
Corynebacterium_tuberculostearicum	38304	S	300	178	478	0.00003
Corynebacterium_matruchotii	43768	S	281	20	301	0.00002
Corynebacterium_renale	1724	S	278	32	310	0.00002
Corynebacterium_endometrii	2488819	S	267	51	318	0.00002
Corynebacterium_aquilae	203263	S	267	40	307	0.00002
Corynebacterium_kalinowskii	2675216	S	263	128	391	0.00003
Corynebacterium_zhongnanshanii	2768834	S	247	33	280	0.00002
Corynebacterium_camporealensis	161896	S	237	60	297	0.00002
Corynebacterium_urogenitale	2487892	S	236	42	278	0.00002
Corynebacterium_lizhenjunii	2709394	S	235	40	275	0.00002
Corynebacterium_flavescens	28028	S	228	65	293	0.00002
Corynebacterium_epidermidicanis	1050174	S	214	35	249	0.00002
Corynebacterium_simulans	146827	S	197	150	347	0.00002
Corynebacterium_phocae	161895	S	175	23	198	0.00001
Corynebacterium_propinquum	43769	S	171	73	244	0.00002
Corynebacterium_singulare	161899	S	171	145	316	0.00002
Corynebacterium_gerontici	2079234	S	169	34	203	0.00001
Corynebacterium_minutissimum	38301	S	159	163	322	0.00002
Corynebacterium_cystitidis	35757	S	152	9	161	0.00001
Corynebacterium_diphtheriae	1717	S	150	335	485	0.00003
Corynebacterium_kefirresidentii	1979527	S	142	94	236	0.00002
Corynebacterium_pelargi	1471400	S	137	46	183	0.00001
Corynebacterium_pseudodiphtheriticum	37637	S	136	45	181	0.00001
Corynebacterium_argentoratense	42817	S	134	28	162	0.00001
Corynebacterium_macginleyi	38290	S	129	31	160	0.00001
Corynebacterium_pseudopelargi	2080757	S	129	46	175	0.00001
Corynebacterium_resistens	258224	S	125	68	193	0.00001
Corynebacterium_choanae	1862358	S	123	12	135	0.00001
Corynebacterium_casei	160386	S	121	137	258	0.00002
Corynebacterium_deserti	1408191	S	114	41	155	0.00001
Corynebacterium_ammoniagenes	1697	S	111	24	135	0.00001
Corynebacterium_stationis	1705	S	109	28	137	0.00001
Corynebacterium_glutamicum	1718	S	108	1526	1634	0.00010
Corynebacterium_accolens	38284	S	103	254	357	0.00002
Corynebacterium_mustelae	571915	S	90	7	97	0.00001
Corynebacterium_hindlerae	699041	S	82	164	246	0.00002
Corynebacterium_ulcerans	65058	S	75	27	102	0.00001
Corynebacterium_amycolatum	43765	S	72	546	618	0.00004
Corynebacterium_pseudotuberculosis	1719	S	68	15	83	0.00001
Corynebacterium_anserum	2684406	S	68	8	76	0.00000
Corynebacterium_segmentosum	43990	S	63	155	218	0.00001
Corynebacterium_suranareeae	2506452	S	59	17	76	0.00000
Corynebacterium_callunae	1721	S	54	18	72	0.00000
Corynebacterium_rouxii	2719119	S	49	29	78	0.00001
Corynebacterium_silvaticum	2320431	S	43	18	61	0.00000
Corynebacterium_crudilactis	1652495	S	39	44	83	0.00001
Corynebacterium_kutscheri	35755	S	19	2	21	0.00000
Gordonia_sp._PP30	2935861	S	2361	660	3021	0.00019
Gordonia_sp._YC-JH1	2059875	S	1669	1170	2839	0.00018
Gordonia_sp._KTR9	337191	S	1602	329	1931	0.00012
Gordonia_sp._PDNC005	2811424	S	1299	195	1494	0.00010
Gordonia_sp._WA4-43	2878678	S	299	998	1297	0.00008
Gordonia_sp._JH63	2698900	S	192	602	794	0.00005
Gordonia_sp._135	2676309	S	111	726	837	0.00005
Gordonia_sp._1D	1737359	S	52	764	816	0.00005
Gordonia_polyisoprenivorans	84595	S	3517	708	4225	0.00027
Gordonia_terrae	2055	S	2543	1434	3977	0.00025
Gordonia_insulae	2420509	S	2143	304	2447	0.00016
Gordonia_phthalatica	1136941	S	1920	770	2690	0.00017
Gordonia_amarae	36821	S	1838	370	2208	0.00014
Gordonia_bronchialis	2054	S	1825	431	2256	0.00014
Gordonia_jinghuaiqii	2758710	S	1771	350	2121	0.00014
Gordonia_iterans	1004901	S	1756	600	2356	0.00015
Gordonia_rubripertincta	36822	S	1553	906	2459	0.00016
Gordonia_otitidis	249058	S	1483	246	1729	0.00011
Gordonia_pseudoamarae	2831662	S	1449	277	1726	0.00011
Gordonia_zhaorongruii	2597659	S	1191	217	1408	0.00009
Gordonia_alkanivorans	84096	S	384	1389	1773	0.00011
Gordonia_amicalis	89053	S	296	2096	2392	0.00015
Gordonia_hongkongensis	1701090	S	206	633	839	0.00005
Gordonia_ajococcus	1292359	S	18	883	901	0.00006
Skermania_piniformis	39122	S	1950	239	2189	0.00014
Tsukamurella_paurometabola	2061	S	3742	1913	5655	0.00036
Tsukamurella_tyrosinosolvens	57704	S	3256	1495	4751	0.00030
Tsukamurella_sp._PLM1	2929795	S	2197	739	2936	0.00019
Tsukamurella_pulmonis	47312	S	2167	798	2965	0.00019
Dietzia_sp._oral_taxon_368	712270	S	1277	877	2154	0.00014
Dietzia_sp._DQ12-45-1b	912801	S	13	1656	1669	0.00011
Dietzia_lutea	546160	S	1524	886	2410	0.00015
Dietzia_psychralcaliphila	139021	S	1379	402	1781	0.00011
Dietzia_timorensis	499555	S	1167	655	1822	0.00012
Tomitella_gaofuii	2760083	S	2403	777	3180	0.00020
Tomitella_fengzijianii	2597660	S	2119	739	2858	0.00018
Segniliparus_rotundus	286802	S	1232	73	1305	0.00008
Lawsonella_clevelandensis	1528099	S	188	22	210	0.00001
Amycolatopsis_sp._CA-230715	2745196	S	18598	2969	21567	0.00138
Amycolatopsis_sp._WQ_127309	2932773	S	9923	2933	12856	0.00082
Amycolatopsis_sp._Hca4	2742131	S	9202	3605	12807	0.00082
Amycolatopsis_sp._DSM_110486	2865832	S	9006	1911	10917	0.00070
Amycolatopsis_sp._FDAARGOS_1241	2778070	S	8448	1957	10405	0.00066
Amycolatopsis_sp._YIM_10	2653857	S	6146	1906	8052	0.00051
Amycolatopsis_sp._FU40	2914159	S	4507	2165	6672	0.00043
Amycolatopsis_sp._AA4	1896961	S	4070	2273	6343	0.00041
Amycolatopsis_sp._BJA-103	1911175	S	3148	1376	4524	0.00029
Amycolatopsis_sp._TNS106	2861750	S	2639	1710	4349	0.00028
Amycolatopsis_sp._EV170708-02-1	2919322	S	2104	2309	4413	0.00028
Amycolatopsis_pretoriensis	218821	S	9183	3148	12331	0.00079
Amycolatopsis_acidiphila	715473	S	8922	1981	10903	0.00070
Amycolatopsis_mediterranei	33910	S	8372	6909	15281	0.00098
Amycolatopsis_methanolica	1814	S	6787	2818	9605	0.00061
Amycolatopsis_thermalba	944492	S	6552	2891	9443	0.00060
Amycolatopsis_albispora	1804986	S	5703	3368	9071	0.00058
Amycolatopsis_keratiniphila	129921	S	3229	2984	6213	0.00040
Amycolatopsis_japonica	208439	S	1652	1741	3393	0.00022
Amycolatopsis_aidingensis	2842453	S	5251	640	5891	0.00038
Amycolatopsis_orientalis	31958	S	3571	1317	4888	0.00031
Pseudonocardia_sp._DSM_110487	2865833	S	53277	7910	61187	0.00391
Pseudonocardia_sp._CGMCC_4.1532	2761535	S	10249	6201	16450	0.00105
Pseudonocardia_sp._HH130630-07	1690815	S	7326	2256	9582	0.00061
Pseudonocardia_sp._AL041005-10	445576	S	5927	2246	8173	0.00052
Pseudonocardia_sp._HH130629-09	1641402	S	5179	2257	7436	0.00047
Pseudonocardia_sp._EC080625-04	1096868	S	129	3129	3258	0.00021
Pseudonocardia_sp._EC080619-01	1096856	S	34	7586	7620	0.00049
Pseudonocardia_sp._EC080610-09	1688404	S	22	1669	1691	0.00011
Pseudonocardia_dioxanivorans	240495	S	15950	4477	20427	0.00130
Pseudonocardia_broussonetiae	2736640	S	14243	5001	19244	0.00123
Pseudonocardia_autotrophica	2074	S	7718	2223	9941	0.00063
Pseudonocardia_abyssalis	2792008	S	7488	4080	11568	0.00074
Saccharomonospora_cyanea	40989	S	56212	14618	70830	0.00452
Saccharomonospora_marina	632569	S	4675	1035	5710	0.00036
Saccharomonospora_azurea	40988	S	4419	961	5380	0.00034
Saccharomonospora_glauca	40990	S	3695	927	4622	0.00030
Saccharomonospora_xinjiangensis	75294	S	3207	474	3681	0.00024
Saccharomonospora_viridis	1852	S	2313	313	2626	0.00017
Saccharopolyspora_erythraea	1836	S	18465	6039	24504	0.00156
Saccharopolyspora_gregorii	33914	S	8986	1871	10857	0.00069
Saccharopolyspora_spinosa	60894	S	4879	3323	8202	0.00052
Saccharopolyspora_pogona	333966	S	3475	4426	7901	0.00050
Saccharopolyspora_sp._ASAGF58	2719023	S	2471	3493	5964	0.00038
Saccharothrix_syringae	103733	S	8720	3088	11808	0.00075
Saccharothrix_sp._6-C	2781735	S	8554	2962	11516	0.00074
Saccharothrix_espanaensis	103731	S	6824	2045	8869	0.00057
Allokutzneria_albata	211114	S	18707	4619	23326	0.00149
Kutzneria_sp._CA-103260	2802641	S	9547	2127	11674	0.00075
Kutzneria_albida	43357	S	6320	1504	7824	0.00050
Actinoalloteichus_hoggarensis	1470176	S	3255	463	3718	0.00024
Actinoalloteichus_hymeniacidonis	340345	S	2627	264	2891	0.00018
Actinoalloteichus_sp._GBA129-24	1612551	S	155	1918	2073	0.00013
Actinoalloteichus_fjordicus	1612552	S	128	1914	2042	0.00013
Actinosynnema_pretiosum	42197	S	2761	5456	8217	0.00052
Actinosynnema_mirum	40567	S	304	2966	3270	0.00021
Kibdelosporangium_phytohabitans	860235	S	7542	929	8471	0.00054
Lentzea_guizhouensis	1586287	S	7340	1572	8912	0.00057
Alloactinosynnema_sp._L-07	1653480	S	5370	1217	6587	0.00042
Prauserella_marina	530584	S	3870	352	4222	0.00027
Allosaccharopolyspora_coralli	2665642	S	3743	813	4556	0.00029
Nocardioides_sp._G188	2849501	S	27455	9750	37205	0.00238
Nocardioides_sp._JS614	196162	S	12837	4468	17305	0.00110
Nocardioides_sp._LMS-CY	2840457	S	11646	4465	16111	0.00103
Nocardioides_sp._HDW12B	2714939	S	11482	4341	15823	0.00101
Nocardioides_sp._TF02-7	2917724	S	10120	3822	13942	0.00089
Nocardioides_sp._SCSIO_67246	2872154	S	8284	2557	10841	0.00069
Nocardioides_sp._W7	2931390	S	8143	3245	11388	0.00073
Nocardioides_sp._zg-579	2663857	S	8085	4804	12889	0.00082
Nocardioides_sp._S-1144	2582905	S	7770	3495	11265	0.00072
Nocardioides_sp._cx-173	2898796	S	7600	3055	10655	0.00068
Nocardioides_sp._InS609-2	2760705	S	7207	1939	9146	0.00058
Nocardioides_sp._603	2483798	S	7144	3874	11018	0.00070
Nocardioides_sp._zg-1228	2763008	S	6867	3541	10408	0.00066
Nocardioides_sp._MC1495	2736757	S	6571	2730	9301	0.00059
Nocardioides_sp._JQ2195	2592334	S	6521	1587	8108	0.00052
Nocardioides_sp._S5	2017486	S	6229	3714	9943	0.00063
Nocardioides_sp._CF8	110319	S	5824	2870	8694	0.00056
Nocardioides_sp._zg-536	2803858	S	5382	2729	8111	0.00052
Nocardioides_sp._dk884	2662361	S	4625	5849	10474	0.00067
Nocardioides_sp._ZJ1313	2685869	S	4402	5613	10015	0.00064
Nocardioides_sp._WS12	2486272	S	4324	889	5213	0.00033
Nocardioides_sp._Kera_G14	2884264	S	4258	1027	5285	0.00034
Nocardioides_mesophilus	433659	S	23993	8418	32411	0.00207
Nocardioides_cynanchi	2558918	S	14305	3961	18266	0.00117
Nocardioides_ungokensis	1643322	S	10602	4376	14978	0.00096
Nocardioides_anomalus	2712223	S	9781	3476	13257	0.00085
Nocardioides_euryhalodurans	2518370	S	8706	3129	11835	0.00076
Nocardioides_humi	449461	S	7480	2946	10426	0.00067
Nocardioides_rotundus	1774216	S	7300	3293	10593	0.00068
Nocardioides_dongkuii	2760089	S	7224	4253	11477	0.00073
Nocardioides_okcheonensis	2894081	S	7132	3874	11006	0.00070
Nocardioides_aromaticivorans	200618	S	6671	2994	9665	0.00062
Nocardioides_aquaticus	160826	S	6470	2334	8804	0.00056
Nocardioides_marinisabuli	419476	S	5945	3931	9876	0.00063
Nocardioides_dokdonensis	450734	S	5776	3237	9013	0.00058
Nocardioides_sambongensis	2589074	S	5563	1867	7430	0.00047
Nocardioides_houyundeii	2045452	S	4863	1747	6610	0.00042
Nocardioides_panacisoli	627624	S	4831	1389	6220	0.00040
Nocardioides_seonyuensis	2518371	S	4805	1527	6332	0.00040
Nocardioides_piscis	2714938	S	4377	2006	6383	0.00041
Nocardioides_daphniae	402297	S	3545	1915	5460	0.00035
Nocardioides_jishulii	2575440	S	2949	1276	4225	0.00027
Nocardioides_baekrokdamisoli	1804624	S	2307	336	2643	0.00017
Nocardioides_yefusunii	2500546	S	2209	748	2957	0.00019
Aeromicrobium_sp._Leaf245	1736306	S	3185	1107	4292	0.00027
Aeromicrobium_sp._zg-629	2663859	S	2745	1016	3761	0.00024
Aeromicrobium_sp._A1-2	2107713	S	2407	384	2791	0.00018
Aeromicrobium_erythreum	2041	S	3679	1240	4919	0.00031
Aeromicrobium_chenweiae	2079793	S	3572	1364	4936	0.00032
Aeromicrobium_choanae	1736691	S	3127	1058	4185	0.00027
Aeromicrobium_yanjiei	2662028	S	3021	1071	4092	0.00026
Aeromicrobium_marinum	219314	S	3010	742	3752	0.00024
Marmoricola_scoriae	642780	S	6967	3018	9985	0.00064
Pimelobacter_simplex	2045	S	6338	2737	9075	0.00058
Friedmanniella_luteola	546871	S	5215	1205	6420	0.00041
Mumia_sp._ZJ1417	2708082	S	4626	917	5543	0.00035
Micropruina_glycogenica	75385	S	2297	382	2679	0.00017
Microlunatus_sagamiharensis	546874	S	4855	1274	6129	0.00039
Microlunatus_soli	630515	S	3578	400	3978	0.00025
Microlunatus_sp._Gsoil_973	2672569	S	3424	301	3725	0.00024
Microlunatus_elymi	2596828	S	3276	406	3682	0.00024
Microlunatus_phosphovorus	29405	S	2937	392	3329	0.00021
Tessaracoccus_sp._J1M15	2829499	S	2087	663	2750	0.00018
Tessaracoccus_sp._MC1865	2760310	S	1519	415	1934	0.00012
Tessaracoccus_defluvii	1285901	S	2237	1462	3699	0.00024
Tessaracoccus_aquimaris	1332264	S	2042	1000	3042	0.00019
Tessaracoccus_flavescens	399497	S	1800	1417	3217	0.00021
Tessaracoccus_flavus	1610493	S	1536	1093	2629	0.00017
Tessaracoccus_timonensis	2161816	S	916	415	1331	0.00009
Brevilactibacter_coleopterorum	2714937	S	3073	1521	4594	0.00029
Brevilactibacter_sp._MC1595	2819349	S	2815	1224	4039	0.00026
Acidipropionibacterium_acidipropionici	1748	S	1771	1169	2940	0.00019
Acidipropionibacterium_jensenii	1749	S	1752	1184	2936	0.00019
Acidipropionibacterium_virtanenii	2057246	S	1132	239	1371	0.00009
Propionibacterium_acidifaciens	556499	S	1909	478	2387	0.00015
Propionibacterium_freudenreichii	1744	S	1377	1542	2919	0.00019
Propionibacterium_australiense	119981	S	1353	255	1608	0.00010
Auraticoccus_monumenti	675864	S	3641	749	4390	0.00028
Cutibacterium_avidum	33010	S	1084	331	1415	0.00009
Cutibacterium_acnes	1747	S	541	464	1005	0.00006
Cutibacterium_granulosum	33011	S	528	120	648	0.00004
Cutibacterium_modestum	2559073	S	218	35	253	0.00002
Raineyella_fluvialis	2662261	S	2466	370	2836	0.00018
Arachnia_propionica	1750	S	1539	1508	3047	0.00019
Arachnia_rubra	1547448	S	765	62	827	0.00005
Vaginimicrobium_propionicum	1871034	S	96	39	135	0.00001
Kribbella_flavida	182640	S	11301	2845	14146	0.00090
Kribbella_qitaiheensis	1544730	S	8433	1428	9861	0.00063
Actinopolymorpha_singaporensis	117157	S	8266	1042	9308	0.00059
Actinomadura_sp._NAK00032	2742128	S	59321	19587	78908	0.00504
Actinomadura_sp._WMMB_499	1219491	S	36517	8638	45155	0.00288
Actinomadura_sp._WMMA1423	2591108	S	20236	5636	25872	0.00165
Actinomadura_madurae	1993	S	29371	8362	37733	0.00241
Actinomadura_verrucosospora	46165	S	21352	6312	27664	0.00177
Actinomadura_graeca	2750812	S	12210	2791	15001	0.00096
Thermomonospora_amylolytica	1411117	S	7771	2962	10733	0.00069
Thermomonospora_curvata	2020	S	4962	1515	6477	0.00041
Nonomuraea_nitratireducens	2656914	S	53626	11726	65352	0.00417
Nonomuraea_sp._ATCC_55076	1909395	S	24235	7572	31807	0.00203
Nonomuraea_coxensis	404386	S	20231	5946	26177	0.00167
Nonomuraea_gerenzanensis	93944	S	20170	6583	26753	0.00171
Streptosporangium_roseum	2001	S	9750	2883	12633	0.00081
Streptosporangium_sp._'caverna'	2202249	S	8608	2025	10633	0.00068
Thermobispora_bispora	2006	S	6685	1675	8360	0.00053
Nocardiopsis_dassonvillei	2014	S	7607	5254	12861	0.00082
Nocardiopsis_sp._MT53	2865672	S	4433	1087	5520	0.00035
Nocardiopsis_sp._HDS12	2831968	S	2187	1389	3576	0.00023
Nocardiopsis_gilva	280236	S	3665	775	4440	0.00028
Nocardiopsis_alba	53437	S	2543	479	3022	0.00019
Thermobifida_halotolerans	483545	S	2898	974	3872	0.00025
Thermobifida_alba	53522	S	2771	1142	3913	0.00025
Thermobifida_fusca	2021	S	1481	266	1747	0.00011
Streptomonospora_litoralis	2498135	S	4052	834	4886	0.00031
Spiractinospora_alimapuensis	2820884	S	2929	206	3135	0.00020
Micromonospora_sp._WMMC415	2675222	S	5484	2076	7560	0.00048
Micromonospora_sp._WMMA2032	2039870	S	4267	2771	7038	0.00045
Micromonospora_sp._HM134	2583243	S	4023	1795	5818	0.00037
Micromonospora_sp._B006	2201999	S	3347	2556	5903	0.00038
Micromonospora_sp._L5	648999	S	345	3573	3918	0.00025
Micromonospora_terminaliae	1914461	S	6975	3539	10514	0.00067
Micromonospora_krabiensis	307121	S	6318	2201	8519	0.00054
Micromonospora_carbonacea	47853	S	6227	2802	9029	0.00058
Micromonospora_echinaurantiaca	47857	S	6190	3015	9205	0.00059
Micromonospora_viridifaciens	1881	S	6107	2682	8789	0.00056
Micromonospora_inositola	47865	S	5830	2890	8720	0.00056
Micromonospora_echinofusca	47858	S	5656	2598	8254	0.00053
Micromonospora_auratinigra	261654	S	5516	2917	8433	0.00054
Micromonospora_echinospora	1877	S	5057	1780	6837	0.00044
Micromonospora_coriariae	285665	S	4975	1789	6764	0.00043
Micromonospora_narathiwatensis	299146	S	4917	2317	7234	0.00046
Micromonospora_purpureochromogenes	47872	S	4827	2571	7398	0.00047
Micromonospora_siamensis	299152	S	4751	2292	7043	0.00045
Micromonospora_ferruginea	2749844	S	4550	2635	7185	0.00046
Micromonospora_coxensis	356852	S	4514	2517	7031	0.00045
Micromonospora_sagamiensis	47875	S	4095	1579	5674	0.00036
Micromonospora_maris	1003110	S	3993	1238	5231	0.00033
Micromonospora_zamorensis	709883	S	3971	1283	5254	0.00034
Micromonospora_endophytica_(Xie_et_al._2001)_Li_et_al._2019	515350	S	3693	1145	4838	0.00031
Micromonospora_chokoriensis	356851	S	3619	1181	4800	0.00031
Micromonospora_rifamycinica	291594	S	3411	1538	4949	0.00032
Micromonospora_craniellae	2294034	S	3041	1946	4987	0.00032
Micromonospora_tulbaghiae	479978	S	2393	2544	4937	0.00032
Micromonospora_aurantiaca	47850	S	1865	12198	14063	0.00090
Actinoplanes_sp._L3-i22	2836373	S	13584	9784	23368	0.00149
Actinoplanes_sp._N902-109	649831	S	12207	3805	16012	0.00102
Actinoplanes_sp._OR16	946334	S	10337	5028	15365	0.00098
Actinoplanes_friuliensis	196914	S	11728	2015	13743	0.00088
Actinoplanes_ianthinogenes	122358	S	11053	4651	15704	0.00100
Actinoplanes_teichomyceticus	1867	S	9533	4215	13748	0.00088
Actinoplanes_missouriensis	1866	S	9295	3192	12487	0.00080
Actinoplanes_derwentensis	113562	S	7481	1208	8689	0.00055
Phytohabitans_suffuscus	624315	S	10367	2820	13187	0.00084
Phytohabitans_flavus	1076124	S	8345	1750	10095	0.00064
Plantactinospora_sp._KBS50	2024580	S	6472	1712	8184	0.00052
Plantactinospora_sp._BB1	2071627	S	1508	4305	5813	0.00037
Plantactinospora_sp._BC1	2108470	S	1369	3951	5320	0.00034
Dactylosporangium_vinaceum	53362	S	16044	1937	17981	0.00115
Couchioplanes_caeruleus	56438	S	14654	3982	18636	0.00119
Actinocatenispora_thailandica	227318	S	6443	1881	8324	0.00053
Actinocatenispora_sera	390989	S	6144	1891	8035	0.00051
Catellatospora_sp._IY07-71	2728827	S	10160	2424	12584	0.00080
Polymorphospora_rubra	338584	S	7152	1691	8843	0.00056
Natronosporangium_hydrolyticum	2811111	S	4457	330	4787	0.00031
Verrucosispora_sp._NA02020	2742132	S	2895	2331	5226	0.00033
Salinispora_tropica	168695	S	2407	429	2836	0.00018
Blastococcus_sp._PRF04-17	2933797	S	18140	6811	24951	0.00159
Blastococcus_saxobsidens	138336	S	15377	5176	20553	0.00131
Modestobacter_marinus	477641	S	15619	5983	21602	0.00138
Modestobacter_sp._L9-4	2851567	S	9505	4016	13521	0.00086
Geodermatophilus_obscurus	1861	S	20182	7476	27658	0.00177
Actinomyces_sp._oral_taxon_414	712122	S	1419	310	1729	0.00011
Actinomyces_sp._MAS-1	2755559	S	980	204	1184	0.00008
Actinomyces_sp._Z16	2079536	S	832	304	1136	0.00007
Actinomyces_sp._Chiba101	1851395	S	699	333	1032	0.00007
Actinomyces_sp._432	2057798	S	666	155	821	0.00005
Actinomyces_sp._oral_taxon_171	706438	S	334	267	601	0.00004
Actinomyces_sp._oral_taxon_169	712116	S	169	308	477	0.00003
Actinomyces_sp._HMT_175	2789425	S	139	568	707	0.00005
Actinomyces_sp._HMT897	2789424	S	122	439	561	0.00004
Actinomyces_sp._oral_taxon_897	2081702	S	106	389	495	0.00003
Actinomyces_sp._zg-332	2708340	S	23	4	27	0.00000
Actinomyces_radicidentis	111015	S	1702	746	2448	0.00016
Actinomyces_howellii	52771	S	1371	227	1598	0.00010
Actinomyces_slackii	52774	S	970	173	1143	0.00007
Actinomyces_respiraculi	2744574	S	924	237	1161	0.00007
Actinomyces_procaprae	2560010	S	761	283	1044	0.00007
Actinomyces_faecalis	2722820	S	733	112	845	0.00005
Actinomyces_weissii	675090	S	630	131	761	0.00005
Actinomyces_qiguomingii	2057800	S	617	88	705	0.00005
Actinomyces_viscosus	1656	S	572	243	815	0.00005
Actinomyces_wuliandei	2057743	S	502	137	639	0.00004
Actinomyces_naeslundii	1655	S	495	283	778	0.00005
Actinomyces_gaoshouyii	1960083	S	489	255	744	0.00005
Actinomyces_oris	544580	S	482	1370	1852	0.00012
Actinomyces_marmotae	2737173	S	481	271	752	0.00005
Actinomyces_trachealis	2763540	S	359	72	431	0.00003
Actinomyces_lilanjuaniae	2321394	S	331	82	413	0.00003
Actinomyces_pacaensis	1852377	S	144	19	163	0.00001
Schaalia_sp._19OD2882	2794089	S	630	93	723	0.00005
Schaalia_sp._JY-X169	2758572	S	221	8	229	0.00001
Schaalia_sp._ZJ405	2709403	S	219	22	241	0.00002
Schaalia_odontolytica	1660	S	967	251	1218	0.00008
Schaalia_meyeri	52773	S	449	91	540	0.00003
Schaalia_cardiffensis	181487	S	291	48	339	0.00002
Schaalia_turicensis	131111	S	132	147	279	0.00002
Flaviflexus_salsibiostraticola	1282737	S	981	267	1248	0.00008
Flaviflexus_sp._dk850	2758573	S	450	174	624	0.00004
Flaviflexus_ciconiae	2496867	S	339	44	383	0.00002
Trueperella_pecoris	2733571	S	703	217	920	0.00006
Trueperella_pyogenes	1661	S	532	329	861	0.00005
Trueperella_bialowiezensis	312285	S	392	22	414	0.00003
Pauljensenia_hongkongensis	178339	S	846	320	1166	0.00007
Nanchangia_anserum	2692125	S	787	93	880	0.00006
Actinotignum_schaalii	59505	S	313	23	336	0.00002
Actinobaculum_sp._313	2495645	S	308	18	326	0.00002
Arcanobacterium_haemolyticum	28264	S	96	46	142	0.00001
Arcanobacterium_phocae	131112	S	48	12	60	0.00000
Arcanobacterium_phocisimile	1302235	S	39	9	48	0.00000
Arcanobacterium_sp._2701	2722751	S	30	6	36	0.00000
Changpingibacter_yushuensis	2758440	S	183	57	240	0.00002
Mobiluncus_curtisii	2051	S	158	50	208	0.00001
Varibaculum_sp._EMRHCC_39	2811781	S	80	26	106	0.00001
Boudabousia_tangfeifanii	1912795	S	59	5	64	0.00000
Fannyhessea_vaginae	82135	S	41	13	54	0.00000
Frankia_inefficax	298654	S	9218	1193	10411	0.00066
Frankia_sp._QA3	710111	S	3674	1698	5372	0.00034
Frankia_sp._ArI3	1858	S	2752	2003	4755	0.00030
Candidatus_Frankia_datiscae	2716812	S	4084	612	4696	0.00030
Frankia_casuarinae	106370	S	3434	400	3834	0.00024
Frankia_alni	1859	S	3113	2356	5469	0.00035
Jiangella_sp._DSM_45060	1798224	S	9653	3047	12700	0.00081
Jiangella_alkaliphila	419479	S	8225	2492	10717	0.00068
Bifidobacterium_choerinum	35760	S	1238	573	1811	0.00012
Bifidobacterium_pseudolongum	1694	S	1065	415	1480	0.00009
Bifidobacterium_scardovii	158787	S	912	96	1008	0.00006
Bifidobacterium_longum	216816	S	788	1526	2314	0.00015
Bifidobacterium_bifidum	1681	S	718	371	1089	0.00007
Bifidobacterium_pullorum	78448	S	695	304	999	0.00006
Bifidobacterium_animalis	28025	S	613	435	1048	0.00007
Bifidobacterium_subtile	77635	S	502	80	582	0.00004
Bifidobacterium_asteroides	1684	S	491	15	506	0.00003
Bifidobacterium_adolescentis	1680	S	471	122	593	0.00004
Bifidobacterium_eulemuris	1765219	S	380	108	488	0.00003
Bifidobacterium_thermophilum	33905	S	380	92	472	0.00003
Bifidobacterium_lemurum	1603886	S	363	106	469	0.00003
Bifidobacterium_breve	1685	S	322	362	684	0.00004
Bifidobacterium_actinocoloniiforme	638619	S	314	11	325	0.00002
Bifidobacterium_dentium	1689	S	292	25	317	0.00002
Bifidobacterium_angulatum	1683	S	270	84	354	0.00002
Bifidobacterium_catenulatum	1686	S	176	327	503	0.00003
Bifidobacterium_pseudocatenulatum	28026	S	150	147	297	0.00002
Bifidobacterium_imperatoris	2020965	S	78	53	131	0.00001
Bifidobacterium_saguini	762210	S	63	39	102	0.00001
Bifidobacterium_coryneforme	1687	S	40	66	106	0.00001
Bifidobacterium_indicum	1691	S	34	57	91	0.00001
Parascardovia_denticolens	78258	S	190	35	225	0.00001
Gardnerella_vaginalis	2702	S	23	62	85	0.00001
Scardovia_inopinata	78259	S	26	10	36	0.00000
Nakamurella_multipartita	53461	S	4766	993	5759	0.00037
Nakamurella_panacisegetis	1090615	S	2719	456	3175	0.00020
Nakamurella_sp._PAMC28650	2762325	S	2469	320	2789	0.00018
Nakamurella_antarctica	1902245	S	555	46	601	0.00004
Catenulispora_acidiphila	304895	S	7244	1146	8390	0.00054
Jatrophihabitans_telluris	2038343	S	2923	282	3205	0.00020
Jatrophihabitans_sp._GAS493	1907575	S	2783	285	3068	0.00020
Stackebrandtia_nassauensis	283811	S	3934	387	4321	0.00028
Natronoglycomyces_albus	2811108	S	674	25	699	0.00004
Kineococcus_radiotolerans	131568	S	3992	1198	5190	0.00033
Actinopolyspora_erythraea	414996	S	2695	299	2994	0.00019
Epidermidibacterium_keratini	1891644	S	2688	1411	4099	0.00026
Acidothermus_cellulolyticus	28049	S	1916	104	2020	0.00013
Candidatus_Planktophila_lacus	1884913	S	70	11	81	0.00001
Candidatus_Planktophila_sulfonica	1884904	S	54	17	71	0.00000
Candidatus_Planktophila_versatilis	1884905	S	53	12	65	0.00000
Candidatus_Planktophila_dulcis	1884914	S	37	25	62	0.00000
Candidatus_Planktophila_limnetica	573600	S	20	3	23	0.00000
Candidatus_Planktophila_vernalis	1884907	S	20	4	24	0.00000
Candidatus_Nanopelagicus_limnes	1884634	S	23	45	68	0.00000
Candidatus_Nanopelagicus_hibericus	1884915	S	17	14	31	0.00000
Candidatus_Nanopelagicus_abundans	1884916	S	14	9	23	0.00000
Conexibacter_sp._SYSU_D00693	2812560	S	48813	12593	61406	0.00392
Conexibacter_sp._S30A1	2937800	S	12821	1460	14281	0.00091
Conexibacter_sp._DBS9H8	2937801	S	12184	1254	13438	0.00086
Conexibacter_woesei	191495	S	55957	10593	66550	0.00425
Miltoncostaea_marina	2843215	S	15979	4362	20341	0.00130
Miltoncostaea_oceani	2843216	S	14661	2394	17055	0.00109
Baekduia_soli	496014	S	43462	7721	51183	0.00327
Rubrobacter_xylanophilus	49319	S	12591	1729	14320	0.00091
Rubrobacter_marinus	2653852	S	8527	809	9336	0.00060
Rubrobacter_tropicus	2653851	S	7978	633	8611	0.00055
Rubrobacter_radiotolerans	42256	S	3488	495	3983	0.00025
Rubrobacter_indicoceani	2051957	S	1789	152	1941	0.00012
Aquihabitans_sp._Kera_3	2884263	S	11500	1958	13458	0.00086
Aquihabitans_sp._G128	2849779	S	10600	2230	12830	0.00082
Actinomarinicola_tropica	2789776	S	12491	2577	15068	0.00096
Iamia_sp._SCSIO_61187	2722752	S	11410	1894	13304	0.00085
Ilumatobacter_coccineus	467094	S	4520	305	4825	0.00031
Acidimicrobium_ferrooxidans	53635	S	2030	174	2204	0.00014
Eggerthella_lenta	84112	S	1201	859	2060	0.00013
Eggerthella_guodeyinii	2690837	S	1103	550	1653	0.00011
Eggerthella_sp._YY7918	502558	S	285	135	420	0.00003
Gordonibacter_pamelaeae	471189	S	642	719	1361	0.00009
Gordonibacter_urolithinfaciens	1335613	S	616	500	1116	0.00007
Adlercreutzia_equolifaciens	446660	S	579	398	977	0.00006
Adlercreutzia_hattorii	2707299	S	355	509	864	0.00006
Arabiibacter_massiliensis	1870985	S	1318	299	1617	0.00010
Raoultibacter_timonensis	1907662	S	751	69	820	0.00005
Berryella_intestinalis	1531429	S	664	787	1451	0.00009
Slackia_heliotrinireducens	84110	S	472	15	487	0.00003
Denitrobacterium_detoxificans	79604	S	320	145	465	0.00003
Cryptobacterium_curtum	84163	S	66	7	73	0.00000
Phoenicibacter_congonensis	1944646	S	44	21	65	0.00000
Olsenella_timonensis	1805478	S	1204	391	1595	0.00010
Olsenella_uli	133926	S	619	69	688	0.00004
Olsenella_sp._oral_taxon_807	712411	S	425	26	451	0.00003
Parolsenella_massiliensis	1871022	S	676	408	1084	0.00007
Parolsenella_catena	2003188	S	555	354	909	0.00006
Thermophilibacter_immobilis	2779519	S	842	346	1188	0.00008
Parafannyhessea_umbonata	604330	S	831	526	1357	0.00009
Atopobium_sp._oral_taxon_416	712157	S	198	22	220	0.00001
Lancefieldella_parvula	1382	S	19	2	21	0.00000
Collinsella_aerofaciens	74426	S	1116	642	1758	0.00011
Collinsella_stercoris	147206	S	685	112	797	0.00005
Collinsella_sp._zg1085	2844380	S	59	2	61	0.00000
Coriobacterium_glomerans	33871	S	490	18	508	0.00003
Egibacter_rhizosphaerae	1670831	S	5085	324	5409	0.00035
Egicoccus_halophilus	1670830	S	4679	773	5452	0.00035
Euzebya_pacifica	1608957	S	4163	373	4536	0.00029
Priestia_megaterium	1404	S	74543	85848	160391	0.01024
Priestia_filamentosa	1402861	S	7843	1091	8934	0.00057
Priestia_aryabhattai	412384	S	1668	6739	8407	0.00054
Priestia_flexa	86664	S	389	132	521	0.00003
Priestia_sp._J2	2886505	S	239	1511	1750	0.00011
Priestia_koreensis	284581	S	177	67	244	0.00002
Bacillus_sp._S3	486398	S	1461	461	1922	0.00012
Bacillus_sp._1NLA3E	666686	S	766	294	1060	0.00007
Bacillus_sp._Y1	352858	S	458	191	649	0.00004
Bacillus_sp._FJAT-18017	1705566	S	316	91	407	0.00003
Bacillus_sp._JY-23	2933872	S	315	134	449	0.00003
Bacillus_sp._NSP9.1	1071078	S	184	16	200	0.00001
Bacillus_sp._PAMC26568	2760090	S	176	18	194	0.00001
Bacillus_sp._FJAT-42376	2014076	S	161	65	226	0.00001
Bacillus_sp._OxB-1	98228	S	140	35	175	0.00001
Bacillus_sp._THAF10	2587848	S	126	46	172	0.00001
Bacillus_sp._FJAT-22090	1581038	S	117	33	150	0.00001
Bacillus_sp._KH172YL63	2709784	S	116	43	159	0.00001
Bacillus_sp._SB49	1071080	S	98	18	116	0.00001
Bacillus_sp._WP8	756828	S	71	111	182	0.00001
Bacillus_sp._M4U3P1	2592382	S	69	9	78	0.00001
Bacillus_sp._Cs-700	2589818	S	63	62	125	0.00001
Bacillus_sp._H8-1	2930532	S	52	710	762	0.00005
Bacillus_sp._N1-1	2682541	S	44	41	85	0.00001
Bacillus_sp._275	1941347	S	29	4024	4053	0.00026
Bacillus_sp._NP247	2846779	S	16	26	42	0.00000
Bacillus_sp._N3536	2666127	S	16	17	33	0.00000
Bacillus_sp._N447-1	2789208	S	15	172	187	0.00001
Bacillus_sp._MBGLi79	2070759	S	14	128	142	0.00001
Bacillus_sp._ms-22	2683680	S	10	37	47	0.00000
Bacillus_subtilis	1423	S	2038	39952	41990	0.00268
Bacillus_velezensis	492670	S	444	8895	9339	0.00060
Bacillus_amyloliquefaciens	1390	S	114	5326	5440	0.00035
Bacillus_siamensis	659243	S	34	117	151	0.00001
Bacillus_paralicheniformis	1648923	S	806	583	1389	0.00009
Bacillus_mojavensis	72360	S	56	76	132	0.00001
Bacillus_halotolerans	260554	S	30	87	117	0.00001
Bacillus_vallismortis	72361	S	97	132	229	0.00001
Bacillus_tequilensis	227866	S	73	74	147	0.00001
Bacillus_atrophaeus	1452	S	67	107	174	0.00001
Bacillus_licheniformis	1402	S	46	807	853	0.00005
Bacillus_inaquosorum	483913	S	25	254	279	0.00002
Bacillus_spizizenii	96241	S	12	47	59	0.00000
Bacillus_cereus	1396	S	433	24883	25316	0.00162
Bacillus_pseudomycoides	64104	S	316	154	470	0.00003
Bacillus_thuringiensis	1428	S	301	4443	4744	0.00030
Bacillus_mycoides	1405	S	242	401	643	0.00004
Bacillus_cytotoxicus	580165	S	173	125	298	0.00002
Bacillus_wiedmannii	1890302	S	44	77	121	0.00001
Bacillus_luti	2026191	S	32	36	68	0.00000
Bacillus_paranthracis	2026186	S	21	575	596	0.00004
Bacillus_nitratireducens	2026193	S	21	39	60	0.00000
Bacillus_anthracis	1392	S	19	3697	3716	0.00024
Bacillus_toyonensis	155322	S	11	91	102	0.00001
Bacillus_altitudinis	293387	S	447	2049	2496	0.00016
Bacillus_safensis	561879	S	400	636	1036	0.00007
Bacillus_dafuensis	1742359	S	323	128	451	0.00003
[Brevibacterium]_frigoritolerans	450367	S	287	105	392	0.00003
Bacillus_methanolicus	1471	S	286	148	434	0.00003
Bacillus_infantis	324767	S	283	88	371	0.00002
Bacillus_glycinifermentans	1664069	S	278	101	379	0.00002
Bacillus_pumilus	1408	S	234	243	477	0.00003
Bacillus_aquiflavi	2672567	S	172	50	222	0.00001
Bacillus_weihaiensis	1547283	S	154	57	211	0.00001
Bacillus_badius	1455	S	151	63	214	0.00001
Bacillus_gobiensis	1441095	S	145	47	192	0.00001
Bacillus_smithii	1479	S	131	68	199	0.00001
Bacillus_fonticola	2728853	S	118	35	153	0.00001
Bacillus_cabrialesii	2487276	S	96	104	200	0.00001
Bacillus_shivajii	1983719	S	91	14	105	0.00001
Bacillus_rugosus	2715209	S	50	57	107	0.00001
Neobacillus_drentensis	220684	S	5231	2503	7734	0.00049
Neobacillus_mesonae	1193713	S	1031	378	1409	0.00009
Alkalihalobacillus_clausii	79880	S	4007	836	4843	0.00031
Alkalihalobacillus_krulwichiae	199441	S	130	41	171	0.00001
Alkalihalobacillus_lehensis	300825	S	109	35	144	0.00001
Alkalihalobacillus_sp._LMS39	2924032	S	93	22	115	0.00001
Alkalihalobacillus_miscanthi	2598861	S	67	22	89	0.00001
Cytobacillus_oceanisediminis	665099	S	2047	1189	3236	0.00021
Cytobacillus_ciccensis	1670641	S	398	160	558	0.00004
Cytobacillus_gottheilii	859144	S	357	129	486	0.00003
Cytobacillus_sp._CY-G	2901381	S	215	83	298	0.00002
Cytobacillus_firmus	1399	S	212	108	320	0.00002
Cytobacillus_kochii	859143	S	192	64	256	0.00002
Geobacillus_subterraneus	129338	S	592	424	1016	0.00006
Geobacillus_genomosp._3	1921421	S	315	102	417	0.00003
Geobacillus_stearothermophilus	1422	S	269	371	640	0.00004
Geobacillus_sp._46C-IIa	1963025	S	143	70	213	0.00001
Geobacillus_sp._JS12	1813182	S	23	77	100	0.00001
Geobacillus_sp._Y412MC52	550542	S	19	67	86	0.00001
Geobacillus_sp._C56-T3	691437	S	15	65	80	0.00001
Geobacillus_thermocatenulatus	33938	S	86	91	177	0.00001
Geobacillus_thermoleovorans	33941	S	30	883	913	0.00006
Geobacillus_thermodenitrificans	33940	S	31	191	222	0.00001
Geobacillus_zalihae	213419	S	18	126	144	0.00001
Hydrogenibacillus_sp._N12	2866627	S	2168	259	2427	0.00015
Metabacillus_sp._KUDC1714	2745198	S	545	204	749	0.00005
Metabacillus_sp._cB07	2806989	S	173	73	246	0.00002
Metabacillus_sp._B2-18	2897333	S	108	156	264	0.00002
Metabacillus_sediminilitoris	2567941	S	575	233	808	0.00005
Metabacillus_dongyingensis	2874282	S	233	89	322	0.00002
Metabacillus_litoralis	152268	S	164	165	329	0.00002
Metabacillus_endolithicus	1535204	S	79	97	176	0.00001
Peribacillus_asahii	228899	S	986	535	1521	0.00010
Peribacillus_simplex	1478	S	290	177	467	0.00003
Peribacillus_butanolivorans	421767	S	229	84	313	0.00002
Peribacillus_psychrosaccharolyticus	1407	S	169	64	233	0.00001
Peribacillus_muralis	264697	S	131	34	165	0.00001
Anoxybacillus_sediminis	2613334	S	827	186	1013	0.00006
Anoxybacillus_sp._PDR2	1636720	S	21	158	179	0.00001
Anoxybacillus_flavithermus	33934	S	157	124	281	0.00002
Anoxybacillus_amylolyticus	294699	S	128	29	157	0.00001
Anoxybacillus_caldiproteolyticus	247480	S	126	29	155	0.00001
Anoxybacillus_kamchatkensis	196180	S	12	83	95	0.00001
Lysinibacillus_sp._SGAir0095	2070463	S	219	93	312	0.00002
Lysinibacillus_sp._PLM2	2929796	S	121	50	171	0.00001
Lysinibacillus_sp._Ag94	2936682	S	69	6	75	0.00000
Lysinibacillus_sp._CD3-6	2892541	S	59	23	82	0.00001
Lysinibacillus_sp._2017	2169540	S	57	26	83	0.00001
Lysinibacillus_sp._YS11	2072025	S	47	107	154	0.00001
Lysinibacillus_sp._ACHW1.5	2913506	S	23	45	68	0.00000
Lysinibacillus_timonensis	2086577	S	169	91	260	0.00002
Lysinibacillus_fusiformis	28031	S	105	99	204	0.00001
Lysinibacillus_agricola	2590012	S	84	24	108	0.00001
Lysinibacillus_sphaericus	1421	S	64	70	134	0.00001
Lysinibacillus_parviboronicapiens	436516	S	57	20	77	0.00000
Lysinibacillus_capsici	2115968	S	18	30	48	0.00000
Terribacillus_goriensis	386490	S	1099	203	1302	0.00008
Terribacillus_aidingensis	586416	S	147	28	175	0.00001
Heyndrickxia_oleronia	38875	S	1024	405	1429	0.00009
Heyndrickxia_vini	1476025	S	217	69	286	0.00002
Mesobacillus_foraminis	279826	S	414	122	536	0.00003
Mesobacillus_jeotgali	129985	S	258	115	373	0.00002
Mesobacillus_sp._S13	2880221	S	255	125	380	0.00002
Virgibacillus_sp._MSP4-1	2700081	S	104	23	127	0.00001
Virgibacillus_sp._Bac332	2419842	S	97	12	109	0.00001
Virgibacillus_sp._NKC19-16	2831673	S	82	7	89	0.00001
Virgibacillus_sp._SK37	403957	S	46	48	94	0.00001
Virgibacillus_sp._Bac330	2419841	S	25	28	53	0.00000
Virgibacillus_phasianinus	2017483	S	105	16	121	0.00001
Virgibacillus_necropolis	163877	S	93	14	107	0.00001
Virgibacillus_halodenitrificans	1482	S	67	50	117	0.00001
Virgibacillus_dokdonensis	302167	S	31	38	69	0.00000
Oceanobacillus_kimchii	746691	S	411	60	471	0.00003
Oceanobacillus_iheyensis	182710	S	165	43	208	0.00001
Oceanobacillus_zhaokaii	2052660	S	149	31	180	0.00001
Parageobacillus_thermoglucosidasius	1426	S	215	134	349	0.00002
Parageobacillus_caldoxylosilyticus	81408	S	126	59	185	0.00001
Parageobacillus_genomosp._1	1295642	S	101	42	143	0.00001
Parageobacillus_toebii	153151	S	88	48	136	0.00001
Parageobacillus_sp._KH3-4	2916802	S	87	42	129	0.00001
Niallia_circulans	1397	S	484	150	634	0.00004
Niallia_sp._Man26	2912824	S	245	59	304	0.00002
Halobacillus_sp._SSHM10-5	2932259	S	94	23	117	0.00001
Halobacillus_sp._SSBR10-3	2932257	S	90	13	103	0.00001
Halobacillus_sp._SSTM10-2	2932258	S	76	17	93	0.00001
Halobacillus_mangrovi	402384	S	82	14	96	0.00001
Halobacillus_halophilus	1570	S	68	10	78	0.00001
Halobacillus_litoralis	45668	S	57	10	67	0.00000
Rossellomorea_marisflavi	189381	S	371	159	530	0.00003
Rossellomorea_vietnamensis	218284	S	114	49	163	0.00001
Salicibibacter_cibarius	2743000	S	138	40	178	0.00001
Salicibibacter_kimchii	2099786	S	105	11	116	0.00001
Salicibibacter_cibi	2743001	S	78	14	92	0.00001
Salicibibacter_halophilus	2502791	S	74	24	98	0.00001
Gracilibacillus_salitolerans	2663022	S	189	31	220	0.00001
Gracilibacillus_sp._SSPM10-3	2932255	S	86	28	114	0.00001
Gracilibacillus_sp._SSWR10-1	2932256	S	78	26	104	0.00001
Sutcliffiella_horikoshii	79883	S	206	62	268	0.00002
Sutcliffiella_cohnii	33932	S	170	81	251	0.00002
Weizmannia_coagulans	1398	S	376	228	604	0.00004
Salisediminibacterium_selenitireducens	85683	S	175	27	202	0.00001
Salisediminibacterium_beveridgei	632773	S	92	14	106	0.00001
Fictibacillus_arsenicus	255247	S	114	38	152	0.00001
Fictibacillus_phosphorivorans	1221500	S	113	36	149	0.00001
Gottfriedia_acidiceleris	371036	S	254	83	337	0.00002
Psychrobacillus_sp._INOP01	2829187	S	89	29	118	0.00001
Psychrobacillus_sp._AK_1817	2303505	S	14	14	28	0.00000
Psychrobacillus_glaciei	2283160	S	87	31	118	0.00001
Lederbergia_lenta	1467	S	165	45	210	0.00001
Lentibacillus_amyloliquefaciens	1472767	S	80	11	91	0.00001
Lentibacillus_sp._CBA3610	2518176	S	76	7	83	0.00001
Anaerobacillus_isosaccharinicus	1532552	S	161	39	200	0.00001
Pontibacillus_sp._ALD_SL1	2777185	S	81	12	93	0.00001
Pontibacillus_sp._HMF3514	2692425	S	73	13	86	0.00001
Caldibacillus_thermoamylovorans	35841	S	152	52	204	0.00001
Caldalkalibacillus_thermarum	296745	S	133	26	159	0.00001
Halalkalibacterium_halodurans	86665	S	132	97	229	0.00001
Aeribacillus_pallidus	33936	S	132	54	186	0.00001
Radiobacillus_sp._80	2844358	S	67	14	81	0.00001
Radiobacillus_deserti	2594883	S	62	12	74	0.00000
Alkalihalophilus_pseudofirmus	79885	S	107	19	126	0.00001
Salimicrobium_jeotgali	1230341	S	105	17	122	0.00001
Pradoshia_sp._D12	2651284	S	103	33	136	0.00001
Sediminibacillus_sp._DP4-553-S	2729421	S	97	18	115	0.00001
Mangrovibacillus_cuniculi	2593652	S	93	55	148	0.00001
Evansella_cellulosilytica	1413	S	88	14	102	0.00001
Paraliobacillus_zengyii	2213194	S	63	11	74	0.00000
Amphibacillus_xylanus	1449	S	56	11	67	0.00000
Paenibacillus_sp._B01	2660554	S	2040	619	2659	0.00017
Paenibacillus_sp._RUD330	2023772	S	1183	128	1311	0.00008
Paenibacillus_sp._32O-W	1695218	S	1160	112	1272	0.00008
Paenibacillus_sp._Y412MC10	481743	S	948	1449	2397	0.00015
Paenibacillus_sp._JNUCC-32	2777984	S	801	1295	2096	0.00013
Paenibacillus_sp._H1-7	2282849	S	708	65	773	0.00005
Paenibacillus_sp._R14(2021)	2859228	S	549	78	627	0.00004
Paenibacillus_sp._sptzw28	715179	S	488	45	533	0.00003
Paenibacillus_sp._JZ16	1906272	S	486	105	591	0.00004
Paenibacillus_sp._YPD9-1	2908839	S	395	51	446	0.00003
Paenibacillus_sp._BIHB4019	1870819	S	320	26	346	0.00002
Paenibacillus_sp._HWE-109	1306526	S	310	27	337	0.00002
Paenibacillus_sp._URB8-2	2741301	S	303	67	370	0.00002
Paenibacillus_sp._PK3_47	2072642	S	273	38	311	0.00002
Paenibacillus_sp._CAA11	1532905	S	269	53	322	0.00002
Paenibacillus_sp._PAMC21692	2762320	S	249	186	435	0.00003
Paenibacillus_sp._FSL_H7-0357	1536774	S	245	31	276	0.00002
Paenibacillus_sp._FSL_R7-0273	1536772	S	235	35	270	0.00002
Paenibacillus_sp._FSL_R7-0331	1536773	S	232	36	268	0.00002
Paenibacillus_sp._DCT19	2211212	S	170	28	198	0.00001
Paenibacillus_sp._JNUCC-31	2777983	S	149	37	186	0.00001
Paenibacillus_sp._FSL_P4-0081	1536769	S	146	65	211	0.00001
Paenibacillus_sp._YPG26	2878915	S	141	28	169	0.00001
Paenibacillus_sp._FSL_R5-0912	1536771	S	127	50	177	0.00001
Paenibacillus_sp._19GGS1-52	2758563	S	127	12	139	0.00001
Paenibacillus_sp._481	2835869	S	117	11	128	0.00001
Paenibacillus_sp._E222	2748863	S	95	29	124	0.00001
Paenibacillus_sp._IHB_B_3084	867076	S	82	42	124	0.00001
Paenibacillus_sp._IHBB_10380	1566358	S	60	10	70	0.00000
Paenibacillus_sp._Cedars	1980674	S	55	279	334	0.00002
Paenibacillus_sp._N3/727	2925845	S	52	55	107	0.00001
Paenibacillus_sp._FSL_R5-0345	1536770	S	49	11	60	0.00000
Paenibacillus_sp._FSL_H7-0737	1536775	S	47	12	59	0.00000
Paenibacillus_sp._37	2607911	S	12	107	119	0.00001
Paenibacillus_sp._lzh-N1	2069255	S	11	158	169	0.00001
Paenibacillus_mucilaginosus	61624	S	2825	234	3059	0.00020
Paenibacillus_albicereus	2726185	S	1849	510	2359	0.00015
Paenibacillus_cellulositrophicus	562959	S	1741	174	1915	0.00012
Paenibacillus_lycopersici	2704462	S	1502	186	1688	0.00011
Paenibacillus_ihbetae	1870820	S	1008	140	1148	0.00007
Paenibacillus_rhizovicinus	2704463	S	858	116	974	0.00006
Paenibacillus_konkukensis	2020716	S	847	93	940	0.00006
Paenibacillus_macerans	44252	S	814	75	889	0.00006
Paenibacillus_beijingensis	1126833	S	768	91	859	0.00005
Paenibacillus_dendritiformis	130049	S	696	113	809	0.00005
Paenibacillus_cellulosilyticus	375489	S	526	68	594	0.00004
Paenibacillus_lautus	1401	S	519	566	1085	0.00007
Paenibacillus_stellifer	169760	S	519	93	612	0.00004
Paenibacillus_thiaminolyticus	49283	S	519	82	601	0.00004
Paenibacillus_chitinolyticus	79263	S	510	62	572	0.00004
Paenibacillus_durus	44251	S	491	168	659	0.00004
Paenibacillus_sabinae	365617	S	396	93	489	0.00003
Paenibacillus_naphthalenovorans	162209	S	376	53	429	0.00003
Paenibacillus_xylanilyticus	248903	S	372	77	449	0.00003
Paenibacillus_albus	2495582	S	352	49	401	0.00003
Paenibacillus_polymyxa	1406	S	316	982	1298	0.00008
Paenibacillus_donghaensis	414771	S	301	31	332	0.00002
Paenibacillus_azoreducens	116718	S	297	35	332	0.00002
Paenibacillus_protaetiae	2509456	S	291	44	335	0.00002
Paenibacillus_riograndensis	483937	S	111	76	187	0.00001
Paenibacillus_sonchi	373687	S	97	145	242	0.00002
Paenibacillus_yonginensis	1462996	S	253	103	356	0.00002
Paenibacillus_algicola	2565926	S	248	41	289	0.00002
Paenibacillus_agaridevorans	171404	S	247	264	511	0.00003
Paenibacillus_tritici	1873425	S	233	33	266	0.00002
Paenibacillus_physcomitrellae	1619311	S	221	70	291	0.00002
Paenibacillus_swuensis	1178515	S	212	31	243	0.00002
Paenibacillus_tianjinensis	2810347	S	208	34	242	0.00002
Paenibacillus_sophorae	1333845	S	195	64	259	0.00002
Paenibacillus_guangzhouensis	1473112	S	193	18	211	0.00001
Paenibacillus_borealis	160799	S	185	59	244	0.00002
Paenibacillus_alvei	44250	S	174	22	196	0.00001
Paenibacillus_lentus	1338368	S	159	16	175	0.00001
Paenibacillus_jilunlii	682956	S	148	90	238	0.00002
Paenibacillus_lutimineralis	2707005	S	146	19	165	0.00001
Paenibacillus_barcinonensis	198119	S	145	24	169	0.00001
Paenibacillus_bovis	1616788	S	139	18	157	0.00001
Paenibacillus_psychroresistens	1778678	S	132	7	139	0.00001
Paenibacillus_kribbensis	172713	S	128	44	172	0.00001
Paenibacillus_larvae	1464	S	117	6	123	0.00001
Paenibacillus_baekrokdamisoli	1712516	S	114	12	126	0.00001
Paenibacillus_graminis	189425	S	112	53	165	0.00001
Paenibacillus_pabuli	1472	S	106	35	141	0.00001
Paenibacillus_odorifer	189426	S	104	18	122	0.00001
Paenibacillus_xylanexedens	528191	S	86	55	141	0.00001
Paenibacillus_crassostreae	1763538	S	79	12	91	0.00001
Paenibacillus_terrae	159743	S	77	34	111	0.00001
Paenibacillus_brasilensis	128574	S	68	28	96	0.00001
Paenibacillus_uliginis	683737	S	65	61	126	0.00001
Paenibacillus_antarcticus	253703	S	62	9	71	0.00000
Paenibacillus_peoriae	59893	S	43	219	262	0.00002
Paenibacillus_glucanolyticus	59843	S	33	171	204	0.00001
Brevibacillus_marinus	2496837	S	836	132	968	0.00006
Brevibacillus_agri	51101	S	645	156	801	0.00005
Brevibacillus_composti	2796470	S	573	140	713	0.00005
Brevibacillus_sp._MMS20-4M-10-Y	2895522	S	353	46	399	0.00003
Brevibacillus_sp._DP1.3A	2738867	S	59	49	108	0.00001
Brevibacillus_sp._HD3.3A	2738979	S	55	217	272	0.00002
Brevibacillus_sp._7WMA2	2683193	S	15	66	81	0.00001
Brevibacillus_choshinensis	54911	S	475	106	581	0.00004
Brevibacillus_brevis	1393	S	395	196	591	0.00004
Brevibacillus_laterosporus	1465	S	157	232	389	0.00002
Brevibacillus_formosus	54913	S	47	38	85	0.00001
Brevibacillus_parabrevis	54914	S	38	155	193	0.00001
Cohnella_candidum	2674991	S	1143	152	1295	0.00008
Cohnella_sp._LGH	1619153	S	710	274	984	0.00006
Cohnella_sp._MFER-1	2728023	S	360	55	415	0.00003
Cohnella_cholangitidis	2598458	S	332	66	398	0.00003
Cohnella_abietis	2507935	S	85	10	95	0.00001
Thermobacillus_composti	377615	S	2143	314	2457	0.00016
Saccharibacillus_brassicae	2583377	S	1227	151	1378	0.00009
Aneurinibacillus_soli	1500254	S	289	314	603	0.00004
Alicyclobacillus_acidocaldarius	405212	S	2117	184	2301	0.00015
Alicyclobacillus_acidoterrestris	1450	S	275	44	319	0.00002
Alicyclobacillus_mengziensis	2931921	S	252	18	270	0.00002
Alicyclobacillus_sp._SO9	2665646	S	117	9	126	0.00001
Alicyclobacillus_sp._TC	2606450	S	56	8	64	0.00000
Tumebacillus_avium	1903704	S	1354	633	1987	0.00013
Tumebacillus_algifaecis	1214604	S	459	180	639	0.00004
Kyrpidia_spormannii	2055160	S	327	163	490	0.00003
Kyrpidia_tusciae	33943	S	216	151	367	0.00002
Effusibacillus_dendaii	2743772	S	162	23	185	0.00001
Planococcus_sp._MB-3u-03	2058136	S	107	72	179	0.00001
Planococcus_sp._107-1	2908840	S	61	28	89	0.00001
Planococcus_sp._PAMC_21323	1526927	S	23	11	34	0.00000
Planococcus_plakortidis	1038856	S	165	100	265	0.00002
Planococcus_lenghuensis	2213202	S	149	34	183	0.00001
Planococcus_maritimus	192421	S	142	64	206	0.00001
Planococcus_glaciei	459472	S	139	44	183	0.00001
Planococcus_rifietoensis	200991	S	108	79	187	0.00001
Planococcus_massiliensis	1499687	S	83	18	101	0.00001
Planococcus_halotolerans	2233542	S	57	19	76	0.00000
Planococcus_antarcticus	161360	S	43	14	57	0.00000
Planococcus_halocryophilus	1215089	S	28	15	43	0.00000
Planococcus_donghaensis	414778	S	23	13	36	0.00000
Planococcus_versutus	1302659	S	21	10	31	0.00000
Planococcus_kocurii	1374	S	14	47	61	0.00000
Sporosarcina_sp._Marseille-Q4063	2810514	S	133	24	157	0.00001
Sporosarcina_sp._Te-1	2818390	S	66	15	81	0.00001
Sporosarcina_sp._resist	2762563	S	37	75	112	0.00001
Sporosarcina_sp._PTS2304	2283194	S	26	7	33	0.00000
Sporosarcina_sp._P37	1930546	S	17	49	66	0.00000
Sporosarcina_sp._P33	1930764	S	11	35	46	0.00000
Sporosarcina_ureae	1571	S	129	36	165	0.00001
Sporosarcina_ureilytica	298596	S	41	12	53	0.00000
Sporosarcina_pasteurii	1474	S	36	10	46	0.00000
Sporosarcina_psychrophila	1476	S	16	38	54	0.00000
Solibacillus_silvestris	76853	S	130	49	179	0.00001
Solibacillus_sp._R5-41	2048654	S	72	31	103	0.00001
Ureibacillus_thermophilus	367743	S	63	28	91	0.00001
Ureibacillus_thermosphaericus	51173	S	57	55	112	0.00001
Paenisporosarcina_antarctica	417367	S	60	19	79	0.00001
Paenisporosarcina_cavernae	2320858	S	39	23	62	0.00000
Jeotgalibacillus_malaysiensis	1508404	S	91	31	122	0.00001
Kurthia_sp._11kri321	1750719	S	32	18	50	0.00000
Kurthia_zopfii	1650	S	28	14	42	0.00000
Viridibacillus_sp._JNUCC-6	2779527	S	57	21	78	0.00001
Rummeliibacillus_stabekisii	241244	S	44	23	67	0.00000
Novibacillus_thermophilus	1471761	S	615	81	696	0.00004
Staphylospora_marina	2490858	S	596	107	703	0.00004
Kroppenstedtia_eburnea	714067	S	432	46	478	0.00003
Kroppenstedtia_pulmonis	1380685	S	91	7	98	0.00001
Polycladomyces_abyssicola	1125966	S	314	33	347	0.00002
Laceyella_sacchari	37482	S	242	61	303	0.00002
Thermoactinomyces_vulgaris	2026	S	161	34	195	0.00001
Staphylococcus_aureus	1280	S	74	2032	2106	0.00013
Staphylococcus_pseudintermedius	283734	S	22	24	46	0.00000
Staphylococcus_delphini	53344	S	18	16	34	0.00000
Staphylococcus_epidermidis	1282	S	47	39	86	0.00001
Staphylococcus_sp._17KM0847	2583989	S	17	8	25	0.00000
Staphylococcus_sp._CCM_9025	2892440	S	13	6	19	0.00000
Staphylococcus_haemolyticus	1283	S	32	34	66	0.00000
Staphylococcus_capitis	29388	S	24	23	47	0.00000
Staphylococcus_pseudoxylosus	2282419	S	23	12	35	0.00000
Staphylococcus_lutrae	155085	S	23	10	33	0.00000
Staphylococcus_auricularis	29379	S	23	8	31	0.00000
Staphylococcus_nepalensis	214473	S	21	7	28	0.00000
Staphylococcus_arlettae	29378	S	21	15	36	0.00000
Staphylococcus_simiae	308354	S	19	10	29	0.00000
Staphylococcus_gallinarum	1293	S	18	1	19	0.00000
Staphylococcus_simulans	1286	S	18	7	25	0.00000
Staphylococcus_succinus	61015	S	18	6	24	0.00000
Staphylococcus_chromogenes	46126	S	18	9	27	0.00000
Staphylococcus_hyicus	1284	S	18	9	27	0.00000
Staphylococcus_felis	46127	S	17	7	24	0.00000
Staphylococcus_pasteuri	45972	S	17	14	31	0.00000
Staphylococcus_cohnii	29382	S	17	13	30	0.00000
Staphylococcus_schleiferi	1295	S	17	28	45	0.00000
Staphylococcus_pettenkoferi	170573	S	16	4	20	0.00000
Staphylococcus_agnetis	985762	S	16	6	22	0.00000
Staphylococcus_piscifermentans	70258	S	15	6	21	0.00000
Staphylococcus_hominis	1290	S	15	12	27	0.00000
Staphylococcus_xylosus	1288	S	13	6	19	0.00000
Staphylococcus_muscae	1294	S	13	6	19	0.00000
Staphylococcus_saprophyticus	29385	S	12	6	18	0.00000
Staphylococcus_kloosii	29384	S	11	6	17	0.00000
Staphylococcus_carnosus	1281	S	11	4	15	0.00000
Staphylococcus_lugdunensis	28035	S	11	5	16	0.00000
Staphylococcus_edaphicus	1955013	S	11	3	14	0.00000
Staphylococcus_saccharolyticus	33028	S	10	4	14	0.00000
Staphylococcus_lloydii	2781774	S	10	4	14	0.00000
Staphylococcus_debuckii	2044912	S	10	4	14	0.00000
Macrococcus_armenti	2875764	S	37	18	55	0.00000
Macrococcus_canis	1855823	S	30	14	44	0.00000
Macrococcus_brunensis	198483	S	21	6	27	0.00000
Macrococcus_caseolyticus	69966	S	17	36	53	0.00000
Mammaliicoccus_sciuri	1296	S	63	40	103	0.00001
Mammaliicoccus_stepanovicii	643214	S	16	6	22	0.00000
Mammaliicoccus_lentus	42858	S	14	10	24	0.00000
Mammaliicoccus_vitulinus	71237	S	10	4	14	0.00000
Jeotgalicoccus_sp._WY2	2708346	S	32	7	39	0.00000
Jeotgalicoccus_sp._ATCC_8456	946435	S	14	2	16	0.00000
Jeotgalicoccus_saudimassiliensis	1461582	S	31	4	35	0.00000
Salinicoccus_halodurans	407035	S	63	20	83	0.00001
Nosocomiicoccus_ampullae	489910	S	26	4	30	0.00000
Abyssicoccus_albus	1817405	S	24	7	31	0.00000
Exiguobacterium_alkaliphilum	1428684	S	268	86	354	0.00002
Exiguobacterium_sp._N4-1P	2051906	S	69	47	116	0.00001
Exiguobacterium_sp._Helios	2735868	S	47	22	69	0.00000
Exiguobacterium_sp._PFWT01	2829816	S	31	43	74	0.00000
Exiguobacterium_sp._MH3	1399115	S	21	31	52	0.00000
Exiguobacterium_sp._AT1b	360911	S	17	23	40	0.00000
Exiguobacterium_mexicanum	340146	S	222	73	295	0.00002
Exiguobacterium_acetylicum	41170	S	80	138	218	0.00001
Exiguobacterium_sibiricum	332410	S	60	30	90	0.00001
Exiguobacterium_antarcticum	132920	S	46	17	63	0.00000
Gemella_sp._zg-570	2840371	S	16	10	26	0.00000
Gemella_morbillorum	29391	S	12	19	31	0.00000
Gemella_sanguinis	84135	S	12	11	23	0.00000
Listeria_monocytogenes	1639	S	83	1070	1153	0.00007
Listeria_grayi	1641	S	43	13	56	0.00000
Listeria_innocua	1642	S	42	39	81	0.00001
Listeria_weihenstephanensis	1006155	S	37	9	46	0.00000
Listeria_ivanovii	1638	S	36	11	47	0.00000
Listeria_seeligeri	1640	S	22	8	30	0.00000
Listeria_sp._PSOL-1	1844999	S	22	6	28	0.00000
Listeria_welshimeri	1643	S	15	10	25	0.00000
Listeria_marthii	529731	S	15	6	21	0.00000
Brochothrix_thermosphacta	2756	S	30	10	40	0.00000
Sporolactobacillus_terrae	269673	S	107	15	122	0.00001
Limosilactobacillus_fermentum	1613	S	182	148	330	0.00002
Limosilactobacillus_pontis	35787	S	141	82	223	0.00001
Limosilactobacillus_panis	47493	S	53	24	77	0.00000
Limosilactobacillus_mucosae	97478	S	50	21	71	0.00000
Limosilactobacillus_reuteri	1598	S	37	43	80	0.00001
Limosilactobacillus_gastricus	227942	S	10	4	14	0.00000
Lactobacillus_delbrueckii	1584	S	169	401	570	0.00004
Lactobacillus_sp._3B(2020)	2695882	S	18	13	31	0.00000
Lactobacillus_kefiranofaciens	267818	S	19	28	47	0.00000
Lactobacillus_johnsonii	33959	S	18	14	32	0.00000
Lactobacillus_panisapium	2012495	S	17	3	20	0.00000
Lactobacillus_amylolyticus	83683	S	16	8	24	0.00000
Lactobacillus_jensenii	109790	S	13	4	17	0.00000
Lactobacillus_terrae	2269374	S	12	2	14	0.00000
Lactobacillus_apis	303541	S	12	2	14	0.00000
Lactobacillus_iners	147802	S	12	17	29	0.00000
Lactobacillus_amylovorus	1604	S	10	56	66	0.00000
Levilactobacillus_zymae	267363	S	150	48	198	0.00001
Levilactobacillus_brevis	1580	S	80	33	113	0.00001
Levilactobacillus_suantsaii	2292255	S	60	22	82	0.00001
Levilactobacillus_koreensis	637971	S	36	5	41	0.00000
Lacticaseibacillus_casei	1582	S	58	24	82	0.00001
Lacticaseibacillus_rhamnosus	47715	S	48	26	74	0.00000
Lacticaseibacillus_manihotivorans	88233	S	32	10	42	0.00000
Lacticaseibacillus_paracasei	1597	S	29	91	120	0.00001
Lacticaseibacillus_chiayiensis	2100821	S	29	5	34	0.00000
Lacticaseibacillus_zeae	57037	S	19	10	29	0.00000
Schleiferilactobacillus_harbinensis	304207	S	177	20	197	0.00001
Lactiplantibacillus_pentosus	1589	S	64	18	82	0.00001
Lactiplantibacillus_plantarum	1590	S	43	60	103	0.00001
Lactiplantibacillus_paraplantarum	60520	S	28	8	36	0.00000
Ligilactobacillus_ruminis	1623	S	56	20	76	0.00000
Ligilactobacillus_agilis	1601	S	17	11	28	0.00000
Ligilactobacillus_animalis	1605	S	16	16	32	0.00000
Ligilactobacillus_salivarius	1624	S	15	11	26	0.00000
Ligilactobacillus_murinus	1622	S	11	7	18	0.00000
Weissella_soli	155866	S	18	6	24	0.00000
Weissella_confusa	1583	S	17	18	35	0.00000
Weissella_cibaria	137591	S	15	14	29	0.00000
Leuconostoc_lactis	1246	S	18	37	55	0.00000
Leuconostoc_gelidum	1244	S	11	1	12	0.00000
Leuconostoc_mesenteroides	1245	S	11	13	24	0.00000
Leuconostoc_pseudomesenteroides	33968	S	11	15	26	0.00000
Lentilactobacillus_hilgardii	1588	S	26	6	32	0.00000
Lentilactobacillus_parabuchneri	152331	S	23	7	30	0.00000
Lentilactobacillus_buchneri	1581	S	19	7	26	0.00000
Lentilactobacillus_sp._IM3328	2883998	S	11	3	14	0.00000
Pediococcus_acidilactici	1254	S	38	18	56	0.00000
Pediococcus_damnosus	51663	S	16	8	24	0.00000
Pediococcus_inopinatus	114090	S	10	6	16	0.00000
Loigolactobacillus_coryniformis	1610	S	42	44	86	0.00001
Loigolactobacillus_bifermentans	1607	S	20	5	25	0.00000
Latilactobacillus_curvatus	28038	S	25	13	38	0.00000
Latilactobacillus_sakei	1599	S	21	9	30	0.00000
Latilactobacillus_fuchuensis	164393	S	13	0	13	0.00000
Oenococcus_kitaharae	336988	S	34	7	41	0.00000
Secundilactobacillus_paracollinoides	240427	S	37	13	50	0.00000
Secundilactobacillus_malefermentans	176292	S	14	5	19	0.00000
Liquorilactobacillus_nagelii	82688	S	24	11	35	0.00000
Liquorilactobacillus_mali	1618	S	11	5	16	0.00000
Furfurilactobacillus_rossiae	231049	S	29	5	34	0.00000
Apilactobacillus_kunkeei	148814	S	20	6	26	0.00000
Acetilactobacillus_jinshanensis	1720083	S	26	1	27	0.00000
Bombilactobacillus_bombi	1303590	S	13	2	15	0.00000
Amylolactobacillus_amylophilus	1603	S	13	11	24	0.00000
Periweissella_cryptocerci	2506420	S	12	1	13	0.00000
Streptococcus_sp._HKU75	2781599	S	21	4	25	0.00000
Streptococcus_sp._LPB0220	2610896	S	14	14	28	0.00000
Streptococcus_sp._oral_taxon_431	712633	S	10	5	15	0.00000
Streptococcus_suis	1307	S	51	47	98	0.00001
Streptococcus_sanguinis	1305	S	43	15	58	0.00000
Streptococcus_salivarius	1304	S	37	64	101	0.00001
Streptococcus_equi	1336	S	22	6	28	0.00000
Streptococcus_dysgalactiae	1334	S	13	53	66	0.00000
Streptococcus_oralis	1303	S	30	35	65	0.00000
Streptococcus_pyogenes	1314	S	28	76	104	0.00001
Streptococcus_mutans	1309	S	26	18	44	0.00000
Streptococcus_cristatus	45634	S	24	39	63	0.00000
Streptococcus_gordonii	1302	S	23	10	33	0.00000
Streptococcus_sobrinus	1310	S	20	4	24	0.00000
Streptococcus_thermophilus	1308	S	19	23	42	0.00000
Streptococcus_ratti	1341	S	18	3	21	0.00000
Streptococcus_ferus	1345	S	17	4	21	0.00000
Streptococcus_pantholopis	1811193	S	15	2	17	0.00000
Streptococcus_troglodytae	1111760	S	14	4	18	0.00000
Streptococcus_mitis	28037	S	14	17	31	0.00000
Streptococcus_merionis	400065	S	14	2	16	0.00000
Streptococcus_pluranimalium	82348	S	13	7	20	0.00000
Streptococcus_gallolyticus	315405	S	13	26	39	0.00000
Streptococcus_infantis	68892	S	13	6	19	0.00000
Streptococcus_iniae	1346	S	12	4	16	0.00000
Streptococcus_pneumoniae	1313	S	12	229	241	0.00002
Streptococcus_halichoeri	254785	S	11	16	27	0.00000
Streptococcus_uberis	1349	S	10	3	13	0.00000
Streptococcus_parauberis	1348	S	10	12	22	0.00000
Streptococcus_respiraculi	2021971	S	10	2	12	0.00000
Lactococcus_raffinolactis	1366	S	29	18	47	0.00000
Lactococcus_lactis	1358	S	22	50	72	0.00000
Lactococcus_garvieae	1363	S	22	24	46	0.00000
Lactococcus_cremoris	1359	S	17	19	36	0.00000
Lactococcus_allomyrinae	2419773	S	12	2	14	0.00000
Lactococcus_piscium	1364	S	10	46	56	0.00000
Lactococcus_taiwanensis	1151742	S	10	2	12	0.00000
Enterococcus_avium	33945	S	46	28	74	0.00000
Enterococcus_faecalis	1351	S	40	44	84	0.00001
Enterococcus_cecorum	44008	S	33	28	61	0.00000
Enterococcus_faecium	1352	S	31	242	273	0.00002
Enterococcus_gilvus	160453	S	26	13	39	0.00000
Enterococcus_mundtii	53346	S	26	12	38	0.00000
Enterococcus_raffinosus	71452	S	22	14	36	0.00000
Enterococcus_hirae	1354	S	17	15	32	0.00000
Enterococcus_durans	53345	S	16	18	34	0.00000
Enterococcus_casseliflavus	37734	S	15	46	61	0.00000
Enterococcus_wangshanyuanii	2005703	S	14	2	16	0.00000
Enterococcus_rotai	118060	S	13	0	13	0.00000
Enterococcus_thailandicus	417368	S	11	6	17	0.00000
Vagococcus_lutrae	81947	S	22	46	68	0.00000
Vagococcus_carniphilus	218144	S	17	10	27	0.00000
Vagococcus_fluvialis	2738	S	12	11	23	0.00000
Tetragenococcus_osmophilus	526944	S	15	12	27	0.00000
Carnobacterium_divergens	2748	S	22	10	32	0.00000
Carnobacterium_maltaromaticum	2751	S	16	17	33	0.00000
Jeotgalibaca_sp._MA1X17-3	2908211	S	27	6	33	0.00000
Jeotgalibaca_porci	1868793	S	15	12	27	0.00000
Jeotgalibaca_ciconiae	2496265	S	14	9	23	0.00000
Dolosigranulum_pigrum	29394	S	53	15	68	0.00000
Granulicatella_elegans	137732	S	12	32	44	0.00000
Granulicatella_adiacens	46124	S	10	5	15	0.00000
Marinilactibacillus_sp._15R	1911586	S	16	6	22	0.00000
Aerococcus_sanguinicola	119206	S	28	7	35	0.00000
Aerococcus_urinae	1376	S	19	8	27	0.00000
Aerococcus_christensenii	87541	S	19	30	49	0.00000
Aerococcus_urinaeequi	51665	S	13	94	107	0.00001
Aerococcus_urinaehominis	128944	S	13	2	15	0.00000
Abiotrophia_defectiva	46125	S	24	7	31	0.00000
Ignavigranum_ruoffiae	89093	S	21	3	24	0.00000
Suicoccus_acidiformans	2036206	S	20	14	34	0.00000
Thermaerobacter_sp._FW80	2546351	S	2599	531	3130	0.00020
Thermaerobacter_sp._PB12/4term	2293838	S	1594	390	1984	0.00013
Thermaerobacter_marianensis	73919	S	2153	529	2682	0.00017
Intestinimonas_butyriciproducens	1297617	S	413	162	575	0.00004
Aminipila_luticellarii	2507160	S	62	7	69	0.00000
Aminipila_butyrica	433296	S	44	4	48	0.00000
Aminipila_terrae	2697030	S	34	3	37	0.00000
Emergencia_timonensis	1776384	S	131	48	179	0.00001
Mogibacterium_pumilum	86332	S	10	34	44	0.00000
Flintibacter_sp._KGMB00164	2610895	S	268	37	305	0.00002
Massilistercora_timonensis	2086584	S	137	142	279	0.00002
Carboxydocella_thermautotrophica	178899	S	124	13	137	0.00001
Faecalibacterium_prausnitzii	853	S	1429	1368	2797	0.00018
Dysosmobacter_sp._Marseille-Q4140	2830675	S	562	248	810	0.00005
Dysosmobacter_welbionis	2093857	S	430	318	748	0.00005
Flavonifractor_plautii	292800	S	830	221	1051	0.00007
Ethanoligenens_harbinense	253239	S	558	32	590	0.00004
Vescimonas_coprocola	2714355	S	301	266	567	0.00004
Vescimonas_fastidiosa	2714353	S	210	324	534	0.00003
Ruthenibacterium_lactatiformans	1550024	S	493	146	639	0.00004
Caproiciproducens_sp._NJN-50	2507162	S	414	54	468	0.00003
Oscillibacter_sp._NSJ-62	2763056	S	333	111	444	0.00003
Anaerotruncus_colihominis	169435	S	326	184	510	0.00003
Acutalibacter_muris	1796620	S	300	15	315	0.00002
Caproicibacter_fermentans	2576756	S	278	17	295	0.00002
Pusillibacter_faecalis	2714358	S	197	135	332	0.00002
Ruminococcus_champanellensis	1161942	S	98	16	114	0.00001
Ruminococcus_albus	1264	S	41	1	42	0.00000
Ruminococcus_bicirculans	1160721	S	21	7	28	0.00000
Ruminococcus_bovis	2564099	S	15	2	17	0.00000
Caproicibacterium_amylolyticum	2766537	S	95	7	102	0.00001
Caproicibacterium_lactatifermentans	2666138	S	78	9	87	0.00001
Solibaculum_mannosilyticum	2780922	S	172	166	338	0.00002
Acetivibrio_thermocellus	1515	S	37	5	42	0.00000
Acetivibrio_clariflavus	288965	S	31	20	51	0.00000
Acetivibrio_saccincola	1677857	S	24	15	39	0.00000
Thermoclostridium_stercorarium	1510	S	45	7	52	0.00000
Pseudoclostridium_thermosuccinogenes	84032	S	43	10	53	0.00000
Ruminiclostridium_herbifermentans	2488810	S	29	8	37	0.00000
Ruminiclostridium_cellulolyticum	1521	S	12	3	15	0.00000
Monoglobus_pectinilyticus	1981510	S	38	19	57	0.00000
Mageeibacillus_indolicus	884684	S	23	31	54	0.00000
Fastidiosipila_sanguinis	236753	S	15	8	23	0.00000
Symbiobacterium_thermophilum	2734	S	2977	260	3237	0.00021
Clostridium_sp._M62/1	411486	S	78	100	178	0.00001
Clostridium_sp._SY8519	1042156	S	76	22	98	0.00001
Clostridium_sp._JN-9	2507159	S	49	7	56	0.00000
Clostridium_sp._C5S11	704125	S	41	4	45	0.00000
Clostridium_sp._DL-VIII	641107	S	39	6	45	0.00000
Clostridium_sp._JN-1	2483110	S	25	3	28	0.00000
Clostridium_sp._BNL1100	755731	S	23	2	25	0.00000
Clostridium_sp._MD294	97138	S	22	1	23	0.00000
Clostridium_sp._C1	1155388	S	21	19	40	0.00000
Clostridium_sp._'deep_sea'	2779445	S	21	0	21	0.00000
Clostridium_sp._AWRP	2212991	S	16	8	24	0.00000
Clostridium_sp._BJN0001	2930219	S	16	3	19	0.00000
Clostridium_sp._001	1970093	S	10	7	17	0.00000
Clostridium_tetani	1513	S	109	14	123	0.00001
Clostridium_botulinum	1491	S	103	87	190	0.00001
Clostridium_perfringens	1502	S	94	24	118	0.00001
Clostridium_beijerinckii	1520	S	94	184	278	0.00002
Clostridium_pasteurianum	1501	S	69	11	80	0.00001
Clostridium_saccharoperbutylacetonicum	36745	S	56	10	66	0.00000
Clostridium_argentinense	29341	S	55	7	62	0.00000
Clostridium_cellulovorans	1493	S	54	8	62	0.00000
Clostridium_thermarum	1716543	S	49	28	77	0.00000
Clostridium_formicaceticum	1497	S	46	8	54	0.00000
Clostridium_baratii	1561	S	46	12	58	0.00000
Clostridium_butyricum	1492	S	41	7	48	0.00000
Clostridium_kluyveri	1534	S	39	2	41	0.00000
Clostridium_manihotivorum	2320868	S	34	3	37	0.00000
Clostridium_tyrobutyricum	1519	S	31	2	33	0.00000
Clostridium_sporogenes	1509	S	30	156	186	0.00001
Clostridium_carboxidivorans	217159	S	30	7	37	0.00000
Clostridium_gasigenes	94869	S	29	4	33	0.00000
Clostridium_intestinale	36845	S	27	3	30	0.00000
Clostridium_estertheticum	238834	S	24	4	28	0.00000
Clostridium_drakei	332101	S	24	16	40	0.00000
Clostridium_cadaveris	1529	S	24	5	29	0.00000
Clostridium_fermenticellae	2068654	S	24	2	26	0.00000
Clostridium_aceticum	84022	S	24	2	26	0.00000
Clostridium_saccharobutylicum	169679	S	24	4	28	0.00000
Clostridium_acetobutylicum	1488	S	22	1	23	0.00000
Clostridium_taeniosporum	394958	S	21	3	24	0.00000
Clostridium_isatidis	182773	S	19	8	27	0.00000
Clostridium_bornimense	1216932	S	18	6	24	0.00000
Clostridium_novyi	1542	S	15	86	101	0.00001
Clostridium_septicum	1504	S	13	3	16	0.00000
Clostridium_scatologenes	1548	S	10	8	18	0.00000
Alkaliphilus_sp._B6464	2731219	S	122	32	154	0.00001
Alkaliphilus_oremlandii	461876	S	59	16	75	0.00000
Alkaliphilus_metalliredigens	208226	S	29	5	34	0.00000
Hungatella_hathewayi	154046	S	156	6	162	0.00001
Crassaminicella_profunda	1286698	S	29	6	35	0.00000
Crassaminicella_sp._143-21	2855394	S	22	9	31	0.00000
Crassaminicella_thermophila	2599308	S	21	6	27	0.00000
Geosporobacter_ferrireducens	1424294	S	41	6	47	0.00000
Caloramator_sp._E03	2576307	S	30	2	32	0.00000
Serpentinicella_alkaliphila	1734049	S	18	2	20	0.00000
Paraclostridium_bifermentans	1490	S	15	4	19	0.00000
Sarcina_sp._JB2	2726954	S	11	4	15	0.00000
[Clostridium]_scindens	29347	S	145	58	203	0.00001
Lachnoclostridium_phocaeense	1871021	S	131	113	244	0.00002
[Clostridium]_hylemonae	89153	S	116	31	147	0.00001
Lachnoclostridium_sp._YL32	1834196	S	33	42	75	0.00000
Lachnoclostridium_phytofermentans	66219	S	26	1	27	0.00000
Blautia_producta	33035	S	91	19	110	0.00001
Blautia_sp._NBRC_113351	2877527	S	60	67	127	0.00001
Blautia_sp._SC05B48	2479767	S	12	34	46	0.00000
Blautia_liquoris	2779518	S	55	4	59	0.00000
Blautia_pseudococcoides	1796616	S	53	8	61	0.00000
Blautia_argi	1912897	S	23	20	43	0.00000
Blautia_obeum	40520	S	20	19	39	0.00000
Blautia_hansenii	1322	S	11	7	18	0.00000
Blautia_massiliensis	1737424	S	10	22	32	0.00000
Lachnospiraceae_bacterium_NSJ-29	2763667	S	119	35	154	0.00001
Lachnospiraceae_bacterium_NSJ-38	2763669	S	111	43	154	0.00001
Lachnospiraceae_bacterium_sunii_NSJ-8	2763672	S	66	50	116	0.00001
Lachnospiraceae_bacterium_NSJ-4	2763670	S	24	24	48	0.00000
Roseburia_hominis	301301	S	137	146	283	0.00002
Roseburia_intestinalis	166486	S	31	32	63	0.00000
Roseburia_sp._NSJ-69	2763062	S	17	8	25	0.00000
Anaerocolumna_cellulosilytica	433286	S	121	5	126	0.00001
Anaerocolumna_sedimenticola	2696063	S	39	2	41	0.00000
Anaerocolumna_chitinilytica	1727145	S	29	1	30	0.00000
Enterocloster_bolteae	208479	S	154	47	201	0.00001
Enterocloster_clostridioformis	1531	S	24	60	84	0.00001
Anaerostipes_rhamnosivorans	1229621	S	49	20	69	0.00000
Anaerostipes_caccae	105841	S	48	11	59	0.00000
Butyrivibrio_fibrisolvens	831	S	59	16	75	0.00000
Butyrivibrio_proteoclasticus	43305	S	17	3	20	0.00000
Lacrimispora_sphenoides	29370	S	47	3	50	0.00000
Lacrimispora_saccharolytica	84030	S	40	6	46	0.00000
Coprococcus_catus	116085	S	32	17	49	0.00000
Coprococcus_comes	410072	S	24	25	49	0.00000
Coprococcus_eutactus	33043	S	16	18	34	0.00000
Coprococcus_sp._ART55/1	751585	S	10	9	19	0.00000
Anaerotignum_propionicum	28446	S	77	8	85	0.00001
Sellimonas_intestinalis	1653434	S	59	33	92	0.00001
[Ruminococcus]_gnavus	33038	S	24	16	40	0.00000
[Ruminococcus]_torques	33039	S	11	9	20	0.00000
Anaerobutyricum_hallii	39488	S	28	9	37	0.00000
Dorea_longicatena	88431	S	27	24	51	0.00000
Herbinix_luporum	1679721	S	22	15	37	0.00000
Novisyntrophococcus_fermenticellae	2068655	S	21	2	23	0.00000
Pseudobutyrivibrio_xylanivorans	185007	S	17	1	18	0.00000
Lachnoanaerobaculum_umeaense	617123	S	13	3	16	0.00000
Faecalicatena_sp._Marseille-Q4148	2823316	S	11	5	16	0.00000
Lachnospira_eligens	39485	S	11	2	13	0.00000
Candidatus_Desulforudis_audaxviator	471827	S	847	47	894	0.00006
Desulforamulus_ferrireducens	1833852	S	126	82	208	0.00001
Desulforamulus_ruminis	1564	S	95	14	109	0.00001
Desulforamulus_reducens	59610	S	45	9	54	0.00000
Acididesulfobacillus_acetoxydans	1561005	S	257	10	267	0.00002
Candidatus_Formimonas_warabiya	1761012	S	154	11	165	0.00001
Thermanaerosceptrum_fracticalcis	1712410	S	84	13	97	0.00001
Dehalobacterium_formicoaceticum	51515	S	67	13	80	0.00001
Desulfofarcimen_acetoxidans	58138	S	63	7	70	0.00000
Christensenella_sp._Marseille-P3954	2086585	S	705	357	1062	0.00007
Christensenella_minuta	626937	S	180	50	230	0.00001
Heliomicrobium_modesticaldum	35701	S	775	376	1151	0.00007
Heliorestis_convoluta	356322	S	57	3	60	0.00000
Desulfitobacterium_hafniense	49338	S	99	23	122	0.00001
Desulfitobacterium_dehalogenans	36854	S	70	27	97	0.00001
Desulfitobacterium_metallireducens	142877	S	49	13	62	0.00000
Desulfitobacterium_dichloroeliminans	233055	S	42	44	86	0.00001
Desulfosporosinus_orientis	1563	S	61	11	72	0.00000
Desulfosporosinus_youngiae	339862	S	57	15	72	0.00000
Desulfosporosinus_acidiphilus	885581	S	54	9	63	0.00000
Desulfosporosinus_meridiei	79209	S	39	12	51	0.00000
Dehalobacter_restrictus	55583	S	43	63	106	0.00001
Syntrophobotulus_glycolicus	51197	S	72	5	77	0.00000
Eubacterium_limosum	1736	S	115	94	209	0.00001
Eubacterium_sp._c-25	2841037	S	23	12	35	0.00000
Eubacterium_sp._NSJ-61	2764325	S	15	22	37	0.00000
Eubacterium_sp._MSJ-33	2841528	S	10	6	16	0.00000
Eubacterium_callanderi	53442	S	46	28	74	0.00000
Eubacterium_maltosivorans	2041044	S	22	79	101	0.00001
Acetobacterium_sp._KB-1	2184575	S	61	28	89	0.00001
Acetobacterium_wieringae	52694	S	52	35	87	0.00001
Acetobacterium_woodii	33952	S	17	5	22	0.00000
Alkalibacter_sp._ES005	2815577	S	85	5	90	0.00001
Syntrophothermus_lipocalidus	86170	S	125	10	135	0.00001
Syntrophomonas_wolfei	863	S	66	10	76	0.00000
Candidatus_Contubernalis_alkalaceticum	338645	S	54	2	56	0.00000
Candidatus_Syntrophocurvum_alkaliphilum	2293317	S	24	4	28	0.00000
Romboutsia_ilealis	1115758	S	19	8	27	0.00000
Romboutsia_sp._CE17	2724150	S	15	6	21	0.00000
Peptoclostridium_acidaminophilum	1731	S	38	6	44	0.00000
Clostridioides_difficile	1496	S	20	437	457	0.00003
Terrisporobacter_sp._MCA3	2813371	S	21	3	24	0.00000
Tepidibacter_sp._8C15b	2925782	S	18	3	21	0.00000
Acetoanaerobium_sticklandii	1511	S	16	1	17	0.00000
Paeniclostridium_sordellii	1505	S	16	3	19	0.00000
Filifactor_alocis	143361	S	11	15	26	0.00000
Desulfoscipio_gibsoniae	102134	S	148	12	160	0.00001
Thermincola_potens	863643	S	78	7	85	0.00001
Desulfotomaculum_nigrificans	1565	S	74	31	105	0.00001
Vallitalea_pronyensis	1348613	S	16	1	17	0.00000
Vallitalea_guaymasensis	1185412	S	14	1	15	0.00000
Petrocella_atlantisensis	2173034	S	28	4	32	0.00000
Caloranaerobacter_azorensis	116090	S	47	6	53	0.00000
Alkalicella_caledoniensis	2731377	S	22	3	25	0.00000
Moorella_sp._Hama-1	2138101	S	374	101	475	0.00003
Moorella_thermoacetica	1525	S	343	78	421	0.00003
Moorella_glycerini	55779	S	273	33	306	0.00002
Ammonifex_degensii	42838	S	447	16	463	0.00003
Gelria_sp._Kuro-4	2796927	S	1110	83	1193	0.00008
Thermacetogenium_phaeum	85874	S	419	384	803	0.00005
Carboxydothermus_hydrogenoformans	129958	S	197	17	214	0.00001
Thermoanaerobacter_kivui	2325	S	18	20	38	0.00000
Thermoanaerobacter_mathranii	583357	S	14	51	65	0.00000
Thermanaeromonas_toyohensis	161154	S	85	2	87	0.00001
Caldanaerobacter_subterraneus	911092	S	48	65	113	0.00001
Caldicellulosiruptor_changbaiensis	1222016	S	16	63	79	0.00001
Caldicellulosiruptor_acetigenus	301953	S	13	10	23	0.00000
Thermoanaerobacterium_thermosaccharolyticum	1517	S	32	62	94	0.00001
Thermoanaerobacterium_sp._RBIITD	1550240	S	16	12	28	0.00000
Thermoanaerobacterium_xylanolyticum	29329	S	14	13	27	0.00000
Zhaonella_formicivorans	2528593	S	111	17	128	0.00001
Mahella_australiensis	252966	S	97	50	147	0.00001
Thermodesulfobium_acidiphilum	1794699	S	25	20	45	0.00000
Thermodesulfobium_narugense	184064	S	14	11	25	0.00000
Iocasia_fonsfrigidae	2682810	S	102	17	119	0.00001
Halanaerobium_praevalens	2331	S	28	23	51	0.00000
Halanaerobium_hydrogeniformans	656519	S	13	6	19	0.00000
Halothermothrix_orenii	31909	S	43	9	52	0.00000
Anoxybacter_fermentans	1323375	S	87	41	128	0.00001
Halobacteroides_halobius	42422	S	30	23	53	0.00000
Acetohalobium_arabaticum	28187	S	25	13	38	0.00000
Thermosediminibacter_oceani	291990	S	154	9	163	0.00001
Biomaibacter_acetigenes	2316383	S	72	3	75	0.00000
Tepidanaerobacter_acetatoxydans	499229	S	31	1	32	0.00000
Natranaerofaba_carboxydovora	2742683	S	66	3	69	0.00000
Natranaerobius_thermophilus	375929	S	31	4	35	0.00000
Koleobacter_methoxysyntrophicus	2751313	S	57	5	62	0.00000
Selenomonas_sp._oral_taxon_126	712528	S	575	132	707	0.00005
Selenomonas_sp._oral_taxon_920	1884263	S	376	75	451	0.00003
Selenomonas_sp._oral_taxon_478	712538	S	171	236	407	0.00003
Selenomonas_sp._oral_taxon_136	713030	S	165	216	381	0.00002
Selenomonas_sputigena	69823	S	1074	81	1155	0.00007
Selenomonas_timonae	2754044	S	356	139	495	0.00003
Selenomonas_ruminantium	971	S	157	13	170	0.00001
Megamonas_funiformis	437897	S	18	10	28	0.00000
Pectinatus_frisingensis	865	S	21	1	22	0.00000
Sporomusa_termitida	2377	S	166	21	187	0.00001
Methylomusa_anaerophila	1930071	S	119	8	127	0.00001
Pelosinus_sp._UFO1	484770	S	63	20	83	0.00001
Pelosinus_fermentans	365349	S	34	6	40	0.00000
Megasphaera_stantonii	2144175	S	301	165	466	0.00003
Megasphaera_elsdenii	907	S	293	129	422	0.00003
Megasphaera_massiliensis	1232428	S	146	50	196	0.00001
Dialister_pneumosintes	39950	S	15	116	131	0.00001
Veillonella_rodentium	248315	S	29	19	48	0.00000
Veillonella_parvula	29466	S	16	21	37	0.00000
Acidaminococcus_fermentans	905	S	201	33	234	0.00001
Acidaminococcus_intestini	187327	S	76	9	85	0.00001
Phascolarctobacterium_faecium	33025	S	84	7	91	0.00001
Phascolarctobacterium_succinatutens	626940	S	48	110	158	0.00001
Phascolarctobacterium_sp._Marseille-Q4147	2823317	S	27	19	46	0.00000
Limnochorda_pilosa	1555112	S	2953	121	3074	0.00020
Peptoniphilus_ivorii	54006	S	145	33	178	0.00001
Peptoniphilus_harei	54005	S	21	21	42	0.00000
Murdochiella_vaginalis	1852373	S	86	79	165	0.00001
Anaerococcus_mediterraneensis	1870984	S	45	75	120	0.00001
Finegoldia_magna	1260	S	15	14	29	0.00000
Parvimonas_micra	33033	S	15	26	41	0.00000
Helcococcus_kunzii	40091	S	13	5	18	0.00000
Gudongella_oleilytica	1582259	S	43	8	51	0.00000
Keratinibaculum_paraultunense	1278232	S	24	12	36	0.00000
Tissierella_sp._JN-28	2507161	S	21	4	25	0.00000
Schnuerera_ultunensis	45497	S	18	4	22	0.00000
Gottschalkia_acidurici	1556	S	64	7	71	0.00000
Ezakiella_coagulans	46507	S	75	185	260	0.00002
Ezakiella_massiliensis	1852374	S	19	9	28	0.00000
Sedimentibacter_sp._zth1	2816908	S	23	2	25	0.00000
Allobaculum_sp._Allo2	2853432	S	87	17	104	0.00001
Allobaculum_mucolyticum	2834459	S	52	11	63	0.00000
Faecalibaculum_rodentium	1702221	S	134	38	172	0.00001
[Clostridium]_innocuum	1522	S	48	40	88	0.00001
Erysipelatoclostridium_ramosum	1547	S	13	7	20	0.00000
Erysipelothrix_sp._HDW6C	2714930	S	10	6	16	0.00000
Erysipelothrix_larvae	1514105	S	17	8	25	0.00000
Intestinibaculum_porci	2487118	S	34	14	48	0.00000
Bulleidia_sp._zg-1006	2806552	S	28	10	38	0.00000
Faecalitalea_cylindroides	39483	S	13	25	38	0.00000
Longicatena_caecimuris	1796635	S	13	24	37	0.00000
Faecalibacillus_intestinalis	1982626	S	13	17	30	0.00000
Turicibacter_sp._H121	1712675	S	14	25	39	0.00000
Ndongobacter_massiliensis	1871025	S	111	87	198	0.00001
endosymbiont_'TC1'_of_Trimyema_compressum	243899	S	39	2	41	0.00000
Deinococcus_sp._NW-56	2080419	S	1583	268	1851	0.00012
Deinococcus_sp._TS-293	2737050	S	1228	150	1378	0.00009
Deinococcus_sp._KNUC1210	2917691	S	1162	54	1216	0.00008
Deinococcus_sp._AJ005	2652443	S	821	83	904	0.00006
Deinococcus_sp._QL22	2939437	S	526	55	581	0.00004
Deinococcus_maricopensis	309887	S	2118	213	2331	0.00015
Deinococcus_metallilatus	1211322	S	1892	260	2152	0.00014
Deinococcus_gobiensis	502394	S	1882	294	2176	0.00014
Deinococcus_actinosclerus	1768108	S	1756	1385	3141	0.00020
Deinococcus_ficus	317577	S	1749	194	1943	0.00012
Deinococcus_irradiatisoli	2202254	S	1282	135	1417	0.00009
Deinococcus_peraridilitoris	432329	S	1185	65	1250	0.00008
Deinococcus_wulumuqiensis	980427	S	1148	585	1733	0.00011
Deinococcus_radiopugnans	57497	S	1139	169	1308	0.00008
Deinococcus_radiodurans	1299	S	918	401	1319	0.00008
Deinococcus_geothermalis	68909	S	873	167	1040	0.00007
Deinococcus_soli_(ex_Cha_et_al._2016)	1309411	S	755	939	1694	0.00011
Deinococcus_psychrotolerans	2489213	S	695	23	718	0.00005
Deinococcus_deserti	310783	S	618	52	670	0.00004
Deinococcus_proteolyticus	55148	S	616	172	788	0.00005
Deinococcus_radiophilus	32062	S	325	85	410	0.00003
Deinococcus_puniceus	1182568	S	286	56	342	0.00002
Thermus_thermophilus	274	S	1014	1093	2107	0.00013
Thermus_oshimai	56957	S	556	108	664	0.00004
Thermus_sp._CCB_US3_UF1	1111069	S	356	55	411	0.00003
Thermus_sp._NEB1569	2918899	S	104	188	292	0.00002
Thermus_aquaticus	271	S	449	67	516	0.00003
Thermus_brockianus	56956	S	434	84	518	0.00003
Thermus_caldilimi	2483360	S	248	63	311	0.00002
Thermus_scotoductus	37636	S	105	161	266	0.00002
Thermus_parvatiensis	456163	S	70	341	411	0.00003
Oceanithermus_profundus	187137	S	2669	298	2967	0.00019
Meiothermus_silvanus	52022	S	833	129	962	0.00006
Meiothermus_taiwanensis	172827	S	709	250	959	0.00006
Meiothermus_ruber	277	S	653	242	895	0.00006
Marinithermus_hydrothermalis	186192	S	1809	294	2103	0.00013
Truepera_radiovictrix	332249	S	2728	165	2893	0.00018
Synechococcus_sp._CBW1004	1353136	S	975	237	1212	0.00008
Synechococcus_sp._RSCCF101	2511069	S	793	176	969	0.00006
Synechococcus_sp._CBW1107	2789857	S	686	125	811	0.00005
Synechococcus_sp._JA-3-3Ab	321327	S	520	118	638	0.00004
Synechococcus_sp._CB0101	232348	S	498	104	602	0.00004
Synechococcus_sp._SynAce01	1916956	S	467	49	516	0.00003
Synechococcus_sp._CBW1108	1353147	S	436	57	493	0.00003
Synechococcus_sp._NB0720_10	2907159	S	363	91	454	0.00003
Synechococcus_sp._LA31	2741953	S	338	71	409	0.00003
Synechococcus_sp._RS9909	221352	S	282	95	377	0.00002
Synechococcus_sp._PCC_7336	195250	S	280	9	289	0.00002
Synechococcus_sp._LTW-R	2751170	S	280	65	345	0.00002
Synechococcus_sp._JA-2-3B'a(2-13)	321332	S	248	51	299	0.00002
Synechococcus_sp._HK01-R	2751171	S	239	38	277	0.00002
Synechococcus_sp._Minos11	221341	S	218	15	233	0.00001
Synechococcus_sp._WH_8101	59932	S	218	68	286	0.00002
Synechococcus_sp._KORDI-100	1280380	S	218	14	232	0.00001
Synechococcus_sp._A10-1-5-1	2936507	S	203	44	247	0.00002
Synechococcus_sp._NOUM97013	1442555	S	154	23	177	0.00001
Synechococcus_sp._BMK-MC-1	1442551	S	144	52	196	0.00001
Synechococcus_sp._PROS-7-1	1442556	S	136	54	190	0.00001
Synechococcus_sp._PROS-U-1	1400866	S	132	22	154	0.00001
Synechococcus_sp._KORDI-49	585423	S	128	112	240	0.00002
Synechococcus_sp._MEDNS5	1442554	S	125	37	162	0.00001
Synechococcus_sp._KORDI-52	585425	S	103	30	133	0.00001
Synechococcus_sp._PCC_6312	195253	S	98	4	102	0.00001
Synechococcus_sp._BIOS-E4-1	1400864	S	96	9	105	0.00001
Synechococcus_sp._A15-127	1050624	S	89	77	166	0.00001
Synechococcus_sp._CC9902	316279	S	85	8	93	0.00001
Synechococcus_sp._A15-44	1050646	S	85	130	215	0.00001
Synechococcus_sp._MIT_S9220	166309	S	82	11	93	0.00001
Synechococcus_sp._CBW1006	1353138	S	76	489	565	0.00004
Synechococcus_sp._CBW1002	1353134	S	72	527	599	0.00004
Synechococcus_sp._A15-62	1050657	S	68	42	110	0.00001
Synechococcus_sp._BIOS-U3-1	1400865	S	66	7	73	0.00000
Synechococcus_sp._NIES-970	1827144	S	63	11	74	0.00000
Synechococcus_sp._ROS8604	1442557	S	60	13	73	0.00000
Synechococcus_sp._RS9907	221350	S	59	118	177	0.00001
Synechococcus_sp._PCC_7003	374981	S	53	15	68	0.00000
Synechococcus_sp._WH_8020	32052	S	52	8	60	0.00000
Synechococcus_sp._WH_8109	166314	S	42	28	70	0.00000
Synechococcus_sp._PCC_7502	1173263	S	39	2	41	0.00000
Synechococcus_sp._TAK9802	1442558	S	38	80	118	0.00001
Synechococcus_sp._RS9902	221345	S	36	63	99	0.00001
Synechococcus_sp._MVIR-18-1	1386941	S	36	54	90	0.00001
Synechococcus_sp._PROS-9-1	1968775	S	35	8	43	0.00000
Synechococcus_sp._CC9311	64471	S	26	5	31	0.00000
Synechococcus_sp._M16.1	1442553	S	24	61	85	0.00001
Synechococcus_sp._A18-25c	1866938	S	23	145	168	0.00001
Synechococcus_sp._A15-60	1050655	S	20	121	141	0.00001
Synechococcus_sp._SYN20	1050714	S	17	22	39	0.00000
Synechococcus_sp._PCC_11901	2579791	S	17	70	87	0.00001
Synechococcus_sp._PCC_7002	32049	S	13	49	62	0.00000
Synechococcus_sp._PCC_73109	374982	S	10	39	49	0.00000
Synechococcus_elongatus	32046	S	418	24	442	0.00003
Dactylococcopsis_salina	292566	S	54	21	75	0.00000
Cyanobium_sp._NIES-981	1851505	S	867	260	1127	0.00007
Cyanobium_sp._NS01	261284	S	674	226	900	0.00006
Cyanobium_gracile	59930	S	1061	209	1270	0.00008
Parasynechococcus_marenigrum	2881428	S	231	66	297	0.00002
Prochlorococcus_marinus	1219	S	158	15	173	0.00001
Chamaesiphon_minutus	1173032	S	190	11	201	0.00001
Acaryochloris_marina	155978	S	87	14	101	0.00001
Acaryochloris_sp._'Moss_Beach'	2740837	S	39	32	71	0.00000
Synechocystis_sp._PCC_6714	1147	S	42	15	57	0.00000
Synechocystis_sp._CACIAM_05	1933929	S	10	74	84	0.00001
Nostoc_sp._NIES-4103	2005458	S	145	19	164	0.00001
Nostoc_sp._UHCC_0702	2814655	S	132	16	148	0.00001
Nostoc_sp._MS1	2764711	S	118	16	134	0.00001
Nostoc_sp._ATCC_53789	76335	S	117	160	277	0.00002
Nostoc_sp._TCL26-01	2576904	S	110	9	119	0.00001
Nostoc_sp._CENA543	1869241	S	82	8	90	0.00001
Nostoc_sp._'Lobaria_pulmonaria_(5183)_cyanobiont'	1618022	S	78	16	94	0.00001
Nostoc_sp._C052	2576902	S	72	15	87	0.00001
Nostoc_sp._PCC_7107	317936	S	67	24	91	0.00001
Nostoc_sp._UHCC_0870	2914041	S	65	8	73	0.00000
Nostoc_sp._PCC_7524	28072	S	60	7	67	0.00000
Nostoc_sp._'Peltigera_membranacea_cyanobiont'_N6	1261031	S	50	13	63	0.00000
Nostoc_sp._TCL240-02	2572090	S	43	22	65	0.00000
Nostoc_sp._C057	2576903	S	39	52	91	0.00001
Nostoc_sp._NIES-2111	1973475	S	29	43	72	0.00000
Nostoc_sp._NIES-3756	1751286	S	19	37	56	0.00000
Nostoc_linckia	92942	S	122	20	142	0.00001
Nostoc_piscinale	224012	S	94	14	108	0.00001
Nostoc_sphaeroides	446679	S	91	48	139	0.00001
Nostoc_punctiforme	272131	S	78	57	135	0.00001
Nostoc_commune	1178	S	72	22	94	0.00001
Nostoc_edaphicum	264686	S	70	19	89	0.00001
Nostoc_flagelliforme	1306274	S	63	22	85	0.00001
Anabaena_sp._WA102	1647413	S	80	112	192	0.00001
Anabaena_sp._90	46234	S	35	216	251	0.00002
Anabaena_sp._YBS01	2490939	S	24	712	736	0.00005
Anabaena_cylindrica	1165	S	107	15	122	0.00001
Cylindrospermum_stagnale	142864	S	95	9	104	0.00001
Trichormus_azollae	1164	S	42	4	46	0.00000
Richelia_sinica	1357545	S	31	3	34	0.00000
Calothrix_sp._PCC_7716	2853227	S	179	105	284	0.00002
Calothrix_sp._NIES-2100	1954172	S	122	69	191	0.00001
Calothrix_sp._PCC_7507	99598	S	118	23	141	0.00001
Calothrix_sp._NIES-3974	2005462	S	101	8	109	0.00001
Calothrix_sp._336/3	1337936	S	77	19	96	0.00001
Calothrix_sp._NIES-2098	1954171	S	75	39	114	0.00001
Calothrix_sp._PCC_6303	1170562	S	48	12	60	0.00000
Calothrix_parasitica	1973486	S	127	6	133	0.00001
Calothrix_brevissima	938406	S	114	42	156	0.00001
Sphaerospermopsis_torques-reginae	984207	S	108	38	146	0.00001
Sphaerospermopsis_kisseleviana	289435	S	84	31	115	0.00001
Nodularia_sphaerocarpa	137816	S	89	19	108	0.00001
Nodularia_spumigena	70799	S	63	11	74	0.00000
Dolichospermum_compactum	136073	S	70	72	142	0.00001
Dolichospermum_flos-aquae	1166	S	27	175	202	0.00001
Dolichospermum_sp._UHCC_0315A	1914871	S	25	136	161	0.00001
Anabaenopsis_circularis	109266	S	52	25	77	0.00000
Anabaenopsis_elenkinii	156213	S	38	5	43	0.00000
Scytonema_sp._NIES-4073	2005464	S	165	72	237	0.00002
Scytonema_sp._HK-05	1137095	S	118	46	164	0.00001
Brasilonema_sennae	1397703	S	131	13	144	0.00001
Fischerella_sp._NIES-3754	1752063	S	134	22	156	0.00001
Fischerella_sp._NIES-4106	2005456	S	62	5	67	0.00000
Tolypothrix_sp._PCC_7910	2099387	S	106	25	131	0.00001
Tolypothrix_tenuis	457083	S	61	20	81	0.00001
Rivularia_sp._PCC_7116	373994	S	48	2	50	0.00000
Leptolyngbya_sp._7M	2812896	S	1723	120	1843	0.00012
Leptolyngbya_sp._BL0902	1115757	S	391	24	415	0.00003
Leptolyngbya_sp._NIES-3755	1752064	S	85	9	94	0.00001
Leptolyngbya_sp._PCC_7376	111781	S	26	2	28	0.00000
Leptolyngbya_boryana	1184	S	84	0	84	0.00001
Kovacikia_minuta	2931930	S	374	36	410	0.00003
Leptodesmis_sichuanensis	2906798	S	206	22	228	0.00001
Leptothermofonsia_sichuanensis	2917832	S	201	18	219	0.00001
Thermoleptolyngbya_sp._PKUAC-SCTB121	2811482	S	25	522	547	0.00003
Thermoleptolyngbya_sichuanensis	2885951	S	13	297	310	0.00002
Thermosynechococcus_sp._NK55a	1394889	S	61	27	88	0.00001
Thermosynechococcus_sp._TA-1	2813673	S	22	28	50	0.00000
Thermosynechococcus_sp._CL-1	2583530	S	21	28	49	0.00000
Thermosynechococcus_vestitus	146786	S	124	40	164	0.00001
Halomicronema_hongdechloris	1209493	S	283	12	295	0.00002
Pseudanabaena_sp._PCC_7367	82654	S	123	4	127	0.00001
Pseudanabaena_sp._ABRG5-3	685565	S	52	3	55	0.00000
Gloeobacter_kilaueensis	1416614	S	1351	42	1393	0.00009
Gloeobacter_morelensis	2907343	S	942	399	1341	0.00009
Gloeobacter_violaceus	33072	S	896	416	1312	0.00008
Anthocerotibacter_panamensis	2857077	S	326	12	338	0.00002
Moorena_producens	1155739	S	598	15	613	0.00004
Oscillatoria_nigro-viridis	482564	S	168	92	260	0.00002
Oscillatoria_acuminata	118323	S	129	8	137	0.00001
Geitlerinema_sp._PCC_7407	1173025	S	672	102	774	0.00005
Allocoleopsis_franciscana	2886352	S	152	16	168	0.00001
Oxynema_aestuarii	2874213	S	299	27	326	0.00002
Microcoleus_vaginatus	119532	S	190	69	259	0.00002
Planktothrix_agardhii	1160	S	23	24	47	0.00000
Planktothrix_rubescens	59512	S	22	17	39	0.00000
[Phormidium]_sp._ETS-05	222819	S	216	13	229	0.00001
Crinalium_epipsammum	241425	S	66	8	74	0.00000
Microcystis_aeruginosa	1126	S	248	223	471	0.00003
Microcystis_sp._MC19	1967666	S	26	14	40	0.00000
Gloeothece_citriformis	2546356	S	58	4	62	0.00000
Gloeothece_verrucosa	2546359	S	44	3	47	0.00000
Crocosphaera_subtropica	2546360	S	80	5	85	0.00001
Rippkaea_orientalis	2546366	S	71	7	78	0.00000
Halothece_sp._PCC_7418	65093	S	41	13	54	0.00000
Euhalothece_natronophila	577489	S	24	3	27	0.00000
Candidatus_Atelocyanobacterium_thalassa	713887	S	19	3	22	0.00000
Geminocystis_herdmanii	669359	S	89	12	101	0.00001
Geminocystis_sp._NIES-3709	1617448	S	19	3	22	0.00000
Geminocystis_sp._NIES-3708	1615909	S	16	3	19	0.00000
Gloeocapsa_sp._PCC_7428	1173026	S	109	11	120	0.00001
Chondrocystis_sp._NIES-4102	2005460	S	46	6	52	0.00000
Cyanobacterium_aponinum	379064	S	48	12	60	0.00000
Chroococcidiopsis_sp._CCMEE_29	155894	S	234	42	276	0.00002
Chroococcidiopsis_sp._CCNUC1	2653189	S	53	78	131	0.00001
Chroococcidiopsis_thermalis	54299	S	73	117	190	0.00001
Pleurocapsa_sp._PCC_7327	118163	S	104	12	116	0.00001
Stanieria_cyanosphaera	102116	S	27	8	35	0.00000
Stanieria_sp._NIES-3757	1807358	S	24	8	32	0.00000
Gloeomargarita_lithophora	1188228	S	103	3	106	0.00001
Thermostichus_lividus	33070	S	63	8	71	0.00000
cyanobacterium_endosymbiont_of_Rhopalodia_gibberula	1763363	S	20	2	22	0.00000
cyanobacterium_endosymbiont_of_Epithemia_turgida	718217	S	15	2	17	0.00000
Sphaerobacter_thermophilus	2057	S	9098	581	9679	0.00062
Thermomicrobium_roseum	500	S	1855	44	1899	0.00012
Roseiflexus_sp._RS-1	357808	S	2661	492	3153	0.00020
Roseiflexus_castenholzii	120962	S	2423	479	2902	0.00019
Chloroflexus_aurantiacus	1108	S	846	97	943	0.00006
Chloroflexus_aggregans	152260	S	782	138	920	0.00006
Tepidiforma_bonchosmolovskayae	2601677	S	7097	305	7402	0.00047
Candidatus_Promineofilum_breve	1806508	S	3793	77	3870	0.00025
Caldilinea_aerophila	133453	S	1796	116	1912	0.00012
Anaerolinea_thermophila	167964	S	608	59	667	0.00004
Pelolinea_submarina	913107	S	594	27	621	0.00004
Brevefilum_fermentans	1986204	S	258	9	267	0.00002
Dehalogenimonas_formicexedens	1839801	S	500	130	630	0.00004
Dehalogenimonas_sp._GP	1536648	S	316	81	397	0.00003
Dehalococcoides_mccartyi	61435	S	121	273	394	0.00003
Ktedonosporobacter_rubrisoli	2509675	S	1214	36	1250	0.00008
Thermobaculum_terrenum	166501	S	974	141	1115	0.00007
Phototrophicus_methaneseepsis	2710758	S	408	4	412	0.00003
Fimbriimonas_ginsengisoli	1005039	S	3197	18	3215	0.00021
Chthonomonas_calidirosea	454171	S	664	5	669	0.00004
Mycoplasma_sp._Pen4	640330	S	25	114	139	0.00001
Mycoplasma_sp._SG1	2810348	S	15	0	15	0.00000
Mycoplasma_genitalium	2097	S	16	0	16	0.00000
Candidatus_Hepatoplasma_crinochetorum	295596	S	16	9	25	0.00000
Alteracholeplasma_palmae	38986	S	27	5	32	0.00000
Paracholeplasma_brassicae	61635	S	17	5	22	0.00000
Mariniplasma_anaerobium	2735436	S	10	1	11	0.00000
Spiroplasma_endosymbiont_of_'Nebria_riversi'	2792084	S	11	25	36	0.00000
Gemmata_obscuriglobus	114	S	29385	4338	33723	0.00215
Gemmata_massiliana	1210884	S	11361	4797	16158	0.00103
Gemmata_sp._SH-PL17	1630693	S	10813	5144	15957	0.00102
Urbifossiella_limnaea	2528023	S	57276	5031	62307	0.00398
Frigoriglobus_tundricola	2774151	S	33568	5518	39086	0.00250
Limnoglobus_roseus	2598579	S	26826	1268	28094	0.00179
Tuwongella_immobilis	692036	S	2202	90	2292	0.00015
Telmatocola_sphagniphila	1123043	S	1880	18	1898	0.00012
Tautonia_plasticadhaerens	2527974	S	50870	4348	55218	0.00353
Aquisphaera_giovannonii	406548	S	35346	5827	41173	0.00263
Paludisphaera_borealis	1387353	S	22715	4805	27520	0.00176
Singulisphaera_acidiphila	466153	S	17111	2414	19525	0.00125
Isosphaera_pallida	128	S	3003	209	3212	0.00021
Planctomyces_sp._SH-PL62	1636152	S	21498	7117	28615	0.00183
Planctomyces_sp._SH-PL14	1632864	S	10783	688	11471	0.00073
Caulifigura_coniformis	2527983	S	11816	798	12614	0.00081
Gimesia_panareensis	2527978	S	2238	272	2510	0.00016
Gimesia_chilikensis	2605989	S	1202	734	1936	0.00012
Gimesia_maris	122	S	799	126	925	0.00006
Gimesia_alba	2527973	S	501	90	591	0.00004
Gimesia_algae	2527971	S	475	121	596	0.00004
Gimesia_fumaroli	2527976	S	474	97	571	0.00004
Gimesia_benthica	2608982	S	359	509	868	0.00006
Gimesia_aquarii	2527964	S	335	23	358	0.00002
Maioricimonas_rarisocia	2528026	S	7228	956	8184	0.00052
Alienimonas_californiensis	2527989	S	6590	497	7087	0.00045
Symmachiella_dynata	2527995	S	2604	162	2766	0.00018
Rubinisphaera_brasiliensis	119	S	1671	171	1842	0.00012
Calycomorphotria_hydatis	2528027	S	1508	58	1566	0.00010
Planctopirus_ephydatiae	2528019	S	522	281	803	0.00005
Planctopirus_limnophila	120	S	477	242	719	0.00005
Fuerstiella_marisgermanici	1891926	S	1402	25	1427	0.00009
Crateriforma_conspicua	2527996	S	1068	202	1270	0.00008
Thalassoglobus_polymorphus	2527994	S	538	28	566	0.00004
Polystyrenella_longa	2528007	S	532	48	580	0.00004
Lacipirellula_parvula	2650471	S	8470	1024	9494	0.00061
Lacipirellula_limnantheis	2528024	S	8036	1133	9169	0.00059
Pirellulimonas_nuda	2528009	S	7435	847	8282	0.00053
Botrimarina_mediterranea	2528022	S	6222	609	6831	0.00044
Aeoliella_mucimassa	2527972	S	2115	185	2300	0.00015
Adhaeretor_mobilis	1930276	S	1204	124	1328	0.00008
Bythopirellula_goksoeyrii	1400387	S	987	75	1062	0.00007
Lignipirellula_cremea	2528010	S	5038	601	5639	0.00036
Stieleria_neptunia	2527979	S	2317	251	2568	0.00016
Stieleria_maiorica	2795974	S	2247	435	2682	0.00017
Rosistilla_oblonga	2527990	S	1298	612	1910	0.00012
Rosistilla_carotiformis	2528017	S	907	383	1290	0.00008
Rosistilla_ulvae	1930277	S	877	509	1386	0.00009
Anatilimnocola_aggregata	2528021	S	4034	454	4488	0.00029
Bremerella_volcania	2527984	S	3052	225	3277	0.00021
Pirellula_staleyi	125	S	2376	94	2470	0.00016
Pirellula_sp._SH-Sr6A	1632865	S	650	18	668	0.00004
Roseimaritima_ulvae	980254	S	2013	139	2152	0.00014
Roseimaritima_multifibrata	1930274	S	554	66	620	0.00004
Rubripirellula_lacrimiformis	1930273	S	1057	203	1260	0.00008
Aureliella_helgolandensis	2527968	S	775	63	838	0.00005
Mariniblastus_fucicola	980251	S	768	14	782	0.00005
Rhodopirellula_baltica	265606	S	727	49	776	0.00005
Thermogutta_terrifontis	1331910	S	927	30	957	0.00006
Humisphaera_borealis	2807512	S	14174	348	14522	0.00093
Phycisphaera_mikurensis	547188	S	4367	352	4719	0.00030
Mucisphaera_calidilacus	2527982	S	2193	124	2317	0.00015
Poriferisphaera_corsica	2528020	S	256	2	258	0.00002
Anaerohalosphaera_lusitana	1936003	S	388	10	398	0.00003
Limihaloglobus_sulfuriphilus	1851148	S	185	8	193	0.00001
Sedimentisphaera_cyanobacteriorum	1940790	S	59	65	124	0.00001
Sedimentisphaera_salicampi	1941349	S	59	10	69	0.00000
Candidatus_Kuenenia_stuttgartiensis	174633	S	204	0	204	0.00001
Candidatus_Uabimicrobium_amorphum	2596890	S	76	1	77	0.00000
Opitutus_terrae	107709	S	9314	469	9783	0.00062
Opitutus_sp._GAS368	1882749	S	7199	1162	8361	0.00053
Lacunisphaera_limnophila	1838286	S	6060	933	6993	0.00045
Oleiharenicola_sp._KSB-15	2862869	S	4318	250	4568	0.00029
Nibricoccus_aquaticus	2576891	S	3945	193	4138	0.00026
Ereboglobus_luteus	1796921	S	2505	131	2636	0.00017
Ruficoccus_sp._ZRK36	2866311	S	973	144	1117	0.00007
Coraliomargarita_akajimensis	395922	S	257	6	263	0.00002
Verrucomicrobium_sp._GAS474	1882831	S	3050	341	3391	0.00022
Verrucomicrobium_spinosum	2736	S	1707	114	1821	0.00012
Luteolibacter_ambystomatis	2824561	S	1848	150	1998	0.00013
Luteolibacter_luteus	2728835	S	1590	90	1680	0.00011
Roseimicrobium_sp._ORNL1	2711231	S	2492	98	2590	0.00017
Sulfuriroseicoccus_oceanibius	2707525	S	533	64	597	0.00004
Akkermansia_muciniphila	239935	S	1079	135	1214	0.00008
Akkermansia_glycaniphila	1679444	S	441	35	476	0.00003
Methylacidimicrobium_sp._AP8	2730359	S	759	114	873	0.00006
Methylacidimicrobium_sp._B4	2796139	S	668	137	805	0.00005
Candidatus_Xiphinematobacter_sp._Idaho_Grape	1704307	S	273	21	294	0.00002
Methylacidiphilum_sp._IT6	2795386	S	26	1	27	0.00000
Methylacidiphilum_sp._IT5	2795384	S	25	43	68	0.00000
Methylacidiphilum_kamchatkense	431057	S	28	1	29	0.00000
Methylacidiphilum_infernorum	511746	S	22	38	60	0.00000
Kiritimatiella_glycovorans	1307763	S	1111	1275	2386	0.00015
Tichowtungia_aerotolerans	2697043	S	431	18	449	0.00003
Candidatus_Protochlamydia_naegleriophila	389348	S	58	38	96	0.00001
Candidatus_Protochlamydia_amoebophila	362787	S	29	18	47	0.00000
Parachlamydia_acanthamoebae	83552	S	87	26	113	0.00001
Neochlamydia_sp._S13	1353976	S	43	8	51	0.00000
Candidatus_Rhabdochlamydia_porcellionis	225148	S	27	41	68	0.00000
Candidatus_Rhabdochlamydia_oedothoracis	2720720	S	19	21	40	0.00000
Simkania_negevensis	83561	S	63	7	70	0.00000
Waddlia_chondrophila	71667	S	38	8	46	0.00000
Chlamydia_sp._2742-308	1806891	S	11	10	21	0.00000
Chlamydia_suis	83559	S	10	30	40	0.00000
Candidatus_Velamenicoccus_archaeovorus	1930593	S	321	1	322	0.00002
Gemmatirosa_kalamazoonesis	861299	S	135483	12555	148038	0.00945
Gemmatimonas_groenlandica	2732249	S	13981	1864	15845	0.00101
Gemmatimonas_aurantiaca	173480	S	10218	1219	11437	0.00073
Gemmatimonas_phototrophica	1379270	S	8774	1430	10204	0.00065
Hymenobacter_sp._5317J-9	2932250	S	1022	240	1262	0.00008
Hymenobacter_sp._PAMC_26628	1484118	S	942	247	1189	0.00008
Hymenobacter_sp._APR13	1356852	S	898	285	1183	0.00008
Hymenobacter_sp._PAMC_26554	1484116	S	825	80	905	0.00006
Hymenobacter_sp._BRD128	2675878	S	760	99	859	0.00005
Hymenobacter_sp._5116S-27	2932249	S	601	70	671	0.00004
Hymenobacter_sp._BT18	2835648	S	584	70	654	0.00004
Hymenobacter_sp._5116S-3	2932248	S	549	62	611	0.00004
Hymenobacter_sp._NBH84	2596915	S	457	51	508	0.00003
Hymenobacter_sp._DG01	2584940	S	455	84	539	0.00003
Hymenobacter_sp._5413J-13	2932251	S	408	45	453	0.00003
Hymenobacter_sp._DG25B	1385664	S	392	84	476	0.00003
Hymenobacter_sp._5420S-77	2932254	S	385	58	443	0.00003
Hymenobacter_sp._S2-20-2	2761579	S	376	53	429	0.00003
Hymenobacter_sp._BRD67	2675877	S	347	374	721	0.00005
Hymenobacter_sp._DG25A	1385663	S	240	53	293	0.00002
Hymenobacter_sp._5516J-16	2932253	S	149	315	464	0.00003
Hymenobacter_sp._HDW8	2714932	S	146	539	685	0.00004
Hymenobacter_sp._5516S-25	2933777	S	114	227	341	0.00002
Hymenobacter_sp._5414T-23	2932252	S	12	1052	1064	0.00007
Hymenobacter_monticola	1705399	S	1030	214	1244	0.00008
Hymenobacter_busanensis	2607656	S	1021	124	1145	0.00007
Hymenobacter_sedentarius	1411621	S	897	152	1049	0.00007
Hymenobacter_jejuensis	2502781	S	711	60	771	0.00005
Hymenobacter_nivis	1850093	S	693	201	894	0.00006
Hymenobacter_oligotrophus	2319843	S	655	77	732	0.00005
Hymenobacter_swuensis	1446467	S	461	115	576	0.00004
Hymenobacter_tibetensis	497967	S	382	67	449	0.00003
Hymenobacter_baengnokdamensis	2615203	S	367	452	819	0.00005
Hymenobacter_qilianensis	1385715	S	332	67	399	0.00003
Hymenobacter_radiodurans	2496028	S	134	519	653	0.00004
Pontibacter_russatus	2694929	S	1101	121	1222	0.00008
Pontibacter_actiniarum	323450	S	636	168	804	0.00005
Pontibacter_pudoricolor	2694930	S	546	69	615	0.00004
Pontibacter_akesuensis	388950	S	468	77	545	0.00003
Pontibacter_sp._SGAir0037	2571030	S	243	45	288	0.00002
Pontibacter_korlensis	400092	S	215	34	249	0.00002
Rufibacter_radiotolerans	1379910	S	374	44	418	0.00003
Rufibacter_tibetensis	512763	S	265	46	311	0.00002
Rufibacter_sp._DG15C	1379909	S	177	108	285	0.00002
Adhaeribacter_swui	2086471	S	239	26	265	0.00002
Adhaeribacter_radiodurans	2745197	S	141	13	154	0.00001
Nibribacter_ruber	2698458	S	196	120	316	0.00002
Spirosoma_sp._CJU-R4	2728024	S	554	47	601	0.00004
Spirosoma_sp._KUDC1026	2745947	S	332	32	364	0.00002
Spirosoma_sp._RHs26	2898794	S	248	20	268	0.00002
Spirosoma_sp._KCTC_42546	2520506	S	235	36	271	0.00002
Spirosoma_sp._KCTC_72228	2710596	S	182	28	210	0.00001
Spirosoma_rigui	564064	S	456	35	491	0.00003
Spirosoma_taeanense	2735870	S	378	37	415	0.00003
Spirosoma_montaniterrae	1178516	S	348	22	370	0.00002
Spirosoma_radiotolerans	1379870	S	277	21	298	0.00002
Spirosoma_pollinicola	2057025	S	243	28	271	0.00002
Spirosoma_aerolatum	1211326	S	240	12	252	0.00002
Spirosoma_endbachense	2666025	S	193	104	297	0.00002
Spirosoma_aureum	2692134	S	158	103	261	0.00002
Rhodocytophaga_rosea	2704465	S	197	7	204	0.00001
Cytophaga_hutchinsonii	985	S	101	9	110	0.00001
Aquirufa_nivalisilvae	2516557	S	36	13	49	0.00000
Aquirufa_sp._9H-EGSE	2696560	S	30	13	43	0.00000
Dyadobacter_fermentans	94254	S	957	84	1041	0.00007
Dyadobacter_sandarakinus	2747268	S	309	28	337	0.00002
Dyadobacter_sp._LJ419	2906456	S	172	11	183	0.00001
Dyadobacter_sp._NIV53	2861765	S	127	7	134	0.00001
Fibrella_aestuarina	651143	S	761	69	830	0.00005
Fibrella_sp._ES10-3-2-2	1834519	S	304	24	328	0.00002
Runella_slithyformis	106	S	267	19	286	0.00002
Runella_rosea	2259595	S	166	14	180	0.00001
Runella_sp._SP2	2268026	S	155	8	163	0.00001
Larkinella_sp._IE-0392	2907205	S	219	15	234	0.00001
Leadbetterella_byssophila	316068	S	51	25	76	0.00000
Arcticibacterium_luteifluviistationis	1784714	S	31	1	32	0.00000
Chryseolinea_soli	2321403	S	1497	46	1543	0.00010
Fulvivirga_sp._SS9-22	2904245	S	107	10	117	0.00001
Fulvivirga_sp._W9P-11	2904246	S	84	29	113	0.00001
Fulvivirga_sp._SW1-E11	2904247	S	58	27	85	0.00001
Fulvivirga_lutea	2810512	S	68	7	75	0.00000
Echinicola_sp._20G	2781961	S	56	7	63	0.00000
Echinicola_sp._SCS_3-6	2859768	S	48	20	68	0.00000
Echinicola_strongylocentroti	1795355	S	82	15	97	0.00001
Echinicola_vietnamensis	390884	S	74	38	112	0.00001
Echinicola_soli	2591634	S	70	6	76	0.00000
Echinicola_rosea	1807691	S	68	31	99	0.00001
Algoriphagus_sp._Y33	2772483	S	85	7	92	0.00001
Algoriphagus_sp._NBT04N3	2705473	S	55	16	71	0.00000
Algoriphagus_sanaruensis	1727163	S	85	10	95	0.00001
Algoriphagus_machipongonensis	388413	S	41	3	44	0.00000
Aquiflexum_balticum	280473	S	119	17	136	0.00001
Cyclobacterium_marinum	104	S	64	17	81	0.00001
Cyclobacterium_amurskyense	320787	S	41	5	46	0.00000
Mongoliitalea_daihaiensis	2782006	S	59	6	65	0.00000
Belliella_baltica	232259	S	49	22	71	0.00000
Flammeovirga_pectinis	2494373	S	20	5	25	0.00000
Flammeovirga_kamogawensis	373891	S	17	4	21	0.00000
Flammeovirga_sp._MY04	1191459	S	15	23	38	0.00000
Flammeovirga_yaeyamensis	367791	S	14	21	35	0.00000
Candidatus_Amoebophilus_asiaticus	281120	S	55	2	57	0.00000
Cardinium_endosymbiont_of_Encarsia_pergandiella	249402	S	10	6	16	0.00000
Cardinium_endosymbiont_of_Oedothorax_gibbosus	931101	S	10	19	29	0.00000
Marivirga_tractuosa	1006	S	62	23	85	0.00001
Mangrovivirga_cuniculi	2715131	S	59	4	63	0.00000
Bernardetia_litoralis	999	S	38	3	41	0.00000
Chitinophaga_sp._XS-30	2604421	S	834	254	1088	0.00007
Chitinophaga_sp._KRA15-503	2829818	S	391	187	578	0.00004
Chitinophaga_oryzae	2725414	S	680	110	790	0.00005
Chitinophaga_filiformis	104663	S	514	89	603	0.00004
Chitinophaga_alhagiae	2203219	S	505	11	516	0.00003
Chitinophaga_pinensis	79329	S	298	69	367	0.00002
Chitinophaga_agri	2703787	S	259	72	331	0.00002
Chitinophaga_caeni	2029983	S	207	34	241	0.00002
Flavisolibacter_ginsenosidimutans	661481	S	1600	101	1701	0.00011
Flavisolibacter_tropicus	1492898	S	1066	165	1231	0.00008
Niastella_koreensis	354356	S	2557	287	2844	0.00018
Panacibacter_ginsenosidivorans	1813871	S	1299	64	1363	0.00009
Pseudocnuella_soli	2502779	S	1187	152	1339	0.00009
Flavihumibacter_sp._IMCC34838	2838156	S	521	47	568	0.00004
Flavihumibacter_sp._IMCC34837	2838157	S	400	28	428	0.00003
Lacibacter_sp._S13-6-6	2760713	S	884	42	926	0.00006
Niabella_ginsenosidivorans	1176587	S	446	46	492	0.00003
Niabella_soli	446683	S	411	50	461	0.00003
Arachidicoccus_sp._BS20	1850526	S	256	88	344	0.00002
Arachidicoccus_sp._5GH13-10	2875539	S	165	33	198	0.00001
Arachidicoccus_sp._B3-10	2545455	S	105	8	113	0.00001
Arachidicoccus_soli	2341117	S	159	20	179	0.00001
Arachidicoccus_ginsenosidivorans	496057	S	135	26	161	0.00001
Paraflavitalea_soli	2315862	S	839	68	907	0.00006
Pseudobacter_ginsenosidimutans	661488	S	677	62	739	0.00005
Ferruginibacter_sp._KIS38-8	2875540	S	380	35	415	0.00003
Ferruginibacter_lapsinanis	563172	S	267	24	291	0.00002
Phnomibacter_ginsenosidimutans	2676868	S	478	60	538	0.00003
Filimonas_lacunae	477680	S	426	54	480	0.00003
Rhodocaloribacter_litoris	2558931	S	5569	597	6166	0.00039
Rhodothermus_marinus	29549	S	4898	281	5179	0.00033
Salinibacter_ruber	146919	S	3042	49	3091	0.00020
Flavobacterium_sp._HJ-32-4	1160795	S	233	16	249	0.00002
Flavobacterium_sp._CLA17	2724135	S	54	10	64	0.00000
Flavobacterium_sp._IGB_4-14	1871076	S	53	4	57	0.00000
Flavobacterium_sp._M31R6	2739062	S	48	7	55	0.00000
Flavobacterium_sp._F-29	2893883	S	45	10	55	0.00000
Flavobacterium_sp._MDT1-60	1979344	S	45	9	54	0.00000
Flavobacterium_sp._CJ74	2294119	S	45	3	48	0.00000
Flavobacterium_sp._F-323	2893885	S	42	9	51	0.00000
Flavobacterium_sp._B183	907046	S	41	9	50	0.00000
Flavobacterium_sp._K5-23	2746225	S	39	9	48	0.00000
Flavobacterium_sp._F-70	2893884	S	38	8	46	0.00000
Flavobacterium_sp._Sr18	935222	S	36	6	42	0.00000
Flavobacterium_sp._MMS21-Er5	2937442	S	35	15	50	0.00000
Flavobacterium_sp._SLB02	2665645	S	34	7	41	0.00000
Flavobacterium_sp._140616W15	2478552	S	34	7	41	0.00000
Flavobacterium_sp._KBS0721	1179672	S	30	9	39	0.00000
Flavobacterium_sp._GENT5	1751095	S	24	5	29	0.00000
Flavobacterium_sp._F-340	2893886	S	24	7	31	0.00000
Flavobacterium_sp._KK2020170	2830782	S	23	7	30	0.00000
Flavobacterium_sp._I3-2	2748319	S	20	30	50	0.00000
Flavobacterium_sp._CS20	2775246	S	19	8	27	0.00000
Flavobacterium_sp._CECT_9288	2845819	S	19	20	39	0.00000
Flavobacterium_sp._KSM-R2A25	2895947	S	19	5	24	0.00000
Flavobacterium_sp._WSW3-B6	2856519	S	18	2	20	0.00000
Flavobacterium_sp._LPB0248	2614441	S	17	9	26	0.00000
Flavobacterium_sp._KSM-R2A30	2897181	S	16	5	21	0.00000
Flavobacterium_sp._xlx-214	2654325	S	16	3	19	0.00000
Flavobacterium_sp._CHNK8	2871165	S	13	14	27	0.00000
Flavobacterium_sp._SHINM13	1751056	S	13	32	45	0.00000
Flavobacterium_endoglycinae	2816357	S	240	53	293	0.00002
Flavobacterium_album	2175091	S	130	9	139	0.00001
Flavobacterium_magnum	2162713	S	126	14	140	0.00001
Flavobacterium_commune	1306519	S	104	17	121	0.00001
Flavobacterium_pallidum	2172098	S	91	9	100	0.00001
Flavobacterium_nackdongense	2547394	S	67	6	73	0.00000
Flavobacterium_inviolabile	2748320	S	61	9	70	0.00000
Flavobacterium_anhuiense	459526	S	58	23	81	0.00001
Flavobacterium_johnsoniae	986	S	52	28	80	0.00001
Flavobacterium_sangjuense	2518177	S	51	5	56	0.00000
Flavobacterium_kingsejongi	1678728	S	49	7	56	0.00000
Flavobacterium_gilvum	1492737	S	44	6	50	0.00000
Flavobacterium_crocinum	2183896	S	44	13	57	0.00000
Flavobacterium_enshiense	1341165	S	43	5	48	0.00000
Flavobacterium_alkalisoli	2602769	S	41	3	44	0.00000
Flavobacterium_sediminis	2201181	S	39	40	79	0.00001
Flavobacterium_psychrophilum	96345	S	36	7	43	0.00000
Flavobacterium_sediminilitoris	2024526	S	33	4	37	0.00000
Flavobacterium_fluviale	2249356	S	31	12	43	0.00000
Flavobacterium_faecale	1355330	S	31	4	35	0.00000
Flavobacterium_nitrogenifigens	1617283	S	26	13	39	0.00000
Flavobacterium_crassostreae	1763534	S	25	6	31	0.00000
Flavobacterium_branchiophilum	55197	S	25	2	27	0.00000
Flavobacterium_arcticum	1784713	S	20	2	22	0.00000
Flavobacterium_haoranii	683124	S	20	8	28	0.00000
Flavobacterium_jumunjinense	998845	S	19	3	22	0.00000
Flavobacterium_davisii	2906077	S	19	7	26	0.00000
Flavobacterium_covae	2906076	S	18	23	41	0.00000
Flavobacterium_oreochromis	2906078	S	17	7	24	0.00000
Flavobacterium_indicum	312277	S	16	2	18	0.00000
Flavobacterium_columnare	996	S	16	28	44	0.00000
Muricauda_sp._SCSIO_65647	2908843	S	58	2	60	0.00000
Muricauda_sp._SCSIO_64092	2908842	S	56	2	58	0.00000
Muricauda_oceani	2698672	S	100	55	155	0.00001
Muricauda_aquimarina	254955	S	89	48	137	0.00001
Muricauda_lutaonensis	516051	S	82	21	103	0.00001
Muricauda_ruestringensis	111501	S	57	5	62	0.00000
Muricauda_aurantiaca	1383885	S	30	2	32	0.00000
Capnocytophaga_sp._oral_taxon_902	2748316	S	33	72	105	0.00001
Capnocytophaga_sp._oral_taxon_878	1316596	S	20	8	28	0.00000
Capnocytophaga_sp._FDAARGOS_737	2545799	S	15	11	26	0.00000
Capnocytophaga_gingivalis	1017	S	56	7	63	0.00000
Capnocytophaga_haemolytica	45243	S	53	5	58	0.00000
Capnocytophaga_canimorsus	28188	S	41	14	55	0.00000
Capnocytophaga_sputigena	1019	S	36	15	51	0.00000
Capnocytophaga_stomatis	1848904	S	21	5	26	0.00000
Capnocytophaga_ochracea	1018	S	14	24	38	0.00000
Gramella_sp._GC03-9	2920386	S	58	19	77	0.00000
Gramella_sp._MT6	2705471	S	29	5	34	0.00000
Gramella_sp._MAR_2010_147	1250205	S	22	4	26	0.00000
Gramella_fulva	2126553	S	77	8	85	0.00001
Gramella_flava	1486245	S	66	24	90	0.00001
Gramella_echinicola	279359	S	44	6	50	0.00000
Gramella_forsetii	411153	S	37	10	47	0.00000
Gramella_salexigens	1913577	S	37	4	41	0.00000
Polaribacter_sp._G4M1	2808900	S	22	4	26	0.00000
Polaribacter_sp._MED152	313598	S	19	3	22	0.00000
Polaribacter_sp._SA4-12	1312072	S	19	6	25	0.00000
Polaribacter_sp._L3A8	2686361	S	19	11	30	0.00000
Polaribacter_sp._Hel1_33_78	1336804	S	18	3	21	0.00000
Polaribacter_sp._SM13	2818493	S	15	3	18	0.00000
Polaribacter_sp._Q13	2806551	S	15	8	23	0.00000
Polaribacter_sp._KT25b	1855336	S	14	4	18	0.00000
Polaribacter_sp._NJDZ03	2855841	S	13	12	25	0.00000
Polaribacter_sp._ALD11	2058137	S	13	4	17	0.00000
Polaribacter_sp._SA4-10	754397	S	13	2	15	0.00000
Polaribacter_vadi	1774273	S	21	3	24	0.00000
Polaribacter_litorisediminis	1908341	S	18	2	20	0.00000
Polaribacter_haliotis	1888915	S	17	7	24	0.00000
Polaribacter_reichenbachii	996801	S	13	1	14	0.00000
Polaribacter_sejongensis	985043	S	12	7	19	0.00000
Robiginitalea_biformata	252307	S	275	17	292	0.00002
Nonlabens_sp._Hel1_33_55	1336802	S	31	7	38	0.00000
Nonlabens_sp._MB-3u-79	2058134	S	16	4	20	0.00000
Nonlabens_sp._Ci31	2608253	S	16	3	19	0.00000
Nonlabens_spongiae	331648	S	51	30	81	0.00001
Nonlabens_ponticola	2496866	S	39	7	46	0.00000
Nonlabens_marinus	930802	S	30	14	44	0.00000
Nonlabens_dokdonensis	328515	S	18	5	23	0.00000
Winogradskyella_sp._PC-19	754417	S	22	7	29	0.00000
Winogradskyella_sp._PG-2	754409	S	21	3	24	0.00000
Winogradskyella_sp._J14-2	1936080	S	17	5	22	0.00000
Winogradskyella_sp._HaHa_3_26	2749995	S	12	6	18	0.00000
Winogradskyella_sp._MH6	2929510	S	11	3	14	0.00000
Winogradskyella_forsetii	2686077	S	59	23	82	0.00001
Winogradskyella_sediminis	1382466	S	17	6	23	0.00000
Winogradskyella_schleiferi	2686078	S	16	9	25	0.00000
Winogradskyella_helgolandensis	2697010	S	12	3	15	0.00000
Maribacter_sp._MJ134	2496865	S	33	7	40	0.00000
Maribacter_sp._HTCC2170	313603	S	23	1	24	0.00000
Maribacter_cobaltidurans	1178778	S	35	32	67	0.00000
Maribacter_hydrothermalis	1836467	S	28	4	32	0.00000
Maribacter_dokdonensis	320912	S	10	20	30	0.00000
Antarcticibacterium_sp._1MA-6-2	2908210	S	61	9	70	0.00000
Antarcticibacterium_arcticum	2585771	S	47	7	54	0.00000
Antarcticibacterium_flavum	2058175	S	46	11	57	0.00000
Salegentibacter_sp._T436	1729720	S	46	50	96	0.00001
Salegentibacter_salegens	143223	S	45	7	52	0.00000
Salegentibacter_mishustinae	270918	S	43	42	85	0.00001
Aequorivita_sp._H23M31	2494375	S	49	17	66	0.00000
Aequorivita_sublithincola	101385	S	47	35	82	0.00001
Tenacibaculum_sp._SZ-18	754423	S	15	13	28	0.00000
Tenacibaculum_jejuense	584609	S	24	2	26	0.00000
Tenacibaculum_dicentrarchi	669041	S	22	11	33	0.00000
Tenacibaculum_maritimum	107401	S	21	6	27	0.00000
Tenacibaculum_todarodis	1850252	S	20	7	27	0.00000
Tenacibaculum_singaporense	2358479	S	11	9	20	0.00000
Myroides_fluvii	2572594	S	35	16	51	0.00000
Myroides_odoratus	256	S	28	10	38	0.00000
Myroides_phaeus	702745	S	26	24	50	0.00000
Cellulophaga_sp._L1A9	2686362	S	15	12	27	0.00000
Cellulophaga_sp._HaHaR_3_176	1942464	S	14	4	18	0.00000
Cellulophaga_baltica	76594	S	26	8	34	0.00000
Cellulophaga_lytica	979	S	24	6	30	0.00000
Cellulophaga_algicola	59600	S	21	4	25	0.00000
Sinomicrobium_sp._HD2P242	2900738	S	124	5	129	0.00001
Formosa_sp._Hel3_A1_48	1336795	S	23	6	29	0.00000
Formosa_sp._Hel1_33_131	1336794	S	21	2	23	0.00000
Formosa_sp._Hel1_31_208	1798225	S	16	2	18	0.00000
Formosa_sp._L2A11	2686363	S	14	5	19	0.00000
Formosa_agariphila	320324	S	32	7	39	0.00000
Formosa_sediminum	2594004	S	12	3	15	0.00000
Kordia_antarctica	1218801	S	59	4	63	0.00000
Kordia_sp._SMS9	2282170	S	42	2	44	0.00000
Aquimarina_sp._TRL1	2736252	S	25	2	27	0.00000
Aquimarina_sp._BL5	1714860	S	23	3	26	0.00000
Aquimarina_sp._AD10	1714849	S	22	1	23	0.00000
Aquimarina_sp._AD1	1714848	S	18	2	20	0.00000
Lacinutrix_sp._WUR7	2653681	S	28	7	35	0.00000
Lacinutrix_sp._Bg11-31	2057808	S	18	4	22	0.00000
Lacinutrix_sp._5H-3-7-4	983544	S	11	5	16	0.00000
Lacinutrix_venerupis	1486034	S	18	5	23	0.00000
Flagellimonas_sp._HMM57	2905121	S	36	3	39	0.00000
Flagellimonas_sp._CMM7	2654676	S	34	2	36	0.00000
Zunongwangia_sp._SCSIO_43204	2779359	S	37	28	65	0.00000
Zunongwangia_profunda	398743	S	28	25	53	0.00000
Algibacter_sp._L1A34	2686365	S	19	11	30	0.00000
Algibacter_sp._L3A6	2686366	S	11	6	17	0.00000
Algibacter_alginicilyticus	1736674	S	24	7	31	0.00000
Muriicola_soli	2507538	S	60	4	64	0.00000
Lutibacter_sp._A64	2918526	S	18	6	24	0.00000
Lutibacter_sp._A80	2918453	S	13	5	18	0.00000
Lutibacter_profundi	1622118	S	19	4	23	0.00000
Leeuwenhoekiella_sp._ZYFB001	2719912	S	19	14	33	0.00000
Leeuwenhoekiella_palythoae	573501	S	17	17	34	0.00000
Zobellia_galactanivorans	63186	S	53	3	56	0.00000
Aggregatimonas_sangjinii	2583587	S	52	2	54	0.00000
Dokdonia_sp._MED134	313590	S	10	16	26	0.00000
Tamlana_carrageenivorans	2069432	S	25	9	34	0.00000
Tamlana_sp._s12	1630406	S	17	6	23	0.00000
Psychroflexus_torquis	57029	S	22	1	23	0.00000
Psychroflexus_sp._ALD_RP9	2777186	S	22	2	24	0.00000
Arenibacter_algicola	616991	S	44	15	59	0.00000
Mariniflexile_sp._TRM1-10	2027857	S	44	4	48	0.00000
Pukyongia_salina	2094025	S	42	3	45	0.00000
Zhouia_spongiae	2202721	S	41	10	51	0.00000
Gilvibacter_sp._SZ-19	754429	S	40	5	45	0.00000
Seonamhaeicola_sp._ML3	2937786	S	18	2	20	0.00000
Seonamhaeicola_sp._S2-3	1936081	S	17	4	21	0.00000
Euzebyella_marina	1761453	S	35	20	55	0.00000
Olleya_aquimaris	639310	S	17	9	26	0.00000
Costertonia_aggregata	343403	S	33	7	40	0.00000
Flavivirga_eckloniae	1803846	S	33	3	36	0.00000
Constantimarinum_furrinae	2562285	S	32	3	35	0.00000
Bizionia_sp._M204	2675331	S	32	7	39	0.00000
Amniculibacterium_sp._G2-70	2767188	S	32	41	73	0.00000
Aegicerativicinus_sediminis	2893202	S	30	2	32	0.00000
Gillisia_sp._Hel1_33_143	1336796	S	29	10	39	0.00000
Galbibacter_sp._BG1	1170699	S	29	3	32	0.00000
Marixanthomonas_sp._SCSIO_43207	2779360	S	27	8	35	0.00000
Changchengzhania_lutea	2049305	S	26	3	29	0.00000
Sediminicola_sp._YIK13	1453352	S	25	2	27	0.00000
Croceibacter_atlanticus	313588	S	24	4	28	0.00000
Siansivirga_zeaxanthinifaciens	762954	S	23	6	29	0.00000
Urechidicola_croceus	1850246	S	22	12	34	0.00000
Flavobacteriaceae_bacterium_10Alg115	2584122	S	22	1	23	0.00000
Oceanihabitans_sp._IOP_32	2529032	S	21	9	30	0.00000
Wenyingzhuangia_fucanilytica	1790137	S	19	3	22	0.00000
Sabulilitoribacter_sp._BrNp1-15	2916754	S	12	2	14	0.00000
Chryseobacterium_sp.	1871047	S	91	42	133	0.00001
Chryseobacterium_sp._6424	2039166	S	78	21	99	0.00001
Chryseobacterium_sp._Y16C	2920939	S	68	52	120	0.00001
Chryseobacterium_sp._SC2-2	2929800	S	64	41	105	0.00001
Chryseobacterium_sp._F4	2852098	S	59	4	63	0.00000
Chryseobacterium_sp._ZHDP1	2838877	S	45	43	88	0.00001
Chryseobacterium_sp._C-17	2898076	S	40	22	62	0.00000
Chryseobacterium_sp._IHB_B_17019	1721091	S	37	7	44	0.00000
Chryseobacterium_sp._cx-624	2758037	S	37	8	45	0.00000
Chryseobacterium_sp._MEBOG07	2879939	S	33	10	43	0.00000
Chryseobacterium_sp._G0201	2487065	S	31	9	40	0.00000
Chryseobacterium_sp._3008163	2478663	S	29	16	45	0.00000
Chryseobacterium_sp._T16E-39	2015076	S	27	3	30	0.00000
Chryseobacterium_sp._POL2	2713414	S	26	20	46	0.00000
Chryseobacterium_sp._G0186	2487064	S	26	19	45	0.00000
Chryseobacterium_sp._PCH239	2825845	S	26	19	45	0.00000
Chryseobacterium_sp._LJ668	2864040	S	25	4	29	0.00000
Chryseobacterium_sp._MEBOG06	2879938	S	23	5	28	0.00000
Chryseobacterium_sp._DH-B6	2759528	S	22	10	32	0.00000
Chryseobacterium_sp._StRB126	878220	S	21	7	28	0.00000
Chryseobacterium_sp._SNU_WT5	2594269	S	21	8	29	0.00000
Chryseobacterium_sp._ADR-1	2929799	S	18	6	24	0.00000
Chryseobacterium_sp._G0162	2487063	S	11	12	23	0.00000
Chryseobacterium_indologenes	253	S	127	66	193	0.00001
Chryseobacterium_taklimakanense	536441	S	105	66	171	0.00001
Chryseobacterium_daecheongense	192389	S	98	17	115	0.00001
Chryseobacterium_camelliae	1265445	S	68	47	115	0.00001
Chryseobacterium_indoltheticum	254	S	61	15	76	0.00000
Chryseobacterium_shandongense	1493872	S	58	40	98	0.00001
Chryseobacterium_nepalense	1854498	S	55	9	64	0.00000
Chryseobacterium_arthrosphaerae	651561	S	54	31	85	0.00001
Chryseobacterium_carnipullorum	1124835	S	43	17	60	0.00000
Chryseobacterium_salivictor	2547600	S	40	6	46	0.00000
Chryseobacterium_gallinarum	1324352	S	36	14	50	0.00000
Chryseobacterium_gleum	250	S	34	48	82	0.00001
Chryseobacterium_aureum	2497456	S	33	7	40	0.00000
Chryseobacterium_balustinum	246	S	32	11	43	0.00000
Chryseobacterium_lactis	1241981	S	30	37	67	0.00000
Chryseobacterium_manosquense	2754694	S	28	25	53	0.00000
Chryseobacterium_piperi	558152	S	24	3	27	0.00000
Chryseobacterium_joostei	112234	S	22	8	30	0.00000
Chryseobacterium_nakagawai	1241982	S	21	34	55	0.00000
Chryseobacterium_glaciei	1685010	S	20	4	24	0.00000
Chryseobacterium_cucumeris	1813611	S	18	9	27	0.00000
Chryseobacterium_bernardetii	1241978	S	16	137	153	0.00001
Kaistella_sp._97-N-M2	2908645	S	68	10	78	0.00001
Kaistella_sp._GW4-15	2878534	S	22	3	25	0.00000
Kaistella_daneshvariae	2487074	S	60	6	66	0.00000
Kaistella_carnis	1241979	S	35	13	48	0.00000
Candidatus_Kaistella_beijingensis	2820270	S	29	12	41	0.00000
Kaistella_jeonii	266749	S	28	2	30	0.00000
Kaistella_antarctica	266748	S	25	2	27	0.00000
Kaistella_flava_(ex_Peng_et_al._2021)	2038776	S	25	4	29	0.00000
Epilithonimonas_vandammei	2487072	S	42	75	117	0.00001
Epilithonimonas_zeae	1416779	S	41	5	46	0.00000
Elizabethkingia_anophelis	1117645	S	47	60	107	0.00001
Elizabethkingia_meningoseptica	238	S	42	4	46	0.00000
Elizabethkingia_miricola	172045	S	21	18	39	0.00000
Elizabethkingia_sp._JS20170427COW	2583851	S	14	2	16	0.00000
Elizabethkingia_ursingii	1756150	S	15	4	19	0.00000
Cruoricaptor_ignavus	1118202	S	116	17	133	0.00001
Empedobacter_brevis	247	S	25	12	37	0.00000
Empedobacter_stercoris	1628248	S	19	8	27	0.00000
Empedobacter_falsenii	343874	S	11	9	20	0.00000
Apibacter_raozihei	2500547	S	23	12	35	0.00000
Bergeyella_cardium	1585976	S	43	10	53	0.00000
Cloacibacterium_caeni	2004710	S	21	36	57	0.00000
Ornithobacterium_rhinotracheale	28251	S	42	35	77	0.00000
Riemerella_anatipestifer	34085	S	30	87	117	0.00001
Weeksella_virosa	1014	S	19	9	28	0.00000
Faecalibacter_bovis	2898187	S	18	3	21	0.00000
Fluviicola_taffensis	191579	S	174	10	184	0.00001
Crocinitomix_sp._GM2_3_6_6	2862509	S	40	1	41	0.00000
Blattabacterium_cuenoti	1653831	S	144	46	190	0.00001
Croceimicrobium_hydrocarbonivorans	2761580	S	67	17	84	0.00001
Owenweeksia_hongkongensis	253245	S	48	6	54	0.00000
Candidatus_Sulcia_muelleri	336810	S	29	12	41	0.00000
Candidatus_Walczuchella_monophlebidarum	1415657	S	11	2	13	0.00000
Ichthyobacterium_seriolicida	242600	S	14	0	14	0.00000
Alistipes_communis	2585118	S	664	482	1146	0.00007
Alistipes_onderdonkii	328813	S	661	764	1425	0.00009
Alistipes_dispar	2585119	S	619	77	696	0.00004
Alistipes_finegoldii	214856	S	514	463	977	0.00006
Alistipes_shahii	328814	S	456	261	717	0.00005
Alistipes_megaguti	2364787	S	453	52	505	0.00003
Alistipes_senegalensis	1288121	S	451	98	549	0.00004
Alistipes_sp._dk3624	2662363	S	427	91	518	0.00003
Alistipes_indistinctus	626932	S	418	85	503	0.00003
Prevotella_sp._oral_taxon_475	712471	S	67	6	73	0.00000
Prevotella_sp._Rep29	2691580	S	60	5	65	0.00000
Prevotella_sp._E13-17	2913616	S	58	2	60	0.00000
Prevotella_sp._E2-28	2913620	S	48	3	51	0.00000
Prevotella_sp._E15-22	2937774	S	46	4	50	0.00000
Prevotella_sp._E9-3	2913621	S	41	8	49	0.00000
Prevotella_sp._E13-3	2913617	S	13	53	66	0.00000
Prevotella_sp._oral_taxon_299	652716	S	12	1	13	0.00000
Prevotella_sp._E2-25	2913619	S	12	46	58	0.00000
Prevotella_dentalis	52227	S	283	58	341	0.00002
Prevotella_denticola	28129	S	98	33	131	0.00001
Prevotella_multiformis	282402	S	89	40	129	0.00001
Prevotella_melaninogenica	28132	S	85	31	116	0.00001
Prevotella_copri	165179	S	81	37	118	0.00001
Prevotella_intermedia	28131	S	78	37	115	0.00001
Prevotella_ruminicola	839	S	58	2	60	0.00000
Prevotella_enoeca	76123	S	43	8	51	0.00000
Prevotella_oris	28135	S	40	5	45	0.00000
Prevotella_buccalis	28127	S	38	40	78	0.00001
Prevotella_nigrescens	28133	S	26	17	43	0.00000
Prevotella_histicola	470565	S	24	4	28	0.00000
Prevotella_jejuni	1177574	S	22	9	31	0.00000
Prevotella_fusca	589436	S	21	4	25	0.00000
Prevotella_bryantii	77095	S	20	1	21	0.00000
Prevotella_herbatica	2801997	S	16	0	16	0.00000
Pseudoprevotella_muciniphila	2133944	S	99	10	109	0.00001
Paraprevotella_xylaniphila	454155	S	98	83	181	0.00001
Bacteroides_sp._CBA7301	2715212	S	53	23	76	0.00000
Bacteroides_sp._M10	2763022	S	21	49	70	0.00000
Bacteroides_fragilis	817	S	104	177	281	0.00002
Bacteroides_cellulosilyticus	246787	S	96	32	128	0.00001
Bacteroides_heparinolyticus	28113	S	85	19	104	0.00001
Bacteroides_eggerthii	28111	S	80	83	163	0.00001
Bacteroides_zoogleoformans	28119	S	75	17	92	0.00001
Bacteroides_thetaiotaomicron	818	S	65	39	104	0.00001
Bacteroides_uniformis	820	S	64	186	250	0.00002
Bacteroides_stercoris	46506	S	60	56	116	0.00001
Bacteroides_salyersiae	291644	S	53	48	101	0.00001
Bacteroides_helcogenes	290053	S	50	2	52	0.00000
Bacteroides_nordii	291645	S	37	26	63	0.00000
Bacteroides_faecis	674529	S	37	28	65	0.00000
Bacteroides_xylanisolvens	371601	S	36	80	116	0.00001
Bacteroides_zhangwenhongii	2650157	S	36	22	58	0.00000
Bacteroides_ovatus	28116	S	33	59	92	0.00001
Bacteroides_intestinalis	329854	S	30	4	34	0.00000
Bacteroides_luhongzhouii	2650158	S	26	10	36	0.00000
Bacteroides_caecimuris	1796613	S	25	32	57	0.00000
Bacteroides_caccae	47678	S	23	7	30	0.00000
Bacteroides_coprosuis	151276	S	21	1	22	0.00000
Phocaeicola_salanitronis	376805	S	133	55	188	0.00001
Phocaeicola_coprophilus	387090	S	63	33	96	0.00001
Phocaeicola_dorei	357276	S	32	55	87	0.00001
Phocaeicola_vulgatus	821	S	24	24	48	0.00000
Tannerella_serpentiformis	712710	S	458	21	479	0.00003
Tannerella_forsythia	28112	S	101	12	113	0.00001
Parabacteroides_goldsteinii	328812	S	117	28	145	0.00001
Parabacteroides_merdae	46503	S	97	101	198	0.00001
Parabacteroides_distasonis	823	S	78	196	274	0.00002
Parabacteroides_johnsonii	387661	S	50	38	88	0.00001
Sodaliphilus_pleomorphus	2606626	S	323	154	477	0.00003
Duncaniella_dubosii	2518971	S	87	14	101	0.00001
Muribaculum_gordoncarteri	2530390	S	122	14	136	0.00001
Muribaculum_intestinale	1796646	S	100	11	111	0.00001
Porphyromonas_sp._oral_taxon_275	712435	S	334	32	366	0.00002
Porphyromonas_asaccharolytica	28123	S	100	9	109	0.00001
Porphyromonas_gingivalis	837	S	72	10	82	0.00001
Porphyromonas_somerae	322095	S	40	10	50	0.00000
Porphyromonas_cangingivalis	36874	S	34	5	39	0.00000
Porphyromonas_crevioricanis	393921	S	27	6	33	0.00000
Porphyromonas_endodontalis	28124	S	17	1	18	0.00000
Proteiniphilum_saccharofermentans	1642647	S	95	5	100	0.00001
Proteiniphilum_sp._JNU-WLY501	2829812	S	42	0	42	0.00000
Petrimonas_mucosa	1642646	S	129	4	133	0.00001
Dysgonomonas_sp._HDW5B	2714927	S	11	14	25	0.00000
Butyricimonas_faecalis	2093856	S	63	60	123	0.00001
Butyricimonas_virosa	544645	S	51	8	59	0.00000
Odoribacter_splanchnicus	28118	S	69	61	130	0.00001
Barnesiella_viscericola	397865	S	162	201	363	0.00002
Coprobacter_secundus	1501392	S	32	27	59	0.00000
Paludibacter_propionicigenes	185300	S	57	1	58	0.00000
Tenuifilum_thalassicum	2590900	S	47	1	48	0.00000
Salinivirga_cyanobacteriivorans	1307839	S	34	0	34	0.00000
Draconibacterium_orientale	1168034	S	78	7	85	0.00001
Draconibacterium_halophilum	2706887	S	56	4	60	0.00000
Maribellus_comscasis	2681766	S	71	4	75	0.00000
Labilibaculum_antarcticum	1717717	S	40	4	44	0.00000
Alkalitalea_saponilacus	889453	S	34	4	38	0.00000
Mucilaginibacter_sp._14171R-50	2703789	S	172	10	182	0.00001
Mucilaginibacter_sp._SMC90	2929803	S	155	9	164	0.00001
Mucilaginibacter_sp._F39-2	2728022	S	130	9	139	0.00001
Mucilaginibacter_sp._21P	2778902	S	127	7	134	0.00001
Mucilaginibacter_mali	2740462	S	251	10	261	0.00002
Mucilaginibacter_ginsenosidivorans	398053	S	228	9	237	0.00002
Mucilaginibacter_daejeonensis	398049	S	215	14	229	0.00001
Mucilaginibacter_gotjawali	1550579	S	215	7	222	0.00001
Mucilaginibacter_ginsenosidivorax	862126	S	186	8	194	0.00001
Mucilaginibacter_celer	2305508	S	182	8	190	0.00001
Mucilaginibacter_xinganensis	1234841	S	158	8	166	0.00001
Mucilaginibacter_rubeus	2027860	S	155	381	536	0.00003
Mucilaginibacter_paludis	423351	S	150	8	158	0.00001
Mucilaginibacter_mallensis	652787	S	132	5	137	0.00001
Mucilaginibacter_ginkgonis	2682091	S	132	6	138	0.00001
Mucilaginibacter_gossypii	551996	S	79	60	139	0.00001
Pedobacter_sp._HDW13	2714940	S	120	17	137	0.00001
Pedobacter_sp._PACM_27299	1727164	S	101	16	117	0.00001
Pedobacter_sp._KBS0701	2578106	S	89	35	124	0.00001
Pedobacter_sp._G11	2482728	S	81	12	93	0.00001
Pedobacter_sp._SW-16	2766984	S	81	18	99	0.00001
Pedobacter_sp._Q8-18	2895286	S	57	5	62	0.00000
Pedobacter_sp._D749	2856523	S	39	15	54	0.00000
Pedobacter_heparinus	984	S	118	11	129	0.00001
Pedobacter_endophyticus	2789740	S	116	12	128	0.00001
Pedobacter_steynii	430522	S	114	12	126	0.00001
Pedobacter_schmidteae	2201271	S	104	10	114	0.00001
Pedobacter_suwonensis	332999	S	83	19	102	0.00001
Pedobacter_cryoconitis	188932	S	78	9	87	0.00001
Pedobacter_roseus	336820	S	68	21	89	0.00001
Pedobacter_ginsengisoli	363852	S	56	8	64	0.00000
Pedobacter_aquae	2605747	S	46	5	51	0.00000
Sphingobacterium_thalpophilum	259	S	359	419	778	0.00005
Sphingobacterium_sp._DR205	2713573	S	87	10	97	0.00001
Sphingobacterium_sp._CZ-2	2557994	S	55	15	70	0.00000
Sphingobacterium_sp._UDSM-2020	2795738	S	48	18	66	0.00000
Sphingobacterium_sp._SRCM116780	2907623	S	42	8	50	0.00000
Sphingobacterium_sp._dk4302	2662364	S	30	3	33	0.00000
Sphingobacterium_sp._PCS056	2931400	S	26	6	32	0.00000
Sphingobacterium_sp._ML3W	1538644	S	24	9	33	0.00000
Sphingobacterium_sp._G1-14	2003121	S	13	65	78	0.00001
Sphingobacterium_spiritivorum	258	S	151	110	261	0.00002
Sphingobacterium_lactis	797291	S	68	61	129	0.00001
Sphingobacterium_multivorum	28454	S	65	151	216	0.00001
Sphingobacterium_hotanense	649196	S	60	20	80	0.00001
Sphingobacterium_mizutaii	1010	S	58	9	67	0.00000
Sphingobacterium_psychroaquaticum	561061	S	53	11	64	0.00000
Sphingobacterium_daejeonense	371142	S	29	8	37	0.00000
Sphingobacterium_paramultivorum	2886510	S	14	15	29	0.00000
Olivibacter_sp._LS-1	2592345	S	232	14	246	0.00002
Olivibacter_sp._SDN3	2764720	S	124	19	143	0.00001
Anseongella_ginsenosidimutans	496056	S	308	13	321	0.00002
Solitalea_canadensis	995	S	91	8	99	0.00001
Solitalea_sp._S2-8	2911172	S	80	9	89	0.00001
Pseudopedobacter_saltans	151895	S	83	72	155	0.00001
Haliscomenobacter_hydrossis	2350	S	311	4	315	0.00002
Saprospira_grandis	1008	S	55	1	56	0.00000
Candidatus_Sulfidibacterium_hydrothermale	2875962	S	91	3	94	0.00001
Chlorobaculum_limnaeum	274537	S	1051	176	1227	0.00008
Chlorobaculum_tepidum	1097	S	568	164	732	0.00005
Chlorobaculum_parvum	274539	S	527	104	631	0.00004
Pelodictyon_luteolum	1100	S	463	68	531	0.00003
Pelodictyon_phaeoclathratiforme	34090	S	93	5	98	0.00001
Chlorobium_limicola	1092	S	181	15	196	0.00001
Chlorobium_phaeovibrioides	1094	S	117	21	138	0.00001
Chlorobium_phaeobacteroides	1096	S	94	12	106	0.00001
Prosthecochloris_sp._GSB1	281093	S	412	28	440	0.00003
Prosthecochloris_sp._HL-130-GSB	1974213	S	135	24	159	0.00001
Prosthecochloris_sp._CIB_2401	1868325	S	127	32	159	0.00001
Prosthecochloris_aestuarii	1102	S	131	13	144	0.00001
Chloroherpeton_thalassium	100716	S	185	3	188	0.00001
Candidatus_Cyclonatronum_proteinivorum	1457365	S	312	33	345	0.00002
Melioribacter_roseus	1134405	S	127	8	135	0.00001
Ignavibacterium_album	591197	S	80	6	86	0.00001
Fibrobacter_succinogenes	833	S	161	3	164	0.00001
Candidatus_Cloacimonas_acidaminovorans	456827	S	79	1	80	0.00001
Luteitalea_sp._TBR-22	2802971	S	40919	8033	48952	0.00313
Luteitalea_pratensis	1855912	S	32161	4108	36269	0.00232
Granulicella_sp._WH15	2602070	S	3882	781	4663	0.00030
Granulicella_sp._5B5	1617967	S	3395	617	4012	0.00026
Granulicella_mallensis	940614	S	2753	369	3122	0.00020
Granulicella_tundricola	940615	S	2131	315	2446	0.00016
Terriglobus_roseus	392734	S	3595	854	4449	0.00028
Terriglobus_albidus	1592106	S	2600	276	2876	0.00018
Terriglobus_saanensis	870903	S	1720	252	1972	0.00013
Acidobacterium_capsulatum	33075	S	3951	567	4518	0.00029
Acidobacterium_sp._4Y35	2763107	S	3346	277	3623	0.00023
Candidatus_Koribacter_versatilis	658062	S	6462	243	6705	0.00043
Edaphobacter_sp._12200R-103	2703788	S	2282	523	2805	0.00018
Edaphobacter_sp._4G125	2763071	S	1310	259	1569	0.00010
Acidisarcina_polymorpha	2211140	S	2447	203	2650	0.00017
Paludibaculum_fermentans	1473598	S	8314	247	8561	0.00055
Chloracidobacterium_aggregatum	2851959	S	1222	1022	2244	0.00014
Chloracidobacterium_validum	2821543	S	1016	20	1036	0.00007
Chloracidobacterium_sp._D	2821536	S	106	387	493	0.00003
Chloracidobacterium_thermophilum	458033	S	61	206	267	0.00002
Sulfidibacter_corallicola	2818388	S	2186	55	2241	0.00014
Thermotomaculum_hydrothermale	981385	S	76	4	80	0.00001
Nitrospira_moscoviensis	42253	S	6531	618	7149	0.00046
Nitrospira_japonica	1325564	S	4082	535	4617	0.00029
Nitrospira_sp._KM1	1936990	S	3274	338	3612	0.00023
Candidatus_Nitrospira_inopinata	1715989	S	2695	254	2949	0.00019
Leptospirillum_ferrooxidans	180	S	120	2	122	0.00001
Leptospirillum_ferriphilum	178606	S	64	103	167	0.00001
Leptospirillum_sp._Group_II_'CF-1'	1660083	S	37	75	112	0.00001
Dissulfurispira_thermophila	2715679	S	161	7	168	0.00001
Thermodesulfovibrio_yellowstonii	28262	S	79	1	80	0.00001
Treponema_brennaborense	81028	S	164	56	220	0.00001
Treponema_primitia	88058	S	122	7	129	0.00001
Treponema_azotonutricium	150829	S	110	5	115	0.00001
Treponema_sp._Marseille-Q4132	2766701	S	60	25	85	0.00001
Treponema_sp._OMZ_838	1539298	S	32	29	61	0.00000
Treponema_socranskii	53419	S	87	36	123	0.00001
Treponema_caldarium	215591	S	63	9	72	0.00000
Treponema_vincentii	69710	S	53	48	101	0.00001
Treponema_parvum	138851	S	51	2	53	0.00000
Treponema_succinifaciens	167	S	31	23	54	0.00000
Treponema_denticola	158	S	29	10	39	0.00000
Treponema_peruense	2787628	S	28	3	31	0.00000
Treponema_phagedenis	162	S	28	11	39	0.00000
Treponema_medium	58231	S	26	28	54	0.00000
Treponema_pedis	409322	S	17	4	21	0.00000
Treponema_putidum	221027	S	10	6	16	0.00000
Spirochaeta_thermophila	154	S	633	16	649	0.00004
Spirochaeta_africana	46355	S	204	10	214	0.00001
Salinispira_pacifica	1307761	S	101	3	104	0.00001
Sediminispirochaeta_smaragdinae	55206	S	99	3	102	0.00001
Oceanispirochaeta_crateris	2518645	S	41	2	43	0.00000
Thiospirochaeta_perfilievii	252967	S	11	0	11	0.00000
Sphaerochaeta_associata	1129264	S	101	11	112	0.00001
Sphaerochaeta_coccoides	273376	S	86	4	90	0.00001
Sphaerochaeta_globosa	1131703	S	65	8	73	0.00000
Sphaerochaeta_pleomorpha	1131707	S	22	3	25	0.00000
Breznakiella_homolactica	2798577	S	144	14	158	0.00001
Leptospira_kmetyi	408139	S	96	3	99	0.00001
Leptospira_santarosai	28183	S	89	6	95	0.00001
Leptospira_tipperaryensis	2564040	S	49	1	50	0.00000
Leptospira_weilii	28184	S	46	6	52	0.00000
Leptospira_noguchii	28182	S	40	3	43	0.00000
Leptospira_kobayashii	1917830	S	33	0	33	0.00000
Leptospira_borgpetersenii	174	S	28	4	32	0.00000
Leptospira_mayottensis	1137606	S	25	35	60	0.00000
Leptospira_biflexa	172	S	22	0	22	0.00000
Leptospira_interrogans	173	S	11	73	84	0.00001
Turneriella_parva	29510	S	304	2	306	0.00002
Pyramidobacter_piscolens	638849	S	703	40	743	0.00005
Aminomonas_paucivorans	81412	S	646	65	711	0.00005
Fretibacterium_fastidiosum	651822	S	581	8	589	0.00004
Thermanaerovibrio_acidaminovorans	81462	S	273	98	371	0.00002
Thermanaerovibrio_velox	108007	S	156	36	192	0.00001
Cloacibacillus_porcorum	1197717	S	476	95	571	0.00004
Jonquetella_anthropi	428712	S	318	48	366	0.00002
Aminobacterium_colombiense	81468	S	79	4	83	0.00001
Acetomicrobium_mobile	97477	S	64	1	65	0.00000
Thermovirga_lienii	336261	S	48	39	87	0.00001
Candidatus_Bipolaricaulis_anaerobius	2026885	S	733	31	764	0.00005
Candidatus_Nanosynbacter_featherlites	2572088	S	92	54	146	0.00001
Candidatus_Nanosynbacter_lyticus	2093824	S	58	162	220	0.00001
Nanosynbacter_sp._HMT-352	2899133	S	19	62	81	0.00001
Candidatus_Saccharimonas_aalborgensis	1332188	S	207	2	209	0.00001
Candidatus_Minimicrobia_vallesae	2841264	S	10	73	83	0.00001
Candidatus_Chazhemtobacterium_aquaticus	2715735	S	60	0	60	0.00000
Candidatus_Babela_massiliensis	673862	S	59	1	60	0.00000
Candidatus_Absconditicoccus_praedator	2735562	S	46	0	46	0.00000
Thermotoga_caldifontis	1508419	S	109	115	224	0.00001
Pseudothermotoga_hypogea	57487	S	62	26	88	0.00001
Pseudothermotoga_thermarum	119394	S	23	6	29	0.00000
Thermosipho_ferrireducens	2571116	S	27	5	32	0.00000
Thermosipho_africanus	2421	S	11	19	30	0.00000
Fervidobacterium_pennivorans	93466	S	16	49	65	0.00000
Mesotoga_infera	1236046	S	78	16	94	0.00001
Mesotoga_prima	1184387	S	25	5	30	0.00000
Kosmotoga_olearia	651457	S	21	5	26	0.00000
Kosmotoga_pacifica	1330330	S	10	2	12	0.00000
Defluviitoga_tunisiensis	1006576	S	13	30	43	0.00000
Athalassotoga_saccharophila	1441386	S	28	0	28	0.00000
Thermocrinis_minervae	381751	S	86	15	101	0.00001
Thermocrinis_ruber	75906	S	28	5	33	0.00000
Thermocrinis_albus	136094	S	18	2	20	0.00000
Hydrogenobacter_sp._T-8	1632019	S	25	8	33	0.00000
Hydrogenobacter_thermophilus	940	S	15	6	21	0.00000
Aquifex_aeolicus	63363	S	48	3	51	0.00000
Sulfurihydrogenibium_azorense	309806	S	110	12	122	0.00001
Persephonella_marina	309805	S	75	5	80	0.00001
Thermosulfidibacter_takaii	412593	S	131	5	136	0.00001
Thermovibrio_ammonificans	228745	S	117	23	140	0.00001
Desulfurobacterium_thermolithotrophum	64160	S	27	4	31	0.00000
Thermosulfurimonas_marina	2047767	S	192	37	229	0.00001
Thermodesulfatator_indicus	171695	S	85	16	101	0.00001
Thermosulfuriphilus_ammonigenes	1936021	S	81	4	85	0.00001
Thermodesulfobacterium_sp._TA1	2234087	S	21	15	36	0.00000
Thermodesulfobacterium_geofontis	1295609	S	17	11	28	0.00000
Caldimicrobium_thiodismutans	1653476	S	31	8	39	0.00000
Caldithrix_abyssi	187145	S	396	4	400	0.00003
Geovibrio_thiophilus	139438	S	98	29	127	0.00001
Calditerrivibrio_nitroreducens	477976	S	57	12	69	0.00000
Flexistipes_sinusarabici	2352	S	45	8	53	0.00000
Denitrovibrio_acetiphilus	118000	S	40	8	48	0.00000
Mucispirillum_schaedleri	248039	S	36	5	41	0.00000
Deferribacter_desulfuricans	197162	S	24	6	30	0.00000
Fusobacterium_ulcerans	861	S	18	3	21	0.00000
Fusobacterium_sp._NSJ-57	2764326	S	11	16	27	0.00000
Fusobacterium_necrophorum	859	S	17	7	24	0.00000
Fusobacterium_nucleatum	851	S	16	44	60	0.00000
Ilyobacter_polytropus	167642	S	13	1	14	0.00000
Leptotrichia_wadei	157687	S	15	31	46	0.00000
Sebaldella_termitidis	826	S	24	2	26	0.00000
Pseudoleptotrichia_goodfellowii	157692	S	10	5	15	0.00000
Desulfurispirillum_indicum	936456	S	276	127	403	0.00003
Endomicrobium_proavitum	1408281	S	41	12	53	0.00000
Candidatus_Endomicrobium_trichonymphae	1408204	S	40	11	51	0.00000
Elusimicrobium_minutum	423605	S	93	1	94	0.00001
Coprothermobacter_proteolyticus	35786	S	134	28	162	0.00001
Caldisericum_exile	693075	S	99	0	99	0.00001
Dictyoglomus_thermophilum	14	S	12	41	53	0.00000
Atribacter_laminatus	2847778	S	51	1	52	0.00000
Fusarium_acuminatum	5515	S	9296	568	9864	0.00063
Fusarium_avenaceum	40199	S	139	5	144	0.00001
Fusarium_sambucinum	5128	S	969	248	1217	0.00008
Fusarium_longipes	694270	S	211	9	220	0.00001
Fusarium_poae	36050	S	205	59	264	0.00002
Fusarium_sporotrichioides	5514	S	179	11	190	0.00001
Fusarium_pseudograminearum	101028	S	164	32	196	0.00001
Fusarium_venenatum	56646	S	77	131	208	0.00001
Fusarium_graminearum	5518	S	69	334	403	0.00003
Fusarium_culmorum	5516	S	56	24	80	0.00001
Fusarium_oxysporum	5507	S	1810	811	2621	0.00017
Fusarium_nygamai	42673	S	289	102	391	0.00003
Fusarium_fujikuroi	5127	S	137	16	153	0.00001
Fusarium_pseudonygamai	47755	S	108	30	138	0.00001
Fusarium_thapsinum	120644	S	99	25	124	0.00001
Fusarium_verticillioides	117187	S	41	74	115	0.00001
Fusarium_equiseti	61235	S	333	64	397	0.00003
Fusarium_scirpi	2211609	S	318	53	371	0.00002
Fusarium_dimerum	57145	S	546	18	564	0.00004
Fusarium_decemcellulare	57161	S	541	13	554	0.00004
Fusarium_lateritium	5523	S	459	15	474	0.00003
Fusarium_graminum	86546	S	163	35	198	0.00001
Fusarium_heterosporum	42747	S	144	30	174	0.00001
Fusarium_nelsonii	77846	S	149	39	188	0.00001
Fusarium_chlamydosporum	86545	S	109	28	137	0.00001
Fusarium_musae	1042133	S	34	59	93	0.00001
Metarhizium_rileyi	1649241	S	647	118	765	0.00005
Metarhizium_album	92629	S	603	21	624	0.00004
Metarhizium_guizhouense	169041	S	538	276	814	0.00005
Metarhizium_acridum	92637	S	267	196	463	0.00003
Metarhizium_anisopliae	5530	S	116	170	286	0.00002
Metarhizium_humberi	2596975	S	115	65	180	0.00001
Metarhizium_majus	1650735	S	113	48	161	0.00001
Metarhizium_brunneum	500148	S	108	84	192	0.00001
Metarhizium_robertsii	568076	S	59	39	98	0.00001
Ustilaginoidea_virens	1159556	S	832	46	878	0.00006
Pochonia_chlamydosporia	280754	S	248	20	268	0.00002
Trichoderma_reesei	51453	S	421	36	457	0.00003
Trichoderma_citrinoviride	58853	S	401	38	439	0.00003
Trichoderma_pleuroti	500994	S	300	27	327	0.00002
Trichoderma_asperellum	101201	S	253	16	269	0.00002
Trichoderma_atroviride	63577	S	233	51	284	0.00002
Trichoderma_erinaceum	202914	S	223	28	251	0.00002
Trichoderma_afroharzianum	1567482	S	151	25	176	0.00001
Trichoderma_harzianum	5544	S	139	23	162	0.00001
Trichoderma_koningiopsis	337941	S	133	17	150	0.00001
Trichoderma_hamatum	49224	S	131	9	140	0.00001
Trichoderma_gamsii	398673	S	128	14	142	0.00001
Trichoderma_longibrachiatum	5548	S	59	454	513	0.00003
Trichoderma_viride	5547	S	43	431	474	0.00003
Trichoderma_koningii	97093	S	28	202	230	0.00001
Trichoderma_virens	29875	S	27	208	235	0.00002
Beauveria_felina	37994	S	708	41	749	0.00005
Beauveria_pseudobassiana	931006	S	391	65	456	0.00003
Beauveria_brongniartii	118266	S	246	70	316	0.00002
Beauveria_rudraprayagi	1481906	S	162	223	385	0.00002
Beauveria_bassiana	176275	S	125	181	306	0.00002
Cordyceps_fumosorosea	114497	S	979	90	1069	0.00007
Purpureocillium_lilacinum	33203	S	1287	99	1386	0.00009
Drechmeria_coniospora	98403	S	948	48	996	0.00006
Clonostachys_rosea	29856	S	445	35	480	0.00003
Colletotrichum_higginsianum	80884	S	1134	277	1411	0.00009
Thermothelomyces_thermophilus	78579	S	6153	424	6577	0.00042
Thermothielavioides_terrestris	2587410	S	4631	438	5069	0.00032
Neurospora_crassa	5141	S	1423	98	1521	0.00010
Pyricularia_pennisetigena	1578925	S	455	78	533	0.00003
Pyricularia_oryzae	318829	S	389	115	504	0.00003
Pyricularia_grisea	148305	S	303	50	353	0.00002
Neopestalotiopsis_rosae	1562205	S	180	235	415	0.00003
Neopestalotiopsis_clavispora	289240	S	172	243	415	0.00003
Botrytis_cinerea	40559	S	261	1	262	0.00002
Aspergillus_chevalieri	182096	S	3001	400	3401	0.00022
Aspergillus_luchuensis	1069201	S	2451	254	2705	0.00017
Aspergillus_oryzae	5062	S	344	788	1132	0.00007
Aspergillus_flavus	5059	S	131	328	459	0.00003
Aspergillus_puulaauensis	1220207	S	1348	72	1420	0.00009
Aspergillus_fumigatus	746128	S	490	39	529	0.00003
Penicillium_citrinum	5077	S	789	121	910	0.00006
Penicillium_chrysogenum	5076	S	526	149	675	0.00004
Penicillium_aurantiogriseum	36655	S	305	151	456	0.00003
Penicillium_expansum	27334	S	270	168	438	0.00003
Penicillium_italicum	40296	S	246	137	383	0.00002
Penicillium_digitatum	36651	S	217	66	283	0.00002
Paecilomyces_niveus	5093	S	343	16	359	0.00002
Paecilomyces_variotii	264951	S	266	30	296	0.00002
Talaromyces_rugulosus	121627	S	293	21	314	0.00002
Ampelomyces_quisqualis	50730	S	515	64	579	0.00004
Paraphaeosphaeria_minitans	565426	S	511	203	714	0.00005
Zymoseptoria_tritici	1047171	S	241	5	246	0.00002
Cercospora_beticola	122368	S	212	1	213	0.00001
Eremothecium_gossypii	33169	S	149	131	280	0.00002
Eremothecium_cymbalariae	45285	S	16	0	16	0.00000
Naumovozyma_castellii	27288	S	56	5	61	0.00000
Naumovozyma_dairenensis	27289	S	47	2	49	0.00000
Saccharomyces_eubayanus	1080349	S	34	1	35	0.00000
Saccharomyces_cerevisiae	4932	S	22	3	25	0.00000
Saccharomyces_paradoxus	27291	S	19	1	20	0.00000
Tetrapisispora_blattae	1071379	S	40	2	42	0.00000
Tetrapisispora_phaffii	113608	S	25	1	26	0.00000
Kluyveromyces_marxianus	4911	S	49	9	58	0.00000
Kluyveromyces_lactis	28985	S	12	1	13	0.00000
Lachancea_thermotolerans	381046	S	62	4	66	0.00000
[Candida]_glabrata	5478	S	52	2	54	0.00000
Kazachstania_naganishii	588726	S	41	2	43	0.00000
Kazachstania_africana	432096	S	10	0	10	0.00000
Torulaspora_globosa	48254	S	29	2	31	0.00000
Torulaspora_delbrueckii	4950	S	15	1	16	0.00000
Zygosaccharomyces_rouxii	4956	S	27	1	28	0.00000
Zygotorulaspora_mrakii	42260	S	20	2	22	0.00000
Candida_dubliniensis	42374	S	91	5	96	0.00001
Candida_albicans	5476	S	35	1	36	0.00000
Candida_orthopsilosis	273371	S	25	0	25	0.00000
Scheffersomyces_stipitis	4924	S	23	0	23	0.00000
Debaryomyces_hansenii	4959	S	15	0	15	0.00000
Brettanomyces_nanus	13502	S	30	11	41	0.00000
Brettanomyces_bruxellensis	5007	S	27	5	32	0.00000
Ogataea_parapolymorpha	1005962	S	60	1	61	0.00000
Pichia_kudriavzevii	4909	S	48	2	50	0.00000
Yarrowia_lipolytica	4952	S	114	1	115	0.00001
Sugiyamaella_lignohabitans	796027	S	78	7	85	0.00001
Saccharomycodes_ludwigii	36035	S	15	2	17	0.00000
Komagataella_phaffii	460519	S	14	0	14	0.00000
Schizosaccharomyces_pombe	4896	S	37	1	38	0.00000
Pseudozyma_flocculosa	84751	S	1488	14	1502	0.00010
Ustilago_maydis	5270	S	440	11	451	0.00003
Sporisorium_graminicola	280036	S	342	53	395	0.00003
Malassezia_restricta	76775	S	156	28	184	0.00001
Phlebiopsis_gigantea	82310	S	508	5	513	0.00003
Rhizoctonia_solani	456999	S	120	6	126	0.00001
Marasmius_oreades	181124	S	101	4	105	0.00001
Cryptococcus_neoformans	5207	S	81	11	92	0.00001
Cryptococcus_gattii_VGI	37769	S	26	30	56	0.00000
Encephalitozoon_cuniculi	6035	S	11	11	22	0.00000
Phytophthora_cryptogea	4786	S	1001	87	1088	0.00007
Phytophthora_cinnamomi	4785	S	976	174	1150	0.00007
Phytophthora_fragariae	53985	S	704	107	811	0.00005
Phytophthora_infestans	4787	S	345	587	932	0.00006
Phytophthora_boehmeriae	109152	S	247	31	278	0.00002
Phytophthora_cactorum	29920	S	227	36	263	0.00002
Phytophthora_parasitica	4792	S	185	25	210	0.00001
Pythium_aphanidermatum	65070	S	563	11	574	0.00004
