name	taxonomy_id	taxonomy_lvl	kraken_assigned_reads	added_reads	new_est_reads	fraction_total_reads
Bradyrhizobium sp. 200	2782665	S	9072	2139	11211	0.00071
Bradyrhizobium sp. 170	2782641	S	8191	2236	10427	0.00066
Bradyrhizobium sp. CCBAU 051011	858422	S	7918	1614	9532	0.00060
Bradyrhizobium sp. CCBAU 51753	1325100	S	7322	1709	9031	0.00057
Bradyrhizobium sp. ORS 278	114615	S	6488	1600	8088	0.00051
Bradyrhizobium sp. A19	2898149	S	6428	1212	7640	0.00048
Bradyrhizobium sp. BTAi1	288000	S	6413	1267	7680	0.00049
Bradyrhizobium sp. ORS 285	115808	S	6259	1521	7780	0.00049
Bradyrhizobium sp. SK17	2057741	S	5098	1772	6870	0.00043
Bradyrhizobium sp. 186	2782654	S	4568	1294	5862	0.00037
Bradyrhizobium sp. CCBAU 53421	1325120	S	4013	1319	5332	0.00034
Bradyrhizobium sp. CCBAU 53338	1325111	S	3459	1462	4921	0.00031
Bradyrhizobium sp. CCBAU 53340	1325112	S	3325	1334	4659	0.00029
Bradyrhizobium sp. 1(2017)	1404888	S	3255	1065	4320	0.00027
Bradyrhizobium sp. 195	2782662	S	3076	1152	4228	0.00027
Bradyrhizobium sp. CCBAU 53351	1325114	S	3018	1573	4591	0.00029
Bradyrhizobium sp. S2-11-2	2840472	S	2895	2303	5198	0.00033
Bradyrhizobium sp. 6(2017)	1197460	S	2892	1463	4355	0.00028
Bradyrhizobium sp. CCGE-LA001	1223566	S	2679	1040	3719	0.00024
Bradyrhizobium sp. S2-20-1	2840469	S	2429	2050	4479	0.00028
Bradyrhizobium sp. 41S5	1404443	S	2340	1636	3976	0.00025
Bradyrhizobium sp. S2-11-4	2840473	S	2321	2153	4474	0.00028
Bradyrhizobium sp. I71	2590772	S	2267	2048	4315	0.00027
Bradyrhizobium sp. 191	2782659	S	2160	2205	4365	0.00028
Bradyrhizobium sp. CCBAU 51765	1325102	S	2070	1945	4015	0.00025
Bradyrhizobium sp. C-145	574727	S	1471	1482	2953	0.00019
Bradyrhizobium sp.	376	S	1115	3702	4817	0.00030
Bradyrhizobium sp. 144S4	2823807	S	858	2146	3004	0.00019
Bradyrhizobium sp. 40	2782674	S	854	1968	2822	0.00018
Bradyrhizobium sp. 4	2782678	S	843	2179	3022	0.00019
Bradyrhizobium sp. 323S2	1404649	S	808	2062	2870	0.00018
Bradyrhizobium sp. 192	2782660	S	674	1653	2327	0.00015
Bradyrhizobium sp. LCT2	2493093	S	547	1547	2094	0.00013
Bradyrhizobium sp. SG09	2599805	S	321	2314	2635	0.00017
Bradyrhizobium sp. 187	2782655	S	319	1568	1887	0.00012
Bradyrhizobium sp. TM102	2599819	S	274	1888	2162	0.00014
Bradyrhizobium sp. CW1	2782686	S	210	3233	3443	0.00022
Bradyrhizobium sp. 38S5	2819348	S	185	2251	2436	0.00015
Bradyrhizobium sp. 172	2782643	S	163	1973	2136	0.00013
Bradyrhizobium sp. 1S5	2816456	S	147	1650	1797	0.00011
Bradyrhizobium sp. 131	2782609	S	135	2192	2327	0.00015
Bradyrhizobium sp. 155	2782629	S	104	1862	1966	0.00012
Bradyrhizobium sp. CCBAU 21365	1325083	S	11	538	549	0.00003
Bradyrhizobium erythrophlei	1437360	S	19887	1793	21680	0.00137
Bradyrhizobium diazoefficiens	1355477	S	15149	39209	54358	0.00343
Bradyrhizobium icense	1274631	S	8837	1378	10215	0.00065
Bradyrhizobium paxllaeri	190148	S	7330	1466	8796	0.00056
Bradyrhizobium lablabi	722472	S	6604	7885	14489	0.00092
Bradyrhizobium oligotrophicum	44255	S	5871	1120	6991	0.00044
Bradyrhizobium genosp. L	83637	S	5666	1240	6906	0.00044
Bradyrhizobium canariense	255045	S	5639	8965	14604	0.00092
Bradyrhizobium japonicum	375	S	5577	8299	13876	0.00088
Bradyrhizobium arachidis	858423	S	4379	1315	5694	0.00036
Bradyrhizobium guangdongense	1325090	S	4090	1567	5657	0.00036
Bradyrhizobium quebecense	2748629	S	3630	2123	5753	0.00036
Bradyrhizobium genosp. B	83627	S	3621	824	4445	0.00028
Bradyrhizobium cosmicum	1404864	S	3529	1204	4733	0.00030
Bradyrhizobium vignae	1549949	S	3393	848	4241	0.00027
Bradyrhizobium guangzhouense	1325095	S	3234	1274	4508	0.00028
Bradyrhizobium guangxiense	1325115	S	2975	1338	4313	0.00027
Bradyrhizobium septentrionale	1404411	S	2860	1802	4662	0.00029
Bradyrhizobium daqingense	993502	S	2604	1456	4060	0.00026
Bradyrhizobium betae	244734	S	2161	1300	3461	0.00022
Bradyrhizobium amphicarpaeae	1404768	S	2128	923	3051	0.00019
Bradyrhizobium symbiodeficiens	1404367	S	1924	2934	4858	0.00031
Bradyrhizobium zhanjiangense	1325107	S	1422	1443	2865	0.00018
Bradyrhizobium elkanii	29448	S	1064	4106	5170	0.00033
Bradyrhizobium ottawaense	931866	S	706	4476	5182	0.00033
Rhodopseudomonas palustris	1076	S	22712	8739	31451	0.00199
Rhodopseudomonas boonkerdii	475937	S	2944	852	3796	0.00024
Rhodopseudomonas sp. SK50-23	340268	S	2862	636	3498	0.00022
Tardiphaga sp. 37S4	1404741	S	1669	1258	2927	0.00019
Tardiphaga sp. vice154	2592814	S	155	2096	2251	0.00014
Tardiphaga sp. vice278	2592815	S	84	1782	1866	0.00012
Tardiphaga sp. vice304	2592817	S	59	976	1035	0.00007
Tardiphaga sp. vice352	2592816	S	25	660	685	0.00004
Tardiphaga robiniae	943830	S	1715	1152	2867	0.00018
Afipia carboxidovorans	40137	S	4136	1038	5174	0.00033
Afipia sp. GAS231	1882747	S	2873	2286	5159	0.00033
Variibacter gotjawalensis	1333996	S	6716	596	7312	0.00046
Nitrobacter hamburgensis	912	S	3480	666	4146	0.00026
Nitrobacter winogradskyi	913	S	2718	514	3232	0.00020
Rhizobium sp. BG4	2613770	S	2449	497	2946	0.00019
Rhizobium sp. WYJ-E13	2849093	S	2147	288	2435	0.00015
Rhizobium sp. NXC24	2048897	S	1976	296	2272	0.00014
Rhizobium sp. WL3	2603277	S	1710	345	2055	0.00013
Rhizobium sp. ACO-34A	1571470	S	1699	371	2070	0.00013
Rhizobium sp. SL42	2806346	S	1652	319	1971	0.00012
Rhizobium sp. 11515TR	2028343	S	1485	338	1823	0.00012
Rhizobium sp. AB2/73	2795216	S	1448	765	2213	0.00014
Rhizobium sp. CIAT894	2020312	S	1313	529	1842	0.00012
Rhizobium sp. NZLR1	2731096	S	1206	384	1590	0.00010
Rhizobium sp. NLR16a	2731112	S	1201	474	1675	0.00011
Rhizobium sp. NXC14	1981173	S	1131	418	1549	0.00010
Rhizobium sp. K102	2918527	S	1048	628	1676	0.00011
Rhizobium sp. C104	2917727	S	989	476	1465	0.00009
Rhizobium sp. L51/94	2819999	S	741	841	1582	0.00010
Rhizobium sp. 007	2785056	S	529	780	1309	0.00008
Rhizobium sp. X9	2815360	S	495	1047	1542	0.00010
Rhizobium sp. Kim5	2020311	S	349	649	998	0.00006
Rhizobium sp. IE4771	1301032	S	348	593	941	0.00006
Rhizobium sp. TAL182	2020313	S	258	616	874	0.00006
Rhizobium sp. NIBRBAC000502774	2590777	S	200	878	1078	0.00007
Rhizobium sp. ZX09	2291939	S	113	449	562	0.00004
Rhizobium sp. Y9	1914541	S	101	326	427	0.00003
Rhizobium sp. B230/85	2819994	S	91	862	953	0.00006
Rhizobium sp. T136	555319	S	66	1513	1579	0.00010
Rhizobium sp. N324	1703969	S	60	1095	1155	0.00007
Rhizobium sp. CCGE531	2364271	S	53	1652	1705	0.00011
Rhizobium sp. B21/90	2819993	S	26	802	828	0.00005
Rhizobium sp. CCGE532	2364272	S	17	1120	1137	0.00007
Rhizobium leguminosarum	384	S	11587	21524	33111	0.00209
Rhizobium etli	29449	S	3425	3388	6813	0.00043
Rhizobium pseudoryzae	379684	S	2265	516	2781	0.00018
Rhizobium jaguaris	1312183	S	2228	296	2524	0.00016
Rhizobium gallicum	56730	S	2180	2394	4574	0.00029
Rhizobium phaseoli	396	S	2001	3493	5494	0.00035
Rhizobium bangladeshense	1138189	S	1769	406	2175	0.00014
Rhizobium lentis	1138194	S	1458	428	1886	0.00012
Rhizobium tropici	398	S	1343	338	1681	0.00011
Rhizobium binae	1138190	S	1246	424	1670	0.00011
Rhizobium rosettiformans	1368430	S	1226	596	1822	0.00012
Rhizobium daejeonense	240521	S	1170	392	1562	0.00010
Rhizobium rhizoryzae	451876	S	1008	147	1155	0.00007
Rhizobium indicum	2583231	S	836	626	1462	0.00009
Rhizobium pusense	648995	S	723	2571	3294	0.00021
Rhizobium acidisoli	1538158	S	680	481	1161	0.00007
Rhizobium oryzihabitans	2267833	S	404	520	924	0.00006
Rhizobium laguerreae	1076926	S	330	470	800	0.00005
Rhizobium hidalgonense	1538159	S	286	541	827	0.00005
Rhizobium ruizarguesonis	2081791	S	252	1509	1761	0.00011
Rhizobium favelukesii	348824	S	36	984	1020	0.00006
Agrobacterium tumefaciens	358	S	6118	5834	11952	0.00076
Agrobacterium fabrum	1176649	S	616	791	1407	0.00009
Agrobacterium fabacearum	1183401	S	124	1507	1631	0.00010
Agrobacterium vitis	373	S	3101	410	3511	0.00022
Agrobacterium sp. T29	2580515	S	478	371	849	0.00005
Agrobacterium sp. MA01	2664893	S	341	682	1023	0.00006
Agrobacterium sp. RAC06	1842536	S	331	676	1007	0.00006
Agrobacterium sp. CGMCC 11546	2579248	S	161	324	485	0.00003
Agrobacterium sp. S7/73	2820002	S	79	414	493	0.00003
Agrobacterium vaccinii	2735528	S	1267	186	1453	0.00009
Agrobacterium larrymoorei	160699	S	830	155	985	0.00006
Agrobacterium salinitolerans	1183413	S	779	296	1075	0.00007
Agrobacterium rubi	28099	S	750	229	979	0.00006
Agrobacterium rhizogenes	359	S	630	1483	2113	0.00013
Neorhizobium galegae	399	S	6866	2089	8955	0.00057
Neorhizobium sp. NCHU2750	1825976	S	2022	505	2527	0.00016
Neorhizobium sp. SOG26	2060726	S	1990	442	2432	0.00015
Pseudorhizobium banfieldiae	1125847	S	1411	824	2235	0.00014
Pseudorhizobium flavum	1335061	S	1409	913	2322	0.00015
Sinorhizobium meliloti	382	S	16291	12213	28504	0.00180
Sinorhizobium fredii	380	S	9502	13251	22753	0.00144
Sinorhizobium americanum	194963	S	3256	1312	4568	0.00029
Sinorhizobium sp. BG8	2613773	S	2616	475	3091	0.00020
Sinorhizobium sp. CCBAU 05631	794846	S	482	722	1204	0.00008
Sinorhizobium medicae	110321	S	2936	394	3330	0.00021
Ensifer adhaerens	106592	S	9994	4964	14958	0.00095
Ensifer mexicanus	375549	S	4107	688	4795	0.00030
Ensifer sp. PDNC004	2811423	S	2654	1166	3820	0.00024
Ensifer sp. T173	555315	S	446	1873	2319	0.00015
Ensifer alkalisoli	1752398	S	3046	643	3689	0.00023
Ensifer sojae	716925	S	2924	1154	4078	0.00026
Shinella sp. HZN7	879274	S	4271	3827	8098	0.00051
Shinella sp. PSBB067	2715959	S	3325	2628	5953	0.00038
Shinella sp. XGS7	2877941	S	2780	2636	5416	0.00034
Shinella sp. H4-D48	2925841	S	1379	580	1959	0.00012
Shinella zoogloeoides	352475	S	3352	5001	8353	0.00053
Shinella oryzae	2871820	S	1876	878	2754	0.00017
Ciceribacter thiooxidans	1969821	S	2739	601	3340	0.00021
Georhizobium profundi	2341112	S	2555	637	3192	0.00020
Peteryoungia desertarenae	1813451	S	874	170	1044	0.00007
Candidatus Liberibacter africanus	34020	S	48	20	68	0.00000
Candidatus Liberibacter asiaticus	34021	S	36	22	58	0.00000
Liberibacter crescens	1273132	S	23	153	176	0.00001
Candidatus Liberibacter americanus	309868	S	12	2	14	0.00000
Candidatus Liberibacter solanacearum	556287	S	12	1	13	0.00000
Mesorhizobium sp. 8	2584466	S	5442	1482	6924	0.00044
Mesorhizobium sp. DCY119	2108445	S	3674	980	4654	0.00029
Mesorhizobium sp. Pch-S	2082387	S	3392	528	3920	0.00025
Mesorhizobium sp. M1B.F.Ca.ET.045.04.1.1	2493673	S	3297	1404	4701	0.00030
Mesorhizobium sp. L-2-11	2744521	S	3146	1354	4500	0.00028
Mesorhizobium sp. J8	2777475	S	3126	1130	4256	0.00027
Mesorhizobium sp. M3A.F.Ca.ET.080.04.2.1	2493676	S	3084	1048	4132	0.00026
Mesorhizobium sp. M1D.F.Ca.ET.043.01.1.1	2493669	S	3056	2029	5085	0.00032
Mesorhizobium sp. B1-1-8	2589976	S	3000	850	3850	0.00024
Mesorhizobium sp. M1E.F.Ca.ET.045.02.1.1	2493672	S	2999	1661	4660	0.00029
Mesorhizobium sp. M1A.F.Ca.IN.022.06.1.1	2493680	S	2955	1052	4007	0.00025
Mesorhizobium sp. M9A.F.Ca.ET.002.03.1.2	2493668	S	2883	1464	4347	0.00027
Mesorhizobium sp. B2-1-1	2589974	S	2881	737	3618	0.00023
Mesorhizobium sp. 131-2-1	2744518	S	2851	1680	4531	0.00029
Mesorhizobium sp. B2-8-5	2589903	S	2695	1000	3695	0.00023
Mesorhizobium sp. INR15	2654248	S	2617	424	3041	0.00019
Mesorhizobium sp. M4B.F.Ca.ET.058.02.1.1	2493675	S	2592	1219	3811	0.00024
Mesorhizobium sp. M6A.T.Cr.TU.016.01.1.1	2493677	S	2564	957	3521	0.00022
Mesorhizobium sp. PAMC28654	2880934	S	2559	542	3101	0.00020
Mesorhizobium sp. B4-1-4	2589888	S	2101	570	2671	0.00017
Mesorhizobium sp. B2-1-8	2589967	S	2043	701	2744	0.00017
Mesorhizobium sp. M7D.F.Ca.US.005.01.1.1	2493678	S	1858	709	2567	0.00016
Mesorhizobium sp. M8A.F.Ca.ET.057.01.1.1	2493679	S	1731	733	2464	0.00016
Mesorhizobium sp. L-8-10	2744523	S	1657	5724	7381	0.00047
Mesorhizobium sp. M2A.F.Ca.ET.043.05.1.1	2493671	S	1654	1552	3206	0.00020
Mesorhizobium sp. NZP2077	2483404	S	1646	609	2255	0.00014
Mesorhizobium sp. M7A.F.Ce.TU.012.03.2.1	2493681	S	1632	668	2300	0.00015
Mesorhizobium sp. L-8-3	2744522	S	1555	5519	7074	0.00045
Mesorhizobium sp. 113-3-3	2744516	S	1500	920	2420	0.00015
Mesorhizobium sp. AA22	1854057	S	1469	1033	2502	0.00016
Mesorhizobium sp. NBSH29	2654249	S	1397	113	1510	0.00010
Mesorhizobium sp. 113-1-2	2744515	S	1395	765	2160	0.00014
Mesorhizobium sp. 113-3-9	2744517	S	1154	953	2107	0.00013
Mesorhizobium sp. NZP2298	2483403	S	1153	761	1914	0.00012
Mesorhizobium sp. M2A.F.Ca.ET.046.03.2.1	2493674	S	1016	2968	3984	0.00025
Mesorhizobium sp. M2A.F.Ca.ET.043.02.1.1	2493670	S	887	2465	3352	0.00021
Mesorhizobium sp. WSM1497	278153	S	368	822	1190	0.00008
Mesorhizobium sp. 131-3-5	2744520	S	257	880	1137	0.00007
Mesorhizobium sp. 131-2-5	2744519	S	244	1822	2066	0.00013
Mesorhizobium sp. NZP2234	2483402	S	165	653	818	0.00005
Mesorhizobium terrae	2725666	S	3639	1387	5026	0.00032
Mesorhizobium opportunistum	593909	S	3243	1536	4779	0.00030
Mesorhizobium amorphae	71433	S	2610	716	3326	0.00021
Mesorhizobium ciceri	39645	S	2180	5888	8068	0.00051
Mesorhizobium loti	381	S	1860	16712	18572	0.00117
Mesorhizobium australicum	536018	S	1718	603	2321	0.00015
Mesorhizobium erdmanii	1777866	S	1678	536	2214	0.00014
Mesorhizobium huakuii	28104	S	1616	1384	3000	0.00019
Mesorhizobium japonicum	2066070	S	1383	1141	2524	0.00016
Aquibium microcysteis	675281	S	7543	2434	9977	0.00063
Aquibium oceanicum	1670800	S	5629	1498	7127	0.00045
Aminobacter sp. MSH1	374606	S	3640	2433	6073	0.00038
Aminobacter sp. SR38	2774562	S	742	3292	4034	0.00025
Aminobacter sp. MDW-2	2666139	S	486	2431	2917	0.00018
Aminobacter aminovorans	83263	S	532	1897	2429	0.00015
Nitratireductor sp. SY7	2599600	S	4944	1065	6009	0.00038
Nitratireductor sp. OM-1	1756988	S	2324	430	2754	0.00017
Nitratireductor kimnyeongensis	430679	S	1510	229	1739	0.00011
Phyllobacterium sp. T1018	555316	S	1555	230	1785	0.00011
Phyllobacterium sp. 628	2718938	S	844	137	981	0.00006
Phyllobacterium sp. T1293	555317	S	681	97	778	0.00005
Phyllobacterium zundukense	1867719	S	1567	259	1826	0.00012
Roseitalea porphyridii	1852022	S	3866	754	4620	0.00029
Hoeflea phototrophica	244596	S	1514	200	1714	0.00011
Hoeflea sp. IMCC20628	1620421	S	1494	161	1655	0.00010
Oricola thermophila	2742145	S	3009	474	3483	0.00022
Salaquimonas pukyongi	2712698	S	1223	61	1284	0.00008
Lentilitoribacter sp. Alg239-R112	2305987	S	82	1	83	0.00001
Methylobacterium nodulans	114616	S	9496	1411	10907	0.00069
Methylobacterium sp. 17Sr1-1	2202826	S	4337	2328	6665	0.00042
Methylobacterium sp. WL1	2603276	S	4161	960	5121	0.00032
Methylobacterium sp. C1	1479019	S	513	4085	4598	0.00029
Methylobacterium sp. XJLW	739141	S	261	3563	3824	0.00024
Methylobacterium aquaticum	270351	S	8522	4228	12750	0.00081
Methylobacterium durans	2202825	S	6149	1027	7176	0.00045
Methylobacterium radiodurans	2202828	S	5664	1600	7264	0.00046
Methylobacterium currus	2051553	S	5565	2626	8191	0.00052
Methylobacterium organophilum	410	S	4573	2755	7328	0.00046
Methylobacterium terrae	2202827	S	4510	2357	6867	0.00043
Methylobacterium mesophilicum	39956	S	4096	960	5056	0.00032
Methylobacterium brachiatum	269660	S	3978	1591	5569	0.00035
Methylobacterium tardum	374432	S	3922	1526	5448	0.00034
Methylobacterium indicum	1775910	S	3758	2104	5862	0.00037
Methylobacterium oryzae	334852	S	3251	4471	7722	0.00049
Methylobacterium radiotolerans	31998	S	1433	8285	9718	0.00061
Methylobacterium phyllosphaerae	418223	S	581	2229	2810	0.00018
Microvirga sp. VF16	2807101	S	16607	2903	19510	0.00123
Microvirga sp. 17 mud 1-3	2082949	S	5752	1365	7117	0.00045
Microvirga ossetica	1882682	S	15116	2979	18095	0.00114
Microvirga thermotolerans	2651334	S	8009	2474	10483	0.00066
Methylorubrum populi	223967	S	7586	3758	11344	0.00072
Methylorubrum extorquens	408	S	5755	9839	15594	0.00099
Methylorubrum sp. B1-46	2897334	S	2734	1250	3984	0.00025
Methylorubrum zatmanii	29429	S	210	1098	1308	0.00008
Pseudolabrys taiwanensis	331696	S	12758	2551	15309	0.00097
Pseudolabrys sp. FHR47	2562284	S	9193	1961	11154	0.00070
Xanthobacter dioxanivorans	2528964	S	6909	2679	9588	0.00061
Xanthobacter sp. YC-JY1	2419844	S	2260	2565	4825	0.00030
Xanthobacter autotrophicus	280	S	2013	2462	4475	0.00028
Starkeya sp. ORNL1	2709380	S	7542	1789	9331	0.00059
Starkeya novella	921	S	6763	2930	9693	0.00061
Ancylobacter polymorphus	223390	S	4675	2601	7276	0.00046
Ancylobacter sp. TS-1	1850374	S	4673	2242	6915	0.00044
Ancylobacter pratisalsi	1745854	S	3862	1018	4880	0.00031
Labrys sp. KNU-23	2789216	S	4996	603	5599	0.00035
Azorhizobium caulinodans	7	S	4846	1193	6039	0.00038
Rhodoplanes sp. Z2-YC6860	674703	S	28675	3351	32026	0.00202
Hyphomicrobium denitrificans	53399	S	6602	971	7573	0.00048
Hyphomicrobium nitrativorans	1427356	S	6246	639	6885	0.00044
Hyphomicrobium sp. MC1	717785	S	3187	296	3483	0.00022
Methyloceanibacter caenitepidi	1384459	S	3367	769	4136	0.00026
Methyloceanibacter sp. wino2	2170729	S	3188	776	3964	0.00025
Methyloligella sp. GL2	2742204	S	4551	647	5198	0.00033
Aquabacter sp. L1I39	2820278	S	4068	811	4879	0.00031
Rhodomicrobium vannielii	1069	S	3473	275	3748	0.00024
Caenibius sp. WL	2872646	S	1469	298	1767	0.00011
Caenibius tardaugens	169176	S	1014	866	1880	0.00012
Candidatus Filomicrobium marinum	1608628	S	1680	57	1737	0.00011
Bosea sp. Tri-49	1867715	S	7901	2054	9955	0.00063
Bosea sp. RAC05	1842539	S	6194	2260	8454	0.00053
Bosea sp. F3-2	2599640	S	5961	2135	8096	0.00051
Bosea sp. AS-1	2015316	S	5006	1769	6775	0.00043
Bosea sp. ANAM02	2020412	S	4925	2043	6968	0.00044
Bosea sp. PAMC 26642	1792307	S	4563	1087	5650	0.00036
Bosea vaviloviae	1526658	S	5234	1411	6645	0.00042
Devosia sp. A16	1736675	S	7008	921	7929	0.00050
Devosia sp. SL43	2806348	S	2361	440	2801	0.00018
Devosia sp. JXJ CY 41	2917991	S	2305	427	2732	0.00017
Devosia sp. 1566	2499144	S	2230	251	2481	0.00016
Devosia sp. I507	2083786	S	1743	523	2266	0.00014
Devosia sp. MC521	2759954	S	830	136	966	0.00006
Devosia ginsengisoli	400770	S	3038	572	3610	0.00023
Devosia salina	2860336	S	2525	843	3368	0.00021
Devosia beringensis	2657486	S	2406	369	2775	0.00018
Devosia oryziradicis	2801335	S	2356	446	2802	0.00018
Devosia rhizoryzae	2774137	S	2008	227	2235	0.00014
Youhaiella tibetensis	1447062	S	3574	812	4386	0.00028
Paradevosia shaoguanensis	1335043	S	3301	1266	4567	0.00029
Pelagibacterium halotolerans	531813	S	1812	259	2071	0.00013
Maritalea myrionectae	454601	S	416	15	431	0.00003
Aureimonas sp. SA4125	2826993	S	4663	1006	5669	0.00036
Aureimonas sp. AU20	1349819	S	4128	691	4819	0.00030
Aureimonas sp. OT7	2816454	S	2070	1887	3957	0.00025
Aureimonas populi	1701758	S	3802	851	4653	0.00029
Aureimonas mangrovi	2758041	S	3323	807	4130	0.00026
Aureimonas altamirensis	370622	S	1962	750	2712	0.00017
Martelella sp. AD-3	686597	S	1122	3471	4593	0.00029
Martelella mediterranea	293089	S	2120	872	2992	0.00019
Martelella endophytica	1486262	S	1899	488	2387	0.00015
Martelella lutilitoris	2583532	S	1243	1142	2385	0.00015
Aurantimonas sp. HBX-1	2906072	S	6172	2146	8318	0.00053
Nordella sp. HKS 07	2712222	S	13582	884	14466	0.00091
Pseudorhodoplanes sinuspersici	1235591	S	9929	875	10804	0.00068
Terrihabitans soli	708113	S	4531	606	5137	0.00032
Candidatus Hodgkinia cicadicola	573658	S	63	1	64	0.00000
Methylocystis bryophila	655015	S	3224	368	3592	0.00023
Methylocystis parvus	134	S	3171	424	3595	0.00023
Methylocystis heyeri	391905	S	2936	369	3305	0.00021
Methylocystis sp. SC2	187303	S	1950	536	2486	0.00016
Methylocystis sp. SB2	743836	S	755	1184	1939	0.00012
Methylocystis rosea	173366	S	2308	1769	4077	0.00026
Methylosinus trichosporium	426	S	4294	963	5257	0.00033
Methylosinus sp. C49	2699395	S	3479	766	4245	0.00027
Stappia indica	538381	S	6133	1700	7833	0.00050
Stappia sp. ES.058	1881061	S	3112	453	3565	0.00023
Roseibium aggregatum	187304	S	3314	526	3840	0.00024
Roseibium alexandrii	388408	S	909	92	1001	0.00006
Pannonibacter phragmitetus	121719	S	3958	3192	7150	0.00045
Labrenzia sp. VG12	2021862	S	1905	250	2155	0.00014
Labrenzia sp. PHM005	2590016	S	853	73	926	0.00006
Labrenzia sp. THAF82	2587861	S	708	48	756	0.00005
Pseudovibrio sp. FO-BEG1	911045	S	306	149	455	0.00003
Pseudovibrio brasiliensis	1898042	S	294	140	434	0.00003
Phreatobacter stygius	1940610	S	7904	1376	9280	0.00059
Phreatobacter cathodiphilus	1868589	S	7448	2541	9989	0.00063
Phreatobacter sp. NMCR1094	2570229	S	4939	1072	6011	0.00038
Kaustia mangrovi	2593653	S	9391	1065	10456	0.00066
Parvibaculum lavamentivorans	256618	S	3990	2825	6815	0.00043
Pyruvatibacter mobilis	1712261	S	2636	367	3003	0.00019
Candidatus Phaeomarinobacter ectocarpi	1458461	S	1009	56	1065	0.00007
Chelatococcus sp. CO-6	1702325	S	6741	4486	11227	0.00071
Chelatococcus daeguensis	444444	S	3638	2369	6007	0.00038
Blastochloris tepida	2233851	S	6460	2508	8968	0.00057
Blastochloris viridis	1079	S	5435	1679	7114	0.00045
Methylocella silvestris	199596	S	3123	399	3522	0.00022
Methylocella tundrae	227605	S	2736	294	3030	0.00019
Methylovirgula ligni	569860	S	2610	365	2975	0.00019
Methylovirgula sp. HY1	2822761	S	2033	139	2172	0.00014
Beijerinckia indica	533	S	1385	119	1504	0.00010
Acuticoccus sp. I52.16.1	2928472	S	7933	990	8923	0.00056
Brucella anthropi	529	S	1582	1085	2667	0.00017
Brucella intermedia	94625	S	1401	284	1685	0.00011
Brucella sp. BTU1	2840456	S	199	43	242	0.00002
Brucella sp. 10RB9215	1149953	S	89	103	192	0.00001
Brucella sp. 09RB8910	1844051	S	56	63	119	0.00001
Brucella sp. 6810	2769351	S	50	86	136	0.00001
Brucella sp. BO3	2691913	S	46	80	126	0.00001
Brucella sp. 2280	2592625	S	44	92	136	0.00001
Brucella sp. 09RB8471	1149952	S	40	78	118	0.00001
Brucella sp. BO2	693750	S	36	86	122	0.00001
Brucella sp. 458	2821140	S	31	73	104	0.00001
[Ochrobactrum] quorumnocens	271865	S	502	87	589	0.00004
Brucella pseudogrignonensis	419475	S	329	120	449	0.00003
Brucella pituitosa	571256	S	159	65	224	0.00001
Brucella melitensis	29459	S	55	2174	2229	0.00014
Brucella inopinata	1218315	S	42	52	94	0.00001
Brucella ovis	236	S	13	43	56	0.00000
Brucella suis	29461	S	13	297	310	0.00002
Brucella pinnipedialis	120576	S	12	256	268	0.00002
Brucella abortus	235	S	11	394	405	0.00003
Brucella ceti	120577	S	11	161	172	0.00001
Pseudochrobactrum sp. Wa41.01b-1	2864102	S	118	122	240	0.00002
Pseudochrobactrum sp. XF203	2879116	S	115	109	224	0.00001
Pseudochrobactrum algeriensis	2834768	S	132	137	269	0.00002
Kaistia sp. 32K	2795690	S	7279	2128	9407	0.00059
Hartmannibacter diazotrophicus	1482074	S	4655	988	5643	0.00036
Breoghania sp. L-A4	2304600	S	4654	716	5370	0.00034
Lichenihabitans psoromatis	2528642	S	1385	809	2194	0.00014
Lichenihabitans sp. PAMC28606	2880932	S	1214	823	2037	0.00013
Cohaesibacter sp. ES.047	1798205	S	883	40	923	0.00006
Bartonella apis	1686310	S	263	17	280	0.00002
Bartonella sp. HY038	2759660	S	77	13	90	0.00001
Bartonella sp. 46A	2893471	S	19	15	34	0.00000
Bartonella sp. WD16.2	1933904	S	10	20	30	0.00000
Bartonella australis	388640	S	36	5	41	0.00000
Bartonella quintana	803	S	23	7	30	0.00000
Bartonella vinsonii	33047	S	23	17	40	0.00000
Bartonella birtlesii	111504	S	20	8	28	0.00000
Bartonella bacilliformis	774	S	19	3	22	0.00000
Bartonella alsatica	52764	S	18	5	23	0.00000
Bartonella henselae	38323	S	15	5	20	0.00000
Bartonella ancashensis	1318743	S	15	2	17	0.00000
Bartonella grahamii	33045	S	11	9	20	0.00000
Bartonella tribocorum	85701	S	10	36	46	0.00000
Sphingomonas sp. S8-45	2938948	S	11364	1438	12802	0.00081
Sphingomonas sp. HDW15A	2714942	S	10159	859	11018	0.00070
Sphingomonas sp. DM2-R-LB4	2899123	S	9378	3307	12685	0.00080
Sphingomonas sp. MM-1	745310	S	6386	8091	14477	0.00091
Sphingomonas sp. CL5.1	2653203	S	6022	2083	8105	0.00051
Sphingomonas sp. AK-PDB1-5	2872652	S	5799	975	6774	0.00043
Sphingomonas sp. Cra20	1327635	S	5785	952	6737	0.00043
Sphingomonas sp. AP4-R1	2735134	S	5123	680	5803	0.00037
Sphingomonas sp. LM7	1938607	S	4930	1122	6052	0.00038
Sphingomonas sp. NBWT7	2596913	S	4371	1477	5848	0.00037
Sphingomonas sp. S2-65	2903960	S	4244	883	5127	0.00032
Sphingomonas sp. AAP5	1523415	S	4154	1121	5275	0.00033
Sphingomonas sp. FARSPH	2219696	S	3958	3345	7303	0.00046
Sphingomonas sp. PAMC26645	2565555	S	3265	1138	4403	0.00028
Sphingomonas sp. KC8	1030157	S	3230	430	3660	0.00023
Sphingomonas sp. HMP9	1517554	S	3203	1486	4689	0.00030
Sphingomonas sp. HMP6	1517551	S	2619	538	3157	0.00020
Sphingomonas sp. LK11	1390395	S	2047	2106	4153	0.00026
Sphingomonas sp. NIC1	1961362	S	1764	5592	7356	0.00046
Sphingomonas sp. IC081	304378	S	658	3969	4627	0.00029
Sphingomonas lutea	1045317	S	21709	2935	24644	0.00156
Sphingomonas sediminicola	386874	S	20749	2072	22821	0.00144
Sphingomonas daechungensis	1176646	S	18443	1857	20300	0.00128
Sphingomonas sabuli	2764186	S	15350	1972	17322	0.00109
Sphingomonas ginsengisoli An et al. 2013	363835	S	15221	2164	17385	0.00110
Sphingomonas xanthus	2594473	S	14553	3261	17814	0.00113
Sphingomonas sinipercae	2714944	S	14098	1980	16078	0.00102
Sphingomonas rhizophila	2071607	S	13962	3599	17561	0.00111
Sphingomonas piscis	2714943	S	10090	976	11066	0.00070
Sphingomonas koreensis	93064	S	7545	5683	13228	0.00084
Sphingomonas profundi	2681549	S	7544	1246	8790	0.00056
Sphingomonas alpina	653931	S	7131	611	7742	0.00049
Sphingomonas sanxanigenens	397260	S	6676	3240	9916	0.00063
Sphingomonas changnyeongensis	2698679	S	5086	1031	6117	0.00039
Sphingomonas hengshuiensis	1609977	S	4631	619	5250	0.00033
Sphingomonas taxi	1549858	S	4477	1431	5908	0.00037
Sphingomonas panacis	1560345	S	4330	657	4987	0.00032
Sphingomonas suaedae	2599297	S	4151	551	4702	0.00030
Sphingomonas panacisoli	1813879	S	3842	535	4377	0.00028
Sphingomonas radiodurans	2890321	S	3749	513	4262	0.00027
Sphingomonas insulae	424800	S	3115	914	4029	0.00025
Sphingomonas aliaeris	2759526	S	2926	379	3305	0.00021
Sphingomonas paucimobilis	13689	S	2798	1842	4640	0.00029
Sphingomonas sanguinis	33051	S	2048	1842	3890	0.00025
Sphingomonas melonis	152682	S	1933	7237	9170	0.00058
Sphingomonas lacunae	2698828	S	1583	229	1812	0.00011
Sphingomonas paeninsulae	2319844	S	1254	58	1312	0.00008
Sphingobium sp. Cam5-1	2789327	S	11137	3800	14937	0.00094
Sphingobium sp. SYK-6	627192	S	3917	1059	4976	0.00031
Sphingobium sp. EP60837	1855519	S	3040	840	3880	0.00025
Sphingobium sp. TKS	1315974	S	2609	3739	6348	0.00040
Sphingobium sp. CAP-1	2676077	S	2304	1393	3697	0.00023
Sphingobium sp. YG1	2082188	S	2255	949	3204	0.00020
Sphingobium sp. RAC03	1843368	S	1989	367	2356	0.00015
Sphingobium sp. SCG-1	2072936	S	1981	157	2138	0.00014
Sphingobium sp. MI1205	407020	S	1908	2616	4524	0.00029
Sphingobium sp. KCTC 72723	2733867	S	1547	272	1819	0.00011
Sphingobium sp. PAMC28499	2565554	S	535	1011	1546	0.00010
Sphingobium sp. RSMS	520734	S	351	1885	2236	0.00014
Sphingobium sp. YBL2	484429	S	311	1849	2160	0.00014
Sphingobium sp. LF-16	2185111	S	71	1090	1161	0.00007
Sphingobium yanoikuyae	13690	S	3806	7047	10853	0.00069
Sphingobium indicum	332055	S	2905	2130	5035	0.00032
Sphingobium phenoxybenzoativorans	1592790	S	2533	1064	3597	0.00023
Sphingobium amiense	135719	S	2506	3127	5633	0.00036
Sphingobium cloacae	120107	S	2277	3346	5623	0.00036
Sphingobium chlorophenolicum	46429	S	2246	1031	3277	0.00021
Sphingobium herbicidovorans	76947	S	2155	1886	4041	0.00026
Sphingobium xenophagum	121428	S	2151	1401	3552	0.00022
Sphingobium baderi	1332080	S	1901	1913	3814	0.00024
Sphingobium fuliginis	336203	S	956	3577	4533	0.00029
Sphingopyxis sp. PAMC25046	2565556	S	4660	2167	6827	0.00043
Sphingopyxis sp. QXT-31	1357916	S	3712	1080	4792	0.00030
Sphingopyxis sp. YF1	2482763	S	3543	854	4397	0.00028
Sphingopyxis sp. OPL5	2486273	S	3342	668	4010	0.00025
Sphingopyxis sp. 113P3	292913	S	2974	1173	4147	0.00026
Sphingopyxis sp. FD7	1914525	S	2880	1223	4103	0.00026
Sphingopyxis sp. BSN-002	2911495	S	2814	529	3343	0.00021
Sphingopyxis sp. EG6	1874061	S	2539	1294	3833	0.00024
Sphingopyxis sp. MG	1866325	S	126	1155	1281	0.00008
Sphingopyxis macrogoltabida	33050	S	5594	2791	8385	0.00053
Sphingopyxis terrae	33052	S	3327	1835	5162	0.00033
Sphingopyxis lindanitolerans	2054227	S	2798	1335	4133	0.00026
Sphingopyxis fribergensis	1515612	S	2726	1085	3811	0.00024
Sphingopyxis granuli	267128	S	2570	7035	9605	0.00061
Sphingopyxis alaskensis	117207	S	2567	602	3169	0.00020
Novosphingobium sp. Gsoil 351	2675225	S	4422	399	4821	0.00030
Novosphingobium sp. Sx8-5	2896849	S	4270	628	4898	0.00031
Novosphingobium sp. EMRT-2	2571749	S	3537	2112	5649	0.00036
Novosphingobium sp. P6W	1609758	S	3207	564	3771	0.00024
Novosphingobium sp. ES2-1	2780074	S	2193	1187	3380	0.00021
Novosphingobium sp. THN1	1016987	S	2059	777	2836	0.00018
Novosphingobium sp. PP1Y	702113	S	1573	2016	3589	0.00023
Novosphingobium sp. KA1	164608	S	786	3862	4648	0.00029
Novosphingobium resinovorum	158500	S	3947	1983	5930	0.00037
Novosphingobium decolorationis	2698673	S	3094	1704	4798	0.00030
Novosphingobium aromaticivorans	48935	S	3067	1463	4530	0.00029
Novosphingobium ginsenosidimutans	1176536	S	2425	263	2688	0.00017
Novosphingobium pentaromativorans	205844	S	1425	2654	4079	0.00026
Rhizorhabdus wittichii	160791	S	8262	4954	13216	0.00084
Rhizorhabdus dicambivorans	1850238	S	5170	4324	9494	0.00060
Rhizorhabdus phycosphaerae	2711156	S	3774	496	4270	0.00027
Allosphingosinicella indica	941907	S	9912	1269	11181	0.00071
Sphingosinithalassobacter sp. CS137	2762748	S	4351	922	5273	0.00033
Sphingosinithalassobacter tenebrarum	2711215	S	3152	999	4151	0.00026
Parasphingopyxis algicola	2026624	S	4016	283	4299	0.00027
Parasphingopyxis sp. CP4	2724527	S	1171	58	1229	0.00008
Sphingorhabdus sp. YGSMI21	2077182	S	1228	213	1441	0.00009
Sphingorhabdus sp. SMR4y	2584094	S	1038	185	1223	0.00008
Sphingorhabdus sp. M41	1806885	S	920	124	1044	0.00007
Sphingorhabdus lacus	392610	S	758	36	794	0.00005
Sphingorhabdus lutea	1913578	S	123	10	133	0.00001
Blastomonas sp. RAC04	1842535	S	882	1333	2215	0.00014
Blastomonas fulva	1550728	S	767	1497	2264	0.00014
Hankyongella ginsenosidimutans	1763828	S	3406	675	4081	0.00026
Tardibacter chloracetimidivorans	1921510	S	2723	2137	4860	0.00031
Citromicrobium sp. JL477	1634516	S	2260	1062	3322	0.00021
Novosphingopyxis iocasae	2762729	S	1938	1105	3043	0.00019
Parasphingorhabdus halotolerans	2725558	S	455	19	474	0.00003
Parasphingorhabdus litoris	394733	S	415	30	445	0.00003
Parasphingorhabdus sp. JHSY0214	2806553	S	391	27	418	0.00003
Aquisediminimonas profunda	1550733	S	1088	45	1133	0.00007
Erythrobacter sp. HL-111	1798193	S	2975	587	3562	0.00023
Erythrobacter sp. JK5	2829500	S	2166	667	2833	0.00018
Erythrobacter sp. HKB08	2502843	S	2162	485	2647	0.00017
Erythrobacter sp. SDW2	2907154	S	2161	586	2747	0.00017
Erythrobacter sp. THAF29	2587851	S	1341	320	1661	0.00010
Erythrobacter sp. 3-20A1M	2653850	S	1064	1666	2730	0.00017
Erythrobacter sp. LQ02-29	2920384	S	1051	1171	2222	0.00014
Erythrobacter sp. KY5	2011159	S	1001	82	1083	0.00007
Erythrobacter sp. A30-3	2785907	S	985	786	1771	0.00011
Erythrobacter sp. SCSIO 43205	2779361	S	525	102	627	0.00004
Erythrobacter litoralis	39960	S	3627	1571	5198	0.00033
Erythrobacter neustonensis	1112	S	1610	386	1996	0.00013
Erythrobacter mangrovi	2739433	S	1594	588	2182	0.00014
Erythrobacter aureus	2182384	S	1235	233	1468	0.00009
Porphyrobacter sp. CACIAM 03H1	2003315	S	3031	929	3960	0.00025
Porphyrobacter sp. HT-58-2	2023229	S	1585	397	1982	0.00013
Porphyrobacter sp. GA68	2883480	S	1570	695	2265	0.00014
Porphyrobacter sp. LM 6	1896196	S	1529	565	2094	0.00013
Qipengyuania flava	192812	S	4262	2437	6699	0.00042
Qipengyuania sediminis	1532023	S	2632	397	3029	0.00019
Qipengyuania soli	2782568	S	1809	345	2154	0.00014
Qipengyuania aurantiaca	2867233	S	1522	519	2041	0.00013
Qipengyuania gelatinilytica	2867231	S	1221	238	1459	0.00009
Qipengyuania seohaensis	266951	S	1064	232	1296	0.00008
Qipengyuania psychrotolerans	2867238	S	848	115	963	0.00006
Qipengyuania aquimaris	255984	S	820	837	1657	0.00010
Qipengyuania xiapuensis	2867236	S	799	806	1605	0.00010
Altererythrobacter sp. B11	2060312	S	3491	1695	5186	0.00033
Altererythrobacter sp. TH136	2067415	S	2390	467	2857	0.00018
Altererythrobacter sp. BO-6	2604537	S	1460	240	1700	0.00011
Altererythrobacter sp. ZODW24	2185142	S	619	32	651	0.00004
Altererythrobacter epoxidivorans	361183	S	1164	341	1505	0.00010
Altererythrobacter ishigakiensis	476157	S	441	35	476	0.00003
Tsuneonella amylolytica	2338327	S	3105	933	4038	0.00026
Tsuneonella dongtanensis	692370	S	3030	634	3664	0.00023
Tsuneonella mangrovi	1982042	S	2119	338	2457	0.00016
Tsuneonella flava	2055955	S	948	290	1238	0.00008
Croceicoccus sp. YJ47	2798724	S	1918	1100	3018	0.00019
Croceicoccus sp. Ery5	1703340	S	705	805	1510	0.00010
Croceicoccus sp. Ery15	1703338	S	526	867	1393	0.00009
Croceicoccus marinus	450378	S	3356	1828	5184	0.00033
Croceicoccus naphthovorans	1348774	S	1431	1724	3155	0.00020
Aurantiacibacter gangjinensis	502682	S	1322	135	1457	0.00009
Aurantiacibacter atlanticus	1648404	S	588	197	785	0.00005
Pelagerythrobacter marensis	543877	S	1831	267	2098	0.00013
Paraurantiacibacter namhicola	645517	S	1714	234	1948	0.00012
Croceibacterium atlanticum	1267766	S	1686	737	2423	0.00015
Sphingosinicella sp. BN140058	1892855	S	9590	926	10516	0.00066
Sphingosinicella flava	2771430	S	4717	723	5440	0.00034
Sphingosinicella microcystinivorans	335406	S	3403	454	3857	0.00024
Polymorphobacter sp. PAMC 29362	2835787	S	1949	1335	3284	0.00021
Polymorphobacter sp. PAMC 29334	2862331	S	1905	1346	3251	0.00021
Sandaracinobacter sp. M6	2759707	S	3046	226	3272	0.00021
Zymomonas mobilis	542	S	199	134	333	0.00002
Azospirillum sp. B510	137722	S	4192	1607	5799	0.00037
Azospirillum sp. TSH100	652764	S	3363	1586	4949	0.00031
Azospirillum sp. TSA2s	709810	S	3277	2552	5829	0.00037
Azospirillum sp. TSH58	664962	S	2738	3701	6439	0.00041
Azospirillum brasilense	192	S	13881	12359	26240	0.00166
Azospirillum thermophilum	2202148	S	10226	2395	12621	0.00080
Azospirillum thiophilum	528244	S	5303	1772	7075	0.00045
Azospirillum ramasamyi	682998	S	3251	1908	5159	0.00033
Azospirillum lipoferum	193	S	2531	1901	4432	0.00028
Azospirillum humicireducens	1226968	S	2492	1482	3974	0.00025
Azospirillum oryzae	286727	S	2353	2069	4422	0.00028
Azospirillum baldaniorum	1064539	S	1638	3370	5008	0.00032
Skermanella mucosa	1789672	S	6156	4326	10482	0.00066
Skermanella sp. TT6	2775420	S	5665	5913	11578	0.00073
Skermanella rosea	1817965	S	5520	5069	10589	0.00067
Skermanella pratensis	2233999	S	4989	2802	7791	0.00049
Nitrospirillum amazonense	28077	S	5918	723	6641	0.00042
Indioceanicola profundi	2220096	S	5181	755	5936	0.00038
Niveispirillum cyanobacteriorum	1612173	S	2560	291	2851	0.00018
Roseomonas sp. OT10	2897332	S	9822	2463	12285	0.00078
Roseomonas sp. S08	1750527	S	9148	579	9727	0.00061
Roseomonas sp. FDAARGOS_362	2018065	S	656	3473	4129	0.00026
Roseomonas gilardii	257708	S	6968	3229	10197	0.00064
Roseomonas haemaphysalidis	2768162	S	5975	691	6666	0.00042
Roseomonas marmotae	2768161	S	5288	606	5894	0.00037
Roseomonas mucosa	207340	S	578	3565	4143	0.00026
Rhodovastum atsumiense	504468	S	8322	844	9166	0.00058
Komagataeibacter xylinus	28448	S	1724	2877	4601	0.00029
Komagataeibacter saccharivorans	265959	S	713	249	962	0.00006
Komagataeibacter europaeus	33995	S	524	255	779	0.00005
Komagataeibacter nataicola	265960	S	507	225	732	0.00005
Komagataeibacter oboediens	65958	S	475	226	701	0.00004
Komagataeibacter medellinensis	1177712	S	438	349	787	0.00005
Komagataeibacter rhaeticus	215221	S	33	534	567	0.00004
Roseococcus microcysteis	2771361	S	6145	569	6714	0.00042
Acidiphilium multivorum	62140	S	1244	5255	6499	0.00041
Acidiphilium cryptum	524	S	282	1800	2082	0.00013
Sediminicoccus rosea	1225128	S	4189	214	4403	0.00028
Acidibrevibacterium fodinaquatile	1969806	S	3850	340	4190	0.00026
Lichenicola cladoniae	1484109	S	3598	175	3773	0.00024
Acetobacter aceti	435	S	1492	529	2021	0.00013
Acetobacter sp. KACC 21233	2592655	S	345	71	416	0.00003
Acetobacter persici	1076596	S	341	47	388	0.00002
Acetobacter ghanensis	431306	S	224	55	279	0.00002
Acetobacter pasteurianus	438	S	149	341	490	0.00003
Acetobacter orientalis	146474	S	110	15	125	0.00001
Acetobacter tropicalis	104102	S	93	99	192	0.00001
Acetobacter ascendens	481146	S	90	101	191	0.00001
Acetobacter senegalensis	446692	S	67	77	144	0.00001
Acetobacter oryzoeni	2500548	S	28	51	79	0.00001
Acetobacter oryzifermentans	1633874	S	16	154	170	0.00001
Gluconobacter oxydans	442	S	922	902	1824	0.00012
Gluconobacter albidus	318683	S	452	79	531	0.00003
Gluconobacter sphaericus	574987	S	310	70	380	0.00002
Gluconobacter frateurii	38308	S	214	54	268	0.00002
Gluconobacter thailandicus	257438	S	81	56	137	0.00001
Gluconacetobacter diazotrophicus	33996	S	2411	497	2908	0.00018
Granulibacter bethesdensis	364410	S	1528	141	1669	0.00011
Asaia bogorensis	91915	S	1010	176	1186	0.00007
Neoasaia chiangmaiensis	320497	S	1000	200	1200	0.00008
Kozakia baliensis	153496	S	640	221	861	0.00005
Novacetimonas hansenii	436	S	610	277	887	0.00006
Oecophyllibacter saccharovorans	2558360	S	557	19	576	0.00004
Parasaccharibacter sp. TMW 2.1888	2268025	S	35	192	227	0.00001
Parasaccharibacter apium	1510841	S	20	105	125	0.00001
Swingsia sp. F3b2	2558361	S	232	6	238	0.00002
Swingsia samuiensis	1293412	S	31	5	36	0.00000
Neokomagataea tanensis	661191	S	118	19	137	0.00001
Entomobacter blattae	2762277	S	98	7	105	0.00001
Bombella sp. KACC 21507	2697033	S	36	4	40	0.00000
Hypericibacter adhaerens	2602016	S	15549	3103	18652	0.00118
Hypericibacter terrae	2602015	S	12058	1929	13987	0.00088
Magnetospirillum sp. XM-1	1663591	S	3175	1067	4242	0.00027
Magnetospirillum sp. ME-1	1639348	S	2770	1011	3781	0.00024
Magnetospirillum gryphiswaldense	55518	S	3659	306610	310269	0.01961
Magnetospirillum magneticum	84159	S	3266	355	3621	0.00023
Ferrovibrio terrae	2594003	S	10207	664	10871	0.00069
Rhodospirillum centenum	34018	S	6825	989	7814	0.00049
Rhodospirillum rubrum	1085	S	3262	251	3513	0.00022
Tistrella mobilis	171437	S	6568	2858	9426	0.00060
Defluviicoccus vanus	111831	S	3607	334	3941	0.00025
Pararhodospirillum photometricum	1084	S	2131	168	2299	0.00015
Haematospirillum jordaniae	1549855	S	376	33	409	0.00003
Candidatus Endolissoclinum faulkneri	1263979	S	182	2	184	0.00001
Stella humosa	94	S	15863	1129	16992	0.00107
Elioraea tepida	2843330	S	6788	355	7143	0.00045
Thalassospira sp. A40-3	2785908	S	336	136	472	0.00003
Thalassospira sp. B30-1	2785911	S	198	298	496	0.00003
Thalassospira marina	2048283	S	516	35	551	0.00003
Thalassospira indica	1891279	S	373	232	605	0.00004
Thalassospira xiamenensis	220697	S	246	350	596	0.00004
Magnetospira sp. QH-2	1288970	S	1484	51	1535	0.00010
Terasakiella sp. SH-1	2560057	S	183	4	187	0.00001
Paracoccus sp. MC1862	2760307	S	1997	228	2225	0.00014
Paracoccus sp. MA	2895796	S	1767	1001	2768	0.00017
Paracoccus sp. AK26	2589076	S	1723	318	2041	0.00013
Paracoccus sp. H4-D09	2812658	S	1056	236	1292	0.00008
Paracoccus sp. S8-55	2903900	S	977	144	1121	0.00007
Paracoccus sp. Arc7-R13	2500532	S	693	753	1446	0.00009
Paracoccus sanguinis	1545044	S	3133	867	4000	0.00025
Paracoccus liaowanqingii	2560053	S	2236	269	2505	0.00016
Paracoccus yeei	147645	S	2193	3617	5810	0.00037
Paracoccus denitrificans	266	S	1984	1392	3376	0.00021
Paracoccus aminovorans	34004	S	1899	575	2474	0.00016
Paracoccus suum	2259340	S	1889	359	2248	0.00014
Paracoccus zhejiangensis	1077935	S	1849	467	2316	0.00015
Paracoccus pantotrophus	82367	S	1823	1093	2916	0.00018
Paracoccus jeotgali	2065379	S	1725	348	2073	0.00013
Paracoccus contaminans	1945662	S	1598	382	1980	0.00013
Paracoccus aminophilus	34003	S	1448	150	1598	0.00010
Paracoccus tegillarcae	1529068	S	896	56	952	0.00006
Paracoccus kondratievae	135740	S	784	161	945	0.00006
Paracoccus marcusii	59779	S	714	682	1396	0.00009
Paracoccus mutanolyticus	1499308	S	227	806	1033	0.00007
Cereibacter sphaeroides	1063	S	6721	2965	9686	0.00061
Cereibacter azotoformans	43057	S	721	2517	3238	0.00020
Rhodobacter sp. CZR27	2033869	S	2852	946	3798	0.00024
Rhodobacter sp. LPB0142	1850250	S	2188	1584	3772	0.00024
Rhodobacter sp. N10	2807096	S	2154	270	2424	0.00015
Rhodobacter capsulatus	1061	S	2640	570	3210	0.00020
Rhodovulum sp. P5	1564506	S	1510	170	1680	0.00011
Rhodovulum sp. MB263	308754	S	1361	567	1928	0.00012
Rhodovulum sulfidophilum	35806	S	2073	1310	3383	0.00021
Polymorphum gilvum	991904	S	5071	1314	6385	0.00040
Paroceanicella profunda	2579971	S	4765	1287	6052	0.00038
Pikeienuella piscinae	2748098	S	3403	342	3745	0.00024
Pontivivens ytuae	2789856	S	3082	246	3328	0.00021
Thioclava electrotropha	1549850	S	1394	351	1745	0.00011
Thioclava nitratireducens	1915078	S	1262	433	1695	0.00011
Silicimonas algicola	1826607	S	2917	183	3100	0.00020
Pelagovum pacificum	2588711	S	2547	334	2881	0.00018
Frigidibacter mobilis	1335048	S	2203	954	3157	0.00020
Pukyongiella litopenaei	2605946	S	2018	498	2516	0.00016
Brevirhabdus pacifica	1267768	S	1862	890	2752	0.00017
Fuscovulum blasticum	1075	S	1578	211	1789	0.00011
Gymnodinialimonas ceratoperidinii	2856823	S	1542	153	1695	0.00011
Haematobacter massiliensis	195105	S	1486	622	2108	0.00013
Falsirhodobacter sp. PG104	2692330	S	1336	202	1538	0.00010
Tabrizicola piscis	2494374	S	1290	123	1413	0.00009
Gemmobacter aquarius	2169400	S	1261	268	1529	0.00010
Pseudopuniceibacterium antarcticum	2613965	S	1233	101	1334	0.00008
Pacificitalea manganoxidans	1411902	S	1218	276	1494	0.00009
Pseudooceanicola algae	1537215	S	1164	120	1284	0.00008
Monaibacterium sp. h42	2758038	S	1139	272	1411	0.00009
Roseicitreum antarcticum	564137	S	905	49	954	0.00006
Tritonibacter mobilis	379347	S	835	380	1215	0.00008
Yoonia vestfoldensis	245188	S	690	159	849	0.00005
Qingshengfaniella alkalisoli	2599296	S	668	38	706	0.00004
Rhodophyticola sp. CCM32	2916397	S	635	19	654	0.00004
Pseudohalocynthiibacter aestuariivivens	1591409	S	607	124	731	0.00005
Profundibacter amoris	2171755	S	510	18	528	0.00003
Rhodobaca barguzinensis	441209	S	497	23	520	0.00003
Pseudorhodobacter turbinis	2500533	S	437	29	466	0.00003
Parasedimentitalea marina	2483033	S	392	19	411	0.00003
Cognatishimia activa	1715691	S	392	18	410	0.00003
Aestuarium zhoushanense	2820523	S	338	140	478	0.00003
Planktomarina temperata	1284658	S	208	5	213	0.00001
Roseovarius sp. SCSIO 43702	2823043	S	2249	178	2427	0.00015
Roseovarius sp. THAF9	2587847	S	1108	264	1372	0.00009
Roseovarius sp. THAF8	2587846	S	477	710	1187	0.00008
Roseovarius sp. THAF27	2587850	S	465	742	1207	0.00008
Roseovarius sp. TM1035	391613	S	204	411	615	0.00004
Roseovarius indicus	540747	S	2802	871	3673	0.00023
Roseovarius faecimaris	2494550	S	1135	49	1184	0.00007
Roseovarius mucosus	215743	S	203	412	615	0.00004
Sulfitobacter sp. JK7-1	2829501	S	1132	62	1194	0.00008
Sulfitobacter sp. THAF37	2587855	S	1076	444	1520	0.00010
Sulfitobacter sp. JL08	2070369	S	541	12	553	0.00003
Sulfitobacter sp. D7	1968541	S	513	191	704	0.00004
Sulfitobacter sp. SK011	1389004	S	461	11	472	0.00003
Sulfitobacter sp. DSM 110093	2883127	S	375	109	484	0.00003
Sulfitobacter sp. BSw21498	664426	S	344	52	396	0.00003
Sulfitobacter sp. SK012	1389005	S	305	5	310	0.00002
Sulfitobacter sp. SK025	1389011	S	124	255	379	0.00002
Sulfitobacter sp. CB2047	1525218	S	87	240	327	0.00002
Sulfitobacter sp. B30-2	2785912	S	86	186	272	0.00002
Sulfitobacter alexandrii	1917485	S	1732	857	2589	0.00016
Sulfitobacter mediterraneus	83219	S	812	81	893	0.00006
Sulfitobacter indolifex	225422	S	508	111	619	0.00004
Sulfitobacter dubius	218673	S	419	183	602	0.00004
Sulfitobacter pontiacus	60137	S	196	432	628	0.00004
Salipiger profundus	1229727	S	3276	1438	4714	0.00030
Salipiger abyssi	1250539	S	2318	919	3237	0.00020
Salipiger sp. CCB-MM3	1792508	S	2099	297	2396	0.00015
Roseivivax sp. THAF30	2587852	S	1624	386	2010	0.00013
Roseivivax sp. THAF197b	2588299	S	40	826	866	0.00005
Roseivivax sp. THAF40	2587858	S	27	724	751	0.00005
Roseivivax marinus	1379903	S	3027	486	3513	0.00022
Celeribacter indicus	1208324	S	2573	1241	3814	0.00024
Celeribacter ethanolicus	1758178	S	979	332	1311	0.00008
Celeribacter baekdonensis	875171	S	431	114	545	0.00003
Celeribacter marinus	1397108	S	303	10	313	0.00002
Phaeobacter gallaeciensis	60890	S	1265	364	1629	0.00010
Phaeobacter inhibens	221822	S	962	2998	3960	0.00025
Phaeobacter piscinae	1580596	S	428	160	588	0.00004
Phaeobacter porticola	1844006	S	258	34	292	0.00002
Phaeobacter sp. LSS9	681157	S	113	39	152	0.00001
Leisingera aquaemixtae	1396826	S	1316	247	1563	0.00010
Leisingera sp. NJS201	2508306	S	261	411	672	0.00004
Leisingera sp. NJS204	2508307	S	255	424	679	0.00004
Leisingera methylohalidivorans	133924	S	930	218	1148	0.00007
Ruegeria sp. TM1040	292414	S	550	93	643	0.00004
Ruegeria sp. THAF33	2587853	S	442	113	555	0.00004
Ruegeria sp. SCSIO 43209	2793010	S	413	77	490	0.00003
Ruegeria sp. AD91A	2293862	S	337	38	375	0.00002
Ruegeria pomeroyi	89184	S	1608	302	1910	0.00012
Sulfitobacter pseudonitzschiae	1402135	S	1872	646	2518	0.00016
Pseudosulfitobacter sp. DSM 107133	2883100	S	683	271	954	0.00006
Sagittula sp. P11	2009329	S	2619	1061	3680	0.00023
Yangia pacifica	311180	S	2612	441	3053	0.00019
Mameliella alba	561184	S	1889	345	2234	0.00014
Ponticoccus alexandrii	1943633	S	1871	281	2152	0.00014
Dinoroseobacter shibae	215813	S	1843	655	2498	0.00016
Roseobacter ponti	1891787	S	713	18	731	0.00005
Roseobacter denitrificans	2434	S	536	85	621	0.00004
Roseobacter litoralis	42443	S	393	50	443	0.00003
Roseibacterium elongatum	159346	S	1464	125	1589	0.00010
Ketogulonicigenium vulgare	92945	S	773	191	964	0.00006
Ketogulonicigenium robustum	92947	S	655	77	732	0.00005
Octadecabacter sp. SW4	2602067	S	576	82	658	0.00004
Octadecabacter arcticus	53946	S	330	35	365	0.00002
Octadecabacter antarcticus	1217908	S	309	27	336	0.00002
Octadecabacter temperatus	1458307	S	177	3	180	0.00001
Actibacterium sp. EMB200-NS6	1609966	S	1422	680	2102	0.00013
Oceanicola sp. D3	2587163	S	1399	72	1471	0.00009
Maribius sp. THAF1	2587842	S	1089	57	1146	0.00007
Tateyamaria omphalii	299262	S	1059	35	1094	0.00007
Thalassococcus sp. S3	2017482	S	987	25	1012	0.00006
Antarctobacter heliothermus	74033	S	932	48	980	0.00006
Jannaschia sp. CCS1	290400	S	868	23	891	0.00006
Thalassobius gelatinovorus	53501	S	613	33	646	0.00004
Falsihalocynthiibacter arcticus	1579316	S	230	7	237	0.00001
Caulobacter sp. S6	2823693	S	6406	712	7118	0.00045
Caulobacter sp. FWC26	69665	S	2239	970	3209	0.00020
Caulobacter segnis	88688	S	7250	3030	10280	0.00065
Caulobacter mirabilis	69666	S	5975	1128	7103	0.00045
Caulobacter flavus	1679497	S	4873	1354	6227	0.00039
Caulobacter vibrioides	155892	S	4861	2601	7462	0.00047
Caulobacter rhizosphaerae	2010972	S	4015	1149	5164	0.00033
Caulobacter soli	2708539	S	3474	1086	4560	0.00029
Caulobacter henricii	69395	S	2044	347	2391	0.00015
Brevundimonas sp. M20	2591463	S	2241	346	2587	0.00016
Brevundimonas sp. LM2	1938605	S	2184	374	2558	0.00016
Brevundimonas sp. PAMC22021	2861285	S	2141	468	2609	0.00016
Brevundimonas sp. MF30-B	2561924	S	2119	332	2451	0.00015
Brevundimonas sp. AJA228-03	2752515	S	1538	201	1739	0.00011
Brevundimonas sp. CS1	2813778	S	572	571	1143	0.00007
Brevundimonas sp. SGAir0440	2579977	S	471	457	928	0.00006
Brevundimonas sp. DS20	1532555	S	434	1064	1498	0.00009
Brevundimonas sp. GW460-12-10-14-LB2	1827469	S	432	754	1186	0.00007
Brevundimonas sp. 'scallop'	2562582	S	413	731	1144	0.00007
Brevundimonas sp. Bb-A	2560058	S	399	819	1218	0.00008
Brevundimonas naejangsanensis	588932	S	3810	1309	5119	0.00032
Brevundimonas albigilva	1312364	S	2618	1433	4051	0.00026
Brevundimonas goettingensis	2774190	S	2411	378	2789	0.00018
Brevundimonas subvibrioides	74313	S	2029	363	2392	0.00015
Brevundimonas pondensis	2774189	S	1606	490	2096	0.00013
Brevundimonas vitisensis	2800818	S	1517	186	1703	0.00011
Brevundimonas diminuta	293	S	1476	2804	4280	0.00027
Brevundimonas mediterranea	74329	S	1333	517	1850	0.00012
Brevundimonas nasdae	172043	S	1293	863	2156	0.00014
Brevundimonas vesicularis	41276	S	439	971	1410	0.00009
Brevundimonas vancanneytii	1325724	S	371	1442	1813	0.00011
Phenylobacterium zucineum	284016	S	13761	2861	16622	0.00105
Phenylobacterium parvum	2201350	S	3622	404	4026	0.00025
Terricaulis silvestris	2686094	S	14929	533	15462	0.00098
Asticcacaulis excentricus	78587	S	1647	268	1915	0.00012
Asticcacaulis sp. AND118	2840468	S	1491	229	1720	0.00011
Candidatus Viadribacter manganicus	1759059	S	7037	192	7229	0.00046
Hyphomonas sp. CACIAM 19H1	1873716	S	1454	232	1686	0.00011
Hyphomonas sp. Mor2	1906738	S	849	18	867	0.00005
Hyphomonas sp. KY3	2016196	S	822	98	920	0.00006
Hyphomonas neptunium	81032	S	1298	154	1452	0.00009
Hirschia baltica	2724	S	68	1	69	0.00000
Marinicauda algicola	2029849	S	4238	754	4992	0.00032
Maricaulis maris	74318	S	1427	98	1525	0.00010
Glycocaulis alkaliphilus	1434191	S	1337	75	1412	0.00009
Hyphobacterium sp. CCMP332	2749086	S	964	42	1006	0.00006
Aquisalinus flavus	1526572	S	1779	85	1864	0.00012
Parvularcula bermudensis	208216	S	672	83	755	0.00005
Anaplasma ovis	142058	S	76	12	88	0.00001
Anaplasma platys	949	S	69	8	77	0.00000
Anaplasma marginale	770	S	24	44	68	0.00000
Anaplasma centrale	769	S	21	32	53	0.00000
Anaplasma phagocytophilum	948	S	16	1	17	0.00000
Wolbachia pipientis	955	S	24	47	71	0.00000
Neorickettsia helminthoeca	33994	S	12	7	19	0.00000
Neorickettsia findlayensis	2686014	S	12	52	64	0.00000
Ehrlichia ruminantium	779	S	24	6	30	0.00000
Ehrlichia canis	944	S	15	8	23	0.00000
Candidatus Neoehrlichia mikurensis	89586	S	21	5	26	0.00000
Rickettsia tillamookensis	2761623	S	97	29	126	0.00001
Rickettsia amblyommatis	33989	S	17	12	29	0.00000
Rickettsia conorii	781	S	16	32	48	0.00000
Rickettsia australis	787	S	11	3	14	0.00000
Rickettsia endosymbiont of Oedothorax gibbosus	931099	S	23	2	25	0.00000
Rickettsia endosymbiont of Bemisia tabaci	337479	S	10	6	16	0.00000
Rickettsia canadensis	788	S	15	1	16	0.00000
Rickettsia bellii	33990	S	14	16	30	0.00000
Rickettsia typhi	785	S	10	5	15	0.00000
Orientia tsutsugamushi	784	S	23	0	23	0.00000
Candidatus Sneabacter namystus	2601646	S	14	1	15	0.00000
Candidatus Phycorickettsia trachydisci	2115978	S	51	2	53	0.00000
Candidatus Midichloria mitochondrii	234827	S	27	9	36	0.00000
Candidatus Fokinia solitaria	1802984	S	15	2	17	0.00000
Candidatus Deianiraea vastatrix	2163644	S	30	0	30	0.00000
Rickettsiales endosymbiont of Stachyamoeba lipophora	2486578	S	23	2	25	0.00000
Micavibrio aeruginosavorus	349221	S	983	12	995	0.00006
Candidatus Puniceispirillum marinum	767892	S	152	4	156	0.00001
Luteithermobacter gelatinilyticus	2582913	S	564	105	669	0.00004
Paremcibacter congregatus	2043170	S	513	17	530	0.00003
Candidatus Hydrogenosomobacter endosymbioticus	2558174	S	57	1	58	0.00000
Candidatus Cytomitobacter indipagum	2601575	S	26	7	33	0.00000
Candidatus Cytomitobacter primus	2066024	S	11	2	13	0.00000
endosymbiont of Acanthamoeba sp. UWC8	86106	S	37	0	37	0.00000
Candidatus Gromoviella agglomerans	2806609	S	35	1	36	0.00000
Candidatus Nesciobacter abundans	2601668	S	22	2	24	0.00000
Candidatus Nucleicultrix amoebiphila	1509244	S	89	4	93	0.00001
Candidatus Paracaedibacter acanthamoebae	91604	S	87	4	91	0.00001
Magnetococcus marinus	1124597	S	329	9	338	0.00002
Candidatus Pelagibacter sp. RS40	1977865	S	28	20	48	0.00000
Candidatus Pelagibacter sp. IMCC9063	1002672	S	15	2	17	0.00000
Candidatus Fonsibacter ubiquis	1925548	S	56	10	66	0.00000
Kordiimonas pumila	2161677	S	131	2	133	0.00001
Burkholderia ubonensis	101571	S	7247	2892	10139	0.00064
Burkholderia multivorans	87883	S	7213	12866	20079	0.00127
Burkholderia cenocepacia	95486	S	5530	8257	13787	0.00087
Burkholderia cepacia	292	S	4673	7415	12088	0.00076
Burkholderia pyrrocinia	60550	S	3072	932	4004	0.00025
Burkholderia ambifaria	152480	S	2550	2453	5003	0.00032
Burkholderia contaminans	488447	S	2514	1003	3517	0.00022
Burkholderia stagnalis	1503054	S	2330	574	2904	0.00018
Burkholderia anthina	179879	S	2114	1313	3427	0.00022
Burkholderia stabilis	95485	S	2058	1002	3060	0.00019
Burkholderia dolosa	152500	S	2036	24105	26141	0.00165
Burkholderia lata	482957	S	1944	1065	3009	0.00019
Burkholderia territorii	1503055	S	1636	473	2109	0.00013
Burkholderia seminalis	488731	S	1318	366	1684	0.00011
Burkholderia vietnamiensis	60552	S	1283	134990	136273	0.00861
Burkholderia metallica	488729	S	1015	295	1310	0.00008
Burkholderia diffusa	488732	S	779	224	1003	0.00006
Burkholderia pseudomultivorans	1207504	S	651	389	1040	0.00007
Burkholderia latens	488446	S	383	412	795	0.00005
Burkholderia aenigmatica	2015348	S	349	497	846	0.00005
Burkholderia pseudomallei	28450	S	3334	14678	18012	0.00114
Burkholderia mayonis	1385591	S	2318	381	2699	0.00017
Burkholderia thailandensis	57975	S	2234	1618	3852	0.00024
Burkholderia oklahomensis	342113	S	1581	1122	2703	0.00017
Burkholderia savannae	1637837	S	391	277	668	0.00004
Burkholderia sp. MSMB1588	1636423	S	143	143	286	0.00002
Burkholderia sp. MSMB617WGS	1637831	S	141	199	340	0.00002
Burkholderia mallei	13373	S	83	33280	33363	0.00211
Burkholderia sp. DHOD12	2571746	S	4001	342	4343	0.00027
Burkholderia sp. Bp7605	1740163	S	2233	268	2501	0.00016
Burkholderia sp. NRF60-BP8	1637853	S	808	255	1063	0.00007
Burkholderia sp. LA-2-3-30-S1-D2	1637862	S	806	325	1131	0.00007
Burkholderia sp. JP2-270	2217913	S	793	309	1102	0.00007
Burkholderia sp. MSMB0856	1637869	S	742	322	1064	0.00007
Burkholderia sp. PAMC 26561	1795043	S	618	785	1403	0.00009
Burkholderia sp. MS455	2811788	S	551	243	794	0.00005
Burkholderia sp. PAMC 28687	1795874	S	440	865	1305	0.00008
Burkholderia sp. IDO3	1705310	S	351	286	637	0.00004
Burkholderia sp. LAS2	2813843	S	169	427	596	0.00004
Burkholderia sp. KBS0801	1179675	S	160	153	313	0.00002
Burkholderia sp. MS389	2811789	S	59	234	293	0.00002
Burkholderia sp. KJ006	416344	S	50	164	214	0.00001
Burkholderia sp. MBR-1	2732364	S	47	104	151	0.00001
Burkholderia gladioli	28095	S	8834	2306	11140	0.00070
Burkholderia glumae	337	S	3298	926	4224	0.00027
Burkholderia plantarii	41899	S	2341	587	2928	0.00019
Burkholderia perseverans	2615214	S	1979	526	2505	0.00016
Cupriavidus taiwanensis	164546	S	14268	10884	25152	0.00159
Cupriavidus pauculus	82633	S	11908	4750	16658	0.00105
Cupriavidus oxalaticus	96344	S	6697	2748	9445	0.00060
Cupriavidus necator	106590	S	5929	5207	11136	0.00070
Cupriavidus basilensis	68895	S	5858	2959	8817	0.00056
Cupriavidus sp. EM10	2839983	S	2660	1411	4071	0.00026
Cupriavidus sp. MP-37	2884455	S	1329	1272	2601	0.00016
Cupriavidus sp. ISTL7	2771360	S	527	3229	3756	0.00024
Cupriavidus sp. KK10	1478019	S	482	1379	1861	0.00012
Cupriavidus sp. USMAA2-4	876364	S	306	2019	2325	0.00015
Cupriavidus sp. USMAHM13	1389192	S	282	1920	2202	0.00014
Cupriavidus campinensis	151783	S	4781	1591	6372	0.00040
Cupriavidus metallidurans	119219	S	3564	2137	5701	0.00036
Cupriavidus pinatubonensis	248026	S	3187	506	3693	0.00023
Cupriavidus gilardii	82541	S	2048	9865	11913	0.00075
Cupriavidus neocaledonicus	1040979	S	1146	1331	2477	0.00016
Cupriavidus nantongensis	1796606	S	1091	2739	3830	0.00024
Cupriavidus malaysiensis	367825	S	315	1998	2313	0.00015
Paraburkholderia sp. SOS3	1926494	S	3031	408	3439	0.00022
Paraburkholderia sp. PGU16	2735433	S	1496	820	2316	0.00015
Paraburkholderia sp. PGU19	2735434	S	1214	1043	2257	0.00014
Paraburkholderia pallida	2547399	S	4049	683	4732	0.00030
Paraburkholderia aromaticivorans	2026199	S	3619	1522	5141	0.00032
Paraburkholderia acidisoli	2571748	S	3381	554	3935	0.00025
Paraburkholderia caribensis	75105	S	3370	2509	5879	0.00037
Paraburkholderia tropica	92647	S	3206	653	3859	0.00024
Paraburkholderia acidiphila	2571747	S	2887	522	3409	0.00022
Paraburkholderia phytofirmans	261302	S	2748	1047	3795	0.00024
Paraburkholderia edwinii	2861782	S	2727	343	3070	0.00019
Paraburkholderia terricola	169427	S	2633	746	3379	0.00021
Paraburkholderia fungorum	134537	S	2524	568	3092	0.00020
Paraburkholderia atlantica	2654982	S	2468	559	3027	0.00019
Paraburkholderia phymatum	148447	S	2383	586	2969	0.00019
Paraburkholderia sprentiae	948107	S	2345	481	2826	0.00018
Paraburkholderia phenoliruptrix	252970	S	2338	647	2985	0.00019
Paraburkholderia megapolitana	420953	S	2190	187	2377	0.00015
Paraburkholderia graminis	60548	S	2101	486	2587	0.00016
Paraburkholderia terrae	311230	S	1935	2229	4164	0.00026
Paraburkholderia caledonica	134536	S	1899	325	2224	0.00014
Paraburkholderia ginsengisoli	311231	S	1855	533	2388	0.00015
Paraburkholderia hospita	169430	S	1733	1989	3722	0.00024
Paraburkholderia caffeinilytica	1761016	S	1635	411	2046	0.00013
Paraburkholderia xenovorans	36873	S	1577	2008	3585	0.00023
Paraburkholderia dokdonella	2211211	S	1517	373	1890	0.00012
Paraburkholderia dioscoreae	2604047	S	1078	718	1796	0.00011
Ralstonia solanacearum	305	S	8097	16459	24556	0.00155
Ralstonia insidiosa	190721	S	2180	1534	3714	0.00023
Ralstonia mannitolilytica	105219	S	1607	1717	3324	0.00021
Ralstonia pickettii	329	S	1570	649	2219	0.00014
Ralstonia sp. 56D2	2842456	S	1515	214	1729	0.00011
blood disease bacterium A2-HR MARDI	1944648	S	11	526	537	0.00003
Ralstonia syzygii	28097	S	146	553	699	0.00004
Ralstonia pseudosolanacearum	1310165	S	50	1167	1217	0.00008
Pandoraea pnomenusa	93220	S	3275	1509	4784	0.00030
Pandoraea pulmonicola	93221	S	2619	570	3189	0.00020
Pandoraea thiooxydans	445709	S	2586	201	2787	0.00018
Pandoraea vervacti	656178	S	1819	540	2359	0.00015
Pandoraea norimbergensis	93219	S	1796	285	2081	0.00013
Pandoraea sp. XY-2	2518599	S	1777	932	2709	0.00017
Pandoraea faecigallinarum	656179	S	1716	471	2187	0.00014
Pandoraea apista	93218	S	1491	826	2317	0.00015
Pandoraea fibrosis	1891094	S	1311	451	1762	0.00011
Pandoraea oxalativorans	573737	S	1209	589	1798	0.00011
Pandoraea sputorum	93222	S	1199	553	1752	0.00011
Caballeronia sp. Lep1P3	2878150	S	2679	632	3311	0.00021
Caballeronia sp. TF1N1	2878153	S	2140	240	2380	0.00015
Caballeronia sp. SL2Y3	2878151	S	1258	714	1972	0.00012
Caballeronia sp. Sq4a	2878152	S	1141	836	1977	0.00012
Caballeronia sp. M1242	2814653	S	1083	771	1854	0.00012
Caballeronia sp. SBC2	2705547	S	138	1185	1323	0.00008
Caballeronia sp. SBC1	2705548	S	111	1332	1443	0.00009
Caballeronia zhejiangensis	871203	S	2979	705	3684	0.00023
Caballeronia insecticola	758793	S	2654	559	3213	0.00020
Caballeronia grimmiae	1071679	S	2231	1159	3390	0.00021
Polynucleobacter sp. MWH-UH24A	2689110	S	96	6	102	0.00001
Polynucleobacter sp. MWH-Spelu-300-X4	2689109	S	64	3	67	0.00000
Polynucleobacter sp. LimPoW16	1743162	S	55	2	57	0.00000
Polynucleobacter sp. MWH-P3-07-1	1743173	S	53	8	61	0.00000
Polynucleobacter sp. MWH-Aus1W21	1855880	S	52	14	66	0.00000
Polynucleobacter sp. MWH-UH21B	1743174	S	45	10	55	0.00000
Polynucleobacter sp. MWH-Braz-FAM2G	1855883	S	44	6	50	0.00000
Polynucleobacter sp. MWH-CaK5	2689107	S	42	2	44	0.00000
Polynucleobacter sp. TSB-Sco08W16	1758374	S	41	7	48	0.00000
Polynucleobacter sp. AP-Nino-20-G2	2576917	S	40	10	50	0.00000
Polynucleobacter sp. VK25	1758398	S	36	10	46	0.00000
Polynucleobacter sp. JS-JIR-II-b4	1758390	S	34	23	57	0.00000
Polynucleobacter sp. JS-JIR-II-50	2576919	S	34	20	54	0.00000
Polynucleobacter sp. Adler-ghost	2770234	S	33	19	52	0.00000
Polynucleobacter sp. AP-Titi-500A-B4	2576923	S	33	8	41	0.00000
Polynucleobacter sp. AP-Kolm-20A-A1	2081041	S	33	20	53	0.00000
Polynucleobacter sp. es-EL-1	1855652	S	33	6	39	0.00000
Polynucleobacter sp. MWH-UH25E	1855616	S	30	7	37	0.00000
Polynucleobacter sp. MWH-UH35A	1855619	S	30	5	35	0.00000
Polynucleobacter sp. AP-Ainpum-60-G11	2576926	S	29	8	37	0.00000
Polynucleobacter sp. MWH-Svant-W18	1855909	S	29	6	35	0.00000
Polynucleobacter sp. MWH-S4W17	1855910	S	28	18	46	0.00000
Polynucleobacter sp. es-MAR-2	1819725	S	28	7	35	0.00000
Polynucleobacter sp. MWH-UH2A	1855617	S	27	6	33	0.00000
Polynucleobacter sp. MG-6-Vaara-E2	2576932	S	27	5	32	0.00000
Polynucleobacter sp. JS-Mosq-20-D10	2576922	S	27	12	39	0.00000
Polynucleobacter sp. AP-Melu-1000-A1	2081042	S	25	12	37	0.00000
Polynucleobacter sp. AP-Elch-400A-B2	2576930	S	24	14	38	0.00000
Polynucleobacter sp. AP-Sving-400A-A2	2081049	S	23	15	38	0.00000
Polynucleobacter sp. AP-Jannik-300A-C4	2576928	S	19	25	44	0.00000
Polynucleobacter sp. MG-Unter2-18	2081052	S	16	12	28	0.00000
Polynucleobacter sp. AM-7D1	2689102	S	14	19	33	0.00000
Polynucleobacter necessarius	576610	S	253	45	298	0.00002
Polynucleobacter asymbioticus	576611	S	147	24	171	0.00001
Polynucleobacter difficilis	556054	S	115	10	125	0.00001
Polynucleobacter acidiphobus	556053	S	105	7	112	0.00001
Polynucleobacter paneuropaeus	2527775	S	55	6	61	0.00000
Polynucleobacter wuianus	1743168	S	40	12	52	0.00000
Polynucleobacter duraquae	1835254	S	33	22	55	0.00000
Lautropia mirabilis	47671	S	2335	427	2762	0.00017
Chitinimonas arctica	2594795	S	1568	127	1695	0.00011
Mycetohabitans rhizoxinica	412963	S	1509	100	1609	0.00010
Mycoavidus sp. HKI	2840467	S	194	14	208	0.00001
Mycoavidus sp. B2-EB	2651972	S	77	12	89	0.00001
Mycoavidus cysteinexigens	1553431	S	139	15	154	0.00001
Limnobacter sp. SAORIC-580	2732163	S	264	13	277	0.00002
Candidatus Vallotia cooleyia	1177211	S	52	6	58	0.00000
Candidatus Vallotia sp. (ex Adelges kitamiensis)	2864217	S	42	16	58	0.00000
Candidatus Vallotia tarda	1177213	S	39	6	45	0.00000
Candidatus Vallotia lariciata	2018052	S	37	14	51	0.00000
Ephemeroptericola cinctiostellae	2268024	S	156	10	166	0.00001
Variovorax sp. HW608	1034889	S	9213	1576	10789	0.00068
Variovorax sp. PBS-H4	434008	S	5120	3397	8517	0.00054
Variovorax sp. PBL-H6	434009	S	4830	4584	9414	0.00059
Variovorax sp. RA8	662548	S	4782	3816	8598	0.00054
Variovorax sp. WDL1	207745	S	4753	7417	12170	0.00077
Variovorax sp. PAMC 28711	1795631	S	3779	655	4434	0.00028
Variovorax sp. RKNM96	2681552	S	3650	1430	5080	0.00032
Variovorax sp. PAMC26660	2762322	S	3120	799	3919	0.00025
Variovorax sp. PAMC28562	2762323	S	2997	263	3260	0.00021
Variovorax sp. SRS16	282217	S	2587	5491	8078	0.00051
Variovorax sp. 38R	2774875	S	2167	2877	5044	0.00032
Variovorax sp. PBL-E5	434014	S	2015	4957	6972	0.00044
Variovorax sp. PDNC026	2811425	S	101	3571	3672	0.00023
Variovorax sp. PMC12	2126319	S	64	2907	2971	0.00019
Variovorax paradoxus	34073	S	19186	17541	36727	0.00232
Variovorax boronicumulans	436515	S	2924	2239	5163	0.00033
Hydrogenophaga sp. BA0156	2716225	S	6682	4912	11594	0.00073
Hydrogenophaga sp. PBC	795665	S	6565	8023	14588	0.00092
Hydrogenophaga sp. YM1	2806262	S	5853	3041	8894	0.00056
Hydrogenophaga sp. BPS33	2651974	S	4415	3782	8197	0.00052
Hydrogenophaga sp. SL48	2806347	S	3700	923	4623	0.00029
Hydrogenophaga sp. RAC07	1842537	S	3071	1054	4125	0.00026
Hydrogenophaga sp. PBL-H3	434010	S	2713	2598	5311	0.00034
Hydrogenophaga sp. NH-16	2184519	S	1474	3307	4781	0.00030
Hydrogenophaga sp. PAMC20947	2565558	S	1430	99	1529	0.00010
Hydrogenophaga taeniospiralis	65656	S	3185	998	4183	0.00026
Hydrogenophaga pseudoflava	47421	S	1371	2412	3783	0.00024
Hydrogenophaga crassostreae	1763535	S	1364	89	1453	0.00009
Acidovorax sp. JMULE5	2518343	S	4891	1449	6340	0.00040
Acidovorax sp. KKS102	358220	S	3984	2999	6983	0.00044
Acidovorax sp. YS12	2738413	S	3071	2744	5815	0.00037
Acidovorax sp. RAC01	1842533	S	2827	2476	5303	0.00034
Acidovorax sp. 1608163	2478662	S	2127	478	2605	0.00016
Acidovorax sp. HDW3	2714923	S	1664	1239	2903	0.00018
Acidovorax sp. T1	1858609	S	1355	5213	6568	0.00042
Acidovorax avenae	80867	S	6394	4306	10700	0.00068
Acidovorax monticola	1926868	S	3857	1605	5462	0.00035
Acidovorax antarcticus	2743470	S	3208	2524	5732	0.00036
Acidovorax carolinensis	553814	S	2542	2198	4740	0.00030
Acidovorax radicis	758826	S	2010	433	2443	0.00015
Acidovorax citrulli	80869	S	1790	2378	4168	0.00026
Acidovorax cattleyae	80868	S	1571	1155	2726	0.00017
Ramlibacter tataouinensis	94132	S	28036	11750	39786	0.00251
Schlegelella thermodepolymerans	215580	S	15119	7519	22638	0.00143
Schlegelella brevitalea	413882	S	9953	1470	11423	0.00072
Comamonas sp. NLF-7-7	2597701	S	2340	1923	4263	0.00027
Comamonas sp. NLF-1-9	2853163	S	1813	1143	2956	0.00019
Comamonas sp. B21-038	2918299	S	1105	289	1394	0.00009
Comamonas sp. Y33R10-2	2853257	S	387	76	463	0.00003
Comamonas aquatica	225991	S	2915	3039	5954	0.00038
Comamonas serinivorans	1082851	S	2903	844	3747	0.00024
Comamonas testosteroni	285	S	1712	2628	4340	0.00027
Comamonas odontotermitis	379895	S	1132	233	1365	0.00009
Comamonas koreensis	160825	S	1116	749	1865	0.00012
Comamonas thiooxydans	363952	S	888	2007	2895	0.00018
Comamonas piscis	1562974	S	853	175	1028	0.00007
Comamonas kerstersii	225992	S	636	369	1005	0.00006
Comamonas fluminis	2796366	S	562	254	816	0.00005
Rhodoferax sp. BAB1	2741720	S	3437	985	4422	0.00028
Rhodoferax sp. AJA081-3	2752316	S	1170	87	1257	0.00008
Rhodoferax sp. PAMC 29310	2822760	S	834	96	930	0.00006
Rhodoferax sp. MIZ03	2798804	S	631	67	698	0.00004
Rhodoferax koreense	1842727	S	4858	2650	7508	0.00047
Rhodoferax sediminis	2509614	S	3849	614	4463	0.00028
Rhodoferax ferrireducens	192843	S	1758	123	1881	0.00012
Rhodoferax saidenbachensis	1484693	S	1128	128	1256	0.00008
Rhodoferax antarcticus	81479	S	833	67	900	0.00006
Rhodoferax aquaticus	2527691	S	519	54	573	0.00004
Diaphorobacter sp. HDW4A	2714924	S	2038	2104	4142	0.00026
Diaphorobacter sp. HDW4B	2714925	S	1751	231	1982	0.00013
Diaphorobacter sp. JS3051	2792224	S	212	3552	3764	0.00024
Diaphorobacter sp. MNS-0	2866628	S	201	1695	1896	0.00012
Diaphorobacter sp. JS3050	2735554	S	200	2235	2435	0.00015
Diaphorobacter ruginosibacter	1715720	S	2627	500	3127	0.00020
Diaphorobacter aerolatus	1288495	S	1797	2879	4676	0.00030
Diaphorobacter nitroreducens	164759	S	323	903	1226	0.00008
[Acidovorax] ebreus	721785	S	297	1745	2042	0.00013
Delftia tsuruhatensis	180282	S	2423	6822	9245	0.00058
Delftia acidovorans	80866	S	1921	3704	5625	0.00036
Delftia lacustris	558537	S	766	4487	5253	0.00033
Delftia sp. Cs1-4	742013	S	263	619	882	0.00006
Delftia sp. HK171	1920191	S	172	469	641	0.00004
Polaromonas sp. JS666	296591	S	3867	3140	7007	0.00044
Polaromonas naphthalenivorans	216465	S	2597	405	3002	0.00019
Polaromonas vacuolata	37448	S	338	37	375	0.00002
Kinneretia sp. DAIF2	2714952	S	6316	2319	8635	0.00055
Kinneretia sp. XES5	2877940	S	1945	2463	4408	0.00028
Ottowia sp. 27C	2816950	S	3121	613	3734	0.00024
Ottowia sp. oral taxon 894	1658672	S	1169	170	1339	0.00008
Ottowia oryzae	2109914	S	2480	560	3040	0.00019
Alicycliphilus denitrificans	179636	S	6198	11680	17878	0.00113
Melaminivora sp. SC2-9	2109913	S	2720	3334	6054	0.00038
Melaminivora jejuensis	1267217	S	2161	1754	3915	0.00025
Serpentinimonas maccroryi	1458426	S	2126	721	2847	0.00018
Serpentinimonas raichei	1458425	S	1639	617	2256	0.00014
Verminephrobacter eiseniae	364317	S	2856	362	3218	0.00020
Hylemonella gracilis	80880	S	2597	383	2980	0.00019
Pulveribacter suum	2116657	S	2354	1261	3615	0.00023
Simplicispira suum	2109915	S	1982	790	2772	0.00018
Limnohabitans sp. 63ED37-2	1678128	S	869	97	966	0.00006
Limnohabitans sp. 103DPR2	1678129	S	284	22	306	0.00002
Curvibacter sp. AEP1-3	1844971	S	925	69	994	0.00006
Candidatus Symbiobacter mobilis	1436290	S	883	32	915	0.00006
Massilia sp. WG5	1707785	S	4875	2332	7207	0.00046
Massilia sp. HC52	2852099	S	3916	1157	5073	0.00032
Massilia sp. LPB0304	2769491	S	3677	980	4657	0.00029
Massilia sp. DM-R-R2A-13	2899220	S	3480	832	4312	0.00027
Massilia sp. YMA4	1593482	S	3258	1829	5087	0.00032
Massilia sp. NP310	2861282	S	3009	2152	5161	0.00033
Massilia sp. PAMC28688	2861283	S	2418	395	2813	0.00018
Massilia sp. NR 4-1	1678028	S	477	1443	1920	0.00012
Massilia sp. MB5	2919578	S	452	1415	1867	0.00012
Massilia sp. Dwa41.01b	2709302	S	84	2659	2743	0.00017
Massilia sp. Se16.2.3	2709303	S	63	2013	2076	0.00013
Massilia putida	1141883	S	5980	2072	8052	0.00051
Massilia violaceinigra	2045208	S	5738	1762	7500	0.00047
Massilia flava	871742	S	5029	1318	6347	0.00040
Massilia albidiflava	321983	S	3460	1485	4945	0.00031
Massilia lutea	321985	S	3460	1138	4598	0.00029
Massilia umbonata	864828	S	3281	1417	4698	0.00030
Massilia armeniaca	2072590	S	3160	1798	4958	0.00031
Massilia plicata	321984	S	3109	872	3981	0.00025
Massilia oculi	945844	S	2606	1810	4416	0.00028
Massilia antarctica	2765360	S	2498	1018	3516	0.00022
Duganella sp. GN2-R2	2728020	S	4139	1925	6064	0.00038
Duganella sp. AF9R3	2728021	S	2491	565	3056	0.00019
Janthinobacterium sp. 1_2014MBL_MicDiv	1644131	S	1767	699	2466	0.00016
Janthinobacterium sp. 17J80-10	2497863	S	1699	264	1963	0.00012
Janthinobacterium sp. LM6	1938606	S	745	504	1249	0.00008
Janthinobacterium sp. PAMC25594	2861284	S	586	395	981	0.00006
Janthinobacterium sp. Marseille	375286	S	488	130	618	0.00004
Janthinobacterium sp. HH102	1537274	S	373	643	1016	0.00006
Janthinobacterium sp. B9-8	1236179	S	176	50	226	0.00001
Janthinobacterium agaricidamnosum	55508	S	2286	3935	6221	0.00039
Janthinobacterium tructae	2590869	S	599	338	937	0.00006
Janthinobacterium lividum	29581	S	585	649	1234	0.00008
Janthinobacterium svalbardensis	368607	S	548	301	849	0.00005
Herbaspirillum robiniae	2014887	S	2909	1126	4035	0.00026
Herbaspirillum frisingense	92645	S	2113	717	2830	0.00018
Herbaspirillum seropedicae	964	S	2069	808	2877	0.00018
Herbaspirillum hiltneri	341045	S	1801	323	2124	0.00013
Herbaspirillum rubrisubalbicans	80842	S	1758	863	2621	0.00017
Herbaspirillum huttiense	863372	S	1243	541	1784	0.00011
Herbaspirillum sp. meg3	2025949	S	999	122	1121	0.00007
Collimonas fungivorans	158899	S	2314	650	2964	0.00019
Collimonas arenae	279058	S	1804	242	2046	0.00013
Collimonas pratensis	279113	S	1709	362	2071	0.00013
Noviherbaspirillum sp. UKPF54	2601898	S	3783	670	4453	0.00028
Undibacterium sp. YM2	2058625	S	258	98	356	0.00002
Undibacterium sp. KW1	2058624	S	203	77	280	0.00002
Undibacterium parvum	401471	S	254	36	290	0.00002
Glaciimonas sp. PAMC28666	2807626	S	331	22	353	0.00002
Herminiimonas arsenitoxidans	1809410	S	309	52	361	0.00002
Oxalobacter formigenes	847	S	219	21	240	0.00002
Achromobacter xylosoxidans	85698	S	8827	16012	24839	0.00157
Achromobacter sp. AONIH1	1758194	S	3085	4081	7166	0.00045
Achromobacter sp. MFA1 R4	1881016	S	2486	807	3293	0.00021
Achromobacter sp. 77	2756133	S	462	1254	1716	0.00011
Achromobacter sp. B7	2282475	S	369	906	1275	0.00008
Achromobacter sp. ES-001	2860286	S	285	952	1237	0.00008
Achromobacter spanius	217203	S	4814	2085	6899	0.00044
Achromobacter denitrificans	32002	S	4403	3474	7877	0.00050
Achromobacter deleyi	1353891	S	3094	2347	5441	0.00034
Achromobacter insolitus	217204	S	2311	707	3018	0.00019
Achromobacter pestifer	1353889	S	1736	1277	3013	0.00019
Achromobacter mucicolens	1389922	S	649	1081	1730	0.00011
Achromobacter ruhlandii	72557	S	35	1728	1763	0.00011
Bordetella sp. H567	1697043	S	3212	414	3626	0.00023
Bordetella sp. N	1746199	S	2807	349	3156	0.00020
Bordetella genomosp. 13	463040	S	3966	2938	6904	0.00044
Bordetella bronchialis	463025	S	3765	542	4307	0.00027
Bordetella genomosp. 8	1416806	S	3503	450	3953	0.00025
Bordetella genomosp. 9	1416803	S	3341	893	4234	0.00027
Bordetella flabilis	463014	S	3265	298	3563	0.00023
Bordetella petrii	94624	S	2748	3878	6626	0.00042
Bordetella hinzii	103855	S	2669	1241	3910	0.00025
Bordetella trematum	123899	S	1958	899	2857	0.00018
Bordetella pseudohinzii	1331258	S	1564	761	2325	0.00015
Bordetella bronchiseptica	518	S	1460	7217	8677	0.00055
Bordetella holmesii	35814	S	991	369	1360	0.00009
Bordetella avium	521	S	885	133	1018	0.00006
Bordetella genomosp. 6	463024	S	479	1080	1559	0.00010
Bordetella pertussis	520	S	261	3134	3395	0.00021
Bordetella parapertussis	519	S	170	2378	2548	0.00016
Pigmentiphaga sp. H8	2488560	S	5876	812	6688	0.00042
Pigmentiphaga aceris	1940612	S	1487	111	1598	0.00010
Castellaniella defragrans	75697	S	3562	2506	6068	0.00038
Orrella dioscoreae	1851544	S	2940	1107	4047	0.00026
Orrella marina	2163011	S	399	75	474	0.00003
Orrella sp. f23	2782176	S	200	13	213	0.00001
Alcaligenes faecalis	511	S	755	676	1431	0.00009
Alcaligenes sp. SORT26	2813780	S	211	41	252	0.00002
Alcaligenes sp. DN25	1367435	S	53	119	172	0.00001
Alcaligenes aquatilis	323284	S	137	495	632	0.00004
Alcaligenes ammonioxydans	2582914	S	13	144	157	0.00001
Pusillimonas thiosulfatoxidans	2028345	S	850	258	1108	0.00007
Pusillimonas sp. T7-7	1007105	S	585	100	685	0.00004
Pusillimonas sp. DMV24BSW_D	2716226	S	262	20	282	0.00002
Paralcaligenes sp. KSB-10	2901142	S	982	44	1026	0.00006
Kerstersia gyiorum	206506	S	961	215	1176	0.00007
Advenella kashmirensis	310575	S	429	28	457	0.00003
Advenella mimigardefordensis	302406	S	404	26	430	0.00003
Oligella urethralis	90245	S	93	15	108	0.00001
Oligella ureolytica	90244	S	60	51	111	0.00001
Paenalcaligenes hominis	643674	S	59	3	62	0.00000
Basilea psittacipulmonis	1472345	S	42	4	46	0.00000
Pelistega ratti	2652177	S	37	6	43	0.00000
Taylorella asinigenitalis	84590	S	13	1	14	0.00000
Taylorella equigenitalis	29575	S	12	1	13	0.00000
Rhizobacter sp. AJA081-3	2753607	S	8985	2463	11448	0.00072
Rhizobacter gummiphilus	946333	S	8697	1846	10543	0.00067
Sphaerotilus sp. FB-5	2914710	S	5892	3925	9817	0.00062
Sphaerotilus natans	34103	S	5386	2260	7646	0.00048
Mitsuaria sp. 7	1658665	S	10662	2276	12938	0.00082
Methylibium sp. Pch-M	2082386	S	3140	2987	6127	0.00039
Methylibium petroleiphilum	105560	S	3088	3132	6220	0.00039
Rubrivivax gelatinosus	28068	S	9071	3052	12123	0.00077
Aquincola tertiaricarbonis	391953	S	7524	2765	10289	0.00065
Thiomonas sp. X19	1050370	S	2820	1043	3863	0.00024
Thiomonas intermedia	926	S	1872	274	2146	0.00014
Thiomonas arsenitoxydans	426114	S	653	1201	1854	0.00012
Leptothrix cholodnii	34029	S	6204	2119	8323	0.00053
Xylophilus rhododendri	2697032	S	4320	1312	5632	0.00036
Tepidimonas taiwanensis	307486	S	3690	1403	5093	0.00032
Ideonella dechloratans	36863	S	3391	2133	5524	0.00035
Roseateles depolymerans	76731	S	3362	688	4050	0.00026
Aquabacterium olei	1296669	S	3015	843	3858	0.00024
Inhella inkyongensis	392593	S	2123	359	2482	0.00016
Paucibacter sp. KCTC 42545	1768242	S	1626	293	1919	0.00012
Candidatus Ichthyocystis hellenicum	1561003	S	37	0	37	0.00000
Sutterella megalosphaeroides	2494234	S	1114	214	1328	0.00008
Sutterella faecalis	2584944	S	846	137	983	0.00006
Sutterella wadsworthensis	40545	S	436	60	496	0.00003
Turicimonas muris	1796652	S	176	14	190	0.00001
Thauera sp. MZ1T	85643	S	5538	5833	11371	0.00072
Thauera sp. K11	2005884	S	4962	3210	8172	0.00052
Thauera humireducens	1134435	S	3354	2117	5471	0.00035
Thauera chlorobenzoica	96773	S	2546	2556	5102	0.00032
Thauera aromatica	59405	S	2393	3531	5924	0.00037
Thauera hydrothermalis	2184083	S	1475	435	1910	0.00012
Azoarcus sp. KH32C	748247	S	5577	1085	6662	0.00042
Azoarcus sp. DD4	2027405	S	3897	2618	6515	0.00041
Azoarcus olearius	418699	S	4629	1811	6440	0.00041
Azoarcus communis	41977	S	3296	1310	4606	0.00029
Nitrogeniibacter mangrovi	2016596	S	4105	910	5015	0.00032
Nitrogeniibacter aestuarii	2815343	S	1926	222	2148	0.00014
Aromatoleum petrolei	76116	S	5102	1343	6445	0.00041
Aromatoleum aromaticum	551760	S	4075	3063	7138	0.00045
Aromatoleum pumilum	2067960	S	3774	1483	5257	0.00033
Aromatoleum bremense	76115	S	3544	2158	5702	0.00036
Azospira restricta	404405	S	9206	4882	14088	0.00089
Azospira inquinata	2785627	S	716	64	780	0.00005
Azospira oryzae	146939	S	597	1471	2068	0.00013
Azospira sp. I09	1765049	S	585	1729	2314	0.00015
Niveibacterium microcysteis	2811415	S	3037	462	3499	0.00022
Oryzomicrobium terrae	1735038	S	2354	638	2992	0.00019
Rugosibacter aromaticivorans	1565605	S	591	103	694	0.00004
Dechloromonas denitrificans	281362	S	3269	873	4142	0.00026
Dechloromonas sp. HYN0024	2231055	S	907	198	1105	0.00007
Dechloromonas sp. TW-R-39-2	2654218	S	559	272	831	0.00005
Ferribacterium limneticum	76259	S	4302	781	5083	0.00032
Quatrionicoccus australiensis	138118	S	1811	573	2384	0.00015
Fluviibacter phosphoraccumulans	1751046	S	309	116	425	0.00003
Usitatibacter rugosus	2732067	S	15450	1924	17374	0.00110
Usitatibacter palustris	2732487	S	12518	1658	14176	0.00090
Denitratisoma sp. DHT3	1981880	S	3230	2467	5697	0.00036
Denitratisoma oestradiolicum	311182	S	1675	298	1973	0.00012
Sulfuritalea hydrogenivorans	748811	S	3910	635	4545	0.00029
Methyloversatilis sp. RAC08	1842540	S	3392	481	3873	0.00024
Sterolibacterium denitrificans	157592	S	2481	722	3203	0.00020
Thiobacillus denitrificans	36861	S	5038	1054	6092	0.00039
Sulfuritortus calidifontis	1914471	S	3487	1556	5043	0.00032
Sideroxydans sp. MIZ01	2764705	S	1916	443	2359	0.00015
Sideroxydans lithotrophicus	63745	S	1459	249	1708	0.00011
Ferrigenium kumadai	1682490	S	2393	540	2933	0.00019
Ferriphaselus amnicola	1188319	S	703	105	808	0.00005
Candidatus Nitrotoga arctica	453162	S	249	100	349	0.00002
Candidatus Nitrotoga sp. AM1P	2559597	S	190	82	272	0.00002
Gallionella capsiferriformans	370405	S	485	49	534	0.00003
Nitrosospira multiformis	1231	S	3171	123	3294	0.00021
Nitrosospira lacus	1288494	S	783	32	815	0.00005
Nitrosospira sp. NRS527	155925	S	334	252	586	0.00004
Nitrosospira briensis	35799	S	257	208	465	0.00003
Nitrosomonas communis	44574	S	1856	56	1912	0.00012
Nitrosomonas ureae	44577	S	408	15	423	0.00003
Nitrosomonas europaea	915	S	286	44	330	0.00002
Nitrosomonas eutropha	916	S	171	105	276	0.00002
Nitrosomonas stercoris	1444684	S	68	40	108	0.00001
Sulfurimicrobium lacus	2715678	S	2615	359	2974	0.00019
Sulfuriferula plumbiphila	171865	S	1620	298	1918	0.00012
Sulfuriferula sp. AH1	1985873	S	741	157	898	0.00006
Sulfuriferula nivalis	2675298	S	144	12	156	0.00001
Sulfuricella denitrificans	649841	S	1363	135	1498	0.00009
Methylovorus glucosotrophus	266009	S	242	180	422	0.00003
Methylovorus sp. MP688	887061	S	203	167	370	0.00002
Methylobacillus flagellatus	405	S	695	179	874	0.00006
Methylophilus sp. TWE2	1662285	S	177	11	188	0.00001
Methylophilus medardicus	2588534	S	151	12	163	0.00001
Candidatus Methylopumilus turicensis	1581680	S	60	8	68	0.00000
Candidatus Methylopumilus universalis	2588536	S	53	17	70	0.00000
Candidatus Methylopumilus planktonicus	1581557	S	32	11	43	0.00000
Candidatus Methylopumilus rimovensis	2588535	S	13	1	14	0.00000
Methylotenera mobilis	359408	S	120	11	131	0.00001
Methylotenera versatilis	1055487	S	47	4	51	0.00000
Methyloradius palustris	2778876	S	135	11	146	0.00001
Chromobacterium sp. ATCC 53434	2059672	S	2049	761	2810	0.00018
Chromobacterium sp. Rain0013	2292447	S	348	435	783	0.00005
Chromobacterium sp. Beijing	2735795	S	282	805	1087	0.00007
Chromobacterium violaceum	536	S	2052	1303	3355	0.00021
Chromobacterium vaccinii	1108595	S	1996	911	2907	0.00018
Chromobacterium phragmitis	2202141	S	1294	601	1895	0.00012
Chromobacterium paludis	2605945	S	1142	478	1620	0.00010
Chromobacterium rhizoryzae	1778675	S	372	1955	2327	0.00015
Chromobacterium haemolyticum	394935	S	207	1353	1560	0.00010
Iodobacter ciconiae	2496266	S	140	35	175	0.00001
Iodobacter fluviatilis	537	S	129	37	166	0.00001
Jeongeupia sp. USM3	1906741	S	3092	862	3954	0.00025
Jeongeupia sp. HS-3	1009682	S	1270	267	1537	0.00010
Paludibacterium paludis	1225769	S	1492	315	1807	0.00011
Paludibacterium yongneupense	400061	S	1380	208	1588	0.00010
Paludibacterium sp. B53371	2806263	S	975	215	1190	0.00008
Pseudogulbenkiania sp. NH8B	748280	S	2975	1067	4042	0.00026
Vogesella sp. LIG4	1192162	S	1754	487	2241	0.00014
Vogesella sp. XCS3	2877939	S	762	222	984	0.00006
Microvirgula aerodenitrificans	57480	S	1935	386	2321	0.00015
Aquitalea aquatilis	1537400	S	522	172	694	0.00004
Aquitalea denitrificans	519081	S	363	192	555	0.00004
Aquitalea magnusonii	332411	S	342	201	543	0.00003
Aquitalea sp. USM4	1590041	S	327	183	510	0.00003
Laribacter hongkongensis	168471	S	1556	1501	3057	0.00019
Aquaspirillum sp. LM1	1938604	S	1003	156	1159	0.00007
Deefgea sp. D17	2739061	S	130	39	169	0.00001
Deefgea sp. D25	2865840	S	107	15	122	0.00001
Deefgea sp. D13	2864875	S	90	22	112	0.00001
Chitinibacter bivalviorum	2739434	S	167	143	310	0.00002
Chitinibacter fontanus	1737446	S	159	28	187	0.00001
Neisseria sp. KEM232	655307	S	409	63	472	0.00003
Neisseria sp. oral taxon 014	641148	S	183	83	266	0.00002
Neisseria sp. ZJ785	2709396	S	122	16	138	0.00001
Neisseria sp. Dent CA1/247	2912675	S	79	38	117	0.00001
Neisseria bacilliformis	267212	S	444	109	553	0.00004
Neisseria shayeganii	607712	S	379	58	437	0.00003
Neisseria elongata	495	S	336	176	512	0.00003
Neisseria chenwenguii	1853278	S	334	44	378	0.00002
Neisseria meningitidis	487	S	291	723	1014	0.00006
Neisseria dentiae	194197	S	281	36	317	0.00002
Neisseria musculi	1815583	S	243	24	267	0.00002
Neisseria animalis	492	S	172	26	198	0.00001
Neisseria gonorrhoeae	485	S	163	825	988	0.00006
Neisseria lactamica	486	S	157	190	347	0.00002
Neisseria weaveri	28091	S	135	59	194	0.00001
Neisseria animaloris	326522	S	106	24	130	0.00001
Neisseria brasiliensis	2666100	S	97	100	197	0.00001
Neisseria weixii	1853276	S	97	12	109	0.00001
Neisseria zalophi	640030	S	89	10	99	0.00001
Neisseria sicca	490	S	89	176	265	0.00002
Neisseria mucosa	488	S	85	193	278	0.00002
Neisseria canis	493	S	83	21	104	0.00001
Neisseria dumasiana	1931275	S	83	36	119	0.00001
Neisseria arctica	1470200	S	79	8	87	0.00001
Neisseria wadsworthii	607711	S	72	16	88	0.00001
Neisseria macacae	496	S	55	123	178	0.00001
Neisseria zoodegmatis	326523	S	48	33	81	0.00001
Neisseria flavescens	484	S	36	28	64	0.00000
Neisseria cinerea	483	S	35	22	57	0.00000
Neisseria subflava	28449	S	33	26	59	0.00000
Crenobacter cavernae	2290923	S	3569	1243	4812	0.00030
Chitinolyticbacter meiyuanensis	682798	S	2362	302	2664	0.00017
Vitreoscilla filiformis	63	S	1012	189	1201	0.00008
Vitreoscilla massiliensis	1689272	S	97	51	148	0.00001
Kingella potus	265175	S	305	43	348	0.00002
Kingella oralis	505	S	240	39	279	0.00002
Kingella denitrificans	502	S	226	152	378	0.00002
Kingella kingae	504	S	68	11	79	0.00001
Eikenella corrodens	539	S	347	221	568	0.00004
Eikenella exigua	2528037	S	118	79	197	0.00001
Uruburuella suis	252130	S	309	51	360	0.00002
Uruburuella testudinis	1282863	S	251	49	300	0.00002
Paralysiella testudinis	2809020	S	240	52	292	0.00002
Alysiella filiformis	194196	S	71	21	92	0.00001
Alysiella crassa	153491	S	66	19	85	0.00001
Conchiformibius steedae	153493	S	124	20	144	0.00001
Neisseriaceae bacterium CCUG 44465	2917790	S	86	14	100	0.00001
Snodgrassella alvi	1196083	S	53	18	71	0.00000
Morococcus cerebrosus	1056807	S	49	252	301	0.00002
Aquella oligotrophica	2067065	S	47	2	49	0.00000
Simonsiella muelleri	72	S	23	4	27	0.00000
Casimicrobium huifangae	2591109	S	2553	1211	3764	0.00024
Candidatus Kinetoplastibacterium galatii	994695	S	13	6	19	0.00000
Pseudomonas sp. LPB0260	2614442	S	4293	803	5096	0.00032
Pseudomonas sp. CC6-YY-74	1930532	S	3969	441	4410	0.00028
Pseudomonas sp. TCU-HL1	1856685	S	3677	472	4149	0.00026
Pseudomonas sp. DY-1	1755504	S	2966	340	3306	0.00021
Pseudomonas sp. ATCC 13867	1294143	S	2872	920	3792	0.00024
Pseudomonas sp. SCB32	2653853	S	2602	507	3109	0.00020
Pseudomonas sp. PDNC002	2811422	S	2572	507	3079	0.00019
Pseudomonas sp. MM211	2866808	S	2024	169	2193	0.00014
Pseudomonas sp. MTM4	2705472	S	1935	296	2231	0.00014
Pseudomonas sp. ABC1	2748080	S	1929	252	2181	0.00014
Pseudomonas sp. B11D7D	2735906	S	1920	313	2233	0.00014
Pseudomonas sp. KNUC1026	2893890	S	1903	171	2074	0.00013
Pseudomonas sp. Pc102	2678261	S	1681	693	2374	0.00015
Pseudomonas sp. Ost2	2678260	S	1594	203	1797	0.00011
Pseudomonas sp. MSPm1	2726956	S	1545	275	1820	0.00012
Pseudomonas sp. StFLB209	1028989	S	1358	340	1698	0.00011
Pseudomonas sp. 7SR1	1881017	S	1273	208	1481	0.00009
Pseudomonas sp. p1(2021b)	2874628	S	1219	610	1829	0.00012
Pseudomonas sp. L5B5	2883205	S	1160	186	1346	0.00009
Pseudomonas sp. CMR5c	658630	S	1141	291	1432	0.00009
Pseudomonas sp. LPH1	1898684	S	1072	729	1801	0.00011
Pseudomonas sp. OIL-1	2706126	S	910	149	1059	0.00007
Pseudomonas sp. HLS-6	2049589	S	874	254	1128	0.00007
Pseudomonas sp. DG56-2	2320270	S	847	86	933	0.00006
Pseudomonas sp. HN2-3	2886360	S	782	154	936	0.00006
Pseudomonas sp. M30-35	1981174	S	741	41	782	0.00005
Pseudomonas sp. M1	95619	S	740	1487	2227	0.00014
Pseudomonas sp. LAB-08	143813	S	718	117	835	0.00005
Pseudomonas sp. gcc21	2726989	S	718	309	1027	0.00006
Pseudomonas sp. Marseille-Q3773	2866592	S	679	195	874	0.00006
Pseudomonas sp. MPC6	2498848	S	679	125	804	0.00005
Pseudomonas sp. ADPe	2774873	S	648	1377	2025	0.00013
Pseudomonas sp. S34	1573718	S	620	129	749	0.00005
Pseudomonas sp. S09G 359	2054919	S	604	125	729	0.00005
Pseudomonas sp. Leaf58	1736226	S	591	100	691	0.00004
Pseudomonas sp. 15A4	2804761	S	585	114	699	0.00004
Pseudomonas sp. URMO17WK12:I11	1283291	S	581	312	893	0.00006
Pseudomonas sp. ADAK13	2730847	S	572	112	684	0.00004
Pseudomonas sp. Tri1	2823875	S	549	106	655	0.00004
Pseudomonas sp. Seg1	2678259	S	519	104	623	0.00004
Pseudomonas sp. DTU12.3	2073078	S	519	116	635	0.00004
Pseudomonas sp. R5-89-07	658644	S	516	146	662	0.00004
Pseudomonas sp. MM213	2866807	S	505	94	599	0.00004
Pseudomonas sp. DNDY-54	2870860	S	497	180	677	0.00004
Pseudomonas sp. S35	1573719	S	496	116	612	0.00004
Pseudomonas sp. RtIB026	2749999	S	486	254	740	0.00005
Pseudomonas sp. 2hn	2866626	S	481	285	766	0.00005
Pseudomonas sp. 31-12	2201356	S	450	98	548	0.00003
Pseudomonas sp. ACM7	2052956	S	440	64	504	0.00003
Pseudomonas sp. PP3	2815936	S	438	151	589	0.00004
Pseudomonas sp. NIBR-H-19	2901380	S	432	84	516	0.00003
Pseudomonas sp. THAF7b	2587845	S	416	691	1107	0.00007
Pseudomonas sp. HS6	2850559	S	409	86	495	0.00003
Pseudomonas sp. DR48	2871095	S	407	274	681	0.00004
Pseudomonas sp. HN11	1344094	S	401	78	479	0.00003
Pseudomonas sp. OE 28.3	2745519	S	401	85	486	0.00003
Pseudomonas sp. ADAK18	2730848	S	396	59	455	0.00003
Pseudomonas sp. RC3H12	2834406	S	395	212	607	0.00004
Pseudomonas sp. R2A2	2213057	S	386	367	753	0.00005
Pseudomonas sp. LG1E9	2219057	S	384	100	484	0.00003
Pseudomonas sp. phDV1	253237	S	379	1140	1519	0.00010
Pseudomonas sp. SK3(2021)	2841064	S	374	182	556	0.00004
Pseudomonas sp. St316	2678257	S	362	94	456	0.00003
Pseudomonas sp. MRSN12121	1611770	S	355	406	761	0.00005
Pseudomonas sp. SK	2729423	S	347	239	586	0.00004
Pseudomonas sp. LS.1a	2920387	S	345	125	470	0.00003
Pseudomonas sp. HS-18	2879114	S	341	538	879	0.00006
Pseudomonas sp. IzPS59	2774459	S	338	128	466	0.00003
Pseudomonas sp. R84	1573712	S	307	132	439	0.00003
Pseudomonas sp. NIBRBAC000502773	2590776	S	294	117	411	0.00003
Pseudomonas sp. NS1(2017)	2025658	S	294	61	355	0.00002
Pseudomonas sp. CCOS 191	1649877	S	281	203	484	0.00003
Pseudomonas sp. UW4	1207075	S	278	142	420	0.00003
Pseudomonas sp. SDM007	2812000	S	268	167	435	0.00003
Pseudomonas sp. RBPA9	2746321	S	262	413	675	0.00004
Pseudomonas sp. CYM-20-01	2870750	S	261	100	361	0.00002
Pseudomonas sp. LTJR-52	2479392	S	256	65	321	0.00002
Pseudomonas sp. SCA2728.1_7	2825975	S	255	128	383	0.00002
Pseudomonas sp. AO-1	2855434	S	252	237	489	0.00003
Pseudomonas sp. 14181154	2662033	S	250	239	489	0.00003
Pseudomonas sp. FIT81	2837969	S	236	110	346	0.00002
Pseudomonas sp. R76	1573711	S	235	90	325	0.00002
Pseudomonas sp. Z003-0.4C(8344-21)	1855380	S	233	123	356	0.00002
Pseudomonas sp. S07E 245	2866278	S	227	579	806	0.00005
Pseudomonas sp. 02C 26	2054914	S	221	532	753	0.00005
Pseudomonas sp. B10	118613	S	195	106	301	0.00002
Pseudomonas sp. 09C 129	2054915	S	191	171	362	0.00002
Pseudomonas sp. Cab53	2678258	S	189	219	408	0.00003
Pseudomonas sp. FGI182	1259844	S	185	160	345	0.00002
Pseudomonas sp. BIGb0427	2724470	S	182	435	617	0.00004
Pseudomonas sp. MPFS	2795724	S	181	254	435	0.00003
Pseudomonas sp. 3-2	2867408	S	177	208	385	0.00002
Pseudomonas sp. SORT22	2813842	S	172	438	610	0.00004
Pseudomonas sp. DR 5-09	1534110	S	161	198	359	0.00002
Pseudomonas sp. HN2	2884805	S	145	94	239	0.00002
Pseudomonas sp. MYb193	1827300	S	144	143	287	0.00002
Pseudomonas sp. BIOMIG1BAC	1758730	S	140	388	528	0.00003
Pseudomonas sp. J380	2605424	S	135	157	292	0.00002
Pseudomonas sp. Y5-11	2749808	S	134	416	550	0.00003
Pseudomonas sp. St29	1500687	S	133	559	692	0.00004
Pseudomonas sp. LBUM920	2126069	S	132	349	481	0.00003
Pseudomonas sp. SC3(2021)	2871493	S	124	99	223	0.00001
Pseudomonas sp. ATCC 43928	676210	S	118	289	407	0.00003
Pseudomonas sp. AN-B15	2697023	S	117	338	455	0.00003
Pseudomonas sp. FDAARGOS_380	2018067	S	114	70	184	0.00001
Pseudomonas sp. ADAK22	2730851	S	113	302	415	0.00003
Pseudomonas sp. RU47	2005388	S	111	294	405	0.00003
Pseudomonas sp. PONIH3	1636610	S	102	514	616	0.00004
Pseudomonas sp. S150	2559074	S	101	116	217	0.00001
Pseudomonas sp. C27(2019)	2604941	S	101	14	115	0.00001
Pseudomonas sp. SXM-1	2169583	S	100	251	351	0.00002
Pseudomonas sp. R32	1573704	S	96	177	273	0.00002
Pseudomonas sp. R3-18-08	1173283	S	94	287	381	0.00002
Pseudomonas sp. SWI36	2083052	S	94	219	313	0.00002
Pseudomonas sp. LG1D9	2083054	S	92	361	453	0.00003
Pseudomonas sp. GR 6-02	1659194	S	92	223	315	0.00002
Pseudomonas sp. S49	1573720	S	90	241	331	0.00002
Pseudomonas sp. BC42	2933816	S	88	451	539	0.00003
Pseudomonas sp. CFSAN084952	2664899	S	81	172	253	0.00002
Pseudomonas sp. A214	1855331	S	80	189	269	0.00002
Pseudomonas sp. PS1(2021)	2866282	S	76	1961	2037	0.00013
Pseudomonas sp. ArH3a	2862945	S	74	193	267	0.00002
Pseudomonas sp. Os17	1500686	S	70	359	429	0.00003
Pseudomonas sp. IAC-BECa141	2793103	S	69	102	171	0.00001
Pseudomonas sp. Y39-6	2749807	S	68	161	229	0.00001
Pseudomonas sp. R1-43-08	1173270	S	68	423	491	0.00003
Pseudomonas sp. MPDS	2762896	S	67	218	285	0.00002
Pseudomonas sp. DR208	2870840	S	67	115	182	0.00001
Pseudomonas sp. HN8-3	2886361	S	64	92	156	0.00001
Pseudomonas sp. NC02	2067572	S	62	166	228	0.00001
Pseudomonas sp. SWI44	2083053	S	62	561	623	0.00004
Pseudomonas sp. Colony2	2861799	S	62	215	277	0.00002
Pseudomonas sp. TKP	1415630	S	60	146	206	0.00001
Pseudomonas sp. A2	107445	S	56	268	324	0.00002
Pseudomonas sp. R2-37-08W	1173273	S	55	273	328	0.00002
Pseudomonas sp. CFA	2651048	S	55	231	286	0.00002
Pseudomonas sp. TMW 2.1634	1886807	S	54	103	157	0.00001
Pseudomonas sp. R3-52-08	1173284	S	54	344	398	0.00003
Pseudomonas sp. BYT-1	2816906	S	54	395	449	0.00003
Pseudomonas sp. IB20	1702250	S	50	304	354	0.00002
Pseudomonas sp. R4-39-08	1173288	S	50	310	360	0.00002
Pseudomonas sp. R4-35-07	658643	S	50	356	406	0.00003
Pseudomonas sp. OST1909	2777367	S	49	107	156	0.00001
Pseudomonas sp. Eqa60	2799184	S	49	195	244	0.00002
Pseudomonas sp. 7-41	2898483	S	49	160	209	0.00001
Pseudomonas sp. BJP69	2597770	S	48	247	295	0.00002
Pseudomonas sp. DTU12.1	2654238	S	47	197	244	0.00002
Pseudomonas sp. XWY-1	2069256	S	45	234	279	0.00002
Pseudomonas sp. CIP-10	2892442	S	45	346	391	0.00002
Pseudomonas sp. St290	1602166	S	44	120	164	0.00001
Pseudomonas sp. VLB120	69328	S	41	601	642	0.00004
Pseudomonas sp. So3.2b	2864101	S	39	88	127	0.00001
Pseudomonas sp. B14-6	2738843	S	36	72	108	0.00001
Pseudomonas sp. R11-23-07	658632	S	35	330	365	0.00002
Pseudomonas sp. R2-60-08W	1173280	S	33	243	276	0.00002
Pseudomonas sp. SW-3	147212	S	32	88	120	0.00001
Pseudomonas sp. LH1G9	2083055	S	31	77	108	0.00001
Pseudomonas sp. R2-7-07	658641	S	30	298	328	0.00002
Pseudomonas sp. SWI6	2083051	S	30	535	565	0.00004
Pseudomonas sp. R4-34-07	658642	S	29	176	205	0.00001
Pseudomonas sp. SK2	2841063	S	25	487	512	0.00003
Pseudomonas sp. SWI7	2587597	S	24	116	140	0.00001
Pseudomonas sp. I3-I5	2926671	S	23	68	91	0.00001
Pseudomonas sp. KUIN-1	2609418	S	17	68	85	0.00001
Pseudomonas sp. 13159349	2662034	S	16	116	132	0.00001
Pseudomonas sp. bs2935	1761895	S	15	323	338	0.00002
Pseudomonas sp. St386	2678256	S	15	85	100	0.00001
Pseudomonas sp. JY-Q	1338689	S	14	84	98	0.00001
Pseudomonas sp. LTGT-11-2Z	2479393	S	11	247	258	0.00002
Pseudomonas aeruginosa	287	S	14101	164165	178266	0.01126
Pseudomonas mendocina	300	S	11523	3559	15082	0.00095
Pseudomonas alcaligenes	43263	S	7974	5071	13045	0.00082
Pseudomonas furukawaii	1149133	S	4586	1269	5855	0.00037
Pseudomonas oleovorans	301	S	935	2040	2975	0.00019
Pseudomonas resinovorans	53412	S	4477	865	5342	0.00034
Pseudomonas multiresinivorans	95301	S	1473	414	1887	0.00012
Pseudomonas nitroreducens	46680	S	407	707	1114	0.00007
Pseudomonas citronellolis	53408	S	1588	1813	3401	0.00021
Pseudomonas stutzeri	316	S	27252	15203	42455	0.00268
Pseudomonas chloritidismutans	203192	S	249	273	522	0.00003
Pseudomonas balearica	74829	S	4170	4782	8952	0.00057
Pseudomonas xanthomarina	271420	S	1130	160	1290	0.00008
Pseudomonas luteola	47886	S	266	97	363	0.00002
Pseudomonas fluorescens	294	S	10335	6040	16375	0.00103
Pseudomonas protegens	380021	S	2612	4877	7489	0.00047
Pseudomonas orientalis	76758	S	1801	408	2209	0.00014
Pseudomonas azotoformans	47878	S	1324	400	1724	0.00011
Pseudomonas synxantha	47883	S	1221	717	1938	0.00012
Pseudomonas poae	200451	S	932	441	1373	0.00009
Pseudomonas rhodesiae	76760	S	932	325	1257	0.00008
Pseudomonas mediterranea	183795	S	910	208	1118	0.00007
Pseudomonas corrugata	47879	S	846	167	1013	0.00006
Pseudomonas trivialis	200450	S	805	243	1048	0.00007
Pseudomonas tolaasii	29442	S	660	101	761	0.00005
Pseudomonas migulae	78543	S	623	311	934	0.00006
Pseudomonas mucidolens	46679	S	607	77	684	0.00004
Pseudomonas cedrina	651740	S	554	123	677	0.00004
Pseudomonas congelans	200452	S	464	100	564	0.00004
Pseudomonas brenneri	129817	S	346	118	464	0.00003
Pseudomonas libanensis	75588	S	343	333	676	0.00004
Pseudomonas ogarae	1114970	S	239	127	366	0.00002
Pseudomonas mandelii	75612	S	204	355	559	0.00004
Pseudomonas veronii	76761	S	202	378	580	0.00004
Pseudomonas extremorientalis	169669	S	58	93	151	0.00001
Pseudomonas putida	303	S	13019	13308	26327	0.00166
Pseudomonas fulva	47880	S	4238	9280	13518	0.00085
Pseudomonas oryzihabitans	47885	S	3888	665	4553	0.00029
Pseudomonas plecoglossicida	70775	S	898	576	1474	0.00009
Pseudomonas mosselii	78327	S	493	801	1294	0.00008
Pseudomonas monteilii	76759	S	468	675	1143	0.00007
Pseudomonas sp. SGAir0191	2217867	S	234	105	339	0.00002
Pseudomonas shirazica	1940636	S	37	406	443	0.00003
Pseudomonas syringae	317	S	3403	3253	6656	0.00042
Pseudomonas viridiflava	33069	S	2262	238	2500	0.00016
Pseudomonas cichorii	36746	S	1498	120	1618	0.00010
Pseudomonas asturiensis	1190415	S	817	77	894	0.00006
Pseudomonas amygdali	47877	S	304	1160	1464	0.00009
Pseudomonas savastanoi	29438	S	142	452	594	0.00004
Pseudomonas syringae group genomosp. 7	251699	S	612	68	680	0.00004
Pseudomonas fuscovaginae	50340	S	348	138	486	0.00003
Pseudomonas syringae group genomosp. 3	251701	S	169	2033	2202	0.00014
Pseudomonas avellanae	46257	S	145	195	340	0.00002
Pseudomonas coronafaciens	53409	S	135	333	468	0.00003
Pseudomonas sp. Lz4W	1206777	S	64	74	138	0.00001
Pseudomonas tremae	200454	S	32	67	99	0.00001
Pseudomonas chlororaphis	587753	S	6882	5487	12369	0.00078
Pseudomonas lundensis	86185	S	709	80	789	0.00005
Pseudomonas fragi	296	S	358	213	571	0.00004
Pseudomonas otitidis	319939	S	7780	1551	9331	0.00059
Pseudomonas cavernae	2320867	S	5620	816	6436	0.00041
Pseudomonas oryzae	1392877	S	4890	1465	6355	0.00040
Pseudomonas knackmussii	65741	S	4888	3615	8503	0.00054
Pseudomonas psychrotolerans	237610	S	4330	783	5113	0.00032
Pseudomonas lalkuanensis	2604832	S	4060	672	4732	0.00030
Pseudomonas campi	2731681	S	3627	445	4072	0.00026
Pseudomonas guangdongensis	1245526	S	3046	920	3966	0.00025
Pseudomonas entomophila	312306	S	2629	884	3513	0.00022
Pseudomonas tohonis	2725477	S	1697	1084	2781	0.00018
Pseudomonas parafulva	157782	S	1685	381	2066	0.00013
Pseudomonas saudiphocaensis	1499686	S	1655	360	2015	0.00013
Pseudomonas qingdaonensis	2056231	S	1591	281	1872	0.00012
Pseudomonas pohangensis	364197	S	1545	107	1652	0.00010
Pseudomonas vanderleydeniana	2745495	S	1526	181	1707	0.00011
Pseudomonas argentinensis	289370	S	1525	281	1806	0.00011
Pseudomonas eucalypticola	2599595	S	1429	164	1593	0.00010
Pseudomonas wenzhouensis	2906062	S	1331	409	1740	0.00011
Pseudomonas zhaodongensis	1176257	S	1295	455	1750	0.00011
Pseudomonas nanhaiensis	2830842	S	1283	127	1410	0.00009
Pseudomonas alkylphenolica	237609	S	1271	211	1482	0.00009
Pseudomonas rhizosphaerae	216142	S	1218	136	1354	0.00009
Pseudomonas cremoricolorata	157783	S	1176	161	1337	0.00008
Pseudomonas brassicacearum	930166	S	1174	1367	2541	0.00016
Pseudomonas frederiksbergensis	104087	S	1166	253	1419	0.00009
Pseudomonas sediminis	1691904	S	1158	260	1418	0.00009
Pseudomonas toyotomiensis	554344	S	1135	718	1853	0.00012
Pseudomonas marincola	437900	S	1113	163	1276	0.00008
Pseudomonas phragmitis	1931241	S	1051	79	1130	0.00007
Pseudomonas yamanorum	515393	S	987	160	1147	0.00007
Pseudomonas muyukensis	2842357	S	954	225	1179	0.00007
Pseudomonas umsongensis	198618	S	922	120	1042	0.00007
Pseudomonas alvandae	2842348	S	891	111	1002	0.00006
Pseudomonas xantholysinigenes	2745490	S	808	176	984	0.00006
Pseudomonas tructae	2518644	S	774	111	885	0.00006
Pseudomonas koreensis	198620	S	763	210	973	0.00006
Pseudomonas palleroniana	191390	S	759	94	853	0.00005
Pseudomonas agarici	46677	S	738	28	766	0.00005
Pseudomonas vancouverensis	95300	S	707	90	797	0.00005
Pseudomonas antarctica	219572	S	688	125	813	0.00005
Pseudomonas fakonensis	2842355	S	669	160	829	0.00005
Pseudomonas prosekii	1148509	S	662	88	750	0.00005
Pseudomonas hamedanensis	2745504	S	658	90	748	0.00005
Pseudomonas promysalinigenes	485898	S	655	88	743	0.00005
Pseudomonas silesiensis	1853130	S	646	106	752	0.00005
Pseudomonas thivervalensis	86265	S	640	93	733	0.00005
Pseudomonas alcaliphila	101564	S	638	525	1163	0.00007
Pseudomonas xanthosomae	2842356	S	636	154	790	0.00005
Pseudomonas extremaustralis	359110	S	620	104	724	0.00005
Pseudomonas granadensis	1421430	S	569	187	756	0.00005
Pseudomonas khazarica	2502979	S	566	473	1039	0.00007
Pseudomonas arsenicoxydans	702115	S	563	83	646	0.00004
Pseudomonas graminis	158627	S	556	109	665	0.00004
Pseudomonas sihuiensis	1274359	S	538	509	1047	0.00007
Pseudomonas taetrolens	47884	S	537	60	597	0.00004
Pseudomonas maumuensis	2842354	S	513	182	695	0.00004
Pseudomonas chengduensis	489632	S	493	816	1309	0.00008
Pseudomonas lurida	244566	S	480	78	558	0.00004
Pseudomonas viciae	2505979	S	480	84	564	0.00004
Pseudomonas simiae	321846	S	476	86	562	0.00004
Pseudomonas asgharzadehiana	2842349	S	458	81	539	0.00003
Pseudomonas lini	163011	S	436	66	502	0.00003
Pseudomonas reinekei	395598	S	432	89	521	0.00003
Pseudomonas psychrophila	122355	S	412	48	460	0.00003
Pseudomonas versuta	1788301	S	398	53	451	0.00003
Pseudomonas kunmingensis	1211807	S	377	400	777	0.00005
Pseudomonas allokribbensis	2774460	S	342	94	436	0.00003
Pseudomonas kribbensis	1628086	S	330	210	540	0.00003
Pseudomonas asplenii	53407	S	298	123	421	0.00003
Pseudomonas moraviensis	321662	S	296	322	618	0.00004
Pseudomonas oryziphila	2894079	S	281	156	437	0.00003
Pseudomonas tritici	2745518	S	274	60	334	0.00002
Pseudomonas atacamensis	2565368	S	241	153	394	0.00002
Pseudomonas gozinkensis	2774461	S	240	77	317	0.00002
Pseudomonas zarinae	2745498	S	231	115	346	0.00002
Pseudomonas tensinigenes	2745511	S	216	83	299	0.00002
Pseudomonas zeae	2745510	S	213	72	285	0.00002
Pseudomonas anuradhapurensis	485870	S	212	132	344	0.00002
Pseudomonas azerbaijanoriens	2842350	S	212	97	309	0.00002
Pseudomonas germanica	2815720	S	208	76	284	0.00002
Pseudomonas iranensis	2745503	S	200	100	300	0.00002
Pseudomonas soli	1306993	S	149	452	601	0.00004
Pseudomonas lactis	1615674	S	147	72	219	0.00001
Pseudomonas monsensis	2745509	S	139	98	237	0.00002
Pseudomonas salmasensis	2745514	S	128	56	184	0.00001
Pseudomonas juntendi	2666183	S	125	959	1084	0.00007
Pseudomonas sessilinigenes	658629	S	95	156	251	0.00002
Pseudomonas bijieensis	2681983	S	84	200	284	0.00002
Pseudomonas donghuensis	1163398	S	72	132	204	0.00001
Pseudomonas asiatica	2219225	S	70	259	329	0.00002
Pseudomonas glycinae	1785145	S	70	82	152	0.00001
Pseudomonas rhizophila	2045200	S	61	98	159	0.00001
Pseudomonas cerasi	1583341	S	49	68	117	0.00001
Pseudomonas shahriarae	2745512	S	38	95	133	0.00001
Candidatus Pseudomonas adelgestsugas	1302376	S	33	0	33	0.00000
Pseudomonas taiwanensis	470150	S	20	170	190	0.00001
Azotobacter chroococcum	353	S	3293	1778	5071	0.00032
Azotobacter salinestris	69964	S	2138	969	3107	0.00020
Azotobacter vinelandii	354	S	2098	1464	3562	0.00023
Halopseudomonas xinjiangensis	487184	S	907	82	989	0.00006
Halopseudomonas sabulinigri	472181	S	757	66	823	0.00005
Halopseudomonas aestusnigri	857252	S	714	462	1176	0.00007
Halopseudomonas sp. RR6	2918528	S	679	103	782	0.00005
Halopseudomonas litoralis	797277	S	555	127	682	0.00004
Halopseudomonas salegens	1434072	S	469	33	502	0.00003
Permianibacter aggregans	1510150	S	1576	49	1625	0.00010
Thiopseudomonas alkaliphila	1697053	S	86	17	103	0.00001
Entomomonas sp. F2A	2785331	S	26	6	32	0.00000
Entomomonas moraniae	2213226	S	19	4	23	0.00000
Marinobacter sp. CA1	2817656	S	940	68	1008	0.00006
Marinobacter sp. Arc7-DN-1	2304594	S	575	78	653	0.00004
Marinobacter sp. LPB0319	2769486	S	567	35	602	0.00004
Marinobacter sp. NP-4(2019)	2488665	S	544	98	642	0.00004
Marinobacter sp. LV10R510-11A	1415568	S	285	12	297	0.00002
Marinobacter sp. LQ44	1749259	S	246	364	610	0.00004
Marinobacter sp. es.042	1761794	S	186	180	366	0.00002
Marinobacter sp. JH2	2547598	S	182	50	232	0.00001
Marinobacter sp. CP1	1671721	S	179	339	518	0.00003
Marinobacter sp. BSs20148	490759	S	178	107	285	0.00002
Marinobacter fonticola	2603215	S	771	37	808	0.00005
Marinobacter nauticus	2743	S	598	190	788	0.00005
Marinobacter salarius	1420917	S	568	72	640	0.00004
Marinobacter similis	1420916	S	449	35	484	0.00003
Marinobacter salsuginis	418719	S	429	60	489	0.00003
Marinobacter salinus	1874317	S	363	23	386	0.00002
Marinobacter adhaerens	1033846	S	158	364	522	0.00003
Marinobacter psychrophilus	330734	S	107	65	172	0.00001
Lysobacter sp. KIS68-7	2904252	S	5184	1059	6243	0.00039
Lysobacter sp. TY2-98	2290922	S	4800	810	5610	0.00035
Lysobacter sp. 5GHs7-4	2904253	S	4455	1414	5869	0.00037
Lysobacter sp. CECT 30171	2822368	S	3884	988	4872	0.00031
Lysobacter sp. S4-A87	2925843	S	3816	1282	5098	0.00032
Lysobacter sp. K5869	2820808	S	2943	1411	4354	0.00028
Lysobacter sp. CW239	2762611	S	2873	1561	4434	0.00028
Lysobacter sp. H21R4	2781021	S	771	1428	2199	0.00014
Lysobacter sp. CJ11	2764185	S	686	57	743	0.00005
Lysobacter sp. HDW10	2714936	S	500	144	644	0.00004
Lysobacter sp. H23M47	2781024	S	388	1812	2200	0.00014
Lysobacter enzymogenes	69	S	12202	4548	16750	0.00106
Lysobacter soli	453783	S	10795	2363	13158	0.00083
Lysobacter solisilvae (ex Woo and Kim 2022)	2865112	S	10109	3164	13273	0.00084
Lysobacter capsici	435897	S	7543	7649	15192	0.00096
Lysobacter solisilvae (ex Kim et al. 2021)	2763317	S	6194	1329	7523	0.00048
Lysobacter antibioticus	84531	S	5306	1148	6454	0.00041
Lysobacter maris	1605891	S	4489	1156	5645	0.00036
Lysobacter lycopersici	1324796	S	3692	847	4539	0.00029
Lysobacter arenosi	2795387	S	3668	1217	4885	0.00031
Lysobacter alkalisoli	2591633	S	3251	620	3871	0.00024
Lysobacter oculi	2698682	S	2758	804	3562	0.00023
Lysobacter gummosus	262324	S	688	5403	6091	0.00038
Lysobacter ciconiae	2781022	S	683	1189	1872	0.00012
Lysobacter avium	2781023	S	424	1820	2244	0.00014
Stenotrophomonas maltophilia	40324	S	14063	20071	34134	0.00216
Stenotrophomonas sp. ESTM1D_MKCIP4_1	2072414	S	776	329	1105	0.00007
Stenotrophomonas sp. SAU14A_NAIMI4_5	2072413	S	736	473	1209	0.00008
Stenotrophomonas sp. ZAC14D2_NAIMI4_7	2072405	S	341	374	715	0.00005
Stenotrophomonas sp. ZAC14A_NAIMI4_1	2072412	S	250	477	727	0.00005
Stenotrophomonas sp. YAU14D1_LEIMI4_1	2072407	S	249	436	685	0.00004
Stenotrophomonas sp. ZAC14D2_NAIMI4_6	2072406	S	191	380	571	0.00004
Stenotrophomonas sp. YAU14A_MKIMI4_1	2072408	S	105	606	711	0.00004
Stenotrophomonas sp. SAU14A_NAIMI4_8	2072409	S	102	589	691	0.00004
Stenotrophomonas sp. LM091	1904944	S	1397	558	1955	0.00012
Stenotrophomonas sp. 169	2770322	S	1302	226	1528	0.00010
Stenotrophomonas sp. 364	2691571	S	881	346	1227	0.00008
Stenotrophomonas sp. NA06056	2742129	S	528	260	788	0.00005
Stenotrophomonas sp. WZN-1	2005046	S	286	336	622	0.00004
Stenotrophomonas sp. DR822	2871174	S	192	314	506	0.00003
Stenotrophomonas sp. Pemsol	2040586	S	126	385	511	0.00003
Stenotrophomonas sp. pho	2211160	S	103	479	582	0.00004
Stenotrophomonas sp. ASS1	2282124	S	87	389	476	0.00003
Stenotrophomonas sp. G4	2303750	S	64	281	345	0.00002
Stenotrophomonas sp. MYb57	1827305	S	63	263	326	0.00002
Stenotrophomonas sp. CW117	2775920	S	58	1231	1289	0.00008
Stenotrophomonas sp. SI-NJAU-1	2886359	S	54	245	299	0.00002
Stenotrophomonas sp. NY11291	2939415	S	46	507	553	0.00003
Stenotrophomonas sp. SXG-1	2682487	S	33	369	402	0.00003
Stenotrophomonas rhizophila	216778	S	4340	1333	5673	0.00036
Stenotrophomonas acidaminiphila	128780	S	3316	7720	11036	0.00070
Stenotrophomonas indicatrix	2045451	S	134	512	646	0.00004
Xanthomonas translucens	343	S	4376	5811	10187	0.00064
Xanthomonas campestris	339	S	3474	10190	13664	0.00086
Xanthomonas sp. SS	2724122	S	436	760	1196	0.00008
Xanthomonas sp. GW	2724121	S	415	623	1038	0.00007
Xanthomonas sp. SI	2724123	S	386	680	1066	0.00007
Xanthomonas sp. MLO165	2081477	S	116	183	299	0.00002
Xanthomonas sacchari	56458	S	2321	867	3188	0.00020
Xanthomonas arboricola	56448	S	2052	2304	4356	0.00028
Xanthomonas oryzae	347	S	1695	745	2440	0.00015
Xanthomonas theicola	56464	S	1650	583	2233	0.00014
Xanthomonas citri	346	S	1287	6629	7916	0.00050
Xanthomonas hyacinthi	56455	S	1192	763	1955	0.00012
Xanthomonas vesicatoria	56460	S	1087	654	1741	0.00011
Xanthomonas albilineans	29447	S	1069	145	1214	0.00008
Xanthomonas hortorum	56454	S	1011	783	1794	0.00011
Xanthomonas fragariae	48664	S	975	190	1165	0.00007
Xanthomonas cucurbitae	56453	S	881	173	1054	0.00007
Xanthomonas vasicola	56459	S	775	311	1086	0.00007
Xanthomonas cassavae	56450	S	632	172	804	0.00005
Xanthomonas euroxanthea	2259622	S	541	680	1221	0.00008
Xanthomonas hydrangeae	2775159	S	484	179	663	0.00004
Xanthomonas axonopodis	53413	S	472	512	984	0.00006
Xanthomonas phaseoli	1985254	S	378	1095	1473	0.00009
Xanthomonas euvesicatoria	456327	S	249	4600	4849	0.00031
Xanthomonas perforans	442694	S	43	244	287	0.00002
Luteimonas sp. MC1750	2799326	S	3330	1303	4633	0.00029
Luteimonas sp. S4-F44	2925842	S	3013	623	3636	0.00023
Luteimonas sp. JM171	1896164	S	2913	626	3539	0.00022
Luteimonas sp. MC1572	2799325	S	2681	1358	4039	0.00026
Luteimonas sp. D4P002	2901869	S	2645	715	3360	0.00021
Luteimonas sp. YGD11-2	2508168	S	2605	1163	3768	0.00024
Luteimonas sp. MC1825	2761107	S	2543	1319	3862	0.00024
Luteimonas granuli	1176533	S	3432	1239	4671	0.00030
Luteimonas chenhongjianii	2006110	S	2500	570	3070	0.00019
Luteimonas yindakuii	2565782	S	2420	980	3400	0.00021
Pseudoxanthomonas suwonensis	314722	S	6631	3661	10292	0.00065
Pseudoxanthomonas mexicana	128785	S	4699	5518	10217	0.00065
Pseudoxanthomonas sp. X-1	2571115	S	2985	2700	5685	0.00036
Pseudoxanthomonas sp. F37	2932492	S	75	3870	3945	0.00025
Pseudoxanthomonas daejeonensis	266062	S	2544	685	3229	0.00020
Pseudoxanthomonas spadix	415229	S	1897	713	2610	0.00016
Thermomonas sp. XSG	2771436	S	2435	1146	3581	0.00023
Thermomonas sp. HDW16	2714945	S	1658	491	2149	0.00014
Thermomonas brevis	215691	S	3313	1468	4781	0.00030
Thermomonas aquatica	2202149	S	2762	1589	4351	0.00027
Thermomonas carbonis	1463158	S	2518	573	3091	0.00020
Arenimonas daejeonensis	370777	S	4646	1022	5668	0.00036
Pseudolysobacter antarcticus	2511995	S	2186	63	2249	0.00014
Xylella fastidiosa	2371	S	334	122	456	0.00003
Xylella taiwanensis	1444770	S	201	10	211	0.00001
Luteibacter sp. 321	2911537	S	2628	810	3438	0.00022
Luteibacter sp. EIF3	2780091	S	2098	359	2457	0.00016
Luteibacter sp. 335	2911538	S	1808	428	2236	0.00014
Luteibacter sp. 353	2911539	S	1624	513	2137	0.00014
Luteibacter pinisoli	2589080	S	2078	595	2673	0.00017
Luteibacter rhizovicinus	242606	S	2031	312	2343	0.00015
Luteibacter anthropi	564369	S	1602	320	1922	0.00012
Rhodanobacter denitrificans	666685	S	3875	1767	5642	0.00036
Rhodanobacter sp. FDAARGOS 1247	2778082	S	2419	947	3366	0.00021
Rhodanobacter thiooxydans	416169	S	2227	1210	3437	0.00022
Rhodanobacter glycinis	582702	S	1841	385	2226	0.00014
Dyella thiooxydans	445710	S	3113	1111	4224	0.00027
Dyella japonica	231455	S	1877	654	2531	0.00016
Dyella telluris	2763498	S	1574	484	2058	0.00013
Dyella terrae	522259	S	1329	214	1543	0.00010
Dyella caseinilytica	1849581	S	1123	98	1221	0.00008
Dyella sp. M7H15-1	2501295	S	711	79	790	0.00005
Frateuria sp. 5GH9-34	2898793	S	3027	1115	4142	0.00026
Frateuria sp. 5GH9-11	1542730	S	2779	1305	4084	0.00026
Frateuria aurantia	81475	S	990	141	1131	0.00007
Dokdonella koreensis	323415	S	6565	1285	7850	0.00050
Aerosticca soli	2010829	S	3086	4107	7193	0.00045
Ahniella affigens	2021234	S	1877	53	1930	0.00012
Klebsiella pneumoniae	573	S	1588	79684	81272	0.00514
Klebsiella quasipneumoniae	1463165	S	769	3486	4255	0.00027
Klebsiella oxytoca	571	S	486	346	832	0.00005
Klebsiella sp. A52	2834819	S	34	418	452	0.00003
Klebsiella aerogenes	548	S	443	266	709	0.00004
Klebsiella michiganensis	1134687	S	333	1277	1610	0.00010
Klebsiella variicola	244366	S	282	1093	1375	0.00009
Klebsiella africana	2489010	S	121	76	197	0.00001
Klebsiella huaxiensis	2153354	S	109	111	220	0.00001
Klebsiella quasivariicola	2026240	S	108	119	227	0.00001
Klebsiella grimontii	2058152	S	67	479	546	0.00003
Raoultella sp. HC6	2923366	S	293	213	506	0.00003
Raoultella planticola	575	S	222	242	464	0.00003
Raoultella ornithinolytica	54291	S	163	1330	1493	0.00009
Raoultella terrigena	577	S	138	296	434	0.00003
Raoultella electrica	1259973	S	68	183	251	0.00002
Enterobacter cloacae	550	S	1426	2474	3900	0.00025
Enterobacter hormaechei	158836	S	446	7164	7610	0.00048
Enterobacter cancerogenus	69218	S	350	130	480	0.00003
Enterobacter asburiae	61645	S	343	1698	2041	0.00013
Enterobacter roggenkampii	1812935	S	226	987	1213	0.00008
Enterobacter ludwigii	299767	S	144	364	508	0.00003
Enterobacter chengduensis	2494701	S	139	103	242	0.00002
Enterobacter chuandaensis	2497875	S	114	81	195	0.00001
Enterobacter cloacae complex sp.	2027919	S	44	1196	1240	0.00008
Enterobacter sp. BIDMC 29	1329841	S	27	97	124	0.00001
Enterobacter sp. BIDMC100	1686399	S	14	157	171	0.00001
Enterobacter kobei	208224	S	111	1377	1488	0.00009
Enterobacter sichuanensis	2071710	S	60	58	118	0.00001
Enterobacter sp. SA187	1914861	S	305	58	363	0.00002
Enterobacter sp. JUb54	2724468	S	296	66	362	0.00002
Enterobacter sp. E76	2596949	S	163	332	495	0.00003
Enterobacter sp. RHBSTW-00994	2742676	S	117	32	149	0.00001
Enterobacter sp. Colony194	2866201	S	92	124	216	0.00001
Enterobacter sp. RHBSTW-00175	2742639	S	82	82	164	0.00001
Enterobacter sp. JBIWA008	2831892	S	72	50	122	0.00001
Enterobacter sp. SGAir0187	2836161	S	50	62	112	0.00001
Enterobacter sp. SES19	2705458	S	36	36	72	0.00000
Enterobacter sp. JBIWA003	2831890	S	32	44	76	0.00000
Enterobacter sp. JBIWA005	2831891	S	27	55	82	0.00001
Enterobacter sp. E20	1560339	S	24	227	251	0.00002
Enterobacter sp. N18-03635	2500132	S	18	49	67	0.00000
Enterobacter sp. DNB-S2	2720029	S	12	58	70	0.00000
Enterobacter sp. 18A13	2565914	S	11	51	62	0.00000
Enterobacter huaxiensis	2494702	S	241	79	320	0.00002
Enterobacter mori	539813	S	148	205	353	0.00002
Enterobacter bugandensis	881260	S	108	209	317	0.00002
Enterobacter oligotrophicus	2478464	S	106	35	141	0.00001
Enterobacter soli	885040	S	83	23	106	0.00001
Citrobacter freundii	546	S	334	1694	2028	0.00013
Citrobacter werkmanii	67827	S	57	161	218	0.00001
Citrobacter braakii	57706	S	49	446	495	0.00003
Citrobacter sedlakii	67826	S	47	154	201	0.00001
Citrobacter freundii complex sp. CFNIH2	2066049	S	40	52	92	0.00001
Citrobacter portucalensis	1639133	S	44	516	560	0.00004
Citrobacter youngae	133448	S	13	48	61	0.00000
Citrobacter sp. R56	1573676	S	169	58	227	0.00001
Citrobacter sp. RHB25-C09	2742624	S	128	40	168	0.00001
Citrobacter sp. BDA59-3	2781952	S	33	17	50	0.00000
Citrobacter sp. MGH 55	1439319	S	18	95	113	0.00001
Citrobacter rodentium	67825	S	320	0	320	0.00002
Citrobacter amalonaticus	35703	S	190	1056	1246	0.00008
Citrobacter farmeri	67824	S	168	93	261	0.00002
Citrobacter koseri	545	S	98	153	251	0.00002
Citrobacter tructae	2562449	S	76	39	115	0.00001
Citrobacter pasteurii	1563222	S	75	72	147	0.00001
Citrobacter arsenatis	2546350	S	49	20	69	0.00000
Citrobacter cronae	1748967	S	21	193	214	0.00001
Cronobacter sakazakii	28141	S	499	426	925	0.00006
Cronobacter dublinensis	413497	S	402	157	559	0.00004
Cronobacter condimenti	1163710	S	279	85	364	0.00002
Cronobacter universalis	535744	S	226	173	399	0.00003
Cronobacter malonaticus	413503	S	128	177	305	0.00002
Cronobacter sp. JZ38	1906275	S	63	202	265	0.00002
Cronobacter muytjensii	413501	S	33	136	169	0.00001
Kosakonia sp. SMBL-WEM22	2725560	S	204	91	295	0.00002
Kosakonia sp. CCTCC M2018092	2492396	S	112	106	218	0.00001
Kosakonia sp. MUSA4	2067958	S	103	51	154	0.00001
Kosakonia cowanii	208223	S	405	309	714	0.00005
Kosakonia sacchari	1158459	S	302	142	444	0.00003
Kosakonia radicincitans	283686	S	150	131	281	0.00002
Kosakonia arachidis	551989	S	117	32	149	0.00001
Kosakonia oryzae	497725	S	106	74	180	0.00001
Kosakonia pseudosacchari	1646340	S	106	56	162	0.00001
Leclercia adecarboxylata	83655	S	652	1144	1796	0.00011
Leclercia sp. 29361	2714951	S	174	71	245	0.00002
Leclercia sp. J807	2681307	S	57	81	138	0.00001
Leclercia sp. W6	2282310	S	54	96	150	0.00001
Leclercia sp. W17	2282309	S	31	84	115	0.00001
Leclercia sp. 119287	2681308	S	28	82	110	0.00001
Leclercia sp. G3L	2898725	S	24	126	150	0.00001
Leclercia sp. Colony189	2681309	S	13	216	229	0.00001
Leclercia sp. LSNIH1	1920114	S	11	152	163	0.00001
Leclercia pneumoniae	2815358	S	212	110	322	0.00002
Salmonella enterica	28901	S	1297	48382	49679	0.00314
Salmonella bongori	54736	S	159	62	221	0.00001
Pluralibacter gergoviae	61647	S	1122	298	1420	0.00009
[Enterobacter] lignolyticus	1334193	S	556	156	712	0.00005
Cedecea neteri	158822	S	777	191	968	0.00006
Cedecea lapagei	158823	S	232	75	307	0.00002
Cedecea sp. FDAARGOS_727	2545798	S	194	45	239	0.00002
Escherichia coli	562	S	786	17519	18305	0.00116
Escherichia albertii	208962	S	144	135	279	0.00002
Escherichia fergusonii	564	S	94	166	260	0.00002
Escherichia marmotae	1499973	S	86	54	140	0.00001
Escherichia sp. E4742	2044467	S	52	38	90	0.00001
Lelliottia amnigena	61646	S	494	144	638	0.00004
Lelliottia sp. WB101	2153385	S	90	106	196	0.00001
Lelliottia sp. AC1	2067959	S	80	76	156	0.00001
Kluyvera ascorbata	51288	S	193	160	353	0.00002
Kluyvera intermedia	61648	S	144	116	260	0.00002
Kluyvera sp. CRP	2873269	S	28	76	104	0.00001
Kluyvera genomosp. 3	2774055	S	27	68	95	0.00001
Candidatus Symbiopectobacterium sp. SyEd1	2871826	S	219	28	247	0.00002
Blochmannia endosymbiont of Colobopsis nipponica	2681987	S	22	1	23	0.00000
Blochmannia endosymbiont of Camponotus sp.	700220	S	21	12	33	0.00000
Blochmannia endosymbiont of Camponotus nipponensis	2681986	S	12	0	12	0.00000
Candidatus Hamiltonella defensa	138072	S	56	3	59	0.00000
secondary endosymbiont of Ctenarytaina eucalypti	1199245	S	27	1	28	0.00000
secondary endosymbiont of Heteropsylla cubana	134287	S	20	1	21	0.00000
Candidatus Doolittlea endobia	1778262	S	26	1	27	0.00000
Candidatus Hoaglandella endobia	1778263	S	19	1	20	0.00000
Candidatus Mikella endobia	1778264	S	13	4	17	0.00000
Candidatus Tachikawaea gelatinosa	1410383	S	11	2	13	0.00000
Jejubacter calystegiae	2579935	S	348	39	387	0.00002
Pseudescherichia vulneris	566	S	333	21	354	0.00002
Buttiauxella agrestis	82977	S	121	24	145	0.00001
Buttiauxella ferragutiae	82989	S	30	90	120	0.00001
Buttiauxella sp. 3AFRM03	2479367	S	22	60	82	0.00001
Plesiomonas shigelloides	703	S	295	99	394	0.00002
Atlantibacter hermannii	565	S	275	61	336	0.00002
Shimwellia blattae	563	S	251	53	304	0.00002
Yokenella regensburgei	158877	S	250	117	367	0.00002
Scandinavium goeteborgense	1851514	S	245	48	293	0.00002
Pseudocitrobacter sp. G163CM	2891570	S	213	57	270	0.00002
Phytobacter ursingii	1972431	S	150	207	357	0.00002
Phytobacter diazotrophicus	395631	S	16	121	137	0.00001
Enterobacteriaceae endosymbiont of Donacia cincticornis	2675773	S	20	21	41	0.00000
Candidatus Moranella endobia	1048758	S	53	0	53	0.00000
Shigella boydii	621	S	25	655	680	0.00004
Shigella flexneri	623	S	22	3175	3197	0.00020
Candidatus Profftia tarda	1177216	S	15	0	15	0.00000
Candidatus Profftia lariciata	1987921	S	11	0	11	0.00000
Candidatus Schneideria nysicola	1081631	S	17	1	18	0.00000
Candidatus Ishikawaella capsulata	168169	S	17	1	18	0.00000
Serratia marcescens	615	S	2045	2057	4102	0.00026
Serratia plymuthica	82996	S	713	24153	24866	0.00157
Serratia sp. FDAARGOS_506	2420306	S	157	62	219	0.00001
Serratia sp. ATCC 39006	104623	S	148	16	164	0.00001
Serratia sp. FGI94	671990	S	97	35	132	0.00001
Serratia sp. 1D1416	2447890	S	53	45	98	0.00001
Serratia sp. MYb239	2033438	S	35	83	118	0.00001
Serratia sp. 3ACOL1	2448483	S	30	11	41	0.00000
Serratia sp. P2ACOL2	2482769	S	28	19	47	0.00000
Serratia sp. FS14	1327989	S	23	29	52	0.00000
Serratia sp. Tan611	2773264	S	13	23	36	0.00000
Serratia sp. HRI	2663241	S	13	154	167	0.00001
Serratia sp. JSRIV002	2831894	S	12	18	30	0.00000
Serratia sp. JUb9	2724469	S	11	24	35	0.00000
Serratia rubidaea	61652	S	508	186	694	0.00004
Serratia entomophila	42906	S	478	81	559	0.00004
Serratia odorifera	618	S	374	53	427	0.00003
Serratia proteamaculans	28151	S	310	29	339	0.00002
Serratia fonticola	47917	S	306	77	383	0.00002
Serratia surfactantfaciens	2741499	S	207	39	246	0.00002
Serratia quinivorans	137545	S	184	32	216	0.00001
Serratia liquefaciens	614	S	166	71	237	0.00002
Serratia grimesii	82995	S	152	10	162	0.00001
Serratia symbiotica	138074	S	128	20	148	0.00001
Serratia rhizosphaerae	2597702	S	125	38	163	0.00001
Serratia inhibens	2338073	S	115	23	138	0.00001
Serratia ureilytica	300181	S	78	236	314	0.00002
Serratia ficaria	61651	S	37	42	79	0.00001
Serratia nematodiphila	458197	S	14	33	47	0.00000
Yersinia enterocolitica	630	S	128	125	253	0.00002
Yersinia pseudotuberculosis	633	S	30	55	85	0.00001
Yersinia similis	367190	S	25	4	29	0.00000
Yersinia pestis	632	S	21	1170	1191	0.00008
Yersinia entomophaga	935293	S	86	15	101	0.00001
Yersinia ruckeri	29486	S	85	15	100	0.00001
Yersinia mollaretii	33060	S	75	16	91	0.00001
Yersinia aleksiciae	263819	S	64	16	80	0.00001
Yersinia aldovae	29483	S	53	11	64	0.00000
Yersinia kristensenii	28152	S	52	137	189	0.00001
Yersinia rohdei	29485	S	51	9	60	0.00000
Yersinia canariae	2607663	S	49	15	64	0.00000
Yersinia frederiksenii	29484	S	44	37	81	0.00001
Yersinia massiliensis	419257	S	30	90	120	0.00001
Yersinia intermedia	631	S	27	82	109	0.00001
Yersinia hibernica	2339259	S	14	22	36	0.00000
Rahnella aquatilis	34038	S	284	389	673	0.00004
Rahnella inusitata	58169	S	221	57	278	0.00002
Rahnella sp. ERMR1:05	1805933	S	220	29	249	0.00002
Rahnella victoriana	1510570	S	218	30	248	0.00002
Rahnella aceris	2703885	S	31	66	97	0.00001
Nissabacter sp. SGAir0207	2126321	S	835	123	958	0.00006
Gibbsiella quercinecans	929813	S	525	63	588	0.00004
Ewingella americana	41202	S	269	34	303	0.00002
Rouxiella badensis	1646377	S	245	20	265	0.00002
Chania multitudinisentens	1639108	S	134	13	147	0.00001
Candidatus Fukatsuia symbiotica	1878942	S	59	3	62	0.00000
Pantoea sp. Z09	2886821	S	700	229	929	0.00006
Pantoea sp. SO10	2575375	S	307	60	367	0.00002
Pantoea sp. At-9b	592316	S	233	47	280	0.00002
Pantoea sp. MSR2	2052056	S	217	25	242	0.00002
Pantoea sp. CCBC3-3-1	2490851	S	150	29	179	0.00001
Pantoea sp. MT58	2768165	S	14	110	124	0.00001
Pantoea sp. SM3640	2787629	S	10	72	82	0.00001
Pantoea agglomerans	549	S	1568	500	2068	0.00013
Pantoea dispersa	59814	S	1191	321	1512	0.00010
Pantoea deleyi	470932	S	412	100	512	0.00003
Pantoea vagans	470934	S	410	668	1078	0.00007
Pantoea ananatis	553	S	408	125	533	0.00003
Pantoea cypripedii	55209	S	262	16	278	0.00002
Pantoea alhagi	1891675	S	223	74	297	0.00002
Pantoea stewartii	66269	S	216	56	272	0.00002
Pantoea rwandensis	1076550	S	150	33	183	0.00001
Pantoea eucalypti	470933	S	14	100	114	0.00001
Erwinia sp. E602	2675378	S	656	119	775	0.00005
Erwinia sp. J780	2681984	S	164	31	195	0.00001
Erwinia sp. QL-Z3	2547962	S	47	124	171	0.00001
Erwinia sp. Ejp617	215689	S	45	71	116	0.00001
Erwinia gerundensis	1619313	S	362	71	433	0.00003
Erwinia persicina	55211	S	263	55	318	0.00002
Erwinia rhapontici	55212	S	223	42	265	0.00002
Erwinia amylovora	552	S	194	78	272	0.00002
Erwinia billingiae	182337	S	176	333	509	0.00003
Erwinia tasmaniensis	338565	S	174	36	210	0.00001
Erwinia tracheiphila	65700	S	108	14	122	0.00001
[Pantoea] beijingensis	1324864	S	102	20	122	0.00001
Candidatus Erwinia haradaeae	1922217	S	88	1	89	0.00001
Erwinia pyrifoliae	79967	S	24	36	60	0.00000
Mixta gaviniae	665914	S	491	192	683	0.00004
Mixta calida	665913	S	420	241	661	0.00004
Mixta theicola	1458355	S	348	113	461	0.00003
Mixta sp. X22927	2872648	S	227	129	356	0.00002
Mixta intestinalis	1615494	S	194	56	250	0.00002
Buchnera aphidicola	9	S	272	36	308	0.00002
Tatumella ptyseos	82987	S	106	19	125	0.00001
Tatumella citrea	53336	S	62	9	71	0.00000
Wigglesworthia glossinidia	51229	S	18	1	19	0.00000
Dickeya dadantii	204038	S	494	314	808	0.00005
Dickeya zeae	204042	S	370	384	754	0.00005
Dickeya chrysanthemi	556	S	353	103	456	0.00003
Dickeya dianthicola	204039	S	348	374	722	0.00005
Dickeya fangzhongdai	1778540	S	172	747	919	0.00006
Dickeya poaceiphila	568768	S	129	22	151	0.00001
Dickeya solani	1089444	S	125	68	193	0.00001
Dickeya sp. NCPPB 3274	568766	S	107	75	182	0.00001
Dickeya oryzae	1240404	S	25	54	79	0.00001
Dickeya parazeae	2893572	S	10	40	50	0.00000
Pectobacterium carotovorum	554	S	276	602	878	0.00006
Pectobacterium brasiliense	180957	S	203	243	446	0.00003
Pectobacterium atrosepticum	29471	S	138	47	185	0.00001
Pectobacterium sp. LJ1	2878098	S	86	25	111	0.00001
Pectobacterium sp. PL64	2738983	S	43	29	72	0.00000
Pectobacterium parmentieri	1905730	S	113	35	148	0.00001
Pectobacterium polaris	2042057	S	90	65	155	0.00001
Pectobacterium punjabense	2108399	S	78	19	97	0.00001
Pectobacterium odoriferum	78398	S	72	54	126	0.00001
Pectobacterium wasabiae	55208	S	68	21	89	0.00001
Pectobacterium quasiaquaticum	2774015	S	51	51	102	0.00001
Pectobacterium versatile	2488639	S	49	112	161	0.00001
Pectobacterium aroidearum	1201031	S	33	52	85	0.00001
Pectobacterium parvum	2778550	S	27	41	68	0.00000
Pectobacterium aquaticum	2204145	S	18	23	41	0.00000
Brenneria izadpanahii	2722756	S	320	368	688	0.00004
Brenneria goodwinii	1109412	S	274	305	579	0.00004
Brenneria rubrifaciens	55213	S	270	110	380	0.00002
Lonsdalea populi	1172565	S	347	99	446	0.00003
Lonsdalea britannica	1082704	S	298	79	377	0.00002
Musicola paradisiaca	69223	S	372	28	400	0.00003
Edwardsiella tarda	636	S	542	424	966	0.00006
Edwardsiella hoshinae	93378	S	297	74	371	0.00002
Edwardsiella ictaluri	67780	S	220	319	539	0.00003
Edwardsiella piscicida	1263550	S	58	863	921	0.00006
Hafnia alvei	569	S	137	165	302	0.00002
Hafnia paralvei	546367	S	51	22	73	0.00000
Obesumbacterium proteus	82983	S	41	32	73	0.00000
Morganella morganii	582	S	597	540	1137	0.00007
Providencia rettgeri	587	S	145	225	370	0.00002
Providencia alcalifaciens	126385	S	77	35	112	0.00001
Providencia sp. R33	2828763	S	30	8	38	0.00000
Providencia rustigianii	158850	S	29	10	39	0.00000
Providencia heimbachae	333962	S	28	11	39	0.00000
Providencia sneebia	516075	S	17	1	18	0.00000
Providencia vermicola	333965	S	12	52	64	0.00000
Xenorhabdus bovienii	40576	S	126	31	157	0.00001
Xenorhabdus doucetiae	351671	S	70	12	82	0.00001
Xenorhabdus poinarii	40577	S	55	12	67	0.00000
Xenorhabdus hominickii	351679	S	49	9	58	0.00000
Xenorhabdus nematophila	628	S	48	9	57	0.00000
Xenorhabdus budapestensis	290110	S	36	5	41	0.00000
Proteus mirabilis	584	S	90	196	286	0.00002
Proteus vulgaris	585	S	27	68	95	0.00001
Proteus hauseri	183417	S	18	3	21	0.00000
Proteus penneri	102862	S	13	14	27	0.00000
Photorhabdus thracensis	230089	S	77	15	92	0.00001
Photorhabdus laumondii	2218628	S	43	10	53	0.00000
Photorhabdus akhurstii	171438	S	42	9	51	0.00000
Photorhabdus asymbiotica	291112	S	28	3	31	0.00000
Arsenophonus endosymbiont of Apis mellifera	1541805	S	18	6	24	0.00000
Arsenophonus endosymbiont of Aphis craccivora	1231049	S	14	3	17	0.00000
Arsenophonus nasoniae	638	S	17	7	24	0.00000
Moellerella wisconsensis	158849	S	35	29	64	0.00000
Sodalis sp. dw_23	2697027	S	593	39	632	0.00004
Sodalis endosymbiont of Henestaris halophilus	1929246	S	25	0	25	0.00000
Sodalis praecaptivus	1239307	S	336	216	552	0.00003
Sodalis glossinidius	63612	S	254	35	289	0.00002
Candidatus Sodalis pierantonius	1486991	S	113	77	190	0.00001
Leminorella richardii	158841	S	196	27	223	0.00001
Pragia fontium	82985	S	83	11	94	0.00001
Jinshanibacter zhutongyuii	2498113	S	60	8	68	0.00000
Limnobaculum parvum	2172103	S	50	8	58	0.00000
Thioalkalivibrio sulfidiphilus	1033854	S	2934	1732	4666	0.00029
Thioalkalivibrio paradoxus	108010	S	2721	861	3582	0.00023
Thioalkalivibrio nitratireducens	186931	S	2700	776	3476	0.00022
Thioalkalivibrio sp. K90mix	396595	S	2052	277	2329	0.00015
Thioalkalivibrio versutus	106634	S	1925	271	2196	0.00014
Spiribacter sp. E85	2182432	S	5519	579	6098	0.00039
Spiribacter sp. 2438	2666185	S	1107	128	1235	0.00008
Spiribacter curvatus	1335757	S	1270	80	1350	0.00009
Spiribacter salinus	1335746	S	826	76	902	0.00006
Acidihalobacter aeolianus	2792603	S	2222	331	2553	0.00016
Acidihalobacter ferrooxydans	1765967	S	1750	189	1939	0.00012
Acidihalobacter yilgarnensis	2819280	S	1244	93	1337	0.00008
Halorhodospira halophila	1053	S	2576	304	2880	0.00018
Halorhodospira halochloris	1052	S	385	17	402	0.00003
Aquisalimonas sp. 2447	2740807	S	2513	191	2704	0.00017
Alkalilimnicola ehrlichii	351052	S	2450	343	2793	0.00018
Ectothiorhodospira sp. BSL-9	1442136	S	956	330	1286	0.00008
Ectothiorhodospira haloalkaliphila	421628	S	939	340	1279	0.00008
Ectothiorhodosinus mongolicus	233100	S	311	23	334	0.00002
Allochromatium tepidum	553982	S	1945	1054	2999	0.00019
Allochromatium vinosum	1049	S	1922	838	2760	0.00017
Candidatus Thiodictyon syntrophicum	1166950	S	4381	256	4637	0.00029
Thioflavicoccus mobilis	80679	S	3890	387	4277	0.00027
Marichromatium purpuratum	37487	S	3807	808	4615	0.00029
Thiocapsa bogorovii	521689	S	3250	191	3441	0.00022
Thiocystis violascens	73141	S	2236	209	2445	0.00015
Thermochromatium tepidum	1050	S	1497	403	1900	0.00012
Nitrosococcus halophilus	133539	S	315	43	358	0.00002
Nitrosococcus wardiae	1814290	S	302	39	341	0.00002
Nitrosococcus watsonii	473531	S	214	55	269	0.00002
Nitrosococcus oceani	1229	S	205	49	254	0.00002
Caldichromatium japonicum	2699430	S	1132	144	1276	0.00008
Rheinheimera sp. F8	1763998	S	193	12	205	0.00001
Rheinheimera sp. D18	2545632	S	50	46	96	0.00001
Rheinheimera mangrovi	2498451	S	77	9	86	0.00001
Candidatus Nitrosacidococcus tergens	553981	S	77	4	81	0.00001
Candidatus Nitrosoglobus terrae	1630141	S	54	4	58	0.00000
Wenzhouxiangella marina	1579979	S	2801	214	3015	0.00019
Wenzhouxiangella sp. AB-CW3	2771012	S	1731	95	1826	0.00012
Thiohalobacter sp. COW1	2795687	S	620	1431	2051	0.00013
Thiohalobacter thiocyanaticus	585455	S	528	1510	2038	0.00013
Guyparkeria halophila	47960	S	2529	675	3204	0.00020
Sulfurivermis fontis	1972068	S	2487	967	3454	0.00022
Halothiobacillus sp. LS2	1860122	S	1134	110	1244	0.00008
Halothiobacillus neapolitanus	927	S	440	50	490	0.00003
Woeseia oceani	1548547	S	1543	28	1571	0.00010
Sulfuriflexus mobilis	1811807	S	572	18	590	0.00004
Granulosicoccus antarcticus	437505	S	504	9	513	0.00003
Halomonas sp. THAF5a	2587844	S	2041	800	2841	0.00018
Halomonas sp. 1513	1883416	S	1610	367	1977	0.00012
Halomonas sp. JS92-SW72	2306583	S	1517	1593	3110	0.00020
Halomonas sp. THAF12	2587849	S	1492	898	2390	0.00015
Halomonas sp. YLGW01	2773308	S	1417	239	1656	0.00010
Halomonas sp. HG01	1609967	S	1383	579	1962	0.00012
Halomonas sp. MCCC 1A13316	2733487	S	1236	164	1400	0.00009
Halomonas sp. PGE1	2730360	S	978	1277	2255	0.00014
Halomonas sp. Y2R2	2562282	S	478	25	503	0.00003
Halomonas sp. A40-4	2785909	S	410	110	520	0.00003
Halomonas sp. SH5A2	2749040	S	337	56	393	0.00002
Halomonas sp. KO116	1504981	S	283	120	403	0.00003
Halomonas sp. R57-5	1610576	S	261	111	372	0.00002
Halomonas sp. 18071143	2855441	S	253	570	823	0.00005
Halomonas sp. FeN2	2832500	S	196	88	284	0.00002
Halomonas sp. GFAJ-1	1118153	S	191	34	225	0.00001
Halomonas sp. SS10-MC5	2854257	S	173	1664	1837	0.00012
Halomonas sp. SF2003	2136172	S	153	684	837	0.00005
Halomonas sp. hl-4	1761789	S	112	650	762	0.00005
Halomonas sp. TD01	999141	S	104	55	159	0.00001
Halomonas sp. NyZ770	2883106	S	99	439	538	0.00003
Halomonas sp. HL-93	1666906	S	77	461	538	0.00003
Halomonas sp. GT	1971364	S	49	35	84	0.00001
Halomonas sp. N3-2A	2014541	S	42	56	98	0.00001
Halomonas sp. A3H3	1346287	S	21	607	628	0.00004
Halomonas beimenensis	475662	S	2360	475	2835	0.00018
Halomonas aestuarii	1897729	S	1819	393	2212	0.00014
Halomonas socia	1081866	S	1527	302	1829	0.00012
Halomonas sulfidivorans	2733488	S	1399	297	1696	0.00011
Halomonas tianxiuensis	2497861	S	1393	321	1714	0.00011
Halomonas elongata	2746	S	1234	127	1361	0.00009
Halomonas chromatireducens	507626	S	1052	85	1137	0.00007
Halomonas meridiana	29570	S	732	599	1331	0.00008
Halomonas subglaciescola	29571	S	729	77	806	0.00005
Halomonas huangheensis	1178482	S	592	33	625	0.00004
Halomonas piezotolerans	2609667	S	465	261	726	0.00005
Halomonas profundi	2852117	S	225	32	257	0.00002
Halomonas titanicae	664683	S	173	940	1113	0.00007
Halomonas sulfidoxydans	2733484	S	166	1571	1737	0.00011
Halomonas hydrothermalis	115561	S	133	412	545	0.00003
Halomonas venusta	44935	S	100	135	235	0.00001
Halomonas campaniensis	213554	S	23	116	139	0.00001
Halomonas alkaliphila	272774	S	16	89	105	0.00001
Cobetia sp. L2A1	2686360	S	425	53	478	0.00003
Cobetia sp. cqz5-12	2609415	S	266	371	637	0.00004
Cobetia sp. AM6	2661553	S	114	662	776	0.00005
Cobetia sp. 4B	2758724	S	106	464	570	0.00004
Cobetia pacifica	1055101	S	159	513	672	0.00004
Cobetia amphilecti	1055104	S	96	607	703	0.00004
Cobetia marina	28258	S	12	170	182	0.00001
Halotalea alkalilenta	376489	S	2105	407	2512	0.00016
Salinicola tamaricis	1771309	S	2026	232	2258	0.00014
Kushneria phosphatilytica	657387	S	540	21	561	0.00004
Kushneria konosiri	698828	S	529	136	665	0.00004
Kushneria marisflavi	157779	S	462	116	578	0.00004
Chromohalobacter salexigens	158080	S	1532	167	1699	0.00011
Pistricoccus aurantiacus	1883414	S	1105	73	1178	0.00007
Zymobacter palmae	33074	S	289	39	328	0.00002
Candidatus Portiera aleyrodidarum	91844	S	66	8	74	0.00000
Candidatus Carsonella ruddii	114186	S	12	10	22	0.00000
Alcanivorax sp. N3-2A	2014542	S	1704	1966	3670	0.00023
Alcanivorax sp. NBRC 101098	1113728	S	12	170	182	0.00001
Alcanivorax pacificus	1306787	S	1408	505	1913	0.00012
Alcanivorax xenomutans	1094342	S	801	431	1232	0.00008
Alcanivorax dieselolei	285091	S	778	249	1027	0.00006
Alcanivorax borkumensis	59754	S	12	164	176	0.00001
Ketobacter alkanivorans	1917421	S	304	26	330	0.00002
Marinobacterium aestuarii	1821621	S	987	77	1064	0.00007
Marinobacterium sediminicola	518898	S	412	71	483	0.00003
Marinobacterium georgiense	48076	S	357	124	481	0.00003
Marinobacterium sp. LSUCC0821	2668067	S	51	3	54	0.00000
Marinomonas sp. CT5	2066133	S	42	3	45	0.00000
Marinomonas sp. FW-1	2071621	S	34	9	43	0.00000
Marinomonas sp. A3A	2065312	S	25	4	29	0.00000
Marinomonas profundi	2726122	S	74	25	99	0.00001
Marinomonas primoryensis	178399	S	69	10	79	0.00001
Marinomonas mediterranea	119864	S	62	6	68	0.00000
Marinomonas arctica	383750	S	44	12	56	0.00000
Marinomonas algicola	2773454	S	42	8	50	0.00000
Marinomonas posidonica	936476	S	37	5	42	0.00000
Marinomonas foliarum	491950	S	31	13	44	0.00000
Thalassolituus sp. C2-1	2597518	S	239	20	259	0.00002
Thalassolituus oleivorans	187493	S	118	28	146	0.00001
Venatorbacter cucullus	2661630	S	316	82	398	0.00003
Bacterioplanes sanyensis	1249553	S	201	13	214	0.00001
Neptunomonas concharum	1031538	S	70	7	77	0.00000
Neptunomonas japonica	417574	S	51	4	55	0.00000
Neptunomonas phycophila	1572645	S	38	3	41	0.00000
Nitrincola iocasae	2614693	S	138	22	160	0.00001
Amphritea japonica	452627	S	94	8	102	0.00001
Bermanella marisrubri	207949	S	48	2	50	0.00000
Hahella chejuensis	158327	S	586	74	660	0.00004
Hahella sp. KA22	1628392	S	510	75	585	0.00004
Saccharospirillum mangrovi	2161747	S	659	39	698	0.00004
Reinekea forsetii	1336806	S	268	14	282	0.00002
Gynuella sunshinyii	1445505	S	169	5	174	0.00001
Litoricola lipolytica	418701	S	375	18	393	0.00002
Oleiphilus messinensis	141451	S	150	12	162	0.00001
Spartinivicinus ruber	2683272	S	137	4	141	0.00001
Endozoicomonas montiporae	1027273	S	125	7	132	0.00001
Methylococcus sp. EFPC2	2812648	S	2250	160	2410	0.00015
Methylococcus sp. Mc7	2860258	S	2059	654	2713	0.00017
Methylococcus capsulatus	414	S	2067	492	2559	0.00016
Methylococcus geothermalis	2681310	S	1792	493	2285	0.00014
Methylomonas sp. LL1	2785785	S	615	29	644	0.00004
Methylomonas sp. LW13	107637	S	265	136	401	0.00003
Methylomonas sp. EFPC1	2812647	S	263	144	407	0.00003
Methylomonas sp. DH-1	1727196	S	242	490	732	0.00005
Methylomonas koyamae	702114	S	642	700	1342	0.00008
Methylomonas rhizoryzae	2608981	S	625	26	651	0.00004
Methylomonas denitrificans	1538553	S	530	38	568	0.00004
Methylomonas methanica	421	S	512	27	539	0.00003
Methylomonas paludis	1173101	S	159	7	166	0.00001
Methylomagnum ishizawai	1760988	S	2641	118	2759	0.00017
Methylocaldum marinum	1432792	S	2461	143	2604	0.00016
Methylomicrobium album	39775	S	1941	81	2022	0.00013
Methylomicrobium sp. wino1	2049332	S	439	398	837	0.00005
Methylogaea oryzae	1295382	S	2288	178	2466	0.00016
Candidatus Methylospira mobilis	1808979	S	812	35	847	0.00005
Methylotuvimicrobium buryatense	95641	S	242	305	547	0.00003
Methylotuvimicrobium alcaliphilum	271065	S	181	266	447	0.00003
Methylovulum psychrotolerans	1704499	S	323	8	331	0.00002
Methylobacter sp. S3L5C	2839024	S	109	7	116	0.00001
Aeromonas sp. FDAARGOS 1415	2778064	S	380	214	594	0.00004
Aeromonas sp. CA23	2033032	S	361	157	518	0.00003
Aeromonas sp. FDAARGOS 1409	2778058	S	189	285	474	0.00003
Aeromonas sp. CU5	2033033	S	154	66	220	0.00001
Aeromonas sp. FDAARGOS 1407	2778056	S	65	208	273	0.00002
Aeromonas sp. 1805	2560028	S	53	155	208	0.00001
Aeromonas sp. FDAARGOS 1403	2778052	S	52	166	218	0.00001
Aeromonas sp. FDAARGOS 1410	2778059	S	51	128	179	0.00001
Aeromonas sp. FDAARGOS 1405	2778054	S	46	78	124	0.00001
Aeromonas sp. 2692-1	2560029	S	44	223	267	0.00002
Aeromonas sp. ASNIH4	1636609	S	42	205	247	0.00002
Aeromonas sp. ASNIH5	1758179	S	36	615	651	0.00004
Aeromonas sp. FDAARGOS 1402	2778051	S	35	384	419	0.00003
Aeromonas sp. FDAARGOS 1419	2778068	S	33	100	133	0.00001
Aeromonas sp. FDAARGOS 1411	2778060	S	28	92	120	0.00001
Aeromonas sp. FDAARGOS 1417	2778066	S	28	85	113	0.00001
Aeromonas sp. FDAARGOS 1404	2778053	S	26	96	122	0.00001
Aeromonas sp. FDAARGOS 1406	2778055	S	26	260	286	0.00002
Aeromonas sp. ASNIH1	1636606	S	25	491	516	0.00003
Aeromonas sp. FDAARGOS 1408	2778057	S	24	145	169	0.00001
Aeromonas sp. ASNIH3	1636608	S	20	953	973	0.00006
Aeromonas sp. ASNIH2	1636607	S	19	254	273	0.00002
Aeromonas sp. WP2-W18-CRE-05	2675707	S	18	713	731	0.00005
Aeromonas sp. FDAARGOS 1414	2778063	S	17	56	73	0.00000
Aeromonas sp. FDAARGOS 1416	2778065	S	17	51	68	0.00000
Aeromonas sp. FDAARGOS 1418	2778067	S	10	112	122	0.00001
Aeromonas hydrophila	644	S	1772	4308	6080	0.00038
Aeromonas veronii	654	S	1318	3004	4322	0.00027
Aeromonas schubertii	652	S	920	267	1187	0.00008
Aeromonas media	651	S	828	1549	2377	0.00015
Aeromonas simiae	218936	S	745	781	1526	0.00010
Aeromonas salmonicida	645	S	741	985	1726	0.00011
Aeromonas encheleia	73010	S	737	259	996	0.00006
Aeromonas caviae	648	S	573	4758	5331	0.00034
Aeromonas rivuli	648794	S	465	131	596	0.00004
Aeromonas enteropelogenes	29489	S	459	389	848	0.00005
Aeromonas dhakensis	196024	S	414	864	1278	0.00008
Aeromonas jandaei	650	S	359	379	738	0.00005
Aeromonas sanarellii	633415	S	117	567	684	0.00004
Aeromonas rivipollensis	948519	S	93	153	246	0.00002
Aeromonas allosaccharophila	656	S	71	115	186	0.00001
Zobellella denitrificans	347534	S	1807	423	2230	0.00014
Oceanimonas sp. GK1	511062	S	763	162	925	0.00006
Dongshaea marina	2047966	S	215	21	236	0.00001
Oceanisphaera profunda	1416627	S	116	13	129	0.00001
Oceanisphaera avium	1903694	S	66	9	75	0.00000
Tolumonas auensis	43948	S	140	58	198	0.00001
Succinivibrio dextrinosolvens	83771	S	33	1	34	0.00000
Solimonas sp. K1W22B-7	2303331	S	10611	1164	11775	0.00074
Flagellatimonas centrodinii	2806210	S	2886	222	3108	0.00020
Sinimarinibacterium sp. NLF-5-8	2698684	S	1377	754	2131	0.00013
Steroidobacter denitrificans	465721	S	8089	2135	10224	0.00065
Sulfurifustis variabilis	1675686	S	10819	731	11550	0.00073
Sulfuricaulis limicola	1620215	S	4410	356	4766	0.00030
Acidiferrobacter sp. SPIII_3	1281578	S	1249	338	1587	0.00010
Acidiferrobacter thiooxydans	163359	S	990	271	1261	0.00008
Microbulbifer sp. YPW16	2904242	S	1084	98	1182	0.00007
Microbulbifer sp. SH-1	2681547	S	785	119	904	0.00006
Microbulbifer sp. YPW1	2745199	S	550	96	646	0.00004
Microbulbifer sp. ALW1	1516059	S	490	81	571	0.00004
Microbulbifer sp. THAF38	2587856	S	199	67	266	0.00002
Microbulbifer sp. GL-2	2591606	S	196	33	229	0.00001
Microbulbifer sp. A4B17	359370	S	166	38	204	0.00001
Microbulbifer aggregans	1769779	S	626	75	701	0.00004
Microbulbifer hydrolyticus	48074	S	527	96	623	0.00004
Microbulbifer celer	435905	S	522	64	586	0.00004
Microbulbifer elongatus	86173	S	511	83	594	0.00004
Microbulbifer thermotolerans	252514	S	487	30	517	0.00003
Microbulbifer agarilyticus	260552	S	339	38	377	0.00002
Microbulbifer variabilis	266805	S	158	57	215	0.00001
Cellvibrio sp. KY-YJ-3	454662	S	1328	249	1577	0.00010
Cellvibrio sp. PSBB006	1987723	S	974	31	1005	0.00006
Cellvibrio sp. PSBB023	1945512	S	972	118	1090	0.00007
Cellvibrio sp. KY-GH-1	2303332	S	548	54	602	0.00004
Cellvibrio japonicus	155077	S	544	37	581	0.00004
Teredinibacter turnerae	2426	S	320	12	332	0.00002
Teredinibacter haidensis	2731755	S	157	9	166	0.00001
Teredinibacter purpureus	2731756	S	101	4	105	0.00001
Simiduia agarivorans	447471	S	559	28	587	0.00004
Marinagarivorans sp. GE09	2721545	S	98	7	105	0.00001
Saccharophagus degradans	86304	S	95	2	97	0.00001
Agarilytica rhodophyticola	1737490	S	68	1	69	0.00000
Kineobactrum salinum	2708301	S	1374	52	1426	0.00009
Halioglobus japonicus	930805	S	567	25	592	0.00004
Halioglobus maricola	2601894	S	492	18	510	0.00003
Congregibacter litoralis	393662	S	571	229	800	0.00005
Aequoribacter fuscus	2518989	S	155	21	176	0.00001
Spongiibacter nanhainus	2794344	S	470	52	522	0.00003
Spongiibacter taiwanensis	1748242	S	370	18	388	0.00002
Spongiibacter sp. IMCC21906	1620392	S	114	30	144	0.00001
Zhongshania aliphaticivorans	1470434	S	204	14	218	0.00001
Oceanicoccus sagamiensis	716816	S	100	2	102	0.00001
Shewanella sp. FJAT-53764	2864207	S	90	145	235	0.00001
Shewanella sp. FJAT-53555	2864204	S	84	75	159	0.00001
Shewanella sp. FJAT-54031	2864209	S	74	115	189	0.00001
Shewanella sp. FJAT-51860	2864212	S	70	10	80	0.00001
Shewanella sp. FJAT-53532	2864203	S	62	109	171	0.00001
Shewanella sp. FJAT-52076	2864202	S	57	84	141	0.00001
Shewanella sp. FJAT-53681	2864205	S	55	91	146	0.00001
Shewanella sp. FJAT-52072	2864213	S	53	74	127	0.00001
Shewanella sp. Scap07	2589987	S	48	5	53	0.00000
Shewanella sp. FJAT-53870	2864208	S	45	7	52	0.00000
Shewanella sp. SNU WT4	2590015	S	43	10	53	0.00000
Shewanella sp. WE21	2029986	S	40	20	60	0.00000
Shewanella sp. KX20019	2803864	S	36	4	40	0.00000
Shewanella sp. FJAT-51754	2864211	S	32	47	79	0.00001
Shewanella sp. OM3-2	2908650	S	30	4	34	0.00000
Shewanella sp. FJAT-53749	2864206	S	27	5	32	0.00000
Shewanella sp. Pdp11	2059264	S	27	76	103	0.00001
Shewanella sp. MR-4	60480	S	26	27	53	0.00000
Shewanella sp. Arc9-LZ	2698686	S	24	9	33	0.00000
Shewanella sp. ANA-3	94122	S	23	60	83	0.00001
Shewanella sp. FJAT-51649	2864210	S	20	30	50	0.00000
Shewanella sp. MEBiC00475	2575361	S	11	20	31	0.00000
Shewanella algae	38313	S	285	242	527	0.00003
Shewanella khirikhana	1965282	S	254	38	292	0.00002
Shewanella cyperi	2814292	S	240	129	369	0.00002
Shewanella litorisediminis	1173586	S	177	42	219	0.00001
Shewanella putrefaciens	24	S	161	526	687	0.00004
Shewanella baltica	62322	S	149	195	344	0.00002
Shewanella marisflavi	260364	S	148	27	175	0.00001
Shewanella sedimentimangrovi	2814293	S	131	98	229	0.00001
Shewanella amazonensis	60478	S	129	32	161	0.00001
Shewanella sediminis	271097	S	122	15	137	0.00001
Shewanella dokdonensis	712036	S	104	10	114	0.00001
Shewanella yunxiaonensis	2829809	S	101	15	116	0.00001
Shewanella avicenniae	2814294	S	89	13	102	0.00001
Shewanella benthica	43661	S	73	15	88	0.00001
Shewanella pealeana	70864	S	70	11	81	0.00001
Shewanella loihica	359303	S	66	111	177	0.00001
Shewanella woodyi	60961	S	61	6	67	0.00000
Shewanella denitrificans	192073	S	61	8	69	0.00000
Shewanella oneidensis	70863	S	60	17	77	0.00000
Shewanella psychropiezotolerans	2593655	S	58	10	68	0.00000
Shewanella carassii	1987584	S	52	56	108	0.00001
Shewanella psychrophila	225848	S	50	6	56	0.00000
Shewanella psychromarinicola	2487742	S	49	7	56	0.00000
Shewanella decolorationis	256839	S	46	51	97	0.00001
Shewanella xiamenensis	332186	S	45	233	278	0.00002
Shewanella halifaxensis	271098	S	44	5	49	0.00000
Shewanella piezotolerans	404011	S	44	4	48	0.00000
Shewanella indica	768528	S	43	60	103	0.00001
Shewanella maritima	2520507	S	39	4	43	0.00000
Shewanella chilikensis	558541	S	37	105	142	0.00001
Shewanella vesiculosa	518738	S	36	8	44	0.00000
Shewanella violacea	60217	S	35	6	41	0.00000
Shewanella inventionis	1738770	S	32	14	46	0.00000
Shewanella glacialimarina	2590884	S	32	4	36	0.00000
Shewanella aestuarii	1028752	S	26	9	35	0.00000
Shewanella frigidimarina	56812	S	23	12	35	0.00000
Shewanella donghaensis	238836	S	21	2	23	0.00000
Shewanella livingstonensis	150120	S	16	3	19	0.00000
Shewanella bicestrii	2018305	S	14	56	70	0.00000
Parashewanella tropica	2547970	S	23	2	25	0.00000
Parashewanella spongiae	342950	S	19	1	20	0.00000
Alteromonas sp. RKMC-009	2267264	S	124	14	138	0.00001
Alteromonas sp. BL110	1714845	S	42	7	49	0.00000
Alteromonas sp. RW2A1	1917158	S	17	86	103	0.00001
Alteromonas sp. 76-1	2358187	S	16	5	21	0.00000
Alteromonas macleodii	28108	S	165	65	230	0.00001
Alteromonas mediterranea	314275	S	88	84	172	0.00001
Alteromonas pelagimontana	1858656	S	87	10	97	0.00001
Alteromonas australica	589873	S	31	51	82	0.00001
Alteromonas naphthalenivorans	715451	S	20	10	30	0.00000
Alteromonas stellipolaris	233316	S	13	43	56	0.00000
Salinimonas lutimaris	914153	S	115	22	137	0.00001
Salinimonas marina	2785918	S	100	11	111	0.00001
Salinimonas iocasae	2572577	S	72	16	88	0.00001
Salinimonas sediminis	2303538	S	61	15	76	0.00000
Hydrocarboniclastica marina	2259620	S	628	88	716	0.00005
Agarivorans sp. TSD2052	2937286	S	65	7	72	0.00000
Agarivorans sp. B2Z047	2652721	S	14	9	23	0.00000
Agarivorans gilvus	680279	S	62	5	67	0.00000
Agarivorans aestuarii	1563703	S	25	8	33	0.00000
Agarivorans albus	182262	S	21	16	37	0.00000
Lacimicrobium alkaliphilum	1526571	S	208	14	222	0.00001
Saliniradius amylolyticus	2183582	S	201	19	220	0.00001
Paraglaciecola sp. L1A13	2686359	S	44	3	47	0.00000
Paraglaciecola sp. L3A3	2686358	S	32	2	34	0.00000
Paraglaciecola psychrophila	326544	S	47	3	50	0.00000
Paraglaciecola mesophila	197222	S	43	4	47	0.00000
Glaciecola nitratireducens	300231	S	97	7	104	0.00001
Paraneptunicella aestuarii	2831148	S	87	5	92	0.00001
Saccharobesus litoralis	2172099	S	49	3	52	0.00000
Catenovulum sediminis	1740262	S	31	2	33	0.00000
Pseudoalteromonas sp. R3	1709477	S	91	11	102	0.00001
Pseudoalteromonas sp. A25	116092	S	38	4	42	0.00000
Pseudoalteromonas sp. THAF3	2587843	S	26	13	39	0.00000
Pseudoalteromonas sp. GCY	2003316	S	17	17	34	0.00000
Pseudoalteromonas sp. KAN5	2916633	S	12	21	33	0.00000
Pseudoalteromonas sp. DL-6	1390185	S	12	15	27	0.00000
Pseudoalteromonas sp. A22	327511	S	10	18	28	0.00000
Pseudoalteromonas rubra	43658	S	243	22	265	0.00002
Pseudoalteromonas viridis	339617	S	107	24	131	0.00001
Pseudoalteromonas luteoviolacea	43657	S	86	11	97	0.00001
Pseudoalteromonas donghaensis	621376	S	81	315	396	0.00003
Pseudoalteromonas piscicida	43662	S	62	29	91	0.00001
Pseudoalteromonas shioyasakiensis	1190813	S	50	17	67	0.00000
Pseudoalteromonas xiamenensis	882626	S	41	4	45	0.00000
Pseudoalteromonas agarivorans	176102	S	37	39	76	0.00000
Pseudoalteromonas spongiae	298657	S	33	6	39	0.00000
Pseudoalteromonas ulvae	107327	S	30	1	31	0.00000
Pseudoalteromonas tunicata	314281	S	29	3	32	0.00000
Pseudoalteromonas mariniglutinosa	206042	S	29	23	52	0.00000
Pseudoalteromonas translucida	166935	S	28	47	75	0.00000
Pseudoalteromonas phenolica	161398	S	26	3	29	0.00000
Pseudoalteromonas ruthenica	151081	S	24	12	36	0.00000
Pseudoalteromonas prydzensis	182141	S	22	2	24	0.00000
Pseudoalteromonas piratica	1348114	S	20	2	22	0.00000
Pseudoalteromonas carrageenovora	227	S	20	4	24	0.00000
Pseudoalteromonas aliena	247523	S	18	3	21	0.00000
Pseudoalteromonas espejiana	28107	S	18	2	20	0.00000
Pseudoalteromonas tetraodonis	43659	S	12	38	50	0.00000
Psychrosphaera ytuae	2820710	S	28	6	34	0.00000
Psychrosphaera aestuarii	1266052	S	25	4	29	0.00000
Flocculibacter collagenilyticus	2744479	S	29	2	31	0.00000
Ferrimonas balearica	44012	S	732	88	820	0.00005
Ferrimonas lipolytica	2724191	S	112	15	127	0.00001
Idiomarina sp. OT37-5b	2100422	S	166	37	203	0.00001
Idiomarina sp. X4	2055892	S	63	24	87	0.00001
Idiomarina loihiensis	135577	S	76	0	76	0.00000
Idiomarina abyssalis	86102	S	71	8	79	0.00001
Idiomarina piscisalsi	1096243	S	38	14	52	0.00000
Thalassotalea sp. PS06	2594005	S	59	6	65	0.00000
Thalassotalea sp. LPB0316	2769490	S	39	10	49	0.00000
Thalassotalea sp. HSM 43	2552945	S	29	4	33	0.00000
Thalassotalea crassostreae	1763536	S	18	3	21	0.00000
Colwellia sp. Arc7-635	2497879	S	25	3	28	0.00000
Colwellia sp. 20A7	2689569	S	25	2	27	0.00000
Colwellia sp. PAMC 20917	1816218	S	23	1	24	0.00000
Colwellia sp. MT41	58049	S	21	2	23	0.00000
Colwellia sp. Arc7-D	2161872	S	21	4	25	0.00000
Colwellia psychrerythraea	28229	S	22	1	23	0.00000
Cognaticolwellia beringensis	1967665	S	26	4	30	0.00000
Litorilituus sediminis	718192	S	17	1	18	0.00000
Moritella yayanosii	69539	S	41	13	54	0.00000
Moritella sp. 24	2746230	S	11	3	14	0.00000
Moritella sp. 5	2746231	S	11	17	28	0.00000
Moritella marina	90736	S	23	6	29	0.00000
Psychromonas ingrahamii	357794	S	78	14	92	0.00001
Psychromonas sp. CNPT3	314282	S	21	6	27	0.00000
Vibrio parahaemolyticus	670	S	213	74	287	0.00002
Vibrio harveyi	669	S	91	29	120	0.00001
Vibrio alginolyticus	663	S	74	98	172	0.00001
Vibrio diabolicus	50719	S	41	60	101	0.00001
Vibrio owensii	696485	S	73	40	113	0.00001
Vibrio campbellii	680	S	67	57	124	0.00001
Vibrio natriegens	691	S	47	42	89	0.00001
Vibrio rotiferianus	190895	S	39	14	53	0.00000
Vibrio azureus	512649	S	27	3	30	0.00000
Vibrio sp. OG9-811	2841925	S	167	24	191	0.00001
Vibrio sp. B1FLJ16	2751178	S	55	11	66	0.00000
Vibrio sp. THAF190c	2587865	S	52	6	58	0.00000
Vibrio sp. HDW18	2714948	S	52	8	60	0.00000
Vibrio sp. VB16	2785746	S	38	3	41	0.00000
Vibrio sp. SCSIO 43132	2779363	S	28	8	36	0.00000
Vibrio sp. SS-MA-C1-2	2908646	S	20	3	23	0.00000
Vibrio sp. ED004	2785124	S	17	12	29	0.00000
Vibrio sp. Scap24	2589990	S	16	11	27	0.00000
Vibrio sp. B1FIG11	2751177	S	14	20	34	0.00000
Vibrio fluvialis	676	S	390	60	450	0.00003
Vibrio furnissii	29494	S	326	96	422	0.00003
Vibrio vulnificus	672	S	266	52	318	0.00002
Vibrio sinaloensis	379097	S	78	10	88	0.00001
Vibrio tubiashii	29498	S	37	14	51	0.00000
Vibrio europaeus	300876	S	27	7	34	0.00000
Vibrio mimicus	674	S	132	27	159	0.00001
Vibrio cholerae	666	S	124	2276	2400	0.00015
Vibrio navarrensis	29495	S	121	29	150	0.00001
Vibrio anguillarum	55601	S	105	17	122	0.00001
Vibrio coralliilyticus	190893	S	94	31	125	0.00001
Vibrio cyclitrophicus	47951	S	84	18	102	0.00001
Vibrio spartinae	1918945	S	70	6	76	0.00000
Vibrio maritimus	990268	S	66	6	72	0.00000
Vibrio tapetis	52443	S	63	4	67	0.00000
Vibrio nigripulchritudo	28173	S	63	10	73	0.00000
Vibrio splendidus	29497	S	61	15	76	0.00000
Vibrio astriarenae	1481923	S	60	7	67	0.00000
Vibrio taketomensis	2572923	S	58	7	65	0.00000
Vibrio panuliri	1381081	S	57	6	63	0.00000
Vibrio metoecus	1481663	S	55	15	70	0.00000
Vibrio breoganii	553239	S	55	5	60	0.00000
Vibrio mediterranei	689	S	54	5	59	0.00000
Vibrio alfacsensis	1074311	S	53	24	77	0.00000
Vibrio scophthalmi	45658	S	53	8	61	0.00000
Vibrio gazogenes	687	S	50	5	55	0.00000
Vibrio metschnikovii	28172	S	50	8	58	0.00000
Vibrio neptunius	170651	S	47	6	53	0.00000
Vibrio tritonius	1435069	S	47	5	52	0.00000
Vibrio algicola	2662262	S	46	7	53	0.00000
Vibrio zhugei	2479546	S	45	9	54	0.00000
Vibrio cidicii	1763883	S	43	13	56	0.00000
Vibrio rumoiensis	76258	S	43	24	67	0.00000
Vibrio crassostreae	246167	S	42	16	58	0.00000
Vibrio ponticus	265668	S	41	3	44	0.00000
Vibrio penaeicida	104609	S	40	4	44	0.00000
Vibrio kanaloae	170673	S	37	7	44	0.00000
Vibrio bathopelagicus	2777577	S	33	6	39	0.00000
Vibrio cincinnatiensis	675	S	29	5	34	0.00000
Vibrio aquimaris	2587862	S	27	2	29	0.00000
Vibrio atlanticus	693153	S	26	5	31	0.00000
Vibrio casei	673372	S	26	6	32	0.00000
Vibrio chagasii	170679	S	25	3	28	0.00000
Vibrio gigantis	296199	S	22	5	27	0.00000
Vibrio ziniensis	2711221	S	22	2	24	0.00000
Vibrio aphrogenes	1891186	S	20	2	22	0.00000
Vibrio hyugaensis	1534743	S	19	6	25	0.00000
Vibrio qinghaiensis	2025808	S	10	4	14	0.00000
Photobacterium damselae	38293	S	735	274	1009	0.00006
Photobacterium sp. GJ3	2829502	S	167	19	186	0.00001
Photobacterium sp. TLY01	2907534	S	158	24	182	0.00001
Photobacterium gaetbulicola	1295392	S	214	20	234	0.00001
Photobacterium ganghwense	320778	S	202	43	245	0.00002
Photobacterium profundum	74109	S	34	3	37	0.00000
Salinivibrio kushneri	1908198	S	112	16	128	0.00001
Salinivibrio sp. YCSC6	2003370	S	39	69	108	0.00001
Salinivibrio costicola	51367	S	22	39	61	0.00000
Grimontia hollisae	673	S	149	18	167	0.00001
Thaumasiovibrio subtropicus	1891207	S	83	9	92	0.00001
Aliivibrio fischeri	668	S	36	5	41	0.00000
Aliivibrio salmonicida	40269	S	20	8	28	0.00000
Candidatus Enterovibrio luxaltus	1927128	S	21	0	21	0.00000
Paraphotobacterium marinum	1755811	S	11	2	13	0.00000
Immundisolibacter cernigliae	1810504	S	4501	824	5325	0.00034
Candidatus Endoriftia persephone	393765	S	1242	60	1302	0.00008
Candidatus Vesicomyosocius sp. SY067_SCS001	2732590	S	28	35	63	0.00000
Bathymodiolus thermophilus thioautotrophic gill symbiont	2360	S	44	2	46	0.00000
Bathymodiolus septemdierum thioautotrophic gill symbiont	113267	S	21	2	23	0.00000
Sedimenticola thiotaurini	1543721	S	882	39	921	0.00006
Candidatus Reidiella endopervernicosa	2738883	S	586	12	598	0.00004
Thiolapillus brandeum	1076588	S	544	14	558	0.00004
Pseudohongiella spirulinae	1249552	S	288	7	295	0.00002
Gallaecimonas mangrovi	2291597	S	194	15	209	0.00001
Celerinatantimonas diazotrophica	412034	S	76	5	81	0.00001
Candidatus Thioglobus autotrophicus	1705394	S	22	2	24	0.00000
Candidatus Thioglobus sp. NP1	2508687	S	16	3	19	0.00000
Ignatzschineria sp. HR5S32	2923279	S	35	3	38	0.00000
Candidatus Steffania adelgidicola	1076626	S	18	0	18	0.00000
Candidatus Azoamicus ciliaticola	2652803	S	16	2	18	0.00000
Candidatus Pseudothioglobus singularis	1427364	S	15	6	21	0.00000
Acinetobacter baumannii	470	S	464	2169	2633	0.00017
Acinetobacter pittii	48296	S	70	95	165	0.00001
Acinetobacter calcoaceticus	471	S	35	4	39	0.00000
Acinetobacter seifertii	1530123	S	29	12	41	0.00000
Acinetobacter nosocomialis	106654	S	20	10	30	0.00000
Acinetobacter sp. WCHAc010034	1879049	S	244	118	362	0.00002
Acinetobacter sp. 10FS3-1	2563897	S	33	27	60	0.00000
Acinetobacter sp. TGL-Y2	1407071	S	26	3	29	0.00000
Acinetobacter sp. ASP199	2773709	S	24	16	40	0.00000
Acinetobacter sp. Marseille-Q1620	2714110	S	23	2	25	0.00000
Acinetobacter sp. TTH0-4	1646498	S	21	5	26	0.00000
Acinetobacter sp. CS-2	2798861	S	21	14	35	0.00000
Acinetobacter sp. LoGeW2-3	1808001	S	18	7	25	0.00000
Acinetobacter sp. WCHA55	2004646	S	17	21	38	0.00000
Acinetobacter sp. WCHAc010052	2004647	S	17	10	27	0.00000
Acinetobacter sp. NCu2D-2	1608473	S	11	4	15	0.00000
Acinetobacter johnsonii	40214	S	139	114	253	0.00002
Acinetobacter indicus	756892	S	128	115	243	0.00002
Acinetobacter lwoffii	28090	S	72	91	163	0.00001
Acinetobacter junii	40215	S	61	25	86	0.00001
Acinetobacter soli	487316	S	61	6	67	0.00000
Acinetobacter radioresistens	40216	S	45	7	52	0.00000
Acinetobacter haemolyticus	29430	S	44	23	67	0.00000
Acinetobacter larvae	1789224	S	43	3	46	0.00000
Acinetobacter schindleri	108981	S	39	38	77	0.00000
Acinetobacter bouvetii	202951	S	33	5	38	0.00000
Acinetobacter gyllenbergii	134534	S	32	2	34	0.00000
Acinetobacter tandoii	202954	S	27	2	29	0.00000
Acinetobacter towneri	202956	S	25	59	84	0.00001
Acinetobacter lanii	2715163	S	24	3	27	0.00000
Acinetobacter baylyi	202950	S	20	1	21	0.00000
Acinetobacter shaoyimingii	2715164	S	20	1	21	0.00000
Acinetobacter variabilis	70346	S	20	28	48	0.00000
Acinetobacter dispersus	70348	S	19	1	20	0.00000
Acinetobacter piscicola	2006115	S	18	11	29	0.00000
Acinetobacter wanghuae	2662362	S	17	2	19	0.00000
Acinetobacter ursingii	108980	S	15	13	28	0.00000
Acinetobacter wuhouensis	1879050	S	15	7	22	0.00000
Acinetobacter venetianus	52133	S	14	3	17	0.00000
Acinetobacter cumulans	2136182	S	14	5	19	0.00000
Acinetobacter chinensis	2004650	S	11	7	18	0.00000
Acinetobacter guillouiae	106649	S	10	3	13	0.00000
Psychrobacter sp. DAB_AL43B	1028416	S	31	3	34	0.00000
Psychrobacter sp. 28M-43	2772254	S	23	7	30	0.00000
Psychrobacter sp. P11F6	1699621	S	22	11	33	0.00000
Psychrobacter sp. P11G3	1699623	S	22	6	28	0.00000
Psychrobacter sp. WY6	2708350	S	18	9	27	0.00000
Psychrobacter sp. G	571800	S	17	44	61	0.00000
Psychrobacter sp. P11G5	1699624	S	17	22	39	0.00000
Psychrobacter sp. AntiMn-1	1720344	S	13	55	68	0.00000
Psychrobacter sp. KCTC 72983	2733866	S	12	18	30	0.00000
Psychrobacter sp. YP14	2203895	S	10	16	26	0.00000
Psychrobacter arenosus	256326	S	35	2	37	0.00000
Psychrobacter urativorans	45610	S	19	2	21	0.00000
Psychrobacter cryohalolentis	330922	S	18	48	66	0.00000
Psychrobacter arcticus	334543	S	16	3	19	0.00000
Psychrobacter sanguinis	861445	S	12	3	15	0.00000
Moraxella osloensis	34062	S	145	25	170	0.00001
Moraxella catarrhalis	480	S	42	9	51	0.00000
Moraxella bovis	476	S	39	13	52	0.00000
Moraxella sp. ZY201115	2904121	S	28	3	31	0.00000
Moraxella cuniculi	34061	S	27	3	30	0.00000
Moraxella bovoculi	386891	S	27	59	86	0.00001
Moraxella nonliquefaciens	478	S	21	6	27	0.00000
Aquirhabdus parva	2283318	S	104	4	108	0.00001
Legionella sp. MW5194	2662448	S	157	28	185	0.00001
Legionella sp. PC1000	2746060	S	131	20	151	0.00001
Legionella sp. PC997	2755562	S	34	5	39	0.00000
Legionella geestiana	45065	S	178	14	192	0.00001
Legionella pneumophila	446	S	171	83	254	0.00002
Legionella anisa	28082	S	152	34	186	0.00001
Legionella spiritensis	452	S	139	13	152	0.00001
Legionella sainthelensi	28087	S	113	17	130	0.00001
Legionella israelensis	454	S	81	3	84	0.00001
Legionella lansingensis	45067	S	79	5	84	0.00001
Legionella longbeachae	450	S	70	10	80	0.00001
Legionella cherrii	28084	S	54	3	57	0.00000
Legionella waltersii	66969	S	54	9	63	0.00000
Legionella jordanis	456	S	52	6	58	0.00000
Legionella oakridgensis	29423	S	47	4	51	0.00000
Legionella adelaidensis	45056	S	43	3	46	0.00000
Legionella fallonii	96230	S	42	3	45	0.00000
Legionella antarctica	2708020	S	35	1	36	0.00000
Legionella clemsonensis	1867846	S	34	5	39	0.00000
Legionella hackeliae	449	S	27	4	31	0.00000
Fluoribacter dumoffii	463	S	55	16	71	0.00000
Tatlockia micdadei	451	S	51	2	53	0.00000
Aquicella siphonis	254247	S	243	61	304	0.00002
Aquicella lusitana	254246	S	235	63	298	0.00002
Coxiella burnetii	777	S	216	69	285	0.00002
Coxiella endosymbiont of Amblyomma nuttalli	2749996	S	46	6	52	0.00000
Coxiella endosymbiont of Amblyomma sculptum	2487929	S	42	16	58	0.00000
Candidatus Coxiella mudrowiae	2054173	S	49	5	54	0.00000
Rickettsiella endosymbiont of Dermanyssus gallinae	2856608	S	32	24	56	0.00000
Candidatus Rickettsiella viridis	676208	S	23	20	43	0.00000
Methylophaga frappieri	754477	S	117	57	174	0.00001
Methylophaga sp. TMB456	2881052	S	94	38	132	0.00001
Methylophaga nitratireducenticrescens	754476	S	85	17	102	0.00001
Thiomicrorhabdus xiamenensis	2739063	S	133	9	142	0.00001
Thiomicrorhabdus sediminis	2580412	S	66	4	70	0.00000
Thiomicrorhabdus aquaedulcis	2211106	S	63	3	66	0.00000
Thiomicrorhabdus indica	2267253	S	31	1	32	0.00000
Thiomicrorhabdus sp. Am19	2791037	S	20	1	21	0.00000
Thiomicrospira sp. S5	1803865	S	83	77	160	0.00001
Thiomicrospira microaerophila	406020	S	55	11	66	0.00000
Thiomicrospira aerophila	92245	S	51	9	60	0.00000
Thiomicrospira cyclica	147268	S	45	4	49	0.00000
Hydrogenovibrio thermophilus	265883	S	111	101	212	0.00001
Hydrogenovibrio crunogenus	39765	S	53	2	55	0.00000
Hydrogenovibrio marinus	28885	S	43	1	44	0.00000
Piscirickettsia salmonis	1238	S	79	6	85	0.00001
Thiosulfatimonas sediminis	2675054	S	72	5	77	0.00000
Thiosulfativibrio zosterae	2675053	S	46	2	48	0.00000
Thiothrix litoralis	2891210	S	332	25	357	0.00002
Thiothrix subterranea	2735563	S	190	55	245	0.00002
Thiothrix sp. CT3	96472	S	182	63	245	0.00002
Thiothrix unzii	111769	S	145	79	224	0.00001
Candidatus Thiothrix anitrata	2823902	S	107	66	173	0.00001
Beggiatoa leptomitoformis	288004	S	104	5	109	0.00001
Francisella frigiditurris	1542390	S	29	4	33	0.00000
Francisella tularensis	263	S	24	37	61	0.00000
Francisella uliginis	573570	S	14	5	19	0.00000
Allofrancisella guangzhouensis	594679	S	23	9	32	0.00000
Salinisphaera sp. LB1	2183911	S	2676	114	2790	0.00018
Pasteurella multocida	747	S	889	2244	3133	0.00020
Aggregatibacter actinomycetemcomitans	714	S	99	20	119	0.00001
Aggregatibacter aphrophilus	732	S	60	30	90	0.00001
Aggregatibacter sp. Marseille-P9115	2866570	S	17	16	33	0.00000
Aggregatibacter sp. 2125159857	2820817	S	15	7	22	0.00000
Aggregatibacter segnis	739	S	20	25	45	0.00000
Haemophilus parainfluenzae	729	S	79	30	109	0.00001
Haemophilus influenzae	727	S	57	49	106	0.00001
Haemophilus pittmaniae	249188	S	28	6	34	0.00000
Haemophilus haemolyticus	726	S	27	14	41	0.00000
Haemophilus parahaemolyticus	735	S	18	3	21	0.00000
[Haemophilus] ducreyi	730	S	16	9	25	0.00000
Actinobacillus sp. GY-402	2774188	S	116	59	175	0.00001
Actinobacillus pleuropneumoniae	715	S	22	32	54	0.00000
Actinobacillus porcitonsillarum	189834	S	18	6	24	0.00000
Actinobacillus equuli	718	S	17	6	23	0.00000
Mannheimia haemolytica	75985	S	50	23	73	0.00000
Mannheimia granulomatis	85402	S	50	10	60	0.00000
Mannheimia varigena	85404	S	37	32	69	0.00000
Avibacterium paragallinarum	728	S	35	9	44	0.00000
Avibacterium volantium	762	S	24	6	30	0.00000
Glaesserella parasuis	738	S	40	22	62	0.00000
Glaesserella sp. 15-184	2030797	S	25	6	31	0.00000
Rodentibacter haemolyticus	2778911	S	34	4	38	0.00000
Rodentibacter heylii	1906744	S	29	3	32	0.00000
Bibersteinia trehalosi	47735	S	31	5	36	0.00000
Histophilus somni	731	S	27	8	35	0.00000
Frederiksenia canicola	123824	S	24	5	29	0.00000
Gallibacterium anatis	750	S	20	6	26	0.00000
Bisgaardia hudsonensis	109472	S	14	2	16	0.00000
Vespertiliibacter pulmonis	1443036	S	14	2	16	0.00000
endosymbiont of unidentified scaly snail isolate Monju	1248727	S	2190	184	2374	0.00015
Isorropodon fossajaponicum symbiont	883811	S	21	2	23	0.00000
Abyssogena phaseoliformis symbiont	596095	S	12	2	14	0.00000
Cardiobacterium hominis	2718	S	756	149	905	0.00006
Cardiobacterium sp. Marseille-Q4385	2866573	S	508	89	597	0.00004
Suttonella sp. R2A3	2908648	S	82	5	87	0.00001
Dichelobacter nodosus	870	S	80	22	102	0.00001
Kangiella koreensis	261964	S	85	17	102	0.00001
Kangiella profundi	1561924	S	63	18	81	0.00001
Kangiella sediminilitoris	1144748	S	61	6	67	0.00000
Kangiella geojedonensis	914150	S	33	3	36	0.00000
Gilliamella sp. ESL0443	2704655	S	23	6	29	0.00000
Gilliamella sp. ESL0441	2704654	S	19	17	36	0.00000
Gilliamella sp. ESL0405	2704653	S	11	2	13	0.00000
Gilliamella apicola	1196095	S	33	10	43	0.00000
Zophobihabitans entericus	1635327	S	22	2	24	0.00000
Archangium violaceum	83451	S	31313	6446	37759	0.00239
Archangium gephyra	48	S	20541	4680	25221	0.00159
Cystobacter fuscus	43	S	13182	3763	16945	0.00107
Stigmatella aurantiaca	41	S	10841	1445	12286	0.00078
Melittangium boletus	83453	S	7442	1977	9419	0.00060
Myxococcus xanthus	34	S	10783	27014	37797	0.00239
Myxococcus hansupus	1297742	S	5946	976	6922	0.00044
Myxococcus stipitatus	83455	S	5264	1310	6574	0.00042
Myxococcus sp. SCHIC003	2813577	S	4650	1158	5808	0.00037
Corallococcus coralloides	184914	S	10558	4740	15298	0.00097
Corallococcus macrosporus	35	S	7018	2513	9531	0.00060
Corallococcus sp. EGB	1521117	S	6346	2601	8947	0.00057
Pyxidicoccus sp. SCPEA002	2813578	S	15542	1291	16833	0.00106
Anaeromyxobacter sp. Red232	2918170	S	18776	2384	21160	0.00134
Anaeromyxobacter sp. Fw109-5	404589	S	16077	2466	18543	0.00117
Anaeromyxobacter sp. Red630	2918171	S	14453	2267	16720	0.00106
Anaeromyxobacter sp. K	447217	S	3484	7813	11297	0.00071
Anaeromyxobacter dehalogenans	161493	S	11816	9463	21279	0.00134
Vulgatibacter incomptus	1391653	S	8466	821	9287	0.00059
Sorangium cellulosum	56	S	118439	16839	135278	0.00855
Polyangium aurulentum	2567896	S	28916	3178	32094	0.00203
Chondromyces crocatus	52	S	15259	780	16039	0.00101
Pajaroellobacter abortibovis	1882918	S	214	7	221	0.00001
Sandaracinus amylolyticus	927083	S	45494	2883	48377	0.00306
Labilithrix luteola	1391654	S	14885	767	15652	0.00099
Haliangium ochraceum	80816	S	20930	1351	22281	0.00141
Geomonas sp. RF6	2897342	S	3746	514	4260	0.00027
Geomonas paludis	2740185	S	2619	1385	4004	0.00025
Geomonas nitrogeniifigens	2847991	S	2509	1361	3870	0.00024
Geomonas subterranea	2847989	S	2306	1128	3434	0.00022
Geomonas oryzisoli	2847992	S	2130	1228	3358	0.00021
Geobacter sp. FeAm09	2597769	S	2470	342	2812	0.00018
Geobacter sp. SVR	2495594	S	1780	276	2056	0.00013
Geobacter sp. DSM 9736	1277350	S	1050	82	1132	0.00007
Geobacter sulfurreducens	35554	S	2793	685	3478	0.00022
Geobacter pickeringii	345632	S	2541	705	3246	0.00021
Geobacter metallireducens	28232	S	1679	429	2108	0.00013
Geobacter benzoatilyticus	2815309	S	1071	260	1331	0.00008
Citrifermentans bremense	60035	S	2210	952	3162	0.00020
Citrifermentans bemidjiense	225194	S	2123	839	2962	0.00019
Geotalea uraniireducens	351604	S	1374	109	1483	0.00009
Geotalea daltonii	1203471	S	772	65	837	0.00005
Geoalkalibacter subterraneus	483547	S	1189	1302	2491	0.00016
Trichlorobacter lovleyi	313985	S	737	106	843	0.00005
Desulfuromonas versatilis	2802975	S	4721	915	5636	0.00036
Desulfuromonas sp. DDH964	1823759	S	2981	632	3613	0.00023
Desulfuromonas sp. AOP6	1566351	S	961	117	1078	0.00007
Desulfuromonas soudanensis	1603606	S	2815	347	3162	0.00020
Pelobacter propionicus	29543	S	1693	609	2302	0.00015
Syntrophotalea acetylenica	29542	S	1003	212	1215	0.00008
Syntrophotalea carbinolica	19	S	675	58	733	0.00005
Syntrophotalea acetylenivorans	1842532	S	491	78	569	0.00004
Pseudodesulfovibrio mercurii	641491	S	1996	499	2495	0.00016
Pseudodesulfovibrio indicus	1716143	S	1957	435	2392	0.00015
Pseudodesulfovibrio aespoeensis	182210	S	1409	1173	2582	0.00016
Pseudodesulfovibrio cashew	2678688	S	1148	237	1385	0.00009
Pseudodesulfovibrio tunisiensis	463192	S	973	108	1081	0.00007
Pseudodesulfovibrio sp. SF6	2810563	S	486	48	534	0.00003
Pseudodesulfovibrio sp. zrk46	2725288	S	429	74	503	0.00003
Pseudodesulfovibrio profundus	57320	S	353	419	772	0.00005
Pseudodesulfovibrio piezophilus	879567	S	136	19	155	0.00001
Desulfovibrio sp. IOR2	2583823	S	1305	270	1575	0.00010
Desulfovibrio sp. 86	2666132	S	445	115	560	0.00004
Desulfovibrio sp. G11	631220	S	380	295	675	0.00004
Desulfovibrio vulgaris	881	S	1637	77	1714	0.00011
Desulfovibrio sulfodismutans	63561	S	1478	403	1881	0.00012
Desulfovibrio desulfuricans	876	S	1218	299	1517	0.00010
Desulfovibrio piger	901	S	1097	235	1332	0.00008
Desulfovibrio fairfieldensis	44742	S	870	83	953	0.00006
Desulfovibrio ferrophilus	241368	S	597	54	651	0.00004
Candidatus Desulfovibrio trichonymphae	1725232	S	196	17	213	0.00001
Solidesulfovibrio carbinoliphilus	345370	S	2529	343	2872	0.00018
Solidesulfovibrio magneticus	184917	S	1110	662	1772	0.00011
Solidesulfovibrio carbinolicus	296842	S	1065	855	1920	0.00012
Oceanidesulfovibrio marinus	370038	S	2785	191	2976	0.00019
Desulfocurvibacter africanus	873	S	2198	180	2378	0.00015
Desulfolutivibrio sulfoxidireducens	2773299	S	1934	579	2513	0.00016
Megalodesulfovibrio gigas	879	S	1570	84	1654	0.00010
Oleidesulfovibrio alaskensis	58180	S	510	857	1367	0.00009
Maridesulfovibrio salexigens	880	S	164	20	184	0.00001
Maridesulfovibrio hydrothermalis	191026	S	95	11	106	0.00001
Paradesulfovibrio bizertensis	376490	S	199	22	221	0.00001
Lawsonia intracellularis	29546	S	44	0	44	0.00000
Desulfomicrobium baculatum	899	S	1426	119	1545	0.00010
Desulfomicrobium orale	132132	S	773	242	1015	0.00006
Desulfohalobium retbaense	45663	S	586	32	618	0.00004
Desulfosarcina ovata	83564	S	1513	85	1598	0.00010
Desulfosarcina alkanivorans	571177	S	1500	773	2273	0.00014
Desulfosarcina widdelii	947919	S	1340	176	1516	0.00010
Desulfococcus multivorans	897	S	1238	260	1498	0.00009
Desulfatibacillum aliphaticivorans	218208	S	970	37	1007	0.00006
Desulfoluna sp. ASN36	2810562	S	848	49	897	0.00006
Desulfonema magnum	45655	S	377	12	389	0.00002
Desulfonema limicola	45656	S	106	9	115	0.00001
Desulfobacter hydrogenophilus	2291	S	211	40	251	0.00002
Desulfobacter postgatei	2293	S	199	34	233	0.00001
Desulforapulum autotrophicum	2296	S	295	38	333	0.00002
Desulfobacula toluolica	28223	S	114	11	125	0.00001
Desulfobulbus propionicus	894	S	1391	86	1477	0.00009
Desulfobulbus oralis	1986146	S	957	254	1211	0.00008
Desulfobulbus oligotrophicus	1909699	S	305	322	627	0.00004
Desulfurivibrio alkaliphilus	427923	S	1066	61	1127	0.00007
Desulfomarina profundi	2772557	S	144	14	158	0.00001
Desulfosudis oleivorans	181663	S	1061	68	1129	0.00007
Desulfosediminicola ganghwensis	2569540	S	268	34	302	0.00002
Desulfosediminicola flagellatus	2569541	S	121	14	135	0.00001
Desulfotalea psychrophila	84980	S	122	23	145	0.00001
Desulfocapsa sulfexigens	65555	S	99	6	105	0.00001
Persicimonas caeni	2292766	S	7158	280	7438	0.00047
Bradymonas sediminis	1548548	S	2372	217	2589	0.00016
Bradymonadales bacterium V1718	2600177	S	932	54	986	0.00006
Syntrophobacter fumaroxidans	119484	S	1761	915	2676	0.00017
Desulfoglaeba alkanexedens	361111	S	1581	91	1672	0.00011
Desulfarculus baarsii	453230	S	3151	2300	5451	0.00034
Desulfomonile tiedjei	2358	S	681	8	689	0.00004
Desulfobacca acetoxidans	60893	S	635	19	654	0.00004
Syntrophus aciditrophicus	316277	S	551	39	590	0.00004
Dissulfurimicrobium hydrothermale	1750598	S	292	20	312	0.00002
Candidatus Desulfofervidus auxilii	1621989	S	209	5	214	0.00001
Hippea maritima	84405	S	79	4	83	0.00001
Campylobacter gracilis	824	S	201	14	215	0.00001
Campylobacter showae	204	S	194	21	215	0.00001
Campylobacter concisus	199	S	152	21	173	0.00001
Campylobacter curvus	200	S	130	13	143	0.00001
Campylobacter sp. 19-13652	2840180	S	42	5	47	0.00000
Campylobacter sp. CCUG 57310	2517362	S	20	5	25	0.00000
Campylobacter sp. RM16192	1660080	S	12	3	15	0.00000
Campylobacter sp. RM6914	1032243	S	10	1	11	0.00000
Campylobacter rectus	203	S	99	16	115	0.00001
Campylobacter jejuni	197	S	22	202	224	0.00001
Campylobacter geochelonis	1780362	S	21	1	22	0.00000
Campylobacter fetus	196	S	18	8	26	0.00000
Campylobacter coli	195	S	16	18	34	0.00000
Campylobacter pinnipediorum	1965231	S	15	1	16	0.00000
Campylobacter blaseri	2042961	S	13	1	14	0.00000
Campylobacter canadensis	449520	S	13	1	14	0.00000
Campylobacter iguaniorum	1244531	S	12	1	13	0.00000
Campylobacter lanienae	75658	S	11	3	14	0.00000
Campylobacter hominis	76517	S	10	4	14	0.00000
Sulfurimonas sp. HSL-3221	2894755	S	685	57	742	0.00005
Sulfurimonas sp. SWIR-19	2878390	S	34	47	81	0.00001
Sulfurimonas sp. B2	2590551	S	19	2	21	0.00000
Sulfurimonas sp. H1576	2672570	S	16	1	17	0.00000
Sulfurimonas paralvinellae	317658	S	30	4	34	0.00000
Sulfurimonas hydrogeniphila	2509341	S	20	8	28	0.00000
Sulfurimonas lithotrophica	2590022	S	16	1	17	0.00000
Sulfurimonas gotlandica	1176482	S	15	1	16	0.00000
Sulfuricurvum kujiense	148813	S	76	6	82	0.00001
Helicobacter pylori	210	S	254	131	385	0.00002
Helicobacter sp. NHP19-0003	2849641	S	40	10	50	0.00000
Helicobacter sp. NHP19-0012	2849642	S	34	15	49	0.00000
Helicobacter heilmannii	35817	S	42	22	64	0.00000
Helicobacter suis	104628	S	24	10	34	0.00000
Helicobacter himalayensis	1591088	S	21	2	23	0.00000
Helicobacter bizzozeronii	56877	S	18	2	20	0.00000
Helicobacter cinaedi	213	S	17	18	35	0.00000
Helicobacter canis	29419	S	17	5	22	0.00000
Helicobacter cetorum	138563	S	16	2	18	0.00000
Helicobacter typhlonius	76936	S	16	17	33	0.00000
Helicobacter felis	214	S	15	2	17	0.00000
Helicobacter mustelae	217	S	15	2	17	0.00000
Helicobacter enhydrae	222136	S	12	2	14	0.00000
Helicobacter pullorum	35818	S	12	3	15	0.00000
Helicobacter winghamensis	157268	S	11	4	15	0.00000
Wolinella succinogenes	844	S	78	19	97	0.00001
Nitratifractor salsuginis	269261	S	378	31	409	0.00003
Sulfurovum sp. NBC37-1	387093	S	49	24	73	0.00000
Sulfurovum sp. HSL1-3	2893889	S	49	14	63	0.00000
Sulfurovum sp. XGS-02	2925411	S	25	3	28	0.00000
Sulfurovum lithotrophicum	206403	S	44	25	69	0.00000
Sulfurovum indicum	2779528	S	39	4	43	0.00000
Hydrogenimonas urashimensis	2740515	S	444	49	493	0.00003
Sulfurospirillum cavolei	366522	S	87	6	93	0.00001
Sulfurospirillum sp. UCH001	1581011	S	19	41	60	0.00000
Sulfurospirillum deleyianum	65553	S	23	2	25	0.00000
Sulfurospirillum halorespirans	194424	S	23	2	25	0.00000
Sulfurospirillum multivorans	66821	S	18	64	82	0.00001
Sulfurospirillum barnesii	44674	S	17	1	18	0.00000
Aliarcobacter butzleri	28197	S	12	25	37	0.00000
Aliarcobacter cryaerophilus	28198	S	10	16	26	0.00000
Arcobacter venerupis	1054033	S	12	15	27	0.00000
Arcobacter sp. FWKO B	2593672	S	11	3	14	0.00000
Halarcobacter bivalviorum	663364	S	10	5	15	0.00000
Nitrosophilus alvini	2714855	S	60	21	81	0.00001
Nitrosophilus labii	2706014	S	58	28	86	0.00001
Nitratiruptor sp. YY09-18	2724901	S	33	37	70	0.00000
Nitratiruptor sp. SB155-2	387092	S	25	44	69	0.00000
Caminibacter mediatlanticus	291048	S	49	33	82	0.00001
Caminibacter pacificus	1424653	S	34	19	53	0.00000
Nautilia sp. PV-1	2579250	S	30	12	42	0.00000
Nautilia profundicola	244787	S	24	10	34	0.00000
Acidithiobacillus caldus	33059	S	835	113	948	0.00006
Acidithiobacillus ferrivorans	160808	S	510	83	593	0.00004
Acidithiobacillus ferrooxidans	920	S	355	312	667	0.00004
Acidithiobacillus thiooxidans	930	S	199	10	209	0.00001
Acidithiobacillus ferriphilus	1689834	S	197	34	231	0.00001
Acidithiobacillus ferridurans	1232575	S	35	240	275	0.00002
Acidithiobacillus sp. 'AMD consortium'	2614801	S	29	312	341	0.00002
Bdellovibrio bacteriovorus	959	S	605	59	664	0.00004
Bdellovibrio sp. NC01	2220073	S	121	11	132	0.00001
Bdellovibrio sp. LBG001	2835041	S	73	6	79	0.00001
Bdellovibrio sp. ZAP7	2231053	S	69	32	101	0.00001
Bdellovibrio sp. KM01	2748865	S	55	27	82	0.00001
Pseudobdellovibrio exovorus	453816	S	74	3	77	0.00000
Bacteriovorax stolpii	960	S	94	23	117	0.00001
Halobacteriovorax sp. BALOs_7	2109558	S	35	11	46	0.00000
Halobacteriovorax marinus	97084	S	32	15	47	0.00000
Fluviispira sanaruensis	2493639	S	30	12	42	0.00000
Silvanigrella aquatica	1915309	S	29	11	40	0.00000
Hydrogenophilus thermoluteolus	297	S	1068	225	1293	0.00008
Mariprofundus ferrinatatus	1921087	S	352	33	385	0.00002
Mariprofundus aestuarium	1921086	S	235	27	262	0.00002
Streptomyces sp. AMCC400023	2056258	S	19603	8635	28238	0.00178
Streptomyces sp. NHF165	2175864	S	8845	1848	10693	0.00068
Streptomyces sp. SCSIO 64649	2878388	S	8209	1815	10024	0.00063
Streptomyces sp. CdTB01	1725411	S	7586	2496	10082	0.00064
Streptomyces sp. Z423-1	2730915	S	7057	2351	9408	0.00059
Streptomyces sp. SN-593	659352	S	6874	1970	8844	0.00056
Streptomyces sp. CB01881	2078691	S	6808	1561	8369	0.00053
Streptomyces sp. P3	2135430	S	6601	1907	8508	0.00054
Streptomyces sp. MA3_2.13	2867410	S	6505	1020	7525	0.00048
Streptomyces sp. ST1015	1848900	S	6419	1563	7982	0.00050
Streptomyces sp. So13.3	2136173	S	6153	1382	7535	0.00048
Streptomyces sp. 3214.6	1882757	S	6109	2043	8152	0.00052
Streptomyces sp. ZYC-3	2797636	S	6089	1390	7479	0.00047
Streptomyces sp. MG28	2865673	S	6032	2359	8391	0.00053
Streptomyces sp. WAC 01438	2203204	S	5926	2307	8233	0.00052
Streptomyces sp. HM190	2695266	S	5824	2124	7948	0.00050
Streptomyces sp. 3025	2923272	S	5342	1137	6479	0.00041
Streptomyces sp. SCUT-3	2684469	S	5303	2519	7822	0.00049
Streptomyces sp. BH-MK-02	2880933	S	5295	1336	6631	0.00042
Streptomyces sp. 891-h	2720714	S	5207	1135	6342	0.00040
Streptomyces sp. NA02950	2742137	S	5058	1188	6246	0.00039
Streptomyces sp. LRE541	2931983	S	4833	1266	6099	0.00039
Streptomyces sp. A2-16	2781734	S	4812	1690	6502	0.00041
Streptomyces sp. GQFP	2907545	S	4610	915	5525	0.00035
Streptomyces sp. C8S0	2585716	S	4601	1555	6156	0.00039
Streptomyces sp. JB150	2714844	S	4598	1755	6353	0.00040
Streptomyces sp. YIM 121038	2136401	S	4489	1495	5984	0.00038
Streptomyces sp. NEAU-sy36	2751189	S	4428	1888	6316	0.00040
Streptomyces sp. Go-475	2072505	S	4335	2222	6557	0.00041
Streptomyces sp. DSM 40868	2721173	S	4332	1793	6125	0.00039
Streptomyces sp. MST-110588	2833628	S	4309	1245	5554	0.00035
Streptomyces sp. CMB-StM0423	2059884	S	4290	2119	6409	0.00041
Streptomyces sp. SAT1	1849967	S	4192	1804	5996	0.00038
Streptomyces sp. MBT27	1488356	S	4188	1434	5622	0.00036
Streptomyces sp. W1SF4	2305220	S	4176	1709	5885	0.00037
Streptomyces sp. GMY02	1333528	S	4075	855	4930	0.00031
Streptomyces sp. NA04227	2742136	S	4032	1104	5136	0.00032
Streptomyces sp. BJ20	2930049	S	3915	1816	5731	0.00036
Streptomyces sp. MG62	2838015	S	3910	1637	5547	0.00035
Streptomyces sp. GS7	2692234	S	3774	1178	4952	0.00031
Streptomyces sp. Go 40/10	2825844	S	3732	1831	5563	0.00035
Streptomyces sp. QHH-9511	2684468	S	3703	1185	4888	0.00031
Streptomyces sp. RTd22	1841249	S	3608	1580	5188	0.00033
Streptomyces sp. BHT-5-2	2866715	S	3549	1266	4815	0.00030
Streptomyces sp. RPA4-2	2721244	S	3490	1148	4638	0.00029
Streptomyces sp. Rer75	2750011	S	3478	1674	5152	0.00033
Streptomyces sp. 135	2838850	S	3335	1210	4545	0.00029
Streptomyces sp. HP-A2021	2927875	S	3178	1899	5077	0.00032
Streptomyces sp. SirexAA-E	862751	S	3172	1078	4250	0.00027
Streptomyces sp. HSG2	2797167	S	3163	822	3985	0.00025
Streptomyces sp. Tu 2975	2676871	S	3118	1124	4242	0.00027
Streptomyces sp. SM18	1736046	S	3109	984	4093	0.00026
Streptomyces sp. SYP-A7193	2662065	S	3008	1890	4898	0.00031
Streptomyces sp. fd1-xmd	1812480	S	2985	1425	4410	0.00028
Streptomyces sp. WAC 01529	2203205	S	2761	1088	3849	0.00024
Streptomyces sp. INR7	2607753	S	2758	1496	4254	0.00027
Streptomyces sp. TN58	234612	S	2696	1339	4035	0.00026
Streptomyces sp. S4.7	2705439	S	2512	926	3438	0.00022
Streptomyces sp. WAC 06738	2203210	S	2510	2431	4941	0.00031
Streptomyces sp. jing01	2726118	S	2493	1515	4008	0.00025
Streptomyces sp. S1D4-11	2721246	S	2337	1705	4042	0.00026
Streptomyces sp. CNQ-509	444103	S	2325	2213	4538	0.00029
Streptomyces sp. CB09001	2083284	S	2304	1596	3900	0.00025
Streptomyces sp. SUK 48	2582831	S	2158	1419	3577	0.00023
Streptomyces sp. WY228	2855836	S	2122	1197	3319	0.00021
Streptomyces sp. ADI95-16	1522758	S	2019	1780	3799	0.00024
Streptomyces sp. CCM_MD2014	1561022	S	1917	1745	3662	0.00023
Streptomyces sp. YPW6	2840373	S	1855	1018	2873	0.00018
Streptomyces sp. 769	1262452	S	1817	1405	3222	0.00020
Streptomyces sp. HF10	2692233	S	1748	1285	3033	0.00019
Streptomyces sp. Mg1	465541	S	1718	1613	3331	0.00021
Streptomyces sp. AgN23	1188315	S	1486	1333	2819	0.00018
Streptomyces sp. RPA4-5	2721245	S	1411	939	2350	0.00015
Streptomyces sp. 2323.1	1938841	S	1369	869	2238	0.00014
Streptomyces sp. S8	1837283	S	1303	1161	2464	0.00016
Streptomyces sp. EAS-AB2608	2779671	S	1299	2090	3389	0.00021
Streptomyces sp. 3211	1964449	S	1224	1572	2796	0.00018
Streptomyces sp. S063	2005885	S	1206	865	2071	0.00013
Streptomyces sp. XC 2026	2782004	S	1193	1064	2257	0.00014
Streptomyces sp. NEAU-S7GS2	2202000	S	1187	989	2176	0.00014
Streptomyces sp. ID38640	1265399	S	1165	829	1994	0.00013
Streptomyces sp. Sge12	1972846	S	1093	1726	2819	0.00018
Streptomyces sp. PBH53	1577075	S	1090	1621	2711	0.00017
Streptomyces sp. HNA39	2850561	S	1075	1256	2331	0.00015
Streptomyces sp. WA6-1-16	2879427	S	1039	1071	2110	0.00013
Streptomyces sp. MOE7	1961713	S	958	1172	2130	0.00013
Streptomyces sp. RLB1-33	2721243	S	948	2752	3700	0.00023
Streptomyces sp. Tue 6075	1661694	S	891	1035	1926	0.00012
Streptomyces sp. 11-1-2	1851167	S	884	1647	2531	0.00016
Streptomyces sp. SGAir0924	2109593	S	838	4247	5085	0.00032
Streptomyces sp. NA02536	2742133	S	823	2199	3022	0.00019
Streptomyces sp. CFMR 7	1649184	S	785	1367	2152	0.00014
Streptomyces sp. CB00271	2750025	S	785	1076	1861	0.00012
Streptomyces sp. A144	2871487	S	756	3524	4280	0.00027
Streptomyces sp. SS52	2563602	S	719	3518	4237	0.00027
Streptomyces sp. LBUM 1480	2609808	S	685	6901	7586	0.00048
Streptomyces sp. WAC00303	2933779	S	652	946	1598	0.00010
Streptomyces sp. M56	1495638	S	612	1619	2231	0.00014
Streptomyces sp. CLI2509	1984801	S	599	2119	2718	0.00017
Streptomyces sp. CB04723	2748873	S	594	1073	1667	0.00011
Streptomyces sp. Tu6071	355249	S	563	1778	2341	0.00015
Streptomyces sp. M2	646637	S	505	2787	3292	0.00021
Streptomyces sp. CB09030	2913412	S	489	1650	2139	0.00014
Streptomyces sp. PAMC 26508	1265601	S	478	1755	2233	0.00014
Streptomyces sp. CRSS-Y-16	2906474	S	457	2669	3126	0.00020
Streptomyces sp. endophyte_N2	2153485	S	444	1299	1743	0.00011
Streptomyces sp. V17-9	2831149	S	438	2114	2552	0.00016
Streptomyces sp. HU2014	2939414	S	427	1478	1905	0.00012
Streptomyces sp. BSE6.1	2605730	S	415	1899	2314	0.00015
Streptomyces sp. VN1	1821625	S	401	1709	2110	0.00013
Streptomyces sp. WA1-19	2884220	S	353	1911	2264	0.00014
Streptomyces sp. NA03103	2742134	S	344	2263	2607	0.00016
Streptomyces sp. WAC00288	2094021	S	342	1438	1780	0.00011
Streptomyces sp. S501	2420135	S	326	1292	1618	0.00010
Streptomyces sp. LBUM 1482	2609809	S	322	8375	8697	0.00055
Streptomyces sp. 2114.2	1881022	S	321	2005	2326	0.00015
Streptomyces sp. A1-5	2738410	S	320	1501	1821	0.00012
Streptomyces sp. R527F	1664033	S	282	1615	1897	0.00012
Streptomyces sp. S1A1-7	2594459	S	270	2630	2900	0.00018
Streptomyces sp. KPB2	2305221	S	266	2213	2479	0.00016
Streptomyces sp. GF20	2692235	S	226	1291	1517	0.00010
Streptomyces sp. LBUM 1475	2609807	S	221	6742	6963	0.00044
Streptomyces sp. CA-256286	2801033	S	204	1274	1478	0.00009
Streptomyces sp. RLB3-17	2594455	S	197	3194	3391	0.00021
Streptomyces sp. NBU3104	2911367	S	182	1214	1396	0.00009
Streptomyces sp. 604F	1476754	S	161	1487	1648	0.00010
Streptomyces sp. CC0208	2306165	S	158	4264	4422	0.00028
Streptomyces sp. FR-008	206662	S	137	1136	1273	0.00008
Streptomyces sp. PLM4	2929798	S	134	1124	1258	0.00008
Streptomyces sp. S1D4-20	2594462	S	131	3694	3825	0.00024
Streptomyces sp. GBA 94-10	1218177	S	126	1643	1769	0.00011
Streptomyces sp. A10(2020)	2782013	S	121	1433	1554	0.00010
Streptomyces sp. RLB3-6	2594457	S	110	3580	3690	0.00023
Streptomyces sp. PVA_94-07	1225337	S	107	1612	1719	0.00011
Streptomyces sp. OUCMDZ-3434	1535304	S	93	997	1090	0.00007
Streptomyces sp. RLB1-9	2594454	S	82	4687	4769	0.00030
Streptomyces sp. S1D4-23	2594463	S	80	4442	4522	0.00029
Streptomyces sp. S1D4-14	2594461	S	64	4335	4399	0.00028
Streptomyces sp. ICC1	2099583	S	29	1745	1774	0.00011
Streptomyces sp. SM17	565560	S	27	1124	1151	0.00007
Streptomyces sp. ICC4	2099584	S	19	1322	1341	0.00008
Streptomyces sp. HNM0561	2903099	S	12	2373	2385	0.00015
Streptomyces venezuelae	54571	S	22631	10131	32762	0.00207
Streptomyces cadmiisoli	2184053	S	5215	1394	6609	0.00042
Streptomyces aurantiacus	47760	S	3963	1011	4974	0.00031
Streptomyces qaidamensis	1783515	S	3696	1600	5296	0.00033
Streptomyces alboniger	132473	S	2604	1009	3613	0.00023
Streptomyces koyangensis	188770	S	2016	2060	4076	0.00026
Streptomyces hygroscopicus	1912	S	6739	10476	17215	0.00109
Streptomyces rapamycinicus	1226757	S	4087	978	5065	0.00032
Streptomyces violaceusniger	68280	S	1781	1163	2944	0.00019
Streptomyces yatensis	155177	S	1595	1150	2745	0.00017
Streptomyces malaysiensis	92644	S	489	1425	1914	0.00012
Streptomyces chartreusis	1969	S	11923	5096	17019	0.00108
Streptomyces capitiformicae	2014920	S	11635	1894	13529	0.00085
Streptomyces cyaneochromogenes	2496836	S	10064	3089	13153	0.00083
Streptomyces ferrugineus	1413221	S	9800	3300	13100	0.00083
Streptomyces griseus	1911	S	3583	3222	6805	0.00043
Streptomyces sp. M54	2759525	S	357	901	1258	0.00008
Streptomyces anulatus	1892	S	2712	2796	5508	0.00035
Streptomyces microflavus	1919	S	1319	5672	6991	0.00044
Streptomyces globisporus	1908	S	1005	7183	8188	0.00052
Streptomyces albus	1888	S	9000	4663	13663	0.00086
Streptomyces formicae	1616117	S	8011	2673	10684	0.00068
Streptomyces bingchenggensis	379067	S	7645	1582	9227	0.00058
Streptomyces bathyalis	2710756	S	7615	1401	9016	0.00057
Streptomyces armeniacus	83291	S	7515	1184	8699	0.00055
Streptomyces lydicus	47763	S	7355	5025	12380	0.00078
Streptomyces griseorubiginosus	67304	S	6722	2316	9038	0.00057
Streptomyces buecherae	2763006	S	6716	1864	8580	0.00054
Streptomyces tsukubensis	83656	S	6438	1831	8269	0.00052
Streptomyces spectabilis	68270	S	6319	2159	8478	0.00054
Streptomyces roseirectus	2768066	S	6004	1557	7561	0.00048
Streptomyces niveus	193462	S	5979	2833	8812	0.00056
Streptomyces deccanensis	424188	S	5972	2523	8495	0.00054
Streptomyces davaonensis	348043	S	5916	1744	7660	0.00048
Streptomyces aquilus	2548456	S	5916	1837	7753	0.00049
Streptomyces lincolnensis	1915	S	5847	1776	7623	0.00048
Streptomyces cattleya	29303	S	5645	1798	7443	0.00047
Streptomyces seoulensis	73044	S	5644	2308	7952	0.00050
Streptomyces asoensis	249586	S	5421	1695	7116	0.00045
Streptomyces lunaelactis	1535768	S	5404	1215	6619	0.00042
Streptomyces phaeolivaceus	2653200	S	5360	1536	6896	0.00044
Streptomyces antibioticus	1890	S	5143	1937	7080	0.00045
Streptomyces actuosus	1885	S	5139	2301	7440	0.00047
Streptomyces rimosus	1927	S	5137	9682	14819	0.00094
Streptomyces xanthii	2768069	S	5032	1634	6666	0.00042
Streptomyces calvus	67282	S	4965	2019	6984	0.00044
Streptomyces alboflavus	67267	S	4932	1451	6383	0.00040
Streptomyces xinghaiensis	1038928	S	4873	1612	6485	0.00041
Streptomyces nigra	1827580	S	4762	1975	6737	0.00043
Streptomyces durmitorensis	319947	S	4651	1072	5723	0.00036
Streptomyces galilaeus	33899	S	4635	1647	6282	0.00040
Streptomyces griseoviridis	45398	S	4564	1571	6135	0.00039
Streptomyces genisteinicus	2768068	S	4511	1532	6043	0.00038
Streptomyces griseochromogenes	68214	S	4496	1312	5808	0.00037
Streptomyces albulus	68570	S	4439	1432	5871	0.00037
Streptomyces clavuligerus	1901	S	4426	1160	5586	0.00035
Streptomyces globosus	68209	S	4395	1732	6127	0.00039
Streptomyces dengpaensis	2049881	S	4388	1291	5679	0.00036
Streptomyces vietnamensis	362257	S	4370	1547	5917	0.00037
Streptomyces viridosporus	67581	S	4227	1800	6027	0.00038
Streptomyces aureoverticillatus	66871	S	4209	1204	5413	0.00034
Streptomyces griseocarneus	51201	S	4208	1593	5801	0.00037
Streptomyces exfoliatus	1905	S	4206	1532	5738	0.00036
Streptomyces olivoreticuli	68246	S	4197	1282	5479	0.00035
Streptomyces harbinensis	1176198	S	4190	1250	5440	0.00034
Streptomyces avermitilis	33903	S	4188	1271	5459	0.00034
Streptomyces rectiverticillatus	173860	S	4163	1444	5607	0.00035
Streptomyces glaucescens	1907	S	4112	1873	5985	0.00038
Streptomyces luteoverticillatus	66425	S	4041	1451	5492	0.00035
Streptomyces ambofaciens	1889	S	4035	2544	6579	0.00042
Streptomyces paludis	2282738	S	4029	952	4981	0.00031
Streptomyces ficellus	1977088	S	3961	1525	5486	0.00035
Streptomyces liangshanensis	2717324	S	3927	1073	5000	0.00032
Streptomyces collinus	42684	S	3805	2728	6533	0.00041
Streptomyces chromofuscus	42881	S	3725	1511	5236	0.00033
Streptomyces parvulus	146923	S	3690	1710	5400	0.00034
Streptomyces nodosus	40318	S	3668	1002	4670	0.00030
Streptomyces subrutilus	36818	S	3653	1444	5097	0.00032
Streptomyces roseochromogenus	285450	S	3646	1195	4841	0.00031
Streptomyces broussonetiae	2686304	S	3643	1156	4799	0.00030
Streptomyces peucetius	1950	S	3595	1053	4648	0.00029
Streptomyces lavendulae	1914	S	3557	1313	4870	0.00031
Streptomyces atratus	1893	S	3553	773	4326	0.00027
Streptomyces prasinus	67345	S	3519	1219	4738	0.00030
Streptomyces vinaceus	1960	S	3485	1325	4810	0.00030
Streptomyces incarnatus	665007	S	3463	1038	4501	0.00028
Streptomyces fodineus	1904616	S	3463	1274	4737	0.00030
Streptomyces tendae	1932	S	3451	1500	4951	0.00031
Streptomyces hundungensis	1077946	S	3444	1153	4597	0.00029
Streptomyces pactum	68249	S	3396	1431	4827	0.00031
Streptomyces katrae	68223	S	3299	1319	4618	0.00029
Streptomyces tirandamycinicus	2174846	S	3247	1146	4393	0.00028
Streptomyces gilvosporeus	553510	S	3182	1080	4262	0.00027
Streptomyces pristinaespiralis	38300	S	3182	1473	4655	0.00029
Streptomyces kanamyceticus	1967	S	3142	1092	4234	0.00027
Streptomyces gardneri	66892	S	3112	1297	4409	0.00028
Streptomyces dangxiongensis	1442032	S	3100	1127	4227	0.00027
Streptomyces nitrosporeus	28894	S	3092	934	4026	0.00025
Streptomyces mobaraensis	35621	S	3045	115725	118770	0.00751
Streptomyces coeruleorubidus	116188	S	3019	1472	4491	0.00028
Streptomyces hawaiiensis	67305	S	2980	1333	4313	0.00027
Streptomyces spongiicola	1690221	S	2977	1307	4284	0.00027
Streptomyces pluripotens	1355015	S	2977	732	3709	0.00023
Streptomyces gobiensis	2875706	S	2950	613	3563	0.00023
Streptomyces inhibens	2293571	S	2917	927	3844	0.00024
Streptomyces qinzhouensis	2599401	S	2886	735	3621	0.00023
Streptomyces cyanogenus	80860	S	2886	1322	4208	0.00027
Streptomyces finlayi	67296	S	2859	698	3557	0.00022
Streptomyces angustmyceticus	285578	S	2810	1197	4007	0.00025
Streptomyces pratensis	1169025	S	2789	721	3510	0.00022
Streptomyces huasconensis	1854574	S	2767	1123	3890	0.00025
Streptomyces tuirus	68278	S	2760	1442	4202	0.00027
Streptomyces nojiriensis	66374	S	2755	1219	3974	0.00025
Streptomyces rutgersensis	53451	S	2708	1390	4098	0.00026
Streptomyces fagopyri	2662397	S	2638	934	3572	0.00023
Streptomyces cyaneogriseus	68192	S	2103	1652	3755	0.00024
Streptomyces leeuwenhoekii	1437453	S	2010	1418	3428	0.00022
Streptomyces decoyicus	249567	S	1552	871	2423	0.00015
Streptomyces lydicamycinicus	1546107	S	1319	795	2114	0.00013
Streptomyces auratus	114687	S	1282	855	2137	0.00014
Streptomyces antimycoticus	68175	S	1264	1272	2536	0.00016
Streptomyces xiamenensis	408015	S	1175	1004	2179	0.00014
Streptomyces platensis	58346	S	1013	754	1767	0.00011
Streptomyces albidoflavus	1886	S	342	5094	5436	0.00034
Streptomyces coelicolor	1902	S	273	2437	2710	0.00017
Streptomyces sampsonii	42239	S	251	1995	2246	0.00014
Streptomyces filamentosus	67294	S	797	995	1792	0.00011
Streptomyces californicus	67351	S	792	2548	3340	0.00021
Streptomyces alfalfae	1642299	S	740	4103	4843	0.00031
Streptomyces fungicidicus	68203	S	732	2113	2845	0.00018
Streptomyces olivaceus	47716	S	716	2590	3306	0.00021
Streptomyces fradiae	1906	S	616	9592	10208	0.00065
Streptomyces cavourensis	67258	S	614	1119	1733	0.00011
Streptomyces murinus	33900	S	500	1404	1904	0.00012
Streptomyces mirabilis	68239	S	484	2819	3303	0.00021
Streptomyces scabiei	1930	S	467	4011	4478	0.00028
Streptomyces griseofuscus	146922	S	402	1771	2173	0.00014
Streptomyces noursei	1971	S	398	1534	1932	0.00012
Streptomyces albireticuli	1940	S	397	1654	2051	0.00013
Streptomyces autolyticus	75293	S	358	1176	1534	0.00010
Streptomyces cinereoruber	67260	S	264	1364	1628	0.00010
Streptomyces lividans	1916	S	262	3085	3347	0.00021
Streptomyces rubrolavendulae	285473	S	218	1573	1791	0.00011
Streptomyces violaceoruber	1935	S	204	884	1088	0.00007
Streptomyces rochei	1928	S	154	1137	1291	0.00008
Streptomyces sviceus	285530	S	11	925	936	0.00006
Kitasatospora sp. MMS16-BH015	2018025	S	5300	1956	7256	0.00046
Kitasatospora sp. NA04385	2742135	S	4360	2567	6927	0.00044
Kitasatospora setae	2066	S	4500	2568	7068	0.00045
Kitasatospora aureofaciens	1894	S	3759	1730	5489	0.00035
Kitasatospora albolonga	68173	S	1587	1323	2910	0.00018
Streptacidiphilus sp. P02-A3a	2704468	S	5102	1757	6859	0.00043
Streptacidiphilus sp. PB12-B1b	2705012	S	4454	1961	6415	0.00041
Streptacidiphilus bronchialis	2126346	S	4334	1589	5923	0.00037
Yinghuangia sp. ASG 101	2896848	S	7221	1373	8594	0.00054
Microbacterium sp. No. 7	1714373	S	3606	1632	5238	0.00033
Microbacterium sp. JZ31	1906274	S	2924	842	3766	0.00024
Microbacterium sp. 4R-513	2567934	S	2866	539	3405	0.00022
Microbacterium sp. 10M-3C3	2483401	S	2453	728	3181	0.00020
Microbacterium sp. SSW1-51	2851650	S	2232	560	2792	0.00018
Microbacterium sp. YJN-G	2763257	S	2162	707	2869	0.00018
Microbacterium sp. SSW1-36	2851648	S	1997	436	2433	0.00015
Microbacterium sp. ABRD_28	2268461	S	1853	258	2111	0.00013
Microbacterium sp. BH-3-3-3	1906742	S	1836	451	2287	0.00014
Microbacterium sp. XT11	367477	S	1802	388	2190	0.00014
Microbacterium sp. NIBRBAC000506063	2734618	S	1801	747	2548	0.00016
Microbacterium sp. LKL04	912630	S	1723	421	2144	0.00014
Microbacterium sp. A18JL241	2782166	S	1693	403	2096	0.00013
Microbacterium sp. H1-D42	2925844	S	1682	286	1968	0.00012
Microbacterium sp. cx-55	2875948	S	1623	247	1870	0.00012
Microbacterium sp. Y-01	2048898	S	1547	604	2151	0.00014
Microbacterium sp. PM5	2014534	S	1426	271	1697	0.00011
Microbacterium sp. CBA3102	2603598	S	1371	331	1702	0.00011
Microbacterium sp. TPU 3598	1938334	S	1312	338	1650	0.00010
Microbacterium sp. 1S1	2606451	S	1286	531	1817	0.00011
Microbacterium sp. Nx66	2766784	S	1042	654	1696	0.00011
Microbacterium sp. RG1	2489212	S	722	553	1275	0.00008
Microbacterium sp. 1.5R	1916917	S	339	1015	1354	0.00009
Microbacterium sp. SGAir0570	2070348	S	305	1072	1377	0.00009
Microbacterium sp. CGR1	1696072	S	301	937	1238	0.00008
Microbacterium sp. PAMC22086	2861281	S	259	535	794	0.00005
Microbacterium sp. str. 'China'	2103230	S	180	899	1079	0.00007
Microbacterium sp. PAMC 28756	1795053	S	74	1147	1221	0.00008
Microbacterium sp. KUDC0406	2909588	S	27	1850	1877	0.00012
Microbacterium sp. Se63.02b	2709304	S	18	1299	1317	0.00008
Microbacterium sp. Se5.02b	2864103	S	17	1173	1190	0.00008
Microbacterium sp. PAMC21962	2861280	S	16	652	668	0.00004
Microbacterium cremeum	2782169	S	5303	1166	6469	0.00041
Microbacterium foliorum	104336	S	4115	884	4999	0.00032
Microbacterium oleivorans	273677	S	3424	692	4116	0.00026
Microbacterium hominis	162426	S	3324	9227	12551	0.00079
Microbacterium atlanticum	2782168	S	3182	733	3915	0.00025
Microbacterium oryzae	743009	S	3104	976	4080	0.00026
Microbacterium resistens	156977	S	2508	486	2994	0.00019
Microbacterium lemovicicum	1072463	S	2422	572	2994	0.00019
Microbacterium sediminis	904291	S	2379	1121	3500	0.00022
Microbacterium pygmaeum	370764	S	2074	269	2343	0.00015
Microbacterium testaceum	2033	S	1948	366	2314	0.00015
Microbacterium aurum	36805	S	1918	625	2543	0.00016
Microbacterium wangchenii	2541726	S	1874	441	2315	0.00015
Microbacterium lushaniae	2614639	S	1851	445	2296	0.00015
Microbacterium oxydans	82380	S	1834	1418	3252	0.00021
Microbacterium caowuchunii	2614638	S	1816	363	2179	0.00014
Microbacterium luteum	2782167	S	1705	737	2442	0.00015
Microbacterium esteraromaticum	57043	S	1698	393	2091	0.00013
Microbacterium protaetiae	2509458	S	1695	396	2091	0.00013
Microbacterium chocolatum	84292	S	1648	389	2037	0.00013
Microbacterium hydrocarbonoxydans	273678	S	1533	285	1818	0.00011
Microbacterium schleiferi	69362	S	1118	409	1527	0.00010
Microbacterium fandaimingii	2708079	S	926	84	1010	0.00006
Microbacterium binotii	462710	S	702	529	1231	0.00008
Microbacterium chengjingii	2769067	S	682	39	721	0.00005
Microbacterium amylolyticum	936337	S	668	151	819	0.00005
Microbacterium endophyticum	1526412	S	541	40	581	0.00004
Microbacterium paludicola	300019	S	269	989	1258	0.00008
Microbacterium paraoxydans	199592	S	245	1655	1900	0.00012
Agromyces sp. H17E-10	2932244	S	4206	1505	5711	0.00036
Agromyces sp. LHK192	2498704	S	3732	1183	4915	0.00031
Agromyces sp. CFWR-12	2929802	S	2749	1772	4521	0.00029
Agromyces flavus	589382	S	6170	2127	8297	0.00052
Agromyces soli	659012	S	3656	1442	5098	0.00032
Agromyces aureus	453304	S	3491	1077	4568	0.00029
Agromyces marinus	1389020	S	3315	1329	4644	0.00029
Agromyces protaetiae	2509455	S	2826	884	3710	0.00023
Agromyces badenianii	2080742	S	2707	968	3675	0.00023
Agromyces archimandritae	2781962	S	2628	828	3456	0.00022
Agromyces intestinalis	2592652	S	2484	1517	4001	0.00025
Agromyces laixinhei	2585717	S	2446	616	3062	0.00019
Curtobacterium sp. L6-1	2841594	S	1916	677	2593	0.00016
Curtobacterium sp. BH-2-1-1	1905847	S	1748	622	2370	0.00015
Curtobacterium sp. YC1	2795488	S	1506	739	2245	0.00014
Curtobacterium sp. MR_MD2014	1561023	S	1377	684	2061	0.00013
Curtobacterium sp. TC1	2862880	S	1305	713	2018	0.00013
Curtobacterium sp. 24E2	2804758	S	1099	638	1737	0.00011
Curtobacterium sp. SGAir0471	2070337	S	922	784	1706	0.00011
Curtobacterium sp. TXMA1	2876939	S	856	754	1610	0.00010
Curtobacterium sp. C1	2898151	S	371	1187	1558	0.00010
Curtobacterium sp. Csp2	2495430	S	334	1205	1539	0.00010
Curtobacterium sp. Csp1	2495429	S	59	1389	1448	0.00009
Curtobacterium flaccumfaciens	2035	S	2939	1464	4403	0.00028
Curtobacterium luteum	33881	S	1721	665	2386	0.00015
Rathayibacter sp. VKM Ac-2759	2609252	S	2428	918	3346	0.00021
Rathayibacter sp. VKM Ac-2760	2609253	S	2264	1224	3488	0.00022
Rathayibacter sp. VKM Ac-2804	2609257	S	1674	1263	2937	0.00019
Rathayibacter sp. VKM Ac-2801	2609255	S	1040	991	2031	0.00013
Rathayibacter sp. VKM Ac-2762	2609254	S	387	1052	1439	0.00009
Rathayibacter sp. VKM Ac-2805	2609258	S	365	1022	1387	0.00009
Rathayibacter festucae	110937	S	2427	2577	5004	0.00032
Rathayibacter tanaceti	1671680	S	1470	406	1876	0.00012
Rathayibacter iranicus	59737	S	1015	149	1164	0.00007
Rathayibacter tritici	33888	S	956	310	1266	0.00008
Rathayibacter rathayi	33887	S	872	251	1123	0.00007
Rathayibacter toxicus	145458	S	434	43	477	0.00003
Leucobacter sp. NB 10	2873270	S	1821	573	2394	0.00015
Leucobacter sp. H25R-14	2932245	S	1783	333	2116	0.00013
Leucobacter sp. Psy1	2875729	S	1545	213	1758	0.00011
Leucobacter sp. CX169	2813744	S	1223	354	1577	0.00010
Leucobacter sp. H21R-36	2932246	S	536	1509	2045	0.00013
Leucobacter sp. H21R-40	2932247	S	483	1361	1844	0.00012
Leucobacter muris	1935379	S	2033	831	2864	0.00018
Leucobacter triazinivorans	1784719	S	1803	1175	2978	0.00019
Leucobacter luti	340320	S	705	77	782	0.00005
Leucobacter insecticola	2714934	S	545	53	598	0.00004
Leucobacter viscericola	2714935	S	493	57	550	0.00003
Leucobacter denitrificans	683042	S	377	65	442	0.00003
Leucobacter coleopterorum	2714933	S	348	41	389	0.00002
Agrococcus sp. SCSIO52902	2933290	S	3061	1695	4756	0.00030
Agrococcus sp. SGAir0287	2070347	S	2853	979	3832	0.00024
Agrococcus sp. Marseille-Q4369	2810513	S	2706	1070	3776	0.00024
Agrococcus jejuensis	399736	S	3107	1115	4222	0.00027
Agrococcus carbonis	684552	S	2825	1474	4299	0.00027
Clavibacter michiganensis	28447	S	10837	15471	26308	0.00166
Clavibacter zhangzhiyongii	2768071	S	1421	747	2168	0.00014
Clavibacter sp. A6099	2860285	S	797	546	1343	0.00008
Leifsonia sp. ZF2019	2781978	S	2483	769	3252	0.00021
Leifsonia sp. PS1209	2724914	S	2340	720	3060	0.00019
Leifsonia sp. 21MFCrub1.1	1798223	S	2140	2935	5075	0.00032
Leifsonia shinshuensis	150026	S	3343	1061	4404	0.00028
Leifsonia xyli	1575	S	2031	317	2348	0.00015
Protaetiibacter intestinalis	2419774	S	2427	942	3369	0.00021
Protaetiibacter sp. SSC-01	2759943	S	2378	949	3327	0.00021
Protaetiibacter larvae	2592654	S	1847	642	2489	0.00016
Salinibacterium sp. ZJ450	2708338	S	1902	331	2233	0.00014
Salinibacterium sp. ZJ70	2708084	S	1657	466	2123	0.00013
Salinibacterium sp. dk2585	2603292	S	1332	251	1583	0.00010
Salinibacterium sp. UTAS2018	2508880	S	481	48	529	0.00003
Salinibacterium sp. M195	2583374	S	337	40	377	0.00002
Salinibacterium hongtaonis	2079791	S	639	77	716	0.00005
Cryobacterium sp. LW097	1978566	S	1514	363	1877	0.00012
Cryobacterium sp. PAMC25264	2861288	S	781	508	1289	0.00008
Cryobacterium soli	2220095	S	1187	666	1853	0.00012
Cryobacterium arcticum	670052	S	899	730	1629	0.00010
Frondihabitans sp. PAMC 28766	1795630	S	2436	362	2798	0.00018
Frondihabitans sp. 762G35	1446794	S	2053	483	2536	0.00016
Microterricola viridarii	412690	S	4184	1164	5348	0.00034
Plantibacter sp. PA-3-X8	2480625	S	737	706	1443	0.00009
Plantibacter sp. M259	2583822	S	697	644	1341	0.00008
Plantibacter flavus	150123	S	889	745	1634	0.00010
Microcella flavibacter	1804990	S	2184	1190	3374	0.00021
Microcella alkaliphila	279828	S	1510	298	1808	0.00011
Cnuibacter physcomitrellae	1619308	S	2921	714	3635	0.00023
Mycetocola zhujimingii	2079792	S	1005	137	1142	0.00007
Mycetocola sp. JXN-3	2116510	S	950	164	1114	0.00007
Mycetocola spongiae	2859226	S	872	135	1007	0.00006
Herbiconiux sp. SALV-R1	2735133	S	2753	621	3374	0.00021
Frigoribacterium sp. NBH87	2596916	S	2662	882	3544	0.00022
Subtercola sp. AK-R2A1-2	2895559	S	1575	172	1747	0.00011
Subtercola sp. PAMC28395	2846775	S	963	113	1076	0.00007
Gryllotalpicola protaetiae	2419771	S	2489	547	3036	0.00019
Humibacter sp. WJ7-1	2599293	S	2179	542	2721	0.00017
Chryseoglobus sp. 28M-23	2772253	S	384	880	1264	0.00008
Chryseoglobus indicus	2750620	S	374	903	1277	0.00008
Amnibacterium sp. L3-i23	2905871	S	2051	557	2608	0.00016
Gulosibacter sediminis	1729695	S	1731	576	2307	0.00015
Marisediminicola antarctica	674079	S	1723	242	1965	0.00012
Diaminobutyricimonas sp. LJ205	2683590	S	1590	338	1928	0.00012
Agreia sp. COWG	2773266	S	1272	174	1446	0.00009
Glaciihabitans sp. INWT7	2596912	S	1266	114	1380	0.00009
Aquiluna borgnonia	2499157	S	186	25	211	0.00001
Candidatus Aquiluna sp. UB-MaderosW2red	1855377	S	100	8	108	0.00001
Rhodoluna limnophila	232537	S	143	12	155	0.00001
Candidatus Rhodoluna planktonica	535712	S	80	6	86	0.00001
Rhodoluna lacicola	529884	S	65	5	70	0.00000
Pseudoclavibacter sp. Marseille-Q3772	2866588	S	350	78	428	0.00003
Aurantimicrobium photophilum	1987356	S	125	10	135	0.00001
Aurantimicrobium minutum	708131	S	70	17	87	0.00001
Aurantimicrobium sp. MWH-Uga1	2079575	S	28	6	34	0.00000
Pontimonas salivibrio	1159327	S	149	8	157	0.00001
Arthrobacter sp. QXT-31	1357915	S	4173	1409	5582	0.00035
Arthrobacter sp. QL17	2895818	S	2087	560	2647	0.00017
Arthrobacter sp. FW305-BF8	2879617	S	1933	645	2578	0.00016
Arthrobacter sp. PM3	2017685	S	1733	334	2067	0.00013
Arthrobacter sp. NicSoilB8	2830998	S	1608	509	2117	0.00013
Arthrobacter sp. 24S4-2	2575374	S	1469	406	1875	0.00012
Arthrobacter sp. ERGS1:01	1704044	S	1397	316	1713	0.00011
Arthrobacter sp. UKPF54-2	2600159	S	1391	715	2106	0.00013
Arthrobacter sp. PAMC25564	2565366	S	1377	455	1832	0.00012
Arthrobacter sp. KBS0702	2578107	S	1372	664	2036	0.00013
Arthrobacter sp. U41	1849032	S	1358	474	1832	0.00012
Arthrobacter sp. NicSoilB4	2830997	S	1339	512	1851	0.00012
Arthrobacter sp. PGP41	2079227	S	1323	578	1901	0.00012
Arthrobacter sp. FB24	290399	S	1184	473	1657	0.00010
Arthrobacter sp. NicSoilC5	2831000	S	1181	755	1936	0.00012
Arthrobacter sp. Helios	2828862	S	1076	208	1284	0.00008
Arthrobacter sp. PAMC25284	2861279	S	1038	328	1366	0.00009
Arthrobacter sp. FW306-2-2C-D06B	2879618	S	1003	237	1240	0.00008
Arthrobacter sp. zg-Y462	2886936	S	801	192	993	0.00006
Arthrobacter sp. PAMC 25486	1494608	S	789	151	940	0.00006
Arthrobacter sp. zg-Y809	2886940	S	728	273	1001	0.00006
Arthrobacter sp. StoSoilB20	2830995	S	594	207	801	0.00005
Arthrobacter sp. StoSoilB5	2830992	S	576	204	780	0.00005
Arthrobacter sp. NtRootA1	2830983	S	551	208	759	0.00005
Arthrobacter sp. YN	2020486	S	441	227	668	0.00004
Arthrobacter sp. D5-1	1477518	S	423	347	770	0.00005
Arthrobacter sp. C1-1	2813727	S	388	63	451	0.00003
Arthrobacter sp. NicSoilB11	2830999	S	246	1188	1434	0.00009
Arthrobacter sp. FW306-06-A	2879621	S	243	1031	1274	0.00008
Arthrobacter sp. FW306-05-C	2879620	S	189	1201	1390	0.00009
Arthrobacter sp. StoSoilA2	2830990	S	185	403	588	0.00004
Arthrobacter sp. FW306-07-I	2879622	S	164	1112	1276	0.00008
Arthrobacter sp. StoSoilB19	2830994	S	161	893	1054	0.00007
Arthrobacter sp. StoSoilB13	2830993	S	140	314	454	0.00003
Arthrobacter sp. AQ5-05	2184581	S	42	626	668	0.00004
Arthrobacter agilis	37921	S	3171	528	3699	0.00023
Arthrobacter crystallopoietes	37928	S	2840	607	3447	0.00022
Arthrobacter sulfonylureivorans	2486855	S	1480	277	1757	0.00011
Arthrobacter woluwensis	156980	S	1473	392	1865	0.00012
Arthrobacter dokdonellae	2211210	S	1335	263	1598	0.00010
Arthrobacter jiangjiafuii	2817475	S	1021	312	1333	0.00008
Arthrobacter alpinus	656366	S	961	1272	2233	0.00014
Arthrobacter sunyaminii	2816859	S	704	244	948	0.00006
Kocuria rosea	1275	S	3952	1404	5356	0.00034
Kocuria flava	446860	S	3361	1868	5229	0.00033
Kocuria turfanensis	388357	S	3111	1201	4312	0.00027
Kocuria palustris	71999	S	1660	742	2402	0.00015
Kocuria rhizophila	72000	S	1268	1967	3235	0.00020
Kocuria varians	1272	S	1028	797	1825	0.00012
Kocuria sp. TGY1127_2	2711328	S	433	82	515	0.00003
Kocuria sp. KD4	2719588	S	251	422	673	0.00004
Kocuria sp. BT304	1702043	S	127	646	773	0.00005
Kocuria indica	1049583	S	246	492	738	0.00005
Pseudarthrobacter sp. L1SW	2851598	S	1192	568	1760	0.00011
Pseudarthrobacter sp. BIM B-2242	2772401	S	1031	307	1338	0.00008
Pseudarthrobacter sp. SSS035	2931399	S	869	749	1618	0.00010
Pseudarthrobacter sp. NIBRBAC000502772	2590775	S	605	453	1058	0.00007
Pseudarthrobacter sp. NBSH8	2596911	S	591	247	838	0.00005
Pseudarthrobacter sp. NIBRBAC000502771	2590774	S	265	989	1254	0.00008
Pseudarthrobacter sp. NIBRBAC000502770	2590785	S	258	850	1108	0.00007
Pseudarthrobacter phenanthrenivorans	361575	S	1347	765	2112	0.00013
Pseudarthrobacter equi	728066	S	1071	463	1534	0.00010
Pseudarthrobacter chlorophenolicus	85085	S	1023	424	1447	0.00009
Pseudarthrobacter psychrotolerans	2697569	S	850	371	1221	0.00008
Pseudarthrobacter sulfonivorans	121292	S	714	723	1437	0.00009
Micrococcus luteus	1270	S	3569	6374	9943	0.00063
Micrococcus sp. KD337-16	2856555	S	1436	982	2418	0.00015
Micrococcus sp. KBS0714	1179670	S	43	380	423	0.00003
Micrococcus yunnanensis	566027	S	54	448	502	0.00003
Sinomonas atrocyanea	37927	S	3057	1173	4230	0.00027
Sinomonas sp. R1AF57	2020377	S	2601	708	3309	0.00021
Glutamicibacter protophormiae	37930	S	1119	789	1908	0.00012
Glutamicibacter creatinolyticus	162496	S	1072	299	1371	0.00009
Glutamicibacter halophytocola	1933880	S	562	116	678	0.00004
Glutamicibacter nicotianae	37929	S	457	1293	1750	0.00011
Glutamicibacter mishrai	1775880	S	453	109	562	0.00004
Glutamicibacter arilaitensis	256701	S	405	165	570	0.00004
Glutamicibacter sp. ZJUTW	1155384	S	128	495	623	0.00004
Rothia kristinae	37923	S	1833	1206	3039	0.00019
Rothia mucilaginosa	43675	S	538	129	667	0.00004
Rothia nasimurium	85336	S	354	201	555	0.00004
Rothia aeria	172042	S	292	141	433	0.00003
Rothia dentocariosa	2047	S	172	84	256	0.00002
Rothia terrae	396015	S	109	53	162	0.00001
Rothia amarae	169480	S	103	54	157	0.00001
Rothia sp. ZJ932	2810516	S	74	13	87	0.00001
Paenarthrobacter ureafaciens	37931	S	725	1323	2048	0.00013
Paenarthrobacter aurescens	43663	S	648	494	1142	0.00007
Paenarthrobacter sp. YJN-5	2735316	S	264	636	900	0.00006
Paenarthrobacter sp. YJN-D	2735317	S	151	330	481	0.00003
Paenarthrobacter nicotinovorans	29320	S	121	231	352	0.00002
Citricoccus sp. SGAir0253	2567881	S	2894	930	3824	0.00024
Nesterenkonia sp. NBAIMH1	2600320	S	1003	77	1080	0.00007
Paeniglutamicibacter sp. Y32M11	2853258	S	583	109	692	0.00004
Psychromicrobium lacuslunae	1618207	S	414	68	482	0.00003
Auritidibacter sp. NML130574	2170745	S	385	47	432	0.00003
Neomicrococcus aestuarii	556325	S	309	159	468	0.00003
Renibacterium salmoninarum	1646	S	245	17	262	0.00002
Cellulomonas sp. Y8	2591145	S	4629	2430	7059	0.00045
Cellulomonas sp. H30R-01	2704467	S	4072	1917	5989	0.00038
Cellulomonas sp. C5510	2871170	S	3761	1834	5595	0.00035
Cellulomonas sp. JZ18	2654191	S	3680	1909	5589	0.00035
Cellulomonas sp. zg-ZUI188	2819978	S	3562	1222	4784	0.00030
Cellulomonas sp. zg-ZUI157	2819979	S	3017	1271	4288	0.00027
Cellulomonas sp. zg-ZUI222	2816956	S	2987	1373	4360	0.00028
Cellulomonas sp. EW123	2608402	S	2597	1839	4436	0.00028
Cellulomonas sp. PSBB021	2003551	S	2467	2334	4801	0.00030
Cellulomonas fimi	1708	S	3925	3569	7494	0.00047
Cellulomonas shaoxiangyii	2566013	S	3413	1706	5119	0.00032
Cellulomonas flavigena	1711	S	3295	1497	4792	0.00030
Cellulomonas iranensis	76862	S	3295	1844	5139	0.00032
Cellulomonas gilvus	11	S	2920	1530	4450	0.00028
Cellulomonas taurus	2729175	S	2454	967	3421	0.00022
Actinotalea sp. JY-7876	2758442	S	3709	1622	5331	0.00034
Oerskovia sp. KBS0722	1179673	S	2836	1097	3933	0.00025
Pseudactinotalea sp. HY158	2654547	S	2652	473	3125	0.00020
Paraoerskovia marina	545619	S	1895	601	2496	0.00016
Janibacter melonis	262209	S	3748	1534	5282	0.00033
Janibacter limosus	53458	S	2363	755	3118	0.00020
Janibacter indicus	857417	S	1360	2194	3554	0.00022
Janibacter sp. YB324	2761047	S	772	1664	2436	0.00015
Phycicoccus sp. HDW14	2714941	S	4621	1823	6444	0.00041
Phycicoccus endophyticus	1690220	S	3896	1359	5255	0.00033
Intrasporangium calvum	53358	S	5714	1880	7594	0.00048
Pedococcus dokdonensis	443156	S	4149	1450	5599	0.00035
Arsenicicoccus sp. oral taxon 190	1658671	S	3597	1660	5257	0.00033
Tetrasphaera sp. HKS02	1813880	S	3489	1077	4566	0.00029
Cellulosimicrobium cellulans	1710	S	6512	7682	14194	0.00090
Cellulosimicrobium sp. BI34T	2587808	S	2703	1455	4158	0.00026
Cellulosimicrobium sp. JZ28	1906273	S	634	1623	2257	0.00014
Cellulosimicrobium sp. 72-3	2731680	S	321	1556	1877	0.00012
Cellulosimicrobium sp. TH-20	1980001	S	257	1286	1543	0.00010
Xylanimonas protaetiae	2509457	S	3359	1755	5114	0.00032
Xylanimonas allomyrinae	2509459	S	2828	1078	3906	0.00025
Xylanimonas cellulosilytica	186189	S	2745	1178	3923	0.00025
Isoptericola variabilis	139208	S	4272	2703	6975	0.00044
Isoptericola dokdonensis	372663	S	3437	1621	5058	0.00032
Ornithinimicrobium avium	2283195	S	4008	1278	5286	0.00033
Ornithinimicrobium sp. HY006	2508882	S	2803	1115	3918	0.00025
Ornithinimicrobium sp. INDO-MA30-4	2908651	S	526	114	640	0.00004
Ornithinimicrobium flavum	1288636	S	3239	1229	4468	0.00028
Ornithinimicrobium ciconiae	2594265	S	2457	462	2919	0.00018
Ornithinimicrobium pratense	2593973	S	2061	702	2763	0.00017
Serinicoccus chungangensis	767452	S	2924	1166	4090	0.00026
Serinicoccus hydrothermalis	1758689	S	2626	1350	3976	0.00025
Serinicoccus profundi	1078471	S	2493	1056	3549	0.00022
Serinicoccus marinus	247333	S	2228	1200	3428	0.00022
Brachybacterium sp. CBA3105	2887346	S	2623	706	3329	0.00021
Brachybacterium sp. SGAir0954	2571029	S	2538	812	3350	0.00021
Brachybacterium sp. P6-10-X1	1903186	S	2405	484	2889	0.00018
Brachybacterium saurashtrense	556288	S	2301	743	3044	0.00019
Brachybacterium ginsengisoli	1331682	S	2297	754	3051	0.00019
Brachybacterium faecium	43669	S	2172	745	2917	0.00018
Brachybacterium vulturis	2017484	S	1624	650	2274	0.00014
Brachybacterium avium	2017485	S	1403	559	1962	0.00012
Dermabacter vaginalis	1630135	S	804	624	1428	0.00009
Dermabacter jinjuensis	1667168	S	653	644	1297	0.00008
Devriesea agamarum	472569	S	354	24	378	0.00002
Brevibacterium sp. CS2	2575923	S	2447	1184	3631	0.00023
Brevibacterium sp. SMBL_HHYL_HB1	2777556	S	1053	279	1332	0.00008
Brevibacterium sp. HY170	2898795	S	507	165	672	0.00004
Brevibacterium sp. 'Marine'	2725563	S	439	317	756	0.00005
Brevibacterium sp. W7.2	2823518	S	364	1931	2295	0.00015
Brevibacterium casei	33889	S	2492	1921	4413	0.00028
Brevibacterium linens	1703	S	1726	1131	2857	0.00018
Brevibacterium luteolum	199591	S	1438	692	2130	0.00013
Brevibacterium atlanticum	2697563	S	921	217	1138	0.00007
Brevibacterium aurantiacum	273384	S	867	654	1521	0.00010
Brevibacterium sandarakinum	629680	S	855	175	1030	0.00007
Brevibacterium oceani	358099	S	816	203	1019	0.00006
Brevibacterium limosum	2697565	S	697	284	981	0.00006
Brevibacterium pigmentatum	1496080	S	605	485	1090	0.00007
Brevibacterium siliguriense	1136497	S	564	180	744	0.00005
Georgenia sp. TF02-10	2917725	S	4274	1913	6187	0.00039
Georgenia yuyongxinii	2589797	S	4034	1220	5254	0.00033
Georgenia wutianyii	2585135	S	3587	1526	5113	0.00032
Georgenia faecalis	2483799	S	3270	1109	4379	0.00028
Haloactinobacterium kanbiaonis	2675754	S	4025	711	4736	0.00030
Ruania sp. LR1S40	2897774	S	2192	568	2760	0.00017
Ruania sp. M4N3S171	2897773	S	1316	231	1547	0.00010
Ruania zhangjianzhongii	2603206	S	2673	331	3004	0.00019
Ruania alkalisoli	2779775	S	1659	348	2007	0.00013
Dermacoccus nishinomiyaensis	1274	S	2378	1183	3561	0.00023
Dermacoccus sp. PAMC28757	2762331	S	1616	672	2288	0.00014
Luteipulveratus mongoliensis	571913	S	3059	514	3573	0.00023
Allobranchiibius sp. GilTou73	2904523	S	2413	638	3051	0.00019
Yimella sp. cx-51	2770551	S	1568	380	1948	0.00012
Beutenbergia cavernae	84757	S	4817	974	5791	0.00037
Miniimonas sp. S16	2171623	S	3255	2029	5284	0.00033
Pengzhenrongella sicca	2819238	S	4354	1456	5810	0.00037
Luteimicrobium xylanilyticum	1133546	S	3588	1327	4915	0.00031
Sanguibacter keddieii	60920	S	2807	1011	3818	0.00024
Sanguibacter sp. HDW7	2714931	S	2624	994	3618	0.00023
Gephyromycinifex aptenodytis	2716227	S	1340	185	1525	0.00010
Austwickia chelonae	100225	S	1101	102	1203	0.00008
Dermatophilus congolensis	1863	S	335	38	373	0.00002
Kytococcus sedentarius	1276	S	2609	3236	5845	0.00037
Demequina sp. TMPB413	2881056	S	1015	98	1113	0.00007
Jonesia denitrificans	43674	S	215	46	261	0.00002
Tropheryma whipplei	2039	S	55	0	55	0.00000
Mycolicibacterium litorale	758802	S	4780	1369	6149	0.00039
Mycolicibacterium smegmatis	1772	S	3783	2385	6168	0.00039
Mycolicibacterium fortuitum	1766	S	3590	1393	4983	0.00031
Mycolicibacterium sp. YH-1	2908837	S	2309	1458	3767	0.00024
Mycolicibacterium madagascariense	212765	S	3174	516	3690	0.00023
Mycolicibacterium hassiacum	46351	S	3149	891	4040	0.00026
Mycolicibacterium neoaurum	1795	S	3073	613	3686	0.00023
Mycolicibacterium rutilum	370526	S	3014	932	3946	0.00025
Mycolicibacterium sediminis	1286180	S	3013	579	3592	0.00023
Mycolicibacterium phlei	1771	S	2948	1051	3999	0.00025
Mycolicibacterium arabiense	1286181	S	2858	469	3327	0.00021
Mycolicibacterium pulveris	36813	S	2856	506	3362	0.00021
Mycolicibacterium mageritense	53462	S	2813	500	3313	0.00021
Mycolicibacterium vaccae	1810	S	2739	572	3311	0.00021
Mycolicibacterium chubuense	1800	S	2735	648	3383	0.00021
Mycolicibacterium thermoresistibile	1797	S	2717	639	3356	0.00021
Mycolicibacterium parafortuitum	39692	S	2698	569	3267	0.00021
Mycolicibacterium psychrotolerans	216929	S	2694	641	3335	0.00021
Mycolicibacterium chitae	1792	S	2642	667	3309	0.00021
Mycolicibacterium moriokaense	39691	S	2612	339	2951	0.00019
Mycolicibacterium duvalii	39688	S	2418	499	2917	0.00018
Mycolicibacterium poriferae	39694	S	2397	527	2924	0.00018
Mycolicibacterium monacense	85693	S	2387	787	3174	0.00020
Mycolicibacterium phocaicum	319706	S	2353	1205	3558	0.00022
Mycolicibacterium fallax	1793	S	2342	989	3331	0.00021
Mycolicibacterium tokaiense	39695	S	2337	395	2732	0.00017
Mycolicibacterium celeriflavum	1249101	S	2332	479	2811	0.00018
Mycolicibacterium gadium	1794	S	2313	324	2637	0.00017
Mycolicibacterium rhodesiae	36814	S	2299	391	2690	0.00017
Mycolicibacterium gilvum	1804	S	2269	857	3126	0.00020
Mycolicibacterium fluoranthenivorans	258505	S	2244	312	2556	0.00016
Mycolicibacterium insubricum	444597	S	2204	657	2861	0.00018
Mycolicibacterium baixiangningiae	2761578	S	2164	366	2530	0.00016
Mycolicibacterium confluentis	28047	S	2162	351	2513	0.00016
Mycolicibacterium aurum	1791	S	2132	297	2429	0.00015
Mycolicibacterium boenickei	146017	S	1891	2318	4209	0.00027
Mycolicibacterium anyangense	1431246	S	1873	326	2199	0.00014
Mycolicibacterium aichiense	1799	S	1843	336	2179	0.00014
Mycolicibacterium mengxianglii	2736649	S	1767	203	1970	0.00012
Mycolicibacterium austroafricanum	39687	S	1734	6071	7805	0.00049
Mycolicibacterium helvum	1534349	S	1518	191	1709	0.00011
Mycobacterium doricum	126673	S	1489	352	1841	0.00012
Mycolicibacterium mucogenicum	56689	S	1435	573	2008	0.00013
Mycolicibacterium alvei	67081	S	1341	376	1717	0.00011
Mycolicibacterium sarraceniae	1534348	S	1141	154	1295	0.00008
Mycolicibacterium septicum	98668	S	903	579	1482	0.00009
Mycolicibacterium farcinogenes	1802	S	626	2176	2802	0.00018
Mycolicibacterium vanbaalenii	110539	S	418	6056	6474	0.00041
Mycolicibacterium nivoides	2487344	S	201	848	1049	0.00007
Mycobacterium saskatchewanense	220927	S	2625	529	3154	0.00020
Mycobacterium parmense	185642	S	2294	445	2739	0.00017
Mycobacterium kubicae	120959	S	1984	334	2318	0.00015
Mycobacterium shigaense	722731	S	1692	254	1946	0.00012
Mycobacterium simiae	1784	S	1576	145	1721	0.00011
Mycobacterium heidelbergense	53376	S	1523	374	1897	0.00012
Mycobacterium lentiflavum	141349	S	1512	360	1872	0.00012
Mycobacterium stomatepiae	470076	S	1487	301	1788	0.00011
Mycobacterium florentinum	292462	S	1472	332	1804	0.00011
Mycobacterium sp. JS623	212767	S	2503	225	2728	0.00017
Mycobacterium sp. IDR2000157661	2867005	S	2311	449	2760	0.00017
Mycobacterium sp. DL592	2675524	S	1861	325	2186	0.00014
Mycobacterium sp. YC-RL4	1682113	S	1832	690	2522	0.00016
Mycobacterium sp. EPa45	1545728	S	1695	303	1998	0.00013
Mycobacterium sp. MS1601	1936029	S	1687	256	1943	0.00012
Mycobacterium sp. DL440	2675523	S	1366	320	1686	0.00011
Mycobacterium sp. TY59	2775496	S	1216	212	1428	0.00009
Mycobacterium sp. WY10	1920667	S	234	673	907	0.00006
Mycobacterium sp. PYR15	2051552	S	88	732	820	0.00005
Mycobacterium sp. 20KCMC460	2903536	S	85	1672	1757	0.00011
Mycobacterium sp. MOTT36Y	1168287	S	39	480	519	0.00003
Mycobacterium sp. IWGMT90018-18076	2871094	S	18	639	657	0.00004
Mycobacterium avium	1764	S	3464	3838	7302	0.00046
Mycobacterium intracellulare	1767	S	1739	14350	16089	0.00102
Mycobacterium mantenii	560555	S	1617	209	1826	0.00012
Mycobacterium colombiense	339268	S	1465	263	1728	0.00011
Mycobacterium marseillense	701042	S	1328	318	1646	0.00010
Mycobacterium paraintracellulare	1138383	S	398	2484	2882	0.00018
Mycobacterium grossiae	1552759	S	3271	1038	4309	0.00027
Mycobacterium rufum	318424	S	2780	867	3647	0.00023
Mycobacterium canettii	78331	S	931	657	1588	0.00010
Mycobacterium tuberculosis	1773	S	486	13111	13597	0.00086
Mycobacterium dioxanotrophicus	482462	S	2379	612	2991	0.00019
Mycobacterium goodii	134601	S	2379	896	3275	0.00021
Mycobacterium holsaticum	152142	S	2293	385	2678	0.00017
Mycobacterium paragordonae	1389713	S	2234	280	2514	0.00016
Mycobacterium diernhoferi	1801	S	2189	465	2654	0.00017
Mycobacterium branderi	43348	S	2151	277	2428	0.00015
Mycobacterium conspicuum	44010	S	2145	274	2419	0.00015
Mycobacterium frederiksbergense	117567	S	2036	657	2693	0.00017
Mycobacterium gordonae	1778	S	1849	163	2012	0.00013
Mycobacterium koreense	1069220	S	1817	564	2381	0.00015
Mycobacterium cookii	1775	S	1673	180	1853	0.00012
Mycobacterium paraterrae	577492	S	1659	195	1854	0.00012
Mycobacterium heckeshornense	110505	S	1659	136	1795	0.00011
Mycobacterium vicinigordonae	1719132	S	1531	87	1618	0.00010
Mycobacterium riyadhense	486698	S	1519	68	1587	0.00010
Mycobacterium shinjukuense	398694	S	1457	151	1608	0.00010
Mycobacterium noviomagense	459858	S	1452	125	1577	0.00010
Mycobacterium kansasii	1768	S	1439	144	1583	0.00010
Mycobacterium lacus	169765	S	1430	112	1542	0.00010
Mycobacterium malmoense	1780	S	1401	229	1630	0.00010
Mycobacterium ostraviense	2738409	S	1384	140	1524	0.00010
Mycobacterium xenopi	1789	S	1372	166	1538	0.00010
Mycobacterium paraseoulense	590652	S	1369	282	1651	0.00010
Mycobacterium seoulense	386911	S	1248	299	1547	0.00010
Mycobacterium virginiense	1795032	S	1186	333	1519	0.00010
Mycobacterium basiliense	2094119	S	1147	44	1191	0.00008
Mycobacterium spongiae	886343	S	1118	33	1151	0.00007
Mycobacterium crocinum	388459	S	814	455	1269	0.00008
Mycobacterium haemophilum	29311	S	765	40	805	0.00005
Mycobacterium marinum	1781	S	388	1514	1902	0.00012
Mycobacterium senegalense	1796	S	280	1587	1867	0.00012
Mycobacterium novum	2492438	S	191	2709	2900	0.00018
Mycobacterium leprae	1769	S	187	5	192	0.00001
Mycobacterium lepromatosis	480418	S	181	5	186	0.00001
Mycobacterium ulcerans	1809	S	168	795	963	0.00006
Mycobacterium shottsii	133549	S	96	163	259	0.00002
Mycobacterium pallens	370524	S	72	666	738	0.00005
Mycobacterium pseudoshottsii	265949	S	49	288	337	0.00002
Mycolicibacter sp. MYC340	2855503	S	1216	326	1542	0.00010
Mycolicibacter sp. MYC098	2872309	S	1108	299	1407	0.00009
Mycolicibacter sp. MYC017	2875777	S	807	689	1496	0.00009
Mycolicibacter sp. MYC123	2855502	S	204	916	1120	0.00007
Mycolicibacter sp. MYC101	2872311	S	194	850	1044	0.00007
Mycolicibacter terrae	1788	S	1475	490	1965	0.00012
Mycolicibacter hiberniae	29314	S	1361	311	1672	0.00011
Mycolicibacter minnesotensis	1118379	S	958	179	1137	0.00007
Mycolicibacter sinensis	875328	S	217	2511	2728	0.00017
Mycobacteroides abscessus	36809	S	2447	2198	4645	0.00029
Mycobacteroides chelonae	1774	S	1461	1084	2545	0.00016
Mycobacteroides immunogenum	83262	S	937	209	1146	0.00007
Mycobacteroides saopaulense	1578165	S	929	136	1065	0.00007
Mycobacteroides salmoniphilum	404941	S	825	94	919	0.00006
[Mycobacterium] stephanolepidis	1520670	S	470	143	613	0.00004
Mycolicibacillus parakoreensis	1069221	S	1940	603	2543	0.00016
Hoyosella subflava	639313	S	1004	64	1068	0.00007
Rhodococcus sp. X156	2499145	S	3682	1477	5159	0.00033
Rhodococcus sp. MTM3W5.2	1805827	S	3071	849	3920	0.00025
Rhodococcus sp. SGAir0479	2567884	S	2637	889	3526	0.00022
Rhodococcus sp. W8901	2742603	S	2517	765	3282	0.00021
Rhodococcus sp. PBTS 1	1653478	S	2168	651	2819	0.00018
Rhodococcus sp. ABRD24	2507582	S	1655	337	1992	0.00013
Rhodococcus sp. R79	2811421	S	1628	1068	2696	0.00017
Rhodococcus sp. USK10	2789739	S	1213	835	2048	0.00013
Rhodococcus sp. B7740	1564114	S	1102	174	1276	0.00008
Rhodococcus sp. P1Y	1302308	S	1088	116	1204	0.00008
Rhodococcus sp. WMMA185	679318	S	1020	152	1172	0.00007
Rhodococcus sp. WAY2	2663121	S	876	782	1658	0.00010
Rhodococcus sp. USK13	2806442	S	742	535	1277	0.00008
Rhodococcus sp. RDE2	2885078	S	608	621	1229	0.00008
Rhodococcus sp. WB9	2594007	S	525	729	1254	0.00008
Rhodococcus sp. ZPP	2749906	S	417	1171	1588	0.00010
Rhodococcus sp. S2-17	1990687	S	343	1002	1345	0.00009
Rhodococcus sp. DMU1	2722825	S	339	1309	1648	0.00010
Rhodococcus sp. M8	1925550	S	311	995	1306	0.00008
Rhodococcus sp. WB1	1033922	S	176	1553	1729	0.00011
Rhodococcus sp. 21391	2683591	S	167	788	955	0.00006
Rhodococcus sp. P-2	2795031	S	135	167	302	0.00002
Rhodococcus sp. 2G	1570939	S	127	535	662	0.00004
Rhodococcus sp. DMF-1	2907624	S	105	858	963	0.00006
Rhodococcus sp. p52	935199	S	94	523	617	0.00004
Rhodococcus sp. AQ5-07	2054902	S	82	291	373	0.00002
Rhodococcus sp. YL-1	1045808	S	80	355	435	0.00003
Rhodococcus sp. LW-XY12	2856851	S	67	622	689	0.00004
Rhodococcus sp. 008	1723645	S	57	356	413	0.00003
Rhodococcus sp. PSBB049	2812863	S	51	756	807	0.00005
Rhodococcus sp. H-CA8f	1727214	S	47	209	256	0.00002
Rhodococcus sp. NJ-530	2490853	S	40	232	272	0.00002
Rhodococcus sp. BH4	1807790	S	38	252	290	0.00002
Rhodococcus sp. C1	644410	S	20	239	259	0.00002
Rhodococcus opacus	37919	S	7711	8115	15826	0.00100
Rhodococcus equi	43767	S	3908	1735	5643	0.00036
Rhodococcus fascians	1828	S	3167	809	3976	0.00025
Rhodococcus rhodochrous	1829	S	2462	1528	3990	0.00025
Rhodococcus triatomae	300028	S	2013	656	2669	0.00017
Rhodococcus koreensis	99653	S	1858	590	2448	0.00015
Rhodococcus coprophilus	38310	S	1716	348	2064	0.00013
Rhodococcus jostii	132919	S	1565	685	2250	0.00014
Rhodococcus pyridinivorans	103816	S	1289	5013	6302	0.00040
Rhodococcus ruber	1830	S	1161	3893	5054	0.00032
Rhodococcus qingshengii	334542	S	489	2630	3119	0.00020
Rhodococcus erythropolis	1833	S	483	2272	2755	0.00017
Rhodococcus globerulus	33008	S	930	122	1052	0.00007
Rhodococcus aetherivorans	191292	S	349	3320	3669	0.00023
Nocardia asteroides	1824	S	14501	5503	20004	0.00126
Nocardia brasiliensis	37326	S	8252	2502	10754	0.00068
Nocardia terpenica	455432	S	5680	1146	6826	0.00043
Nocardia cyriacigeorgica	135487	S	5633	2671	8304	0.00052
Nocardia farcinica	37329	S	4500	3145	7645	0.00048
Nocardia huaxiensis	2755382	S	3663	804	4467	0.00028
Nocardia wallacei	480035	S	3523	1102	4625	0.00029
Nocardia arthritidis	228602	S	3498	494	3992	0.00025
Nocardia otitidiscaviarum	1823	S	3088	686	3774	0.00024
Nocardia yamanashiensis	209247	S	2940	654	3594	0.00023
Nocardia sp. CS682	1047172	S	2884	762	3646	0.00023
Nocardia yunnanensis	2382165	S	2837	760	3597	0.00023
Nocardia tengchongensis	2055889	S	2836	784	3620	0.00023
Nocardia gipuzkoensis	2749991	S	2813	1116	3929	0.00025
Nocardia seriolae	37332	S	2777	825	3602	0.00023
Nocardia nova	37330	S	2676	425	3101	0.00020
Nocardia iowensis	204891	S	2603	620	3223	0.00020
Nocardia mangyaensis	2213200	S	2541	752	3293	0.00021
Corynebacterium cyclohexanicum	322009	S	2413	1055	3468	0.00022
Corynebacterium sphenisci	191493	S	2155	702	2857	0.00018
Corynebacterium frankenforstense	1230998	S	1934	623	2557	0.00016
Corynebacterium xerosis	1725	S	1788	1053	2841	0.00018
Corynebacterium bovis	36808	S	1734	421	2155	0.00014
Corynebacterium halotolerans	225326	S	1520	370	1890	0.00012
Corynebacterium freneyi	134034	S	1412	575	1987	0.00013
Corynebacterium nuruki	1032851	S	1319	334	1653	0.00010
Corynebacterium sp. CNCTC7651	2815361	S	511	105	616	0.00004
Corynebacterium sp. NML98-0116	702967	S	360	140	500	0.00003
Corynebacterium sp. 1864	2820399	S	101	202	303	0.00002
Corynebacterium sp. FDAARGOS 1242	2778078	S	91	230	321	0.00002
Corynebacterium sp. 4H37-19	2684405	S	89	10	99	0.00001
Corynebacterium sp. sy039	2599641	S	29	3	32	0.00000
Corynebacterium vitaeruminis	38305	S	1174	371	1545	0.00010
Corynebacterium maris	575200	S	1074	184	1258	0.00008
Corynebacterium humireducens	1223514	S	1042	319	1361	0.00009
Corynebacterium timonense	441500	S	1018	259	1277	0.00008
Corynebacterium marinum	349751	S	1014	398	1412	0.00009
Corynebacterium doosanense	1121358	S	979	487	1466	0.00009
Corynebacterium variabile	1727	S	978	600	1578	0.00010
Corynebacterium yudongzhengii	2080740	S	878	173	1051	0.00007
Corynebacterium liangguodongii	2079535	S	826	196	1022	0.00006
Corynebacterium mycetoides	38302	S	808	398	1206	0.00008
Corynebacterium uterequi	1072256	S	800	146	946	0.00006
Corynebacterium atypicum	191610	S	777	243	1020	0.00006
Corynebacterium comes	2675218	S	759	198	957	0.00006
Corynebacterium provencense	1737425	S	747	185	932	0.00006
Corynebacterium terpenotabidum	89154	S	715	216	931	0.00006
Corynebacterium glyciniphilum	1404244	S	682	92	774	0.00005
Corynebacterium jeikeium	38289	S	672	1717	2389	0.00015
Corynebacterium urealyticum	43771	S	667	696	1363	0.00009
Corynebacterium imitans	156978	S	661	434	1095	0.00007
Corynebacterium sanguinis	2594913	S	659	460	1119	0.00007
Corynebacterium uberis	2883169	S	656	86	742	0.00005
Corynebacterium ureicelerivorans	401472	S	620	215	835	0.00005
Corynebacterium glaucum	187491	S	560	128	688	0.00004
Corynebacterium lujinxingii	2763010	S	557	199	756	0.00005
Corynebacterium qintianiae	2709392	S	518	149	667	0.00004
Corynebacterium falsenii	108486	S	514	231	745	0.00005
Corynebacterium coyleae	53374	S	506	133	639	0.00004
Corynebacterium efficiens	152794	S	504	98	602	0.00004
Corynebacterium kroppenstedtii	161879	S	499	54	553	0.00003
Corynebacterium testudinoris	136857	S	463	101	564	0.00004
Corynebacterium genitalium	38288	S	453	105	558	0.00004
Corynebacterium striatum	43770	S	444	390	834	0.00005
Corynebacterium tuberculostearicum	38304	S	438	276	714	0.00005
Corynebacterium casei	160386	S	426	543	969	0.00006
Corynebacterium incognita	2754725	S	422	102	524	0.00003
Corynebacterium lactis	1231000	S	412	69	481	0.00003
Corynebacterium glucuronolyticum	39791	S	412	104	516	0.00003
Corynebacterium aurimucosum	169292	S	409	200	609	0.00004
Corynebacterium occultum	2675219	S	389	73	462	0.00003
Corynebacterium riegelii	156976	S	341	91	432	0.00003
Corynebacterium matruchotii	43768	S	340	27	367	0.00002
Corynebacterium aquilae	203263	S	336	55	391	0.00002
Corynebacterium endometrii	2488819	S	335	69	404	0.00003
Corynebacterium zhongnanshanii	2768834	S	328	49	377	0.00002
Corynebacterium renale	1724	S	308	39	347	0.00002
Corynebacterium urogenitale	2487892	S	268	52	320	0.00002
Corynebacterium flavescens	28028	S	268	83	351	0.00002
Corynebacterium kalinowskii	2675216	S	265	141	406	0.00003
Corynebacterium epidermidicanis	1050174	S	260	47	307	0.00002
Corynebacterium simulans	146827	S	260	201	461	0.00003
Corynebacterium cystitidis	35757	S	250	17	267	0.00002
Corynebacterium camporealensis	161896	S	236	63	299	0.00002
Corynebacterium lizhenjunii	2709394	S	233	43	276	0.00002
Corynebacterium singulare	161899	S	220	199	419	0.00003
Corynebacterium propinquum	43769	S	215	96	311	0.00002
Corynebacterium argentoratense	42817	S	214	50	264	0.00002
Corynebacterium phocae	161895	S	192	29	221	0.00001
Corynebacterium minutissimum	38301	S	190	192	382	0.00002
Corynebacterium macginleyi	38290	S	189	48	237	0.00001
Corynebacterium choanae	1862358	S	185	21	206	0.00001
Corynebacterium diphtheriae	1717	S	175	223	398	0.00003
Corynebacterium kefirresidentii	1979527	S	166	115	281	0.00002
Corynebacterium stationis	1705	S	165	44	209	0.00001
Corynebacterium pseudopelargi	2080757	S	164	59	223	0.00001
Corynebacterium glutamicum	1718	S	164	2262	2426	0.00015
Corynebacterium pelargi	1471400	S	156	54	210	0.00001
Corynebacterium gerontici	2079234	S	155	33	188	0.00001
Corynebacterium resistens	258224	S	147	88	235	0.00001
Corynebacterium pseudodiphtheriticum	37637	S	129	43	172	0.00001
Corynebacterium deserti	1408191	S	126	47	173	0.00001
Corynebacterium ammoniagenes	1697	S	126	29	155	0.00001
Corynebacterium ulcerans	65058	S	105	52	157	0.00001
Corynebacterium pseudotuberculosis	1719	S	104	57	161	0.00001
Corynebacterium anserum	2684406	S	91	12	103	0.00001
Corynebacterium mustelae	571915	S	89	7	96	0.00001
Corynebacterium amycolatum	43765	S	88	655	743	0.00005
Corynebacterium accolens	38284	S	80	189	269	0.00002
Corynebacterium silvaticum	2320431	S	79	34	113	0.00001
Corynebacterium callunae	1721	S	77	27	104	0.00001
Corynebacterium hindlerae	699041	S	75	142	217	0.00001
Corynebacterium segmentosum	43990	S	72	170	242	0.00002
Corynebacterium suranareeae	2506452	S	58	17	75	0.00000
Corynebacterium crudilactis	1652495	S	54	66	120	0.00001
Corynebacterium rouxii	2719119	S	47	28	75	0.00000
Corynebacterium kutscheri	35755	S	22	3	25	0.00000
Gordonia sp. PP30	2935861	S	2429	762	3191	0.00020
Gordonia sp. KTR9	337191	S	1649	367	2016	0.00013
Gordonia sp. YC-JH1	2059875	S	1646	1292	2938	0.00019
Gordonia sp. PDNC005	2811424	S	1396	237	1633	0.00010
Gordonia sp. WA4-43	2878678	S	317	1094	1411	0.00009
Gordonia sp. JH63	2698900	S	261	820	1081	0.00007
Gordonia sp. 135	2676309	S	126	824	950	0.00006
Gordonia sp. 1D	1737359	S	65	948	1013	0.00006
Gordonia polyisoprenivorans	84595	S	3823	857	4680	0.00030
Gordonia terrae	2055	S	2785	1635	4420	0.00028
Gordonia insulae	2420509	S	2169	339	2508	0.00016
Gordonia amarae	36821	S	2005	453	2458	0.00016
Gordonia jinghuaiqii	2758710	S	1948	429	2377	0.00015
Gordonia phthalatica	1136941	S	1928	869	2797	0.00018
Gordonia iterans	1004901	S	1893	726	2619	0.00017
Gordonia bronchialis	2054	S	1891	493	2384	0.00015
Gordonia pseudoamarae	2831662	S	1638	349	1987	0.00013
Gordonia rubripertincta	36822	S	1570	977	2547	0.00016
Gordonia otitidis	249058	S	1416	260	1676	0.00011
Gordonia zhaorongruii	2597659	S	1202	247	1449	0.00009
Gordonia alkanivorans	84096	S	404	1470	1874	0.00012
Gordonia amicalis	89053	S	318	2241	2559	0.00016
Gordonia hongkongensis	1701090	S	252	769	1021	0.00006
Gordonia ajococcus	1292359	S	10	486	496	0.00003
Skermania piniformis	39122	S	2096	292	2388	0.00015
Tsukamurella paurometabola	2061	S	4057	2192	6249	0.00039
Tsukamurella tyrosinosolvens	57704	S	3253	1574	4827	0.00031
Tsukamurella sp. PLM1	2929795	S	2324	839	3163	0.00020
Tsukamurella pulmonis	47312	S	2270	900	3170	0.00020
Dietzia sp. oral taxon 368	712270	S	1355	1008	2363	0.00015
Dietzia sp. DQ12-45-1b	912801	S	17	1798	1815	0.00011
Dietzia lutea	546160	S	1552	972	2524	0.00016
Dietzia psychralcaliphila	139021	S	1496	481	1977	0.00012
Dietzia timorensis	499555	S	1159	730	1889	0.00012
Tomitella gaofuii	2760083	S	2340	818	3158	0.00020
Tomitella fengzijianii	2597660	S	2155	813	2968	0.00019
Segniliparus rotundus	286802	S	1194	80	1274	0.00008
Lawsonella clevelandensis	1528099	S	233	31	264	0.00002
Micromonospora sp. WMMC415	2675222	S	14420	5977	20397	0.00129
Micromonospora sp. WMMA2032	2039870	S	5797	4120	9917	0.00063
Micromonospora sp. HM134	2583243	S	5725	2786	8511	0.00054
Micromonospora sp. B006	2201999	S	4588	3822	8410	0.00053
Micromonospora sp. L5	648999	S	533	5949	6482	0.00041
Micromonospora echinaurantiaca	47857	S	11202	5957	17159	0.00108
Micromonospora inositola	47865	S	10523	5703	16226	0.00103
Micromonospora krabiensis	307121	S	9609	3668	13277	0.00084
Micromonospora echinofusca	47858	S	9535	4801	14336	0.00091
Micromonospora carbonacea	47853	S	8825	4355	13180	0.00083
Micromonospora purpureochromogenes	47872	S	8565	4988	13553	0.00086
Micromonospora terminaliae	1914461	S	8542	4742	13284	0.00084
Micromonospora viridifaciens	1881	S	8055	3870	11925	0.00075
Micromonospora coxensis	356852	S	7753	4726	12479	0.00079
Micromonospora coriariae	285665	S	7417	2918	10335	0.00065
Micromonospora siamensis	299152	S	7030	3706	10736	0.00068
Micromonospora echinospora	1877	S	6965	2684	9649	0.00061
Micromonospora auratinigra	261654	S	6654	3841	10495	0.00066
Micromonospora narathiwatensis	299146	S	6353	3266	9619	0.00061
Micromonospora sagamiensis	47875	S	6331	2672	9003	0.00057
Micromonospora ferruginea	2749844	S	6330	4003	10333	0.00065
Micromonospora maris	1003110	S	6292	2126	8418	0.00053
Micromonospora endophytica (Xie et al. 2001) Li et al. 2019	515350	S	5865	1972	7837	0.00050
Micromonospora chokoriensis	356851	S	5758	2057	7815	0.00049
Micromonospora zamorensis	709883	S	5642	1997	7639	0.00048
Micromonospora rifamycinica	291594	S	5251	2587	7838	0.00050
Micromonospora craniellae	2294034	S	4478	3010	7488	0.00047
Micromonospora tulbaghiae	479978	S	3294	3793	7087	0.00045
Micromonospora aurantiaca	47850	S	2619	17978	20597	0.00130
Actinoplanes sp. L3-i22	2836373	S	11885	9104	20989	0.00133
Actinoplanes sp. OR16	946334	S	10207	5250	15457	0.00098
Actinoplanes sp. N902-109	649831	S	10018	3386	13404	0.00085
Actinoplanes friuliensis	196914	S	10765	2004	12769	0.00081
Actinoplanes ianthinogenes	122358	S	9775	4278	14053	0.00089
Actinoplanes missouriensis	1866	S	9453	3384	12837	0.00081
Actinoplanes teichomyceticus	1867	S	8789	4068	12857	0.00081
Actinoplanes derwentensis	113562	S	8105	1399	9504	0.00060
Phytohabitans suffuscus	624315	S	20019	5747	25766	0.00163
Phytohabitans flavus	1076124	S	16707	3668	20375	0.00129
Plantactinospora sp. KBS50	2024580	S	9638	2785	12423	0.00079
Plantactinospora sp. BC1	2108470	S	2113	6596	8709	0.00055
Plantactinospora sp. BB1	2071627	S	1918	5923	7841	0.00050
Dactylosporangium vinaceum	53362	S	17694	2388	20082	0.00127
Catellatospora sp. IY07-71	2728827	S	17075	4545	21620	0.00137
Actinocatenispora thailandica	227318	S	7103	2251	9354	0.00059
Actinocatenispora sera	390989	S	6779	2266	9045	0.00057
Polymorphospora rubra	338584	S	11319	2928	14247	0.00090
Couchioplanes caeruleus	56438	S	11002	3260	14262	0.00090
Natronosporangium hydrolyticum	2811111	S	6736	562	7298	0.00046
Verrucosispora sp. NA02020	2742132	S	4143	3477	7620	0.00048
Salinispora tropica	168695	S	3695	713	4408	0.00028
Amycolatopsis sp. DSM 110486	2865832	S	8293	1854	10147	0.00064
Amycolatopsis sp. WQ 127309	2932773	S	7830	2401	10231	0.00065
Amycolatopsis sp. FDAARGOS 1241	2778070	S	7304	1784	9088	0.00057
Amycolatopsis sp. YIM 10	2653857	S	6977	2235	9212	0.00058
Amycolatopsis sp. CA-230715	2745196	S	6670	1174	7844	0.00050
Amycolatopsis sp. Hca4	2742131	S	6643	2601	9244	0.00058
Amycolatopsis sp. FU40	2914159	S	4134	1915	6049	0.00038
Amycolatopsis sp. AA4	1896961	S	3824	2064	5888	0.00037
Amycolatopsis sp. BJA-103	1911175	S	3348	1395	4743	0.00030
Amycolatopsis sp. TNS106	2861750	S	2733	1639	4372	0.00028
Amycolatopsis sp. EV170708-02-1	2919322	S	2348	2293	4641	0.00029
Amycolatopsis acidiphila	715473	S	8036	1982	10018	0.00063
Amycolatopsis pretoriensis	218821	S	6829	2372	9201	0.00058
Amycolatopsis albispora	1804986	S	6577	4171	10748	0.00068
Amycolatopsis mediterranei	33910	S	6541	10933	17474	0.00110
Amycolatopsis keratiniphila	129921	S	3461	2869	6330	0.00040
Amycolatopsis japonica	208439	S	1797	1689	3486	0.00022
Amycolatopsis thermalba	944492	S	5848	2683	8531	0.00054
Amycolatopsis methanolica	1814	S	5744	2476	8220	0.00052
Amycolatopsis aidingensis	2842453	S	5593	765	6358	0.00040
Amycolatopsis orientalis	31958	S	3702	1312	5014	0.00032
Pseudonocardia sp. DSM 110487	2865833	S	26364	4412	30776	0.00194
Pseudonocardia sp. CGMCC 4.1532	2761535	S	7759	4909	12668	0.00080
Pseudonocardia sp. HH130630-07	1690815	S	6485	2260	8745	0.00055
Pseudonocardia sp. AL041005-10	445576	S	5141	2190	7331	0.00046
Pseudonocardia sp. HH130629-09	1641402	S	4164	2058	6222	0.00039
Pseudonocardia sp. EC080625-04	1096868	S	148	4165	4313	0.00027
Pseudonocardia sp. EC080619-01	1096856	S	17	4405	4422	0.00028
Pseudonocardia sp. EC080610-09	1688404	S	16	1409	1425	0.00009
Pseudonocardia dioxanivorans	240495	S	11545	3652	15197	0.00096
Pseudonocardia broussonetiae	2736640	S	10992	4179	15171	0.00096
Pseudonocardia autotrophica	2074	S	7170	2278	9448	0.00060
Pseudonocardia abyssalis	2792008	S	6324	3593	9917	0.00063
Allokutzneria albata	211114	S	67404	18895	86299	0.00545
Saccharopolyspora erythraea	1836	S	13262	5318	18580	0.00117
Saccharopolyspora gregorii	33914	S	5649	1331	6980	0.00044
Saccharopolyspora spinosa	60894	S	2896	1946	4842	0.00031
Saccharopolyspora pogona	333966	S	2637	3172	5809	0.00037
Saccharopolyspora sp. ASAGF58	2719023	S	1640	2187	3827	0.00024
Saccharothrix syringae	103733	S	10119	4012	14131	0.00089
Saccharothrix sp. 6-C	2781735	S	8391	3246	11637	0.00074
Saccharothrix espanaensis	103731	S	7957	2674	10631	0.00067
Saccharomonospora marina	632569	S	4320	1104	5424	0.00034
Saccharomonospora cyanea	40989	S	3175	1272	4447	0.00028
Saccharomonospora azurea	40988	S	3002	1023	4025	0.00025
Saccharomonospora viridis	1852	S	2936	528	3464	0.00022
Saccharomonospora xinjiangensis	75294	S	2401	465	2866	0.00018
Saccharomonospora glauca	40990	S	2225	914	3139	0.00020
Lentzea guizhouensis	1586287	S	16822	4089	20911	0.00132
Kutzneria sp. CA-103260	2802641	S	9266	2342	11608	0.00073
Kutzneria albida	43357	S	7014	1895	8909	0.00056
Actinoalloteichus hoggarensis	1470176	S	3530	564	4094	0.00026
Actinoalloteichus hymeniacidonis	340345	S	2668	304	2972	0.00019
Actinoalloteichus sp. GBA129-24	1612551	S	182	2397	2579	0.00016
Actinoalloteichus fjordicus	1612552	S	103	1639	1742	0.00011
Actinosynnema pretiosum	42197	S	3112	6502	9614	0.00061
Actinosynnema mirum	40567	S	339	3246	3585	0.00023
Kibdelosporangium phytohabitans	860235	S	9079	1270	10349	0.00065
Alloactinosynnema sp. L-07	1653480	S	5758	1481	7239	0.00046
Prauserella marina	530584	S	3708	383	4091	0.00026
Allosaccharopolyspora coralli	2665642	S	3146	776	3922	0.00025
Nocardioides sp. G188	2849501	S	8080	3055	11135	0.00070
Nocardioides sp. JS614	196162	S	6809	2369	9178	0.00058
Nocardioides sp. LMS-CY	2840457	S	6559	2543	9102	0.00058
Nocardioides sp. TF02-7	2917724	S	6153	2419	8572	0.00054
Nocardioides sp. HDW12B	2714939	S	5559	2251	7810	0.00049
Nocardioides sp. W7	2931390	S	5326	2115	7441	0.00047
Nocardioides sp. S-1144	2582905	S	4870	2232	7102	0.00045
Nocardioides sp. zg-1228	2763008	S	4862	2500	7362	0.00047
Nocardioides sp. cx-173	2898796	S	4720	1909	6629	0.00042
Nocardioides sp. zg-579	2663857	S	4643	2743	7386	0.00047
Nocardioides sp. SCSIO 67246	2872154	S	4606	1467	6073	0.00038
Nocardioides sp. S5	2017486	S	4344	2506	6850	0.00043
Nocardioides sp. 603	2483798	S	4074	2207	6281	0.00040
Nocardioides sp. InS609-2	2760705	S	4013	1107	5120	0.00032
Nocardioides sp. MC1495	2736757	S	3971	1688	5659	0.00036
Nocardioides sp. CF8	110319	S	3576	1704	5280	0.00033
Nocardioides sp. zg-536	2803858	S	3573	1845	5418	0.00034
Nocardioides sp. JQ2195	2592334	S	3296	835	4131	0.00026
Nocardioides sp. WS12	2486272	S	3228	686	3914	0.00025
Nocardioides sp. dk884	2662361	S	3054	3239	6293	0.00040
Nocardioides sp. ZJ1313	2685869	S	3037	3238	6275	0.00040
Nocardioides sp. Kera G14	2884264	S	2687	695	3382	0.00021
Nocardioides mesophilus	433659	S	7959	2998	10957	0.00069
Nocardioides anomalus	2712223	S	6096	2256	8352	0.00053
Nocardioides humi	449461	S	5762	2306	8068	0.00051
Nocardioides ungokensis	1643322	S	5394	2289	7683	0.00049
Nocardioides aromaticivorans	200618	S	5051	2318	7369	0.00047
Nocardioides euryhalodurans	2518370	S	4989	1865	6854	0.00043
Nocardioides okcheonensis	2894081	S	4938	2717	7655	0.00048
Nocardioides cynanchi	2558918	S	4682	1371	6053	0.00038
Nocardioides dongkuii	2760089	S	4476	2652	7128	0.00045
Nocardioides aquaticus	160826	S	4354	1629	5983	0.00038
Nocardioides rotundus	1774216	S	4280	2039	6319	0.00040
Nocardioides marinisabuli	419476	S	4114	2721	6835	0.00043
Nocardioides sambongensis	2589074	S	3746	1327	5073	0.00032
Nocardioides dokdonensis	450734	S	3687	2016	5703	0.00036
Nocardioides panacisoli	627624	S	3620	1111	4731	0.00030
Nocardioides houyundeii	2045452	S	3323	1242	4565	0.00029
Nocardioides seonyuensis	2518371	S	3279	1063	4342	0.00027
Nocardioides piscis	2714938	S	3086	1358	4444	0.00028
Nocardioides daphniae	402297	S	2596	1433	4029	0.00025
Nocardioides jishulii	2575440	S	2370	1039	3409	0.00022
Nocardioides yefusunii	2500546	S	1704	622	2326	0.00015
Nocardioides baekrokdamisoli	1804624	S	1688	267	1955	0.00012
Aeromicrobium sp. Leaf245	1736306	S	3230	1238	4468	0.00028
Aeromicrobium sp. zg-629	2663859	S	2598	1055	3653	0.00023
Aeromicrobium sp. A1-2	2107713	S	2294	404	2698	0.00017
Aeromicrobium erythreum	2041	S	3436	1278	4714	0.00030
Aeromicrobium choanae	1736691	S	3266	1215	4481	0.00028
Aeromicrobium marinum	219314	S	2981	820	3801	0.00024
Aeromicrobium chenweiae	2079793	S	2958	1215	4173	0.00026
Aeromicrobium yanjiei	2662028	S	2705	1028	3733	0.00024
Friedmanniella luteola	546871	S	6473	1715	8188	0.00052
Pimelobacter simplex	2045	S	5428	2581	8009	0.00051
Marmoricola scoriae	642780	S	4584	2215	6799	0.00043
Mumia sp. ZJ1417	2708082	S	3947	885	4832	0.00031
Micropruina glycogenica	75385	S	2660	507	3167	0.00020
Microlunatus sagamiharensis	546874	S	5556	1692	7248	0.00046
Microlunatus phosphovorus	29405	S	3852	598	4450	0.00028
Microlunatus soli	630515	S	3642	490	4132	0.00026
Microlunatus elymi	2596828	S	3133	474	3607	0.00023
Microlunatus sp. Gsoil 973	2672569	S	2770	296	3066	0.00019
Tessaracoccus sp. J1M15	2829499	S	2227	788	3015	0.00019
Tessaracoccus sp. MC1865	2760310	S	1713	516	2229	0.00014
Tessaracoccus defluvii	1285901	S	2460	1770	4230	0.00027
Tessaracoccus aquimaris	1332264	S	2181	1184	3365	0.00021
Tessaracoccus flavescens	399497	S	1868	1622	3490	0.00022
Tessaracoccus flavus	1610493	S	1797	1403	3200	0.00020
Tessaracoccus timonensis	2161816	S	1177	592	1769	0.00011
Brevilactibacter coleopterorum	2714937	S	3521	1968	5489	0.00035
Brevilactibacter sp. MC1595	2819349	S	3170	1555	4725	0.00030
Acidipropionibacterium jensenii	1749	S	2111	1592	3703	0.00023
Acidipropionibacterium acidipropionici	1748	S	2072	1545	3617	0.00023
Acidipropionibacterium virtanenii	2057246	S	1409	333	1742	0.00011
Propionibacterium acidifaciens	556499	S	2032	558	2590	0.00016
Propionibacterium freudenreichii	1744	S	1781	2281	4062	0.00026
Propionibacterium australiense	119981	S	1616	325	1941	0.00012
Auraticoccus monumenti	675864	S	4302	1014	5316	0.00034
Cutibacterium avidum	33010	S	1291	451	1742	0.00011
Cutibacterium granulosum	33011	S	789	190	979	0.00006
Cutibacterium acnes	1747	S	539	699	1238	0.00008
Cutibacterium modestum	2559073	S	280	45	325	0.00002
Arachnia propionica	1750	S	1746	254	2000	0.00013
Arachnia rubra	1547448	S	1073	152	1225	0.00008
Raineyella fluvialis	2662261	S	2650	454	3104	0.00020
Vaginimicrobium propionicum	1871034	S	128	61	189	0.00001
Kribbella flavida	182640	S	12006	3373	15379	0.00097
Kribbella qitaiheensis	1544730	S	8407	1576	9983	0.00063
Actinopolymorpha singaporensis	117157	S	6941	1003	7944	0.00050
Nonomuraea sp. ATCC 55076	1909395	S	15182	5735	20917	0.00132
Nonomuraea nitratireducens	2656914	S	15143	3977	19120	0.00121
Nonomuraea gerenzanensis	93944	S	14923	5884	20807	0.00131
Nonomuraea coxensis	404386	S	12681	4501	17182	0.00109
Streptosporangium roseum	2001	S	10313	3432	13745	0.00087
Streptosporangium sp. 'caverna'	2202249	S	9527	2496	12023	0.00076
Thermobispora bispora	2006	S	6469	1862	8331	0.00053
Actinomadura sp. WMMB 499	1219491	S	11661	3507	15168	0.00096
Actinomadura sp. NAK00032	2742128	S	10151	4523	14674	0.00093
Actinomadura sp. WMMA1423	2591108	S	9063	3398	12461	0.00079
Actinomadura madurae	1993	S	11811	4503	16314	0.00103
Actinomadura verrucosospora	46165	S	10579	4072	14651	0.00093
Actinomadura graeca	2750812	S	8209	2411	10620	0.00067
Thermomonospora amylolytica	1411117	S	8025	3662	11687	0.00074
Thermomonospora curvata	2020	S	5536	1979	7515	0.00047
Nocardiopsis sp. MT53	2865672	S	5533	1637	7170	0.00045
Nocardiopsis sp. HDS12	2831968	S	1672	1761	3433	0.00022
Nocardiopsis gilva	280236	S	4253	1078	5331	0.00034
Nocardiopsis dassonvillei	2014	S	2891	3159	6050	0.00038
Nocardiopsis alba	53437	S	2630	598	3228	0.00020
Thermobifida halotolerans	483545	S	3290	1279	4569	0.00029
Thermobifida alba	53522	S	3114	1468	4582	0.00029
Thermobifida fusca	2021	S	2057	426	2483	0.00016
Streptomonospora litoralis	2498135	S	4618	1136	5754	0.00036
Spiractinospora alimapuensis	2820884	S	3179	264	3443	0.00022
Blastococcus sp. PRF04-17	2933797	S	11002	4527	15529	0.00098
Blastococcus saxobsidens	138336	S	9677	3556	13233	0.00084
Modestobacter marinus	477641	S	10352	4273	14625	0.00092
Modestobacter sp. L9-4	2851567	S	6162	2807	8969	0.00057
Geodermatophilus obscurus	1861	S	13294	5396	18690	0.00118
Actinomyces sp. oral taxon 414	712122	S	1734	410	2144	0.00014
Actinomyces sp. MAS-1	2755559	S	1167	264	1431	0.00009
Actinomyces sp. Z16	2079536	S	1010	374	1384	0.00009
Actinomyces sp. Chiba101	1851395	S	860	424	1284	0.00008
Actinomyces sp. 432	2057798	S	773	186	959	0.00006
Actinomyces sp. oral taxon 171	706438	S	411	336	747	0.00005
Actinomyces sp. oral taxon 169	712116	S	245	435	680	0.00004
Actinomyces sp. HMT897	2789424	S	223	619	842	0.00005
Actinomyces sp. oral taxon 897	2081702	S	210	595	805	0.00005
Actinomyces sp. HMT 175	2789425	S	146	582	728	0.00005
Actinomyces sp. zg-332	2708340	S	24	5	29	0.00000
Actinomyces radicidentis	111015	S	1913	942	2855	0.00018
Actinomyces howellii	52771	S	1633	299	1932	0.00012
Actinomyces slackii	52774	S	1154	224	1378	0.00009
Actinomyces respiraculi	2744574	S	1116	305	1421	0.00009
Actinomyces procaprae	2560010	S	1091	415	1506	0.00010
Actinomyces weissii	675090	S	877	201	1078	0.00007
Actinomyces viscosus	1656	S	784	344	1128	0.00007
Actinomyces faecalis	2722820	S	784	132	916	0.00006
Actinomyces qiguomingii	2057800	S	763	114	877	0.00006
Actinomyces naeslundii	1655	S	724	435	1159	0.00007
Actinomyces oris	544580	S	652	1751	2403	0.00015
Actinomyces wuliandei	2057743	S	617	171	788	0.00005
Actinomyces lilanjuaniae	2321394	S	551	139	690	0.00004
Actinomyces marmotae	2737173	S	540	314	854	0.00005
Actinomyces gaoshouyii	1960083	S	521	280	801	0.00005
Actinomyces trachealis	2763540	S	353	75	428	0.00003
Actinomyces pacaensis	1852377	S	137	20	157	0.00001
Schaalia sp. 19OD2882	2794089	S	803	133	936	0.00006
Schaalia sp. JY-X169	2758572	S	314	14	328	0.00002
Schaalia sp. ZJ405	2709403	S	228	26	254	0.00002
Schaalia odontolytica	1660	S	1087	306	1393	0.00009
Schaalia meyeri	52773	S	611	131	742	0.00005
Schaalia cardiffensis	181487	S	345	61	406	0.00003
Schaalia turicensis	131111	S	163	197	360	0.00002
Flaviflexus salsibiostraticola	1282737	S	1082	354	1436	0.00009
Flaviflexus sp. dk850	2758573	S	555	244	799	0.00005
Flaviflexus ciconiae	2496867	S	414	65	479	0.00003
Trueperella pecoris	2733571	S	785	277	1062	0.00007
Trueperella pyogenes	1661	S	619	435	1054	0.00007
Trueperella bialowiezensis	312285	S	429	28	457	0.00003
Pauljensenia hongkongensis	178339	S	965	407	1372	0.00009
Nanchangia anserum	2692125	S	890	120	1010	0.00006
Actinobaculum sp. 313	2495645	S	428	28	456	0.00003
Actinotignum schaalii	59505	S	379	31	410	0.00003
Arcanobacterium haemolyticum	28264	S	94	51	145	0.00001
Arcanobacterium phocisimile	1302235	S	70	17	87	0.00001
Arcanobacterium sp. 2701	2722751	S	50	11	61	0.00000
Arcanobacterium phocae	131112	S	44	12	56	0.00000
Changpingibacter yushuensis	2758440	S	259	91	350	0.00002
Mobiluncus curtisii	2051	S	237	84	321	0.00002
Varibaculum sp. EMRHCC_39	2811781	S	122	45	167	0.00001
Fannyhessea vaginae	82135	S	99	38	137	0.00001
Boudabousia tangfeifanii	1912795	S	77	7	84	0.00001
Frankia inefficax	298654	S	10478	1533	12011	0.00076
Frankia sp. QA3	710111	S	4245	2009	6254	0.00040
Frankia sp. ArI3	1858	S	3184	2377	5561	0.00035
Candidatus Frankia datiscae	2716812	S	4713	733	5446	0.00034
Frankia casuarinae	106370	S	3964	517	4481	0.00028
Frankia alni	1859	S	3638	2900	6538	0.00041
Jiangella sp. DSM 45060	1798224	S	18322	6113	24435	0.00154
Jiangella alkaliphila	419479	S	11417	3653	15070	0.00095
Bifidobacterium pseudolongum	1694	S	1266	561	1827	0.00012
Bifidobacterium choerinum	35760	S	1214	633	1847	0.00012
Bifidobacterium longum	216816	S	1177	2417	3594	0.00023
Bifidobacterium scardovii	158787	S	1099	122	1221	0.00008
Bifidobacterium bifidum	1681	S	773	2203	2976	0.00019
Bifidobacterium animalis	28025	S	743	681	1424	0.00009
Bifidobacterium pullorum	78448	S	724	342	1066	0.00007
Bifidobacterium asteroides	1684	S	650	23	673	0.00004
Bifidobacterium subtile	77635	S	627	121	748	0.00005
Bifidobacterium adolescentis	1680	S	563	141	704	0.00004
Bifidobacterium thermophilum	33905	S	453	125	578	0.00004
Bifidobacterium eulemuris	1765219	S	444	110	554	0.00004
Bifidobacterium breve	1685	S	411	561	972	0.00006
Bifidobacterium lemurum	1603886	S	387	100	487	0.00003
Bifidobacterium actinocoloniiforme	638619	S	385	16	401	0.00003
Bifidobacterium angulatum	1683	S	328	100	428	0.00003
Bifidobacterium dentium	1689	S	303	26	329	0.00002
Bifidobacterium catenulatum	1686	S	236	367	603	0.00004
Bifidobacterium pseudocatenulatum	28026	S	218	147	365	0.00002
Bifidobacterium saguini	762210	S	84	43	127	0.00001
Bifidobacterium imperatoris	2020965	S	77	45	122	0.00001
Bifidobacterium indicum	1691	S	49	67	116	0.00001
Bifidobacterium coryneforme	1687	S	46	63	109	0.00001
Parascardovia denticolens	78258	S	337	78	415	0.00003
Gardnerella vaginalis	2702	S	40	58	98	0.00001
Gardnerella piotii	2792977	S	12	18	30	0.00000
Scardovia inopinata	78259	S	40	19	59	0.00000
Nakamurella multipartita	53461	S	5480	1280	6760	0.00043
Nakamurella panacisegetis	1090615	S	2985	525	3510	0.00022
Nakamurella sp. PAMC28650	2762325	S	2644	358	3002	0.00019
Nakamurella antarctica	1902245	S	652	61	713	0.00005
Catenulispora acidiphila	304895	S	7340	1320	8660	0.00055
Stackebrandtia nassauensis	283811	S	5060	566	5626	0.00036
Natronoglycomyces albus	2811108	S	848	36	884	0.00006
Jatrophihabitans sp. GAS493	1907575	S	2822	323	3145	0.00020
Jatrophihabitans telluris	2038343	S	2740	296	3036	0.00019
Kineococcus radiotolerans	131568	S	4209	1437	5646	0.00036
Epidermidibacterium keratini	1891644	S	2704	1618	4322	0.00027
Actinopolyspora erythraea	414996	S	2682	337	3019	0.00019
Acidothermus cellulolyticus	28049	S	2075	127	2202	0.00014
Candidatus Planktophila lacus	1884913	S	91	19	110	0.00001
Candidatus Planktophila versatilis	1884905	S	69	21	90	0.00001
Candidatus Planktophila sulfonica	1884904	S	65	29	94	0.00001
Candidatus Planktophila limnetica	573600	S	38	8	46	0.00000
Candidatus Planktophila vernalis	1884907	S	34	9	43	0.00000
Candidatus Planktophila dulcis	1884914	S	28	23	51	0.00000
Candidatus Nanopelagicus hibericus	1884915	S	28	17	45	0.00000
Candidatus Nanopelagicus abundans	1884916	S	18	9	27	0.00000
Candidatus Nanopelagicus limnes	1884634	S	11	19	30	0.00000
Aquihabitans sp. G128	2849779	S	18269	4278	22547	0.00142
Aquihabitans sp. Kera 3	2884263	S	16210	3068	19278	0.00122
Iamia sp. SCSIO 61187	2722752	S	20374	3795	24169	0.00153
Actinomarinicola tropica	2789776	S	18637	4259	22896	0.00145
Ilumatobacter coccineus	467094	S	6474	446	6920	0.00044
Acidimicrobium ferrooxidans	53635	S	2705	234	2939	0.00019
Rubrobacter xylanophilus	49319	S	19886	2991	22877	0.00145
Rubrobacter tropicus	2653851	S	16539	1400	17939	0.00113
Rubrobacter marinus	2653852	S	12489	1266	13755	0.00087
Rubrobacter radiotolerans	42256	S	4996	747	5743	0.00036
Rubrobacter indicoceani	2051957	S	2818	253	3071	0.00019
Baekduia soli	496014	S	13860	2772	16632	0.00105
Conexibacter sp. SYSU D00693	2812560	S	15647	4381	20028	0.00127
Conexibacter sp. DBS9H8	2937801	S	5523	583	6106	0.00039
Conexibacter sp. S30A1	2937800	S	5373	633	6006	0.00038
Conexibacter woesei	191495	S	21877	4499	26376	0.00167
Miltoncostaea marina	2843215	S	10565	3025	13590	0.00086
Miltoncostaea oceani	2843216	S	9899	1691	11590	0.00073
Eggerthella lenta	84112	S	1407	1045	2452	0.00015
Eggerthella guodeyinii	2690837	S	1295	596	1891	0.00012
Eggerthella sp. YY7918	502558	S	328	153	481	0.00003
Gordonibacter urolithinfaciens	1335613	S	774	626	1400	0.00009
Gordonibacter pamelaeae	471189	S	674	718	1392	0.00009
Arabiibacter massiliensis	1870985	S	1612	351	1963	0.00012
Adlercreutzia equolifaciens	446660	S	654	407	1061	0.00007
Adlercreutzia hattorii	2707299	S	426	543	969	0.00006
Raoultibacter timonensis	1907662	S	803	72	875	0.00006
Berryella intestinalis	1531429	S	760	1012	1772	0.00011
Slackia heliotrinireducens	84110	S	588	21	609	0.00004
Denitrobacterium detoxificans	79604	S	368	180	548	0.00003
Phoenicibacter congonensis	1944646	S	113	60	173	0.00001
Cryptobacterium curtum	84163	S	60	8	68	0.00000
Olsenella timonensis	1805478	S	1393	511	1904	0.00012
Olsenella uli	133926	S	657	87	744	0.00005
Olsenella sp. oral taxon 807	712411	S	588	44	632	0.00004
Parolsenella massiliensis	1871022	S	711	492	1203	0.00008
Parolsenella catena	2003188	S	572	428	1000	0.00006
Thermophilibacter immobilis	2779519	S	909	445	1354	0.00009
Parafannyhessea umbonata	604330	S	904	643	1547	0.00010
Atopobium sp. oral taxon 416	712157	S	281	35	316	0.00002
Lancefieldella parvula	1382	S	35	4	39	0.00000
Collinsella aerofaciens	74426	S	1245	739	1984	0.00013
Collinsella stercoris	147206	S	816	139	955	0.00006
Collinsella sp. zg1085	2844380	S	55	3	58	0.00000
Coriobacterium glomerans	33871	S	592	23	615	0.00004
Egicoccus halophilus	1670830	S	6491	1213	7704	0.00049
Euzebya pacifica	1608957	S	6422	652	7074	0.00045
Egibacter rhizosphaerae	1670831	S	6349	457	6806	0.00043
Paenibacillus sp. B01	2660554	S	2434	908	3342	0.00021
Paenibacillus sp. RUD330	2023772	S	1475	191	1666	0.00011
Paenibacillus sp. 32O-W	1695218	S	1193	141	1334	0.00008
Paenibacillus sp. R14(2021)	2859228	S	527	89	616	0.00004
Paenibacillus sp. H1-7	2282849	S	488	53	541	0.00003
Paenibacillus sp. sptzw28	715179	S	422	46	468	0.00003
Paenibacillus sp. URB8-2	2741301	S	366	103	469	0.00003
Paenibacillus sp. YPD9-1	2908839	S	344	51	395	0.00003
Paenibacillus sp. PK3_47	2072642	S	306	52	358	0.00002
Paenibacillus sp. FSL R7-0273	1536772	S	289	64	353	0.00002
Paenibacillus sp. FSL H7-0357	1536774	S	282	46	328	0.00002
Paenibacillus sp. BIHB4019	1870819	S	266	25	291	0.00002
Paenibacillus sp. PAMC21692	2762320	S	264	264	528	0.00003
Paenibacillus sp. HWE-109	1306526	S	262	27	289	0.00002
Paenibacillus sp. JZ16	1906272	S	262	79	341	0.00002
Paenibacillus sp. FSL R7-0331	1536773	S	236	54	290	0.00002
Paenibacillus sp. CAA11	1532905	S	194	46	240	0.00002
Paenibacillus sp. Y412MC10	481743	S	192	524	716	0.00005
Paenibacillus sp. YPG26	2878915	S	165	40	205	0.00001
Paenibacillus sp. JNUCC-32	2777984	S	164	473	637	0.00004
Paenibacillus sp. FSL R5-0912	1536771	S	163	115	278	0.00002
Paenibacillus sp. FSL P4-0081	1536769	S	139	106	245	0.00002
Paenibacillus sp. 19GGS1-52	2758563	S	122	14	136	0.00001
Paenibacillus sp. 481	2835869	S	112	13	125	0.00001
Paenibacillus sp. IHB B 3084	867076	S	111	75	186	0.00001
Paenibacillus sp. JNUCC-31	2777983	S	99	34	133	0.00001
Paenibacillus sp. E222	2748863	S	95	40	135	0.00001
Paenibacillus sp. DCT19	2211212	S	66	13	79	0.00001
Paenibacillus sp. FSL R5-0345	1536770	S	53	21	74	0.00000
Paenibacillus sp. IHBB 10380	1566358	S	44	9	53	0.00000
Paenibacillus sp. N3/727	2925845	S	41	59	100	0.00001
Paenibacillus sp. FSL H7-0737	1536775	S	41	17	58	0.00000
Paenibacillus sp. Cedars	1980674	S	25	171	196	0.00001
Paenibacillus mucilaginosus	61624	S	2454	192	2646	0.00017
Paenibacillus albicereus	2726185	S	2009	692	2701	0.00017
Paenibacillus lycopersici	2704462	S	1558	229	1787	0.00011
Paenibacillus rhizovicinus	2704463	S	850	135	985	0.00006
Paenibacillus macerans	44252	S	825	91	916	0.00006
Paenibacillus cellulositrophicus	562959	S	803	96	899	0.00006
Paenibacillus konkukensis	2020716	S	750	97	847	0.00005
Paenibacillus beijingensis	1126833	S	746	102	848	0.00005
Paenibacillus dendritiformis	130049	S	734	152	886	0.00006
Paenibacillus thiaminolyticus	49283	S	621	129	750	0.00005
Paenibacillus chitinolyticus	79263	S	606	89	695	0.00004
Paenibacillus stellifer	169760	S	580	124	704	0.00004
Paenibacillus durus	44251	S	551	242	793	0.00005
Paenibacillus ihbetae	1870820	S	526	89	615	0.00004
Paenibacillus cellulosilyticus	375489	S	402	61	463	0.00003
Paenibacillus donghaensis	414771	S	400	52	452	0.00003
Paenibacillus sabinae	365617	S	393	117	510	0.00003
Paenibacillus albus	2495582	S	392	63	455	0.00003
Paenibacillus naphthalenovorans	162209	S	392	67	459	0.00003
Paenibacillus lautus	1401	S	354	519	873	0.00006
Paenibacillus protaetiae	2509456	S	315	55	370	0.00002
Paenibacillus tritici	1873425	S	298	54	352	0.00002
Paenibacillus riograndensis	483937	S	113	110	223	0.00001
Paenibacillus sonchi	373687	S	82	155	237	0.00002
Paenibacillus azoreducens	116718	S	273	39	312	0.00002
Paenibacillus physcomitrellae	1619311	S	265	108	373	0.00002
Paenibacillus polymyxa	1406	S	260	1355	1615	0.00010
Paenibacillus tianjinensis	2810347	S	258	53	311	0.00002
Paenibacillus agaridevorans	171404	S	255	341	596	0.00004
Paenibacillus algicola	2565926	S	254	50	304	0.00002
Paenibacillus borealis	160799	S	245	102	347	0.00002
Paenibacillus swuensis	1178515	S	240	41	281	0.00002
Paenibacillus yonginensis	1462996	S	239	128	367	0.00002
Paenibacillus guangzhouensis	1473112	S	238	28	266	0.00002
Paenibacillus sophorae	1333845	S	233	99	332	0.00002
Paenibacillus xylanilyticus	248903	S	191	48	239	0.00002
Paenibacillus lutimineralis	2707005	S	191	31	222	0.00001
Paenibacillus alvei	44250	S	190	30	220	0.00001
Paenibacillus graminis	189425	S	177	110	287	0.00002
Paenibacillus psychroresistens	1778678	S	177	12	189	0.00001
Paenibacillus jilunlii	682956	S	148	120	268	0.00002
Paenibacillus kribbensis	172713	S	146	66	212	0.00001
Paenibacillus bovis	1616788	S	143	23	166	0.00001
Paenibacillus lentus	1338368	S	137	17	154	0.00001
Paenibacillus barcinonensis	198119	S	130	26	156	0.00001
Paenibacillus odorifer	189426	S	122	26	148	0.00001
Paenibacillus baekrokdamisoli	1712516	S	116	15	131	0.00001
Paenibacillus larvae	1464	S	114	11	125	0.00001
Paenibacillus pabuli	1472	S	86	37	123	0.00001
Paenibacillus terrae	159743	S	69	40	109	0.00001
Paenibacillus crassostreae	1763538	S	68	13	81	0.00001
Paenibacillus brasilensis	128574	S	63	34	97	0.00001
Paenibacillus uliginis	683737	S	58	74	132	0.00001
Paenibacillus xylanexedens	528191	S	50	42	92	0.00001
Paenibacillus antarcticus	253703	S	43	8	51	0.00000
Paenibacillus glucanolyticus	59843	S	37	263	300	0.00002
Paenibacillus peoriae	59893	S	28	192	220	0.00001
Brevibacillus marinus	2496837	S	1044	209	1253	0.00008
Brevibacillus choshinensis	54911	S	780	214	994	0.00006
Brevibacillus agri	51101	S	741	214	955	0.00006
Brevibacillus composti	2796470	S	656	195	851	0.00005
Brevibacillus sp. MMS20-4M-10-Y	2895522	S	399	65	464	0.00003
Brevibacillus sp. HD3.3A	2738979	S	51	218	269	0.00002
Brevibacillus sp. DP1.3A	2738867	S	43	40	83	0.00001
Brevibacillus sp. 7WMA2	2683193	S	13	63	76	0.00000
Brevibacillus brevis	1393	S	405	239	644	0.00004
Brevibacillus laterosporus	1465	S	114	128	242	0.00002
Brevibacillus parabrevis	54914	S	70	308	378	0.00002
Brevibacillus formosus	54913	S	58	53	111	0.00001
Cohnella candidum	2674991	S	1310	195	1505	0.00010
Cohnella sp. LGH	1619153	S	763	322	1085	0.00007
Cohnella sp. MFER-1	2728023	S	408	65	473	0.00003
Cohnella cholangitidis	2598458	S	374	72	446	0.00003
Cohnella abietis	2507935	S	118	14	132	0.00001
Thermobacillus composti	377615	S	2187	369	2556	0.00016
Saccharibacillus brassicae	2583377	S	1370	195	1565	0.00010
Aneurinibacillus soli	1500254	S	179	260	439	0.00003
Bacillus sp. Y1	352858	S	1070	513	1583	0.00010
Bacillus sp. S3	486398	S	417	152	569	0.00004
Bacillus sp. 1NLA3E	666686	S	232	103	335	0.00002
Bacillus sp. OxB-1	98228	S	186	61	247	0.00002
Bacillus sp. FJAT-18017	1705566	S	186	63	249	0.00002
Bacillus sp. NSP9.1	1071078	S	161	16	177	0.00001
Bacillus sp. JY-23	2933872	S	157	76	233	0.00001
Bacillus sp. KH172YL63	2709784	S	141	62	203	0.00001
Bacillus sp. SB49	1071080	S	133	29	162	0.00001
Bacillus sp. FJAT-42376	2014076	S	116	54	170	0.00001
Bacillus sp. PAMC26568	2760090	S	105	14	119	0.00001
Bacillus sp. M4U3P1	2592382	S	75	12	87	0.00001
Bacillus sp. FJAT-22090	1581038	S	65	24	89	0.00001
Bacillus sp. THAF10	2587848	S	65	27	92	0.00001
Bacillus sp. Cs-700	2589818	S	44	43	87	0.00001
Bacillus sp. N1-1	2682541	S	39	36	75	0.00000
Bacillus sp. WP8	756828	S	29	48	77	0.00000
Bacillus sp. 275	1941347	S	15	2198	2213	0.00014
Bacillus sp. NP247	2846779	S	13	23	36	0.00000
Bacillus sp. N3536	2666127	S	10	27	37	0.00000
Bacillus velezensis	492670	S	243	5296	5539	0.00035
Bacillus amyloliquefaciens	1390	S	122	3364	3486	0.00022
Bacillus siamensis	659243	S	39	145	184	0.00001
Bacillus subtilis	1423	S	367	7799	8166	0.00052
Bacillus paralicheniformis	1648923	S	235	188	423	0.00003
Bacillus mojavensis	72360	S	65	96	161	0.00001
Bacillus halotolerans	260554	S	25	78	103	0.00001
Bacillus tequilensis	227866	S	82	92	174	0.00001
Bacillus atrophaeus	1452	S	81	151	232	0.00001
Bacillus vallismortis	72361	S	53	78	131	0.00001
Bacillus licheniformis	1402	S	39	410	449	0.00003
Bacillus cereus	1396	S	232	20797	21029	0.00133
Bacillus thuringiensis	1428	S	169	12906	13075	0.00083
Bacillus pseudomycoides	64104	S	157	86	243	0.00002
Bacillus mycoides	1405	S	123	228	351	0.00002
Bacillus cytotoxicus	580165	S	113	91	204	0.00001
Bacillus anthracis	1392	S	23	1584	1607	0.00010
Bacillus wiedmannii	1890302	S	22	42	64	0.00000
Bacillus luti	2026191	S	11	13	24	0.00000
Bacillus glycinifermentans	1664069	S	337	137	474	0.00003
Bacillus infantis	324767	S	259	92	351	0.00002
[Brevibacterium] frigoritolerans	450367	S	246	127	373	0.00002
Bacillus badius	1455	S	233	122	355	0.00002
Bacillus methanolicus	1471	S	202	135	337	0.00002
Bacillus dafuensis	1742359	S	154	71	225	0.00001
Bacillus pumilus	1408	S	148	173	321	0.00002
Bacillus safensis	561879	S	146	243	389	0.00002
Bacillus gobiensis	1441095	S	132	49	181	0.00001
Bacillus smithii	1479	S	96	78	174	0.00001
Bacillus fonticola	2728853	S	90	32	122	0.00001
Bacillus weihaiensis	1547283	S	87	37	124	0.00001
Bacillus cabrialesii	2487276	S	84	100	184	0.00001
Bacillus aquiflavi	2672567	S	78	26	104	0.00001
Bacillus altitudinis	293387	S	60	294	354	0.00002
Bacillus shivajii	1983719	S	60	11	71	0.00000
Bacillus rugosus	2715209	S	35	43	78	0.00000
Priestia megaterium	1404	S	3832	5991	9823	0.00062
Priestia filamentosa	1402861	S	2495	411	2906	0.00018
Priestia koreensis	284581	S	138	61	199	0.00001
Priestia flexa	86664	S	134	54	188	0.00001
Priestia aryabhattai	412384	S	91	808	899	0.00006
Priestia sp. J2	2886505	S	16	244	260	0.00002
Geobacillus subterraneus	129338	S	569	490	1059	0.00007
Geobacillus stearothermophilus	1422	S	301	495	796	0.00005
Geobacillus genomosp. 3	1921421	S	290	115	405	0.00003
Geobacillus sp. 46C-IIa	1963025	S	157	90	247	0.00002
Geobacillus sp. JS12	1813182	S	39	148	187	0.00001
Geobacillus sp. Y412MC52	550542	S	23	89	112	0.00001
Geobacillus sp. C56-T3	691437	S	23	108	131	0.00001
Geobacillus thermocatenulatus	33938	S	127	156	283	0.00002
Geobacillus thermoleovorans	33941	S	45	582	627	0.00004
Geobacillus kaustophilus	1462	S	14	146	160	0.00001
Geobacillus thermodenitrificans	33940	S	38	288	326	0.00002
Geobacillus zalihae	213419	S	19	152	171	0.00001
Cytobacillus oceanisediminis	665099	S	2047	1241	3288	0.00021
Cytobacillus firmus	1399	S	532	303	835	0.00005
Cytobacillus ciccensis	1670641	S	153	72	225	0.00001
Cytobacillus gottheilii	859144	S	144	60	204	0.00001
Cytobacillus sp. CY-G	2901381	S	90	40	130	0.00001
Cytobacillus kochii	859143	S	74	28	102	0.00001
Metabacillus sediminilitoris	2567941	S	1241	585	1826	0.00012
Metabacillus sp. KUDC1714	2745198	S	454	198	652	0.00004
Metabacillus sp. cB07	2806989	S	120	57	177	0.00001
Metabacillus sp. B2-18	2897333	S	71	101	172	0.00001
Metabacillus dongyingensis	2874282	S	223	100	323	0.00002
Metabacillus litoralis	152268	S	97	100	197	0.00001
Metabacillus endolithicus	1535204	S	48	57	105	0.00001
Hydrogenibacillus sp. N12	2866627	S	2261	397	2658	0.00017
Anoxybacillus sediminis	2613334	S	1019	322	1341	0.00008
Anoxybacillus amylolyticus	294699	S	141	40	181	0.00001
Anoxybacillus flavithermus	33934	S	114	124	238	0.00002
Anoxybacillus caldiproteolyticus	247480	S	100	30	130	0.00001
Anoxybacillus sp. PDR2	1636720	S	22	92	114	0.00001
Anoxybacillus kamchatkensis	196180	S	11	89	100	0.00001
Mesobacillus foraminis	279826	S	680	230	910	0.00006
Mesobacillus sp. S13	2880221	S	386	221	607	0.00004
Mesobacillus jeotgali	129985	S	354	185	539	0.00003
Alkalihalobacillus clausii	79880	S	747	191	938	0.00006
Alkalihalobacillus krulwichiae	199441	S	99	39	138	0.00001
Alkalihalobacillus sp. LMS39	2924032	S	69	19	88	0.00001
Alkalihalobacillus lehensis	300825	S	67	24	91	0.00001
Alkalihalobacillus miscanthi	2598861	S	52	19	71	0.00000
Terribacillus goriensis	386490	S	946	201	1147	0.00007
Terribacillus aidingensis	586416	S	86	19	105	0.00001
Peribacillus asahii	228899	S	427	274	701	0.00004
Peribacillus simplex	1478	S	254	212	466	0.00003
Peribacillus butanolivorans	421767	S	152	65	217	0.00001
Peribacillus muralis	264697	S	92	28	120	0.00001
Peribacillus psychrosaccharolyticus	1407	S	87	39	126	0.00001
Parageobacillus caldoxylosilyticus	81408	S	164	85	249	0.00002
Parageobacillus thermoglucosidasius	1426	S	145	111	256	0.00002
Parageobacillus genomosp. 1	1295642	S	138	60	198	0.00001
Parageobacillus sp. KH3-4	2916802	S	97	50	147	0.00001
Parageobacillus toebii	153151	S	94	83	177	0.00001
Neobacillus drentensis	220684	S	376	210	586	0.00004
Neobacillus mesonae	1193713	S	277	119	396	0.00003
Lysinibacillus sp. SGAir0095	2070463	S	102	55	157	0.00001
Lysinibacillus sp. PLM2	2929796	S	52	27	79	0.00001
Lysinibacillus sp. CD3-6	2892541	S	46	23	69	0.00000
Lysinibacillus sp. 2017	2169540	S	30	19	49	0.00000
Lysinibacillus sp. Ag94	2936682	S	21	3	24	0.00000
Lysinibacillus sp. YS11	2072025	S	10	33	43	0.00000
Lysinibacillus timonensis	2086577	S	82	55	137	0.00001
Lysinibacillus fusiformis	28031	S	43	57	100	0.00001
Lysinibacillus agricola	2590012	S	36	14	50	0.00000
Lysinibacillus sphaericus	1421	S	29	44	73	0.00000
Lysinibacillus parviboronicapiens	436516	S	29	13	42	0.00000
Lysinibacillus capsici	2115968	S	13	30	43	0.00000
Virgibacillus sp. MSP4-1	2700081	S	67	17	84	0.00001
Virgibacillus sp. Bac332	2419842	S	62	9	71	0.00000
Virgibacillus sp. NKC19-16	2831673	S	57	6	63	0.00000
Virgibacillus sp. SK37	403957	S	31	42	73	0.00000
Virgibacillus sp. Bac330	2419841	S	21	31	52	0.00000
Virgibacillus necropolis	163877	S	65	12	77	0.00000
Virgibacillus phasianinus	2017483	S	40	7	47	0.00000
Virgibacillus halodenitrificans	1482	S	37	35	72	0.00000
Virgibacillus dokdonensis	302167	S	21	34	55	0.00000
Rossellomorea marisflavi	189381	S	382	187	569	0.00004
Rossellomorea vietnamensis	218284	S	91	45	136	0.00001
Salicibibacter halophilus	2502791	S	137	27	164	0.00001
Salicibibacter kimchii	2099786	S	111	10	121	0.00001
Salicibibacter cibarius	2743000	S	93	16	109	0.00001
Salicibibacter cibi	2743001	S	67	8	75	0.00000
Weizmannia coagulans	1398	S	421	243	664	0.00004
Niallia circulans	1397	S	202	74	276	0.00002
Niallia sp. Man26	2912824	S	176	51	227	0.00001
Halobacillus sp. SSBR10-3	2932257	S	73	11	84	0.00001
Halobacillus sp. SSTM10-2	2932258	S	58	14	72	0.00000
Halobacillus sp. SSHM10-5	2932259	S	53	14	67	0.00000
Halobacillus halophilus	1570	S	59	10	69	0.00000
Halobacillus litoralis	45668	S	56	11	67	0.00000
Halobacillus mangrovi	402384	S	54	10	64	0.00000
Salisediminibacterium selenitireducens	85683	S	179	33	212	0.00001
Salisediminibacterium beveridgei	632773	S	111	20	131	0.00001
Oceanobacillus kimchii	746691	S	122	20	142	0.00001
Oceanobacillus zhaokaii	2052660	S	80	20	100	0.00001
Oceanobacillus iheyensis	182710	S	59	17	76	0.00000
Sutcliffiella horikoshii	79883	S	135	47	182	0.00001
Sutcliffiella cohnii	33932	S	81	44	125	0.00001
Lentibacillus sp. CBA3610	2518176	S	101	9	110	0.00001
Lentibacillus amyloliquefaciens	1472767	S	85	12	97	0.00001
Gracilibacillus sp. SSPM10-3	2932255	S	69	19	88	0.00001
Gracilibacillus sp. SSWR10-1	2932256	S	35	9	44	0.00000
Gracilibacillus salitolerans	2663022	S	65	8	73	0.00000
Caldalkalibacillus thermarum	296745	S	175	44	219	0.00001
Heyndrickxia oleronia	38875	S	87	43	130	0.00001
Heyndrickxia vini	1476025	S	81	30	111	0.00001
Fictibacillus arsenicus	255247	S	91	22	113	0.00001
Fictibacillus phosphorivorans	1221500	S	52	12	64	0.00000
Psychrobacillus sp. INOP01	2829187	S	64	26	90	0.00001
Psychrobacillus glaciei	2283160	S	64	28	92	0.00001
Caldibacillus thermoamylovorans	35841	S	120	58	178	0.00001
Salimicrobium jeotgali	1230341	S	112	22	134	0.00001
Pontibacillus sp. ALD_SL1	2777185	S	52	9	61	0.00000
Pontibacillus sp. HMF3514	2692425	S	50	10	60	0.00000
Radiobacillus sp. 80	2844358	S	50	12	62	0.00000
Radiobacillus deserti	2594883	S	42	10	52	0.00000
Gottfriedia acidiceleris	371036	S	93	35	128	0.00001
Sediminibacillus sp. DP4-553-S	2729421	S	89	19	108	0.00001
Aeribacillus pallidus	33936	S	88	65	153	0.00001
Halalkalibacterium halodurans	86665	S	86	75	161	0.00001
Alkalihalophilus pseudofirmus	79885	S	80	18	98	0.00001
Lederbergia lenta	1467	S	69	22	91	0.00001
Pradoshia sp. D12	2651284	S	64	24	88	0.00001
Anaerobacillus isosaccharinicus	1532552	S	62	18	80	0.00001
Evansella cellulosilytica	1413	S	51	9	60	0.00000
Mangrovibacillus cuniculi	2593652	S	43	29	72	0.00000
Amphibacillus xylanus	1449	S	28	6	34	0.00000
Paraliobacillus zengyii	2213194	S	26	5	31	0.00000
Novibacillus thermophilus	1471761	S	4907	851	5758	0.00036
Kroppenstedtia eburnea	714067	S	984	130	1114	0.00007
Kroppenstedtia pulmonis	1380685	S	139	13	152	0.00001
Staphylospora marina	2490858	S	654	128	782	0.00005
Polycladomyces abyssicola	1125966	S	421	48	469	0.00003
Laceyella sacchari	37482	S	309	88	397	0.00003
Thermoactinomyces vulgaris	2026	S	205	51	256	0.00002
Alicyclobacillus acidocaldarius	405212	S	2665	275	2940	0.00019
Alicyclobacillus acidoterrestris	1450	S	324	62	386	0.00002
Alicyclobacillus mengziensis	2931921	S	294	24	318	0.00002
Alicyclobacillus sp. SO9	2665646	S	174	15	189	0.00001
Alicyclobacillus sp. TC	2606450	S	49	7	56	0.00000
Tumebacillus avium	1903704	S	1704	851	2555	0.00016
Tumebacillus algifaecis	1214604	S	729	307	1036	0.00007
Kyrpidia spormannii	2055160	S	376	217	593	0.00004
Kyrpidia tusciae	33943	S	264	215	479	0.00003
Effusibacillus dendaii	2743772	S	202	31	233	0.00001
Planococcus sp. 107-1	2908840	S	115	60	175	0.00001
Planococcus sp. MB-3u-03	2058136	S	109	86	195	0.00001
Planococcus sp. PAMC 21323	1526927	S	22	12	34	0.00000
Planococcus plakortidis	1038856	S	210	149	359	0.00002
Planococcus lenghuensis	2213202	S	196	53	249	0.00002
Planococcus maritimus	192421	S	191	100	291	0.00002
Planococcus glaciei	459472	S	172	62	234	0.00001
Planococcus rifietoensis	200991	S	156	129	285	0.00002
Planococcus massiliensis	1499687	S	103	26	129	0.00001
Planococcus halotolerans	2233542	S	99	39	138	0.00001
Planococcus antarcticus	161360	S	40	15	55	0.00000
Planococcus halocryophilus	1215089	S	30	18	48	0.00000
Planococcus donghaensis	414778	S	29	19	48	0.00000
Planococcus versutus	1302659	S	25	13	38	0.00000
Sporosarcina sp. Te-1	2818390	S	75	22	97	0.00001
Sporosarcina sp. Marseille-Q4063	2810514	S	57	13	70	0.00000
Sporosarcina sp. PTS2304	2283194	S	34	12	46	0.00000
Sporosarcina sp. resist	2762563	S	16	65	81	0.00001
Sporosarcina sp. P37	1930546	S	12	28	40	0.00000
Sporosarcina sp. P33	1930764	S	11	28	39	0.00000
Sporosarcina ureae	1571	S	161	56	217	0.00001
Sporosarcina ureilytica	298596	S	34	14	48	0.00000
Sporosarcina pasteurii	1474	S	30	11	41	0.00000
Solibacillus silvestris	76853	S	92	47	139	0.00001
Solibacillus sp. R5-41	2048654	S	43	25	68	0.00000
Ureibacillus thermosphaericus	51173	S	55	90	145	0.00001
Ureibacillus thermophilus	367743	S	43	32	75	0.00000
Kurthia sp. 11kri321	1750719	S	31	28	59	0.00000
Kurthia zopfii	1650	S	24	17	41	0.00000
Paenisporosarcina antarctica	417367	S	53	20	73	0.00000
Paenisporosarcina cavernae	2320858	S	17	12	29	0.00000
Jeotgalibacillus malaysiensis	1508404	S	66	28	94	0.00001
Rummeliibacillus stabekisii	241244	S	45	27	72	0.00000
Viridibacillus sp. JNUCC-6	2779527	S	39	17	56	0.00000
Exiguobacterium alkaliphilum	1428684	S	344	142	486	0.00003
Exiguobacterium mexicanum	340146	S	319	147	466	0.00003
Exiguobacterium sp. N4-1P	2051906	S	78	58	136	0.00001
Exiguobacterium sp. Helios	2735868	S	52	27	79	0.00001
Exiguobacterium sp. PFWT01	2829816	S	37	56	93	0.00001
Exiguobacterium sp. AT1b	360911	S	36	54	90	0.00001
Exiguobacterium sp. MH3	1399115	S	29	43	72	0.00000
Exiguobacterium acetylicum	41170	S	100	176	276	0.00002
Exiguobacterium sibiricum	332410	S	83	45	128	0.00001
Exiguobacterium antarcticum	132920	S	60	25	85	0.00001
Staphylococcus aureus	1280	S	104	687	791	0.00005
Staphylococcus pseudoxylosus	2282419	S	96	62	158	0.00001
Staphylococcus epidermidis	1282	S	70	72	142	0.00001
Staphylococcus pseudintermedius	283734	S	21	24	45	0.00000
Staphylococcus delphini	53344	S	13	12	25	0.00000
Staphylococcus xylosus	1288	S	29	17	46	0.00000
Staphylococcus saccharolyticus	33028	S	26	12	38	0.00000
Staphylococcus sp. CCM 9025	2892440	S	11	5	16	0.00000
Staphylococcus pettenkoferi	170573	S	22	6	28	0.00000
Staphylococcus capitis	29388	S	21	25	46	0.00000
Staphylococcus haemolyticus	1283	S	20	25	45	0.00000
Staphylococcus lugdunensis	28035	S	17	9	26	0.00000
Staphylococcus schleiferi	1295	S	16	35	51	0.00000
Staphylococcus debuckii	2044912	S	15	8	23	0.00000
Staphylococcus chromogenes	46126	S	15	8	23	0.00000
Staphylococcus simulans	1286	S	14	6	20	0.00000
Staphylococcus hominis	1290	S	13	9	22	0.00000
Staphylococcus muscae	1294	S	12	6	18	0.00000
Staphylococcus simiae	308354	S	12	7	19	0.00000
Staphylococcus condimenti	70255	S	11	5	16	0.00000
Staphylococcus carnosus	1281	S	11	5	16	0.00000
Staphylococcus hyicus	1284	S	11	6	17	0.00000
Staphylococcus gallinarum	1293	S	11	1	12	0.00000
Staphylococcus roterodami	2699836	S	10	11	21	0.00000
Jeotgalicoccus saudimassiliensis	1461582	S	61	9	70	0.00000
Jeotgalicoccus sp. WY2	2708346	S	41	12	53	0.00000
Jeotgalicoccus sp. ATCC 8456	946435	S	18	4	22	0.00000
Mammaliicoccus sciuri	1296	S	71	55	126	0.00001
Mammaliicoccus vitulinus	71237	S	20	11	31	0.00000
Mammaliicoccus stepanovicii	643214	S	10	4	14	0.00000
Macrococcus brunensis	198483	S	33	13	46	0.00000
Macrococcus canis	1855823	S	20	20	40	0.00000
Macrococcus armenti	2875764	S	15	15	30	0.00000
Salinicoccus halodurans	407035	S	88	34	122	0.00001
Nosocomiicoccus ampullae	489910	S	20	4	24	0.00000
Abyssicoccus albus	1817405	S	11	4	15	0.00000
Listeria monocytogenes	1639	S	82	5234	5316	0.00034
Listeria innocua	1642	S	40	55	95	0.00001
Listeria weihenstephanensis	1006155	S	39	10	49	0.00000
Listeria grayi	1641	S	29	10	39	0.00000
Listeria sp. PSOL-1	1844999	S	22	7	29	0.00000
Listeria marthii	529731	S	21	9	30	0.00000
Listeria seeligeri	1640	S	14	11	25	0.00000
Listeria welshimeri	1643	S	14	10	24	0.00000
Listeria ivanovii	1638	S	13	4	17	0.00000
Brochothrix thermosphacta	2756	S	44	17	61	0.00000
Sporolactobacillus terrae	269673	S	137	24	161	0.00001
Limosilactobacillus fermentum	1613	S	231	215	446	0.00003
Limosilactobacillus pontis	35787	S	190	129	319	0.00002
Limosilactobacillus mucosae	97478	S	89	53	142	0.00001
Limosilactobacillus reuteri	1598	S	46	57	103	0.00001
Limosilactobacillus panis	47493	S	40	20	60	0.00000
Limosilactobacillus frumenti	104955	S	12	5	17	0.00000
Lactobacillus delbrueckii	1584	S	232	607	839	0.00005
Lactobacillus sp. 3B(2020)	2695882	S	20	7	27	0.00000
Lactobacillus sp. CBA3605	2099788	S	18	11	29	0.00000
Lactobacillus panisapium	2012495	S	25	5	30	0.00000
Lactobacillus acetotolerans	1600	S	21	6	27	0.00000
Lactobacillus amylovorus	1604	S	21	45	66	0.00000
Lactobacillus apis	303541	S	14	3	17	0.00000
Lactobacillus johnsonii	33959	S	12	15	27	0.00000
Lactobacillus crispatus	47770	S	12	12	24	0.00000
Lactobacillus jensenii	109790	S	12	4	16	0.00000
Lactobacillus iners	147802	S	11	17	28	0.00000
Lactobacillus kefiranofaciens	267818	S	11	12	23	0.00000
Levilactobacillus zymae	267363	S	233	79	312	0.00002
Levilactobacillus brevis	1580	S	132	49	181	0.00001
Levilactobacillus suantsaii	2292255	S	69	28	97	0.00001
Levilactobacillus koreensis	637971	S	57	10	67	0.00000
Lacticaseibacillus rhamnosus	47715	S	69	25	94	0.00001
Lacticaseibacillus casei	1582	S	68	68	136	0.00001
Lacticaseibacillus manihotivorans	88233	S	62	21	83	0.00001
Lacticaseibacillus chiayiensis	2100821	S	40	7	47	0.00000
Lacticaseibacillus zeae	57037	S	39	18	57	0.00000
Lacticaseibacillus paracasei	1597	S	37	114	151	0.00001
Schleiferilactobacillus harbinensis	304207	S	230	29	259	0.00002
Lactiplantibacillus pentosus	1589	S	80	26	106	0.00001
Lactiplantibacillus plantarum	1590	S	78	62	140	0.00001
Lactiplantibacillus paraplantarum	60520	S	21	6	27	0.00000
Leuconostoc lactis	1246	S	41	45	86	0.00001
Leuconostoc pseudomesenteroides	33968	S	18	15	33	0.00000
Leuconostoc mesenteroides	1245	S	17	11	28	0.00000
Leuconostoc gelidum	1244	S	16	2	18	0.00000
Leuconostoc carnosum	1252	S	14	3	17	0.00000
Leuconostoc citreum	33964	S	10	42	52	0.00000
Weissella cibaria	137591	S	44	28	72	0.00000
Weissella confusa	1583	S	41	27	68	0.00000
Weissella soli	155866	S	18	5	23	0.00000
Ligilactobacillus ruminis	1623	S	63	26	89	0.00001
Ligilactobacillus agilis	1601	S	22	17	39	0.00000
Ligilactobacillus animalis	1605	S	16	20	36	0.00000
Ligilactobacillus murinus	1622	S	15	17	32	0.00000
Ligilactobacillus salivarius	1624	S	12	15	27	0.00000
Lentilactobacillus parabuchneri	152331	S	43	16	59	0.00000
Lentilactobacillus buchneri	1581	S	30	13	43	0.00000
Lentilactobacillus hilgardii	1588	S	30	8	38	0.00000
Lentilactobacillus kefiri	33962	S	19	7	26	0.00000
Lentilactobacillus curieae	1138822	S	12	3	15	0.00000
Oenococcus kitaharae	336988	S	35	3	38	0.00000
Oenococcus oeni	1247	S	20	5	25	0.00000
Oenococcus sicerae	2203724	S	17	0	17	0.00000
Loigolactobacillus coryniformis	1610	S	45	44	89	0.00001
Loigolactobacillus bifermentans	1607	S	24	7	31	0.00000
Loigolactobacillus backii	375175	S	13	6	19	0.00000
Latilactobacillus sakei	1599	S	23	20	43	0.00000
Latilactobacillus curvatus	28038	S	19	10	29	0.00000
Latilactobacillus graminis	60519	S	13	5	18	0.00000
Latilactobacillus fuchuensis	164393	S	12	0	12	0.00000
Secundilactobacillus paracollinoides	240427	S	62	24	86	0.00001
Pediococcus acidilactici	1254	S	24	15	39	0.00000
Pediococcus pentosaceus	1255	S	15	9	24	0.00000
Companilactobacillus zhachilii	2304606	S	11	9	20	0.00000
Periweissella cryptocerci	2506420	S	35	5	40	0.00000
Amylolactobacillus amylophilus	1603	S	33	32	65	0.00000
Liquorilactobacillus nagelii	82688	S	11	11	22	0.00000
Furfurilactobacillus rossiae	231049	S	30	5	35	0.00000
Paucilactobacillus hokkaidonensis	1193095	S	15	6	21	0.00000
Paucilactobacillus nenjiangensis	1296540	S	10	6	16	0.00000
Apilactobacillus kunkeei	148814	S	16	2	18	0.00000
Acetilactobacillus jinshanensis	1720083	S	19	1	20	0.00000
Fructilactobacillus fructivorans	1614	S	11	5	16	0.00000
Bombilactobacillus bombi	1303590	S	14	2	16	0.00000
Streptococcus sanguinis	1305	S	84	35	119	0.00001
Streptococcus sp. HKU75	2781599	S	26	12	38	0.00000
Streptococcus suis	1307	S	70	62	132	0.00001
Streptococcus equi	1336	S	35	12	47	0.00000
Streptococcus oralis	1303	S	42	64	106	0.00001
Streptococcus cristatus	45634	S	30	52	82	0.00001
Streptococcus gordonii	1302	S	27	13	40	0.00000
Streptococcus pyogenes	1314	S	27	31	58	0.00000
Streptococcus anginosus	1328	S	16	40	56	0.00000
Streptococcus merionis	400065	S	26	3	29	0.00000
Streptococcus sobrinus	1310	S	24	5	29	0.00000
Streptococcus mitis	28037	S	23	25	48	0.00000
Streptococcus ferus	1345	S	18	4	22	0.00000
Streptococcus pneumoniae	1313	S	17	18	35	0.00000
Streptococcus ratti	1341	S	17	3	20	0.00000
Streptococcus pantholopis	1811193	S	16	2	18	0.00000
Streptococcus mutans	1309	S	15	5	20	0.00000
Streptococcus chenjunshii	2173853	S	15	1	16	0.00000
Streptococcus himalayensis	1888195	S	15	3	18	0.00000
Streptococcus uberis	1349	S	15	5	20	0.00000
Streptococcus thermophilus	1308	S	14	371	385	0.00002
Streptococcus agalactiae	1311	S	14	274	288	0.00002
Streptococcus halichoeri	254785	S	14	22	36	0.00000
Streptococcus respiraculi	2021971	S	13	3	16	0.00000
Streptococcus acidominimus	1326	S	13	6	19	0.00000
Streptococcus parasuis	1501662	S	11	28	39	0.00000
Streptococcus salivarius	1304	S	11	23	34	0.00000
Streptococcus pluranimalium	82348	S	10	6	16	0.00000
Lactococcus raffinolactis	1366	S	43	20	63	0.00000
Lactococcus lactis	1358	S	42	39	81	0.00001
Lactococcus garvieae	1363	S	19	141	160	0.00001
Lactococcus cremoris	1359	S	13	22	35	0.00000
Lactococcus protaetiae	2592653	S	12	2	14	0.00000
Enterococcus avium	33945	S	57	37	94	0.00001
Enterococcus faecalis	1351	S	50	121	171	0.00001
Enterococcus faecium	1352	S	36	298	334	0.00002
Enterococcus casseliflavus	37734	S	36	101	137	0.00001
Enterococcus gilvus	160453	S	35	17	52	0.00000
Enterococcus mundtii	53346	S	35	18	53	0.00000
Enterococcus wangshanyuanii	2005703	S	34	5	39	0.00000
Enterococcus raffinosus	71452	S	26	18	44	0.00000
Enterococcus hirae	1354	S	23	22	45	0.00000
Enterococcus durans	53345	S	21	24	45	0.00000
Enterococcus cecorum	44008	S	16	14	30	0.00000
Enterococcus rotai	118060	S	14	0	14	0.00000
Vagococcus lutrae	81947	S	20	45	65	0.00000
Vagococcus zengguangii	2571750	S	12	13	25	0.00000
Vagococcus coleopterorum	2714946	S	12	6	18	0.00000
Vagococcus fluvialis	2738	S	11	14	25	0.00000
Tetragenococcus halophilus	51669	S	24	15	39	0.00000
Tetragenococcus osmophilus	526944	S	14	12	26	0.00000
Tetragenococcus koreensis	290335	S	12	6	18	0.00000
Aerococcus sanguinicola	119206	S	46	10	56	0.00000
Aerococcus urinaeequi	51665	S	40	96	136	0.00001
Aerococcus urinae	1376	S	34	14	48	0.00000
Aerococcus christensenii	87541	S	18	31	49	0.00000
Aerococcus viridans	1377	S	16	63	79	0.00001
Abiotrophia defectiva	46125	S	36	12	48	0.00000
Suicoccus acidiformans	2036206	S	20	14	34	0.00000
Ignavigranum ruoffiae	89093	S	16	2	18	0.00000
Jeotgalibaca sp. MA1X17-3	2908211	S	18	4	22	0.00000
Jeotgalibaca dankookensis	708126	S	20	5	25	0.00000
Jeotgalibaca porci	1868793	S	17	13	30	0.00000
Jeotgalibaca ciconiae	2496265	S	13	6	19	0.00000
Jeotgalibaca arthritidis	1868794	S	11	28	39	0.00000
Carnobacterium sp. 17-4	208596	S	11	26	37	0.00000
Carnobacterium maltaromaticum	2751	S	20	8	28	0.00000
Carnobacterium divergens	2748	S	14	3	17	0.00000
Carnobacterium inhibens	147709	S	12	9	21	0.00000
Dolosigranulum pigrum	29394	S	41	14	55	0.00000
Marinilactibacillus sp. 15R	1911586	S	18	7	25	0.00000
Granulicatella adiacens	46124	S	13	7	20	0.00000
Thermaerobacter sp. FW80	2546351	S	3365	739	4104	0.00026
Thermaerobacter sp. PB12/4term	2293838	S	2405	628	3033	0.00019
Thermaerobacter marianensis	73919	S	2820	748	3568	0.00023
Intestinimonas butyriciproducens	1297617	S	636	277	913	0.00006
Flintibacter sp. KGMB00164	2610895	S	415	54	469	0.00003
Aminipila terrae	2697030	S	59	6	65	0.00000
Aminipila butyrica	433296	S	57	5	62	0.00000
Aminipila luticellarii	2507160	S	48	5	53	0.00000
Emergencia timonensis	1776384	S	162	68	230	0.00001
Mogibacterium pumilum	86332	S	25	16	41	0.00000
Mogibacterium diversum	114527	S	15	12	27	0.00000
Massilistercora timonensis	2086584	S	178	210	388	0.00002
Carboxydocella thermautotrophica	178899	S	160	18	178	0.00001
Fenollaria sp. EMRHCC_24	2811778	S	11	26	37	0.00000
Faecalibacterium prausnitzii	853	S	1894	2050	3944	0.00025
Dysosmobacter sp. Marseille-Q4140	2830675	S	782	385	1167	0.00007
Dysosmobacter welbionis	2093857	S	525	415	940	0.00006
Flavonifractor plautii	292800	S	1294	370	1664	0.00011
Ethanoligenens harbinense	253239	S	706	43	749	0.00005
Vescimonas coprocola	2714355	S	395	385	780	0.00005
Vescimonas fastidiosa	2714353	S	273	499	772	0.00005
Ruthenibacterium lactatiformans	1550024	S	603	202	805	0.00005
Oscillibacter sp. NSJ-62	2763056	S	509	181	690	0.00004
Anaerotruncus colihominis	169435	S	505	296	801	0.00005
Caproiciproducens sp. NJN-50	2507162	S	490	71	561	0.00004
Acutalibacter muris	1796620	S	351	19	370	0.00002
Caproicibacter fermentans	2576756	S	320	21	341	0.00002
Pusillibacter faecalis	2714358	S	304	233	537	0.00003
Ruminococcus champanellensis	1161942	S	153	8	161	0.00001
Ruminococcus albus	1264	S	77	2	79	0.00001
Ruminococcus bicirculans	1160721	S	19	4	23	0.00000
Ruminococcus bovis	2564099	S	15	2	17	0.00000
Acetivibrio saccincola	1677857	S	101	67	168	0.00001
Acetivibrio thermocellus	1515	S	69	21	90	0.00001
Acetivibrio clariflavus	288965	S	48	33	81	0.00001
Caproicibacterium lactatifermentans	2666138	S	101	13	114	0.00001
Caproicibacterium amylolyticum	2766537	S	99	8	107	0.00001
Solibaculum mannosilyticum	2780922	S	184	205	389	0.00002
Pseudoclostridium thermosuccinogenes	84032	S	68	17	85	0.00001
Ruminiclostridium cellulolyticum	1521	S	29	7	36	0.00000
Ruminiclostridium herbifermentans	2488810	S	27	7	34	0.00000
Thermoclostridium stercorarium	1510	S	54	12	66	0.00000
Mageeibacillus indolicus	884684	S	45	70	115	0.00001
Fastidiosipila sanguinis	236753	S	30	21	51	0.00000
Monoglobus pectinilyticus	1981510	S	23	13	36	0.00000
Symbiobacterium thermophilum	2734	S	3939	397	4336	0.00027
Lachnoclostridium phocaeense	1871021	S	175	176	351	0.00002
[Clostridium] scindens	29347	S	173	82	255	0.00002
[Clostridium] hylemonae	89153	S	171	54	225	0.00001
Lachnoclostridium sp. YL32	1834196	S	34	60	94	0.00001
Lachnoclostridium phytofermentans	66219	S	15	0	15	0.00000
Blautia producta	33035	S	141	32	173	0.00001
Blautia sp. NBRC 113351	2877527	S	68	90	158	0.00001
Blautia sp. SC05B48	2479767	S	16	50	66	0.00000
Blautia liquoris	2779518	S	43	3	46	0.00000
Blautia pseudococcoides	1796616	S	40	6	46	0.00000
Blautia obeum	40520	S	23	24	47	0.00000
Blautia massiliensis	1737424	S	23	54	77	0.00000
Blautia argi	1912897	S	17	18	35	0.00000
Blautia hansenii	1322	S	14	10	24	0.00000
Lachnospiraceae bacterium NSJ-29	2763667	S	157	55	212	0.00001
Lachnospiraceae bacterium NSJ-38	2763669	S	131	59	190	0.00001
Lachnospiraceae bacterium sunii NSJ-8	2763672	S	56	49	105	0.00001
Lachnospiraceae bacterium NSJ-4	2763670	S	37	40	77	0.00000
Roseburia hominis	301301	S	141	167	308	0.00002
Roseburia intestinalis	166486	S	51	63	114	0.00001
Roseburia sp. NSJ-69	2763062	S	17	6	23	0.00000
Anaerocolumna cellulosilytica	433286	S	98	6	104	0.00001
Anaerocolumna sedimenticola	2696063	S	52	4	56	0.00000
Anaerocolumna chitinilytica	1727145	S	45	2	47	0.00000
Enterocloster bolteae	208479	S	160	58	218	0.00001
Enterocloster clostridioformis	1531	S	23	76	99	0.00001
Anaerostipes rhamnosivorans	1229621	S	74	35	109	0.00001
Anaerostipes caccae	105841	S	60	13	73	0.00000
Anaerostipes hadrus	649756	S	27	29	56	0.00000
Lacrimispora saccharolytica	84030	S	67	13	80	0.00001
Lacrimispora sphenoides	29370	S	66	8	74	0.00000
Coprococcus comes	410072	S	52	66	118	0.00001
Coprococcus catus	116085	S	42	27	69	0.00000
Coprococcus sp. ART55/1	751585	S	17	20	37	0.00000
Butyrivibrio fibrisolvens	831	S	39	12	51	0.00000
Butyrivibrio proteoclasticus	43305	S	25	5	30	0.00000
Butyrivibrio hungatei	185008	S	17	3	20	0.00000
Herbinix luporum	1679721	S	83	60	143	0.00001
Sellimonas intestinalis	1653434	S	64	41	105	0.00001
[Ruminococcus] gnavus	33038	S	44	46	90	0.00001
[Ruminococcus] torques	33039	S	16	16	32	0.00000
Anaerotignum propionicum	28446	S	56	6	62	0.00000
Anaerobutyricum hallii	39488	S	34	14	48	0.00000
Novisyntrophococcus fermenticellae	2068655	S	32	4	36	0.00000
Lachnospira eligens	39485	S	25	5	30	0.00000
Dorea longicatena	88431	S	25	28	53	0.00000
Faecalicatena sp. Marseille-Q4148	2823316	S	21	11	32	0.00000
[Clostridium] colinum	36835	S	18	2	20	0.00000
Lachnoanaerobaculum umeaense	617123	S	17	5	22	0.00000
Pseudobutyrivibrio xylanivorans	185007	S	10	0	10	0.00000
Clostridium sp. SY8519	1042156	S	146	50	196	0.00001
Clostridium sp. M62/1	411486	S	105	146	251	0.00002
Clostridium sp. 'deep sea'	2779445	S	36	0	36	0.00000
Clostridium sp. BNL1100	755731	S	35	3	38	0.00000
Clostridium sp. DL-VIII	641107	S	30	6	36	0.00000
Clostridium sp. JN-9	2507159	S	28	5	33	0.00000
Clostridium sp. BJN0001	2930219	S	23	6	29	0.00000
Clostridium sp. C5S11	704125	S	21	3	24	0.00000
Clostridium sp. JN-1	2483110	S	18	3	21	0.00000
Clostridium sp. C1	1155388	S	14	15	29	0.00000
Clostridium sp. MD294	97138	S	12	0	12	0.00000
Clostridium sp. AWRP	2212991	S	11	4	15	0.00000
Clostridium tetani	1513	S	458	63	521	0.00003
Clostridium botulinum	1491	S	71	138	209	0.00001
Clostridium perfringens	1502	S	66	22	88	0.00001
Clostridium pasteurianum	1501	S	52	10	62	0.00000
Clostridium baratii	1561	S	48	15	63	0.00000
Clostridium kluyveri	1534	S	44	3	47	0.00000
Clostridium argentinense	29341	S	32	5	37	0.00000
Clostridium thermarum	1716543	S	32	20	52	0.00000
Clostridium beijerinckii	1520	S	31	61	92	0.00001
Clostridium tyrobutyricum	1519	S	31	3	34	0.00000
Clostridium saccharoperbutylacetonicum	36745	S	29	6	35	0.00000
Clostridium butyricum	1492	S	27	6	33	0.00000
Clostridium manihotivorum	2320868	S	27	3	30	0.00000
Clostridium formicaceticum	1497	S	27	6	33	0.00000
Clostridium estertheticum	238834	S	27	6	33	0.00000
Clostridium intestinale	36845	S	23	3	26	0.00000
Clostridium cadaveris	1529	S	20	5	25	0.00000
Clostridium fermenticellae	2068654	S	20	2	22	0.00000
Clostridium bornimense	1216932	S	19	7	26	0.00000
Clostridium aceticum	84022	S	19	2	21	0.00000
Clostridium sporogenes	1509	S	17	98	115	0.00001
Clostridium gasigenes	94869	S	17	3	20	0.00000
Clostridium saccharobutylicum	169679	S	17	4	21	0.00000
Clostridium carboxidivorans	217159	S	15	4	19	0.00000
Clostridium isatidis	182773	S	14	7	21	0.00000
Clostridium cellulovorans	1493	S	13	2	15	0.00000
Clostridium acetobutylicum	1488	S	11	0	11	0.00000
Clostridium diolis	223919	S	10	124	134	0.00001
Clostridium drakei	332101	S	10	7	17	0.00000
Clostridium taeniosporum	394958	S	10	2	12	0.00000
Hungatella hathewayi	154046	S	202	8	210	0.00001
Alkaliphilus sp. B6464	2731219	S	43	13	56	0.00000
Alkaliphilus oremlandii	461876	S	40	12	52	0.00000
Alkaliphilus metalliredigens	208226	S	20	4	24	0.00000
Caloramator sp. E03	2576307	S	67	8	75	0.00000
Crassaminicella profunda	1286698	S	19	4	23	0.00000
Crassaminicella sp. 143-21	2855394	S	17	8	25	0.00000
Crassaminicella thermophila	2599308	S	14	5	19	0.00000
Geosporobacter ferrireducens	1424294	S	49	10	59	0.00000
Hathewaya histolytica	1498	S	27	13	40	0.00000
Serpentinicella alkaliphila	1734049	S	15	3	18	0.00000
Candidatus Desulforudis audaxviator	471827	S	1113	71	1184	0.00007
Desulforamulus ruminis	1564	S	165	26	191	0.00001
Desulforamulus ferrireducens	1833852	S	154	102	256	0.00002
Desulforamulus reducens	59610	S	77	17	94	0.00001
Acididesulfobacillus acetoxydans	1561005	S	317	14	331	0.00002
Candidatus Formimonas warabiya	1761012	S	238	19	257	0.00002
Thermanaerosceptrum fracticalcis	1712410	S	119	20	139	0.00001
Desulfofarcimen acetoxidans	58138	S	96	13	109	0.00001
Dehalobacterium formicoaceticum	51515	S	89	19	108	0.00001
Christensenella sp. Marseille-P3954	2086585	S	928	523	1451	0.00009
Christensenella minuta	626937	S	296	91	387	0.00002
Heliomicrobium modesticaldum	35701	S	1019	511	1530	0.00010
Heliorestis convoluta	356322	S	72	6	78	0.00000
Desulfitobacterium hafniense	49338	S	179	27	206	0.00001
Desulfitobacterium dehalogenans	36854	S	60	12	72	0.00000
Desulfitobacterium metallireducens	142877	S	44	10	54	0.00000
Desulfitobacterium dichloroeliminans	233055	S	42	40	82	0.00001
Desulfosporosinus orientis	1563	S	84	19	103	0.00001
Desulfosporosinus youngiae	339862	S	80	25	105	0.00001
Desulfosporosinus acidiphilus	885581	S	66	13	79	0.00001
Desulfosporosinus meridiei	79209	S	47	18	65	0.00000
Dehalobacter restrictus	55583	S	63	93	156	0.00001
Syntrophobotulus glycolicus	51197	S	115	9	124	0.00001
Eubacterium limosum	1736	S	120	120	240	0.00002
Eubacterium sp. c-25	2841037	S	38	22	60	0.00000
Eubacterium sp. MSJ-33	2841528	S	21	13	34	0.00000
Eubacterium callanderi	53442	S	65	50	115	0.00001
Eubacterium maltosivorans	2041044	S	31	134	165	0.00001
Acetobacterium sp. KB-1	2184575	S	130	37	167	0.00001
Acetobacterium wieringae	52694	S	73	41	114	0.00001
Acetobacterium woodii	33952	S	38	7	45	0.00000
Alkalibacter sp. ES005	2815577	S	115	8	123	0.00001
Syntrophothermus lipocalidus	86170	S	213	18	231	0.00001
Syntrophomonas wolfei	863	S	87	14	101	0.00001
Candidatus Contubernalis alkalaceticum	338645	S	58	3	61	0.00000
Candidatus Syntrophocurvum alkaliphilum	2293317	S	26	5	31	0.00000
Peptoclostridium acidaminophilum	1731	S	94	17	111	0.00001
Clostridioides difficile	1496	S	44	1815	1859	0.00012
Terrisporobacter sp. MCA3	2813371	S	44	6	50	0.00000
Romboutsia sp. CE17	2724150	S	19	8	27	0.00000
Romboutsia ilealis	1115758	S	18	8	26	0.00000
Filifactor alocis	143361	S	23	36	59	0.00000
Paeniclostridium sordellii	1505	S	20	4	24	0.00000
Acetoanaerobium sticklandii	1511	S	19	2	21	0.00000
Tepidibacter sp. 8C15b	2925782	S	15	3	18	0.00000
Desulfoscipio gibsoniae	102134	S	243	22	265	0.00002
Desulfotomaculum nigrificans	1565	S	129	55	184	0.00001
Thermincola potens	863643	S	128	12	140	0.00001
Vallitalea pronyensis	1348613	S	23	4	27	0.00000
Vallitalea guaymasensis	1185412	S	18	3	21	0.00000
Petrocella atlantisensis	2173034	S	39	6	45	0.00000
Caloranaerobacter azorensis	116090	S	80	12	92	0.00001
Alkalicella caledoniensis	2731377	S	28	4	32	0.00000
Moorella sp. Hama-1	2138101	S	538	115	653	0.00004
Moorella glycerini	55779	S	483	48	531	0.00003
Moorella thermoacetica	1525	S	482	86	568	0.00004
Ammonifex degensii	42838	S	648	27	675	0.00004
Gelria sp. Kuro-4	2796927	S	1381	116	1497	0.00009
Thermacetogenium phaeum	85874	S	547	498	1045	0.00007
Carboxydothermus hydrogenoformans	129958	S	182	17	199	0.00001
Thermoanaerobacter mathranii	583357	S	37	110	147	0.00001
Thermoanaerobacter kivui	2325	S	20	20	40	0.00000
Thermanaeromonas toyohensis	161154	S	147	5	152	0.00001
Caldanaerobacter subterraneus	911092	S	61	77	138	0.00001
Caldicellulosiruptor saccharolyticus	44001	S	19	41	60	0.00000
Caldicellulosiruptor acetigenus	301953	S	15	15	30	0.00000
Caldicellulosiruptor changbaiensis	1222016	S	14	35	49	0.00000
Thermoanaerobacterium thermosaccharolyticum	1517	S	28	85	113	0.00001
Mahella australiensis	252966	S	141	75	216	0.00001
Zhaonella formicivorans	2528593	S	109	16	125	0.00001
Thermodesulfobium acidiphilum	1794699	S	24	24	48	0.00000
Thermodesulfobium narugense	184064	S	19	19	38	0.00000
Iocasia fonsfrigidae	2682810	S	78	7	85	0.00001
Halanaerobium hydrogeniformans	656519	S	29	14	43	0.00000
Halanaerobium praevalens	2331	S	24	14	38	0.00000
Halothermothrix orenii	31909	S	44	8	52	0.00000
Anoxybacter fermentans	1323375	S	161	29	190	0.00001
Halobacteroides halobius	42422	S	66	8	74	0.00000
Acetohalobium arabaticum	28187	S	45	4	49	0.00000
Thermosediminibacter oceani	291990	S	212	25	237	0.00001
Biomaibacter acetigenes	2316383	S	123	10	133	0.00001
Tepidanaerobacter acetatoxydans	499229	S	59	2	61	0.00000
Koleobacter methoxysyntrophicus	2751313	S	154	14	168	0.00001
Natranaerofaba carboxydovora	2742683	S	92	5	97	0.00001
Natranaerobius thermophilus	375929	S	39	5	44	0.00000
Selenomonas sp. oral taxon 126	712528	S	650	169	819	0.00005
Selenomonas sp. oral taxon 920	1884263	S	387	87	474	0.00003
Selenomonas sp. oral taxon 478	712538	S	211	300	511	0.00003
Selenomonas sp. oral taxon 136	713030	S	179	241	420	0.00003
Selenomonas sputigena	69823	S	1133	98	1231	0.00008
Selenomonas timonae	2754044	S	510	230	740	0.00005
Selenomonas ruminantium	971	S	200	19	219	0.00001
Megamonas hypermegale	158847	S	20	44	64	0.00000
Megamonas funiformis	437897	S	11	14	25	0.00000
Pectinatus frisingensis	865	S	35	2	37	0.00000
Sporomusa termitida	2377	S	201	31	232	0.00001
Methylomusa anaerophila	1930071	S	160	13	173	0.00001
Pelosinus fermentans	365349	S	48	11	59	0.00000
Pelosinus sp. UFO1	484770	S	32	12	44	0.00000
Megasphaera stantonii	2144175	S	409	260	669	0.00004
Megasphaera elsdenii	907	S	382	182	564	0.00004
Megasphaera massiliensis	1232428	S	180	71	251	0.00002
Veillonella rodentium	248315	S	40	14	54	0.00000
Veillonella parvula	29466	S	22	16	38	0.00000
Acidaminococcus fermentans	905	S	311	59	370	0.00002
Acidaminococcus intestini	187327	S	103	16	119	0.00001
Phascolarctobacterium faecium	33025	S	88	9	97	0.00001
Phascolarctobacterium succinatutens	626940	S	47	117	164	0.00001
Phascolarctobacterium sp. Marseille-Q4147	2823317	S	47	37	84	0.00001
Limnochorda pilosa	1555112	S	3972	190	4162	0.00026
Allobaculum sp. Allo2	2853432	S	132	27	159	0.00001
Allobaculum mucolyticum	2834459	S	92	22	114	0.00001
Faecalibaculum rodentium	1702221	S	190	50	240	0.00002
Erysipelothrix sp. HDW6C	2714930	S	17	6	23	0.00000
Erysipelothrix sp. HDW6B	2714929	S	10	7	17	0.00000
Erysipelothrix larvae	1514105	S	28	8	36	0.00000
[Clostridium] innocuum	1522	S	66	64	130	0.00001
Erysipelatoclostridium ramosum	1547	S	12	7	19	0.00000
Bulleidia sp. zg-1006	2806552	S	45	19	64	0.00000
Intestinibaculum porci	2487118	S	34	16	50	0.00000
Longicatena caecimuris	1796635	S	15	28	43	0.00000
Faecalibacillus intestinalis	1982626	S	14	18	32	0.00000
Amedibacterium intestinale	2583452	S	10	21	31	0.00000
Turicibacter sp. H121	1712675	S	97	105	202	0.00001
Turicibacter sp. TJ11	2806443	S	12	11	23	0.00000
Turicibacter sanguinis	154288	S	20	6	26	0.00000
Peptoniphilus ivorii	54006	S	198	52	250	0.00002
Peptoniphilus harei	54005	S	16	18	34	0.00000
Murdochiella vaginalis	1852373	S	108	118	226	0.00001
Anaerococcus mediterraneensis	1870984	S	11	25	36	0.00000
Anaerococcus prevotii	33034	S	10	14	24	0.00000
Parvimonas micra	33033	S	37	71	108	0.00001
Finegoldia magna	1260	S	26	22	48	0.00000
Miniphocaeibacter halophilus	2931922	S	10	0	10	0.00000
Schnuerera ultunensis	45497	S	54	10	64	0.00000
Tissierella sp. JN-28	2507161	S	45	10	55	0.00000
Gudongella oleilytica	1582259	S	37	8	45	0.00000
Keratinibaculum paraultunense	1278232	S	31	14	45	0.00000
Gottschalkia acidurici	1556	S	52	6	58	0.00000
Ezakiella coagulans	46507	S	83	231	314	0.00002
Ezakiella massiliensis	1852374	S	32	18	50	0.00000
Sedimentibacter sp. zth1	2816908	S	39	5	44	0.00000
Ndongobacter massiliensis	1871025	S	129	118	247	0.00002
endosymbiont 'TC1' of Trimyema compressum	243899	S	59	4	63	0.00000
Synechococcus sp. CBW1004	1353136	S	1277	349	1626	0.00010
Synechococcus sp. RSCCF101	2511069	S	1026	259	1285	0.00008
Synechococcus sp. CBW1107	2789857	S	964	198	1162	0.00007
Synechococcus sp. JA-3-3Ab	321327	S	681	175	856	0.00005
Synechococcus sp. CBW1108	1353147	S	620	91	711	0.00004
Synechococcus sp. CB0101	232348	S	592	139	731	0.00005
Synechococcus sp. SynAce01	1916956	S	583	70	653	0.00004
Synechococcus sp. NB0720_10	2907159	S	435	122	557	0.00004
Synechococcus sp. LA31	2741953	S	395	94	489	0.00003
Synechococcus sp. JA-2-3B'a(2-13)	321332	S	387	91	478	0.00003
Synechococcus sp. RS9909	221352	S	360	137	497	0.00003
Synechococcus sp. LTW-R	2751170	S	356	93	449	0.00003
Synechococcus sp. PCC 7336	195250	S	355	14	369	0.00002
Synechococcus sp. A10-1-5-1	2936507	S	329	80	409	0.00003
Synechococcus sp. HK01-R	2751171	S	309	56	365	0.00002
Synechococcus sp. KORDI-100	1280380	S	281	21	302	0.00002
Synechococcus sp. Minos11	221341	S	273	21	294	0.00002
Synechococcus sp. WH 8101	59932	S	265	94	359	0.00002
Synechococcus sp. BMK-MC-1	1442551	S	207	85	292	0.00002
Synechococcus sp. NOUM97013	1442555	S	203	34	237	0.00002
Synechococcus sp. PROS-U-1	1400866	S	175	32	207	0.00001
Synechococcus sp. KORDI-52	585425	S	166	54	220	0.00001
Synechococcus sp. KORDI-49	585423	S	149	147	296	0.00002
Synechococcus sp. PROS-7-1	1442556	S	149	67	216	0.00001
Synechococcus sp. MEDNS5	1442554	S	144	48	192	0.00001
Synechococcus sp. BIOS-E4-1	1400864	S	142	16	158	0.00001
Synechococcus sp. MIT S9220	166309	S	132	21	153	0.00001
Synechococcus sp. A15-127	1050624	S	124	122	246	0.00002
Synechococcus sp. BIOS-U3-1	1400865	S	117	14	131	0.00001
Synechococcus sp. A15-62	1050657	S	108	75	183	0.00001
Synechococcus sp. CC9902	316279	S	105	11	116	0.00001
Synechococcus sp. NIES-970	1827144	S	93	19	112	0.00001
Synechococcus sp. PCC 6312	195253	S	89	4	93	0.00001
Synechococcus sp. ROS8604	1442557	S	86	22	108	0.00001
Synechococcus sp. CBW1002	1353134	S	82	677	759	0.00005
Synechococcus sp. PCC 7003	374981	S	82	26	108	0.00001
Synechococcus sp. WH 8020	32052	S	78	15	93	0.00001
Synechococcus sp. RS9907	221350	S	78	177	255	0.00002
Synechococcus sp. A15-44	1050646	S	76	132	208	0.00001
Synechococcus sp. WH 8109	166314	S	73	55	128	0.00001
Synechococcus sp. CBW1006	1353138	S	69	501	570	0.00004
Synechococcus sp. TAK9802	1442558	S	60	142	202	0.00001
Synechococcus sp. M16.1	1442553	S	56	162	218	0.00001
Synechococcus sp. RS9902	221345	S	53	105	158	0.00001
Synechococcus sp. PROS-9-1	1968775	S	52	13	65	0.00000
Synechococcus sp. PCC 7502	1173263	S	48	3	51	0.00000
Synechococcus sp. CC9311	64471	S	47	11	58	0.00000
Synechococcus sp. A18-25c	1866938	S	31	220	251	0.00002
Synechococcus sp. MVIR-18-1	1386941	S	29	49	78	0.00000
Synechococcus sp. SYN20	1050714	S	25	36	61	0.00000
Synechococcus sp. PCC 11901	2579791	S	21	97	118	0.00001
Synechococcus sp. PCC 8807	195248	S	19	108	127	0.00001
Synechococcus sp. PCC 7002	32049	S	16	69	85	0.00001
Synechococcus sp. PCC 7117	195498	S	15	70	85	0.00001
Synechococcus sp. A15-60	1050655	S	14	96	110	0.00001
Synechococcus sp. PCC 73109	374982	S	11	49	60	0.00000
Synechococcus elongatus	32046	S	569	34	603	0.00004
Dactylococcopsis salina	292566	S	86	39	125	0.00001
Cyanobium sp. NIES-981	1851505	S	1166	386	1552	0.00010
Cyanobium sp. NS01	261284	S	870	322	1192	0.00008
Cyanobium gracile	59930	S	1508	337	1845	0.00012
Parasynechococcus marenigrum	2881428	S	250	80	330	0.00002
Prochlorococcus marinus	1219	S	178	18	196	0.00001
Acaryochloris marina	155978	S	140	42	182	0.00001
Acaryochloris sp. 'Moss Beach'	2740837	S	52	72	124	0.00001
Chamaesiphon minutus	1173032	S	251	16	267	0.00002
Synechocystis sp. PCC 6714	1147	S	51	7	58	0.00000
Synechocystis sp. CACIAM 05	1933929	S	27	27	54	0.00000
Synechocystis sp. PCC 7338	2732530	S	11	121	132	0.00001
Nostoc sp. NIES-4103	2005458	S	487	109	596	0.00004
Nostoc sp. UHCC 0702	2814655	S	275	58	333	0.00002
Nostoc sp. C052	2576902	S	173	44	217	0.00001
Nostoc sp. CENA543	1869241	S	144	23	167	0.00001
Nostoc sp. ATCC 53789	76335	S	135	201	336	0.00002
Nostoc sp. 'Lobaria pulmonaria (5183) cyanobiont'	1618022	S	135	30	165	0.00001
Nostoc sp. UHCC 0870	2914041	S	120	41	161	0.00001
Nostoc sp. TCL26-01	2576904	S	112	16	128	0.00001
Nostoc sp. PCC 7524	28072	S	106	22	128	0.00001
Nostoc sp. MS1	2764711	S	96	29	125	0.00001
Nostoc sp. C057	2576903	S	80	124	204	0.00001
Nostoc sp. 'Peltigera membranacea cyanobiont' N6	1261031	S	75	23	98	0.00001
Nostoc sp. TCL240-02	2572090	S	65	35	100	0.00001
Nostoc sp. PCC 7107	317936	S	65	33	98	0.00001
Nostoc sp. NIES-2111	1973475	S	50	114	164	0.00001
Nostoc sp. NIES-3756	1751286	S	25	68	93	0.00001
Nostoc linckia	92942	S	397	92	489	0.00003
Nostoc flagelliforme	1306274	S	147	55	202	0.00001
Nostoc sphaeroides	446679	S	146	86	232	0.00001
Nostoc edaphicum	264686	S	144	41	185	0.00001
Nostoc piscinale	224012	S	128	62	190	0.00001
Nostoc punctiforme	272131	S	124	89	213	0.00001
Nostoc commune	1178	S	73	24	97	0.00001
Anabaena sp. WA102	1647413	S	149	278	427	0.00003
Anabaena sp. 90	46234	S	55	441	496	0.00003
Anabaena cylindrica	1165	S	124	36	160	0.00001
Cylindrospermum stagnale	142864	S	170	60	230	0.00001
Trichormus azollae	1164	S	79	15	94	0.00001
Richelia sinica	1357545	S	44	8	52	0.00000
Calothrix sp. PCC 7716	2853227	S	246	162	408	0.00003
Calothrix sp. NIES-2100	1954172	S	207	129	336	0.00002
Calothrix sp. NIES-3974	2005462	S	206	19	225	0.00001
Calothrix sp. PCC 7507	99598	S	166	38	204	0.00001
Calothrix sp. NIES-2098	1954171	S	86	50	136	0.00001
Calothrix sp. 336/3	1337936	S	63	18	81	0.00001
Calothrix sp. PCC 6303	1170562	S	49	14	63	0.00000
Calothrix parasitica	1973486	S	233	14	247	0.00002
Calothrix brevissima	938406	S	197	79	276	0.00002
Scytonema sp. NIES-4073	2005464	S	429	174	603	0.00004
Scytonema sp. HK-05	1137095	S	310	108	418	0.00003
Brasilonema sennae	1397703	S	216	24	240	0.00002
Nodularia sphaerocarpa	137816	S	171	48	219	0.00001
Nodularia spumigena	70799	S	104	21	125	0.00001
Sphaerospermopsis torques-reginae	984207	S	130	41	171	0.00001
Sphaerospermopsis kisseleviana	289435	S	128	45	173	0.00001
Dolichospermum compactum	136073	S	97	129	226	0.00001
Dolichospermum sp. UHCC 0315A	1914871	S	25	179	204	0.00001
Dolichospermum flos-aquae	1166	S	24	204	228	0.00001
Anabaenopsis circularis	109266	S	74	45	119	0.00001
Anabaenopsis elenkinii	156213	S	29	5	34	0.00000
Tolypothrix sp. PCC 7910	2099387	S	192	47	239	0.00002
Tolypothrix tenuis	457083	S	90	33	123	0.00001
Fischerella sp. NIES-3754	1752063	S	147	29	176	0.00001
Fischerella sp. NIES-4106	2005456	S	139	15	154	0.00001
Rivularia sp. PCC 7116	373994	S	73	4	77	0.00000
Leptolyngbya sp. 7M	2812896	S	2941	229	3170	0.00020
Leptolyngbya sp. BL0902	1115757	S	517	37	554	0.00004
Leptolyngbya sp. NIES-3755	1752064	S	112	15	127	0.00001
Leptolyngbya sp. PCC 7376	111781	S	74	7	81	0.00001
Leptolyngbya boryana	1184	S	172	0	172	0.00001
Kovacikia minuta	2931930	S	558	62	620	0.00004
Leptodesmis sichuanensis	2906798	S	263	35	298	0.00002
Leptothermofonsia sichuanensis	2917832	S	262	29	291	0.00002
Thermoleptolyngbya sp. PKUAC-SCTB121	2811482	S	25	492	517	0.00003
Thermoleptolyngbya sichuanensis	2885951	S	12	259	271	0.00002
Thermosynechococcus sp. NK55a	1394889	S	90	41	131	0.00001
Thermosynechococcus sp. CL-1	2583530	S	45	47	92	0.00001
Thermosynechococcus sp. TA-1	2813673	S	40	39	79	0.00001
Thermosynechococcus vestitus	146786	S	148	51	199	0.00001
Halomicronema hongdechloris	1209493	S	421	20	441	0.00003
Pseudanabaena sp. PCC 7367	82654	S	161	6	167	0.00001
Pseudanabaena sp. ABRG5-3	685565	S	107	7	114	0.00001
Gloeobacter kilaueensis	1416614	S	1813	57	1870	0.00012
Gloeobacter violaceus	33072	S	1332	581	1913	0.00012
Gloeobacter morelensis	2907343	S	1303	517	1820	0.00012
Anthocerotibacter panamensis	2857077	S	443	14	457	0.00003
Moorena producens	1155739	S	700	20	720	0.00005
Oscillatoria nigro-viridis	482564	S	257	132	389	0.00002
Oscillatoria acuminata	118323	S	165	12	177	0.00001
Geitlerinema sp. PCC 7407	1173025	S	920	158	1078	0.00007
Allocoleopsis franciscana	2886352	S	200	24	224	0.00001
Oxynema aestuarii	2874213	S	418	41	459	0.00003
Microcoleus vaginatus	119532	S	246	79	325	0.00002
Planktothrix agardhii	1160	S	48	36	84	0.00001
Planktothrix rubescens	59512	S	26	13	39	0.00000
[Phormidium] sp. ETS-05	222819	S	270	17	287	0.00002
Crinalium epipsammum	241425	S	124	18	142	0.00001
Limnospira indica	147322	S	13	84	97	0.00001
Microcystis aeruginosa	1126	S	314	393	707	0.00004
Microcystis sp. MC19	1967666	S	46	33	79	0.00000
Gloeothece citriformis	2546356	S	70	7	77	0.00000
Gloeothece verrucosa	2546359	S	61	6	67	0.00000
Halothece sp. PCC 7418	65093	S	106	42	148	0.00001
Euhalothece natronophila	577489	S	22	4	26	0.00000
Rippkaea orientalis	2546366	S	85	14	99	0.00001
Crocosphaera subtropica	2546360	S	79	11	90	0.00001
Candidatus Atelocyanobacterium thalassa	713887	S	17	5	22	0.00000
Geminocystis herdmanii	669359	S	72	20	92	0.00001
Geminocystis sp. NIES-3709	1617448	S	38	14	52	0.00000
Geminocystis sp. NIES-3708	1615909	S	12	5	17	0.00000
Gloeocapsa sp. PCC 7428	1173026	S	103	12	115	0.00001
Chondrocystis sp. NIES-4102	2005460	S	68	12	80	0.00001
Cyanobacterium aponinum	379064	S	58	25	83	0.00001
Chroococcidiopsis sp. CCMEE 29	155894	S	364	75	439	0.00003
Chroococcidiopsis sp. CCNUC1	2653189	S	96	113	209	0.00001
Chroococcidiopsis thermalis	54299	S	115	146	261	0.00002
Pleurocapsa sp. PCC 7327	118163	S	188	25	213	0.00001
Stanieria cyanosphaera	102116	S	28	14	42	0.00000
Stanieria sp. NIES-3757	1807358	S	26	16	42	0.00000
Gloeomargarita lithophora	1188228	S	159	6	165	0.00001
Thermostichus lividus	33070	S	88	14	102	0.00001
cyanobacterium endosymbiont of Rhopalodia gibberula	1763363	S	17	3	20	0.00000
cyanobacterium endosymbiont of Epithemia turgida	718217	S	10	1	11	0.00000
Deinococcus sp. NW-56	2080419	S	1818	273	2091	0.00013
Deinococcus sp. TS-293	2737050	S	1469	164	1633	0.00010
Deinococcus sp. KNUC1210	2917691	S	1329	62	1391	0.00009
Deinococcus sp. AJ005	2652443	S	999	91	1090	0.00007
Deinococcus sp. QL22	2939437	S	689	60	749	0.00005
Deinococcus maricopensis	309887	S	2407	239	2646	0.00017
Deinococcus gobiensis	502394	S	2307	333	2640	0.00017
Deinococcus ficus	317577	S	2246	228	2474	0.00016
Deinococcus metallilatus	1211322	S	2198	268	2466	0.00016
Deinococcus actinosclerus	1768108	S	2125	1309	3434	0.00022
Deinococcus irradiatisoli	2202254	S	1644	163	1807	0.00011
Deinococcus peraridilitoris	432329	S	1511	83	1594	0.00010
Deinococcus wulumuqiensis	980427	S	1484	601	2085	0.00013
Deinococcus radiopugnans	57497	S	1361	179	1540	0.00010
Deinococcus geothermalis	68909	S	1140	186	1326	0.00008
Deinococcus radiodurans	1299	S	1041	1842	2883	0.00018
Deinococcus soli (ex Cha et al. 2016)	1309411	S	982	935	1917	0.00012
Deinococcus psychrotolerans	2489213	S	876	27	903	0.00006
Deinococcus proteolyticus	55148	S	794	178	972	0.00006
Deinococcus deserti	310783	S	768	59	827	0.00005
Deinococcus radiophilus	32062	S	431	90	521	0.00003
Deinococcus puniceus	1182568	S	342	54	396	0.00003
Thermus thermophilus	274	S	1322	1542	2864	0.00018
Thermus sp. CCB_US3_UF1	1111069	S	703	120	823	0.00005
Thermus sp. NEB1569	2918899	S	166	330	496	0.00003
Thermus oshimai	56957	S	694	146	840	0.00005
Thermus aquaticus	271	S	682	111	793	0.00005
Thermus brockianus	56956	S	596	126	722	0.00005
Thermus caldilimi	2483360	S	299	84	383	0.00002
Thermus scotoductus	37636	S	159	267	426	0.00003
Thermus parvatiensis	456163	S	80	426	506	0.00003
Meiothermus silvanus	52022	S	1188	201	1389	0.00009
Meiothermus taiwanensis	172827	S	927	342	1269	0.00008
Meiothermus ruber	277	S	857	334	1191	0.00008
Oceanithermus profundus	187137	S	3452	418	3870	0.00024
Marinithermus hydrothermalis	186192	S	2180	390	2570	0.00016
Truepera radiovictrix	332249	S	2742	169	2911	0.00018
Sphaerobacter thermophilus	2057	S	9364	588	9952	0.00063
Thermomicrobium roseum	500	S	2020	38	2058	0.00013
Roseiflexus sp. RS-1	357808	S	2459	384	2843	0.00018
Roseiflexus castenholzii	120962	S	2247	385	2632	0.00017
Chloroflexus aurantiacus	1108	S	893	95	988	0.00006
Chloroflexus aggregans	152260	S	789	135	924	0.00006
Tepidiforma bonchosmolovskayae	2601677	S	6243	306	6549	0.00041
Candidatus Promineofilum breve	1806508	S	5981	140	6121	0.00039
Anaerolinea thermophila	167964	S	1524	168	1692	0.00011
Pelolinea submarina	913107	S	1331	69	1400	0.00009
Brevefilum fermentans	1986204	S	493	20	513	0.00003
Caldilinea aerophila	133453	S	2707	195	2902	0.00018
Dehalogenimonas formicexedens	1839801	S	588	158	746	0.00005
Dehalogenimonas sp. GP	1536648	S	432	115	547	0.00003
Dehalococcoides mccartyi	61435	S	153	339	492	0.00003
Phototrophicus methaneseepsis	2710758	S	1457	17	1474	0.00009
Ktedonosporobacter rubrisoli	2509675	S	1076	36	1112	0.00007
Thermobaculum terrenum	166501	S	845	149	994	0.00006
Fimbriimonas ginsengisoli	1005039	S	3204	21	3225	0.00020
Chthonomonas calidirosea	454171	S	854	8	862	0.00005
Mycoplasma sp. (ex Biomphalaria glabrata)	1749074	S	19	1	20	0.00000
Mycoplasma sp. SG1	2810348	S	12	0	12	0.00000
Mycoplasma mycoides	2102	S	19	164	183	0.00001
Mycoplasma genitalium	2097	S	21	0	21	0.00000
Mycoplasma miroungigenitalium	754515	S	17	19	36	0.00000
Mycoplasma haemofelis	29501	S	12	12	24	0.00000
Candidatus Hepatoplasma crinochetorum	295596	S	19	1	20	0.00000
Candidatus Phytoplasma solani	69896	S	11	0	11	0.00000
Candidatus Phytoplasma ziziphi	135727	S	11	16	27	0.00000
Alteracholeplasma palmae	38986	S	55	7	62	0.00000
Haploplasma axanthum	29552	S	25	10	35	0.00000
Paracholeplasma brassicae	61635	S	17	5	22	0.00000
Mariniplasma anaerobium	2735436	S	10	0	10	0.00000
Spiroplasma endosymbiont of 'Nebria riversi'	2792084	S	13	25	38	0.00000
Spiroplasma platyhelix	301585	S	15	18	33	0.00000
Williamsoniiplasma somnilux	215578	S	14	6	20	0.00000
Malacoplasma iowae	2116	S	16	0	16	0.00000
Candidatus Izimaplasma sp. HR1	1541959	S	16	0	16	0.00000
Gemmata obscuriglobus	114	S	44919	7870	52789	0.00334
Gemmata massiliana	1210884	S	17692	8022	25714	0.00162
Gemmata sp. SH-PL17	1630693	S	16260	8308	24568	0.00155
Urbifossiella limnaea	2528023	S	85448	8435	93883	0.00593
Frigoriglobus tundricola	2774151	S	52510	9191	61701	0.00390
Limnoglobus roseus	2598579	S	41941	2224	44165	0.00279
Tuwongella immobilis	692036	S	3977	198	4175	0.00026
Telmatocola sphagniphila	1123043	S	3370	39	3409	0.00022
Lacipirellula parvula	2650471	S	19479	2667	22146	0.00140
Lacipirellula limnantheis	2528024	S	18985	3030	22015	0.00139
Pirellulimonas nuda	2528009	S	15724	2090	17814	0.00113
Botrimarina mediterranea	2528022	S	14002	1600	15602	0.00099
Aeoliella mucimassa	2527972	S	5231	531	5762	0.00036
Adhaeretor mobilis	1930276	S	3132	378	3510	0.00022
Bythopirellula goksoeyrii	1400387	S	3060	271	3331	0.00021
Lignipirellula cremea	2528010	S	9889	1322	11211	0.00071
Stieleria neptunia	2527979	S	4152	545	4697	0.00030
Stieleria maiorica	2795974	S	4134	995	5129	0.00032
Anatilimnocola aggregata	2528021	S	8089	1025	9114	0.00058
Rosistilla oblonga	2527990	S	2345	1165	3510	0.00022
Rosistilla carotiformis	2528017	S	1682	762	2444	0.00015
Rosistilla ulvae	1930277	S	1555	945	2500	0.00016
Bremerella volcania	2527984	S	6265	562	6827	0.00043
Pirellula staleyi	125	S	4576	208	4784	0.00030
Pirellula sp. SH-Sr6A	1632865	S	1149	38	1187	0.00008
Roseimaritima ulvae	980254	S	3806	286	4092	0.00026
Roseimaritima multifibrata	1930274	S	1057	139	1196	0.00008
Rubripirellula lacrimiformis	1930273	S	2020	459	2479	0.00016
Rhodopirellula baltica	265606	S	1444	122	1566	0.00010
Mariniblastus fucicola	980251	S	1414	33	1447	0.00009
Aureliella helgolandensis	2527968	S	1387	133	1520	0.00010
Thermogutta terrifontis	1331910	S	1799	69	1868	0.00012
Tautonia plasticadhaerens	2527974	S	41043	4253	45296	0.00286
Aquisphaera giovannonii	406548	S	31860	6510	38370	0.00242
Paludisphaera borealis	1387353	S	19736	5288	25024	0.00158
Singulisphaera acidiphila	466153	S	13996	2498	16494	0.00104
Isosphaera pallida	128	S	3935	338	4273	0.00027
Planctomyces sp. SH-PL62	1636152	S	18969	8440	27409	0.00173
Planctomyces sp. SH-PL14	1632864	S	16181	1194	17375	0.00110
Gimesia panareensis	2527978	S	3519	459	3978	0.00025
Gimesia chilikensis	2605989	S	1949	1241	3190	0.00020
Gimesia maris	122	S	1283	216	1499	0.00009
Gimesia alba	2527973	S	871	167	1038	0.00007
Gimesia fumaroli	2527976	S	809	176	985	0.00006
Gimesia algae	2527971	S	801	219	1020	0.00006
Gimesia aquarii	2527964	S	583	43	626	0.00004
Gimesia benthica	2608982	S	519	766	1285	0.00008
Maioricimonas rarisocia	2528026	S	12051	1755	13806	0.00087
Caulifigura coniformis	2527983	S	11934	911	12845	0.00081
Alienimonas californiensis	2527989	S	9316	798	10114	0.00064
Symmachiella dynata	2527995	S	4620	316	4936	0.00031
Rubinisphaera brasiliensis	119	S	2470	280	2750	0.00017
Fuerstiella marisgermanici	1891926	S	2426	50	2476	0.00016
Planctopirus ephydatiae	2528019	S	818	374	1192	0.00008
Planctopirus limnophila	120	S	815	348	1163	0.00007
Calycomorphotria hydatis	2528027	S	2141	92	2233	0.00014
Crateriforma conspicua	2527996	S	1905	494	2399	0.00015
Polystyrenella longa	2528007	S	821	83	904	0.00006
Thalassoglobus polymorphus	2527994	S	816	51	867	0.00005
Humisphaera borealis	2807512	S	12336	338	12674	0.00080
Phycisphaera mikurensis	547188	S	5577	511	6088	0.00038
Mucisphaera calidilacus	2527982	S	2963	195	3158	0.00020
Poriferisphaera corsica	2528020	S	354	3	357	0.00002
Anaerohalosphaera lusitana	1936003	S	596	26	622	0.00004
Limihaloglobus sulfuriphilus	1851148	S	277	24	301	0.00002
Sedimentisphaera salicampi	1941349	S	107	32	139	0.00001
Sedimentisphaera cyanobacteriorum	1940790	S	104	141	245	0.00002
Candidatus Kuenenia stuttgartiensis	174633	S	287	1	288	0.00002
Candidatus Uabimicrobium amorphum	2596890	S	173	3	176	0.00001
Opitutus terrae	107709	S	9475	476	9951	0.00063
Opitutus sp. GAS368	1882749	S	8225	1286	9511	0.00060
Lacunisphaera limnophila	1838286	S	7921	1154	9075	0.00057
Oleiharenicola sp. KSB-15	2862869	S	3977	221	4198	0.00027
Nibricoccus aquaticus	2576891	S	3780	177	3957	0.00025
Ereboglobus luteus	1796921	S	2760	145	2905	0.00018
Ruficoccus sp. ZRK36	2866311	S	1261	202	1463	0.00009
Coraliomargarita akajimensis	395922	S	322	8	330	0.00002
Verrucomicrobium sp. GAS474	1882831	S	3564	403	3967	0.00025
Verrucomicrobium spinosum	2736	S	2381	133	2514	0.00016
Luteolibacter luteus	2728835	S	2571	112	2683	0.00017
Luteolibacter ambystomatis	2824561	S	2432	161	2593	0.00016
Roseimicrobium sp. ORNL1	2711231	S	4423	150	4573	0.00029
Sulfuriroseicoccus oceanibius	2707525	S	708	70	778	0.00005
Akkermansia muciniphila	239935	S	1459	173	1632	0.00010
Akkermansia glycaniphila	1679444	S	515	37	552	0.00003
Methylacidimicrobium sp. AP8	2730359	S	992	162	1154	0.00007
Methylacidimicrobium sp. B4	2796139	S	818	177	995	0.00006
Methylacidiphilum kamchatkense	431057	S	45	3	48	0.00000
Methylacidiphilum sp. IT5	2795384	S	24	64	88	0.00001
Methylacidiphilum sp. IT6	2795386	S	19	1	20	0.00000
Methylacidiphilum infernorum	511746	S	19	50	69	0.00000
Candidatus Xiphinematobacter sp. Idaho Grape	1704307	S	157	12	169	0.00001
Kiritimatiella glycovorans	1307763	S	1497	1921	3418	0.00022
Tichowtungia aerotolerans	2697043	S	523	21	544	0.00003
Neochlamydia sp. S13	1353976	S	114	25	139	0.00001
Candidatus Protochlamydia naegleriophila	389348	S	60	38	98	0.00001
Candidatus Protochlamydia amoebophila	362787	S	29	17	46	0.00000
Parachlamydia acanthamoebae	83552	S	77	26	103	0.00001
Waddlia chondrophila	71667	S	75	13	88	0.00001
Simkania negevensis	83561	S	73	8	81	0.00001
Candidatus Rhabdochlamydia oedothoracis	2720720	S	12	20	32	0.00000
Candidatus Rhabdochlamydia porcellionis	225148	S	11	24	35	0.00000
Chlamydia avium	1457141	S	15	0	15	0.00000
Chlamydia trachomatis	813	S	14	2	16	0.00000
Chlamydia suis	83559	S	12	7	19	0.00000
Chlamydia muridarum	83560	S	10	78	88	0.00001
Chlamydia pecorum	85991	S	10	0	10	0.00000
Candidatus Velamenicoccus archaeovorus	1930593	S	522	2	524	0.00003
Hymenobacter sp. PAMC 26628	1484118	S	1360	356	1716	0.00011
Hymenobacter sp. 5317J-9	2932250	S	1212	306	1518	0.00010
Hymenobacter sp. PAMC 26554	1484116	S	1147	124	1271	0.00008
Hymenobacter sp. APR13	1356852	S	1029	444	1473	0.00009
Hymenobacter sp. BRD128	2675878	S	982	144	1126	0.00007
Hymenobacter sp. 5116S-27	2932249	S	733	124	857	0.00005
Hymenobacter sp. 5116S-3	2932248	S	684	112	796	0.00005
Hymenobacter sp. BT18	2835648	S	637	89	726	0.00005
Hymenobacter sp. DG01	2584940	S	622	179	801	0.00005
Hymenobacter sp. NBH84	2596915	S	579	93	672	0.00004
Hymenobacter sp. S2-20-2	2761579	S	577	95	672	0.00004
Hymenobacter sp. 5413J-13	2932251	S	544	85	629	0.00004
Hymenobacter sp. 5420S-77	2932254	S	531	78	609	0.00004
Hymenobacter sp. DG25B	1385664	S	452	174	626	0.00004
Hymenobacter sp. BRD67	2675877	S	427	443	870	0.00005
Hymenobacter sp. DG25A	1385663	S	380	150	530	0.00003
Hymenobacter sp. HDW8	2714932	S	197	682	879	0.00006
Hymenobacter sp. 5516S-25	2933777	S	173	743	916	0.00006
Hymenobacter sp. 5516J-16	2932253	S	140	638	778	0.00005
Hymenobacter monticola	1705399	S	1322	262	1584	0.00010
Hymenobacter busanensis	2607656	S	1238	144	1382	0.00009
Hymenobacter sedentarius	1411621	S	1090	178	1268	0.00008
Hymenobacter nivis	1850093	S	847	232	1079	0.00007
Hymenobacter jejuensis	2502781	S	839	68	907	0.00006
Hymenobacter oligotrophus	2319843	S	737	87	824	0.00005
Hymenobacter swuensis	1446467	S	651	155	806	0.00005
Hymenobacter tibetensis	497967	S	579	96	675	0.00004
Hymenobacter qilianensis	1385715	S	478	92	570	0.00004
Hymenobacter baengnokdamensis	2615203	S	477	553	1030	0.00007
Hymenobacter radiodurans	2496028	S	221	800	1021	0.00006
Pontibacter russatus	2694929	S	1596	172	1768	0.00011
Pontibacter actiniarum	323450	S	879	248	1127	0.00007
Pontibacter pudoricolor	2694930	S	799	101	900	0.00006
Pontibacter akesuensis	388950	S	626	107	733	0.00005
Pontibacter korlensis	400092	S	374	61	435	0.00003
Pontibacter sp. SGAir0037	2571030	S	321	63	384	0.00002
Rufibacter radiotolerans	1379910	S	453	54	507	0.00003
Rufibacter tibetensis	512763	S	331	57	388	0.00002
Rufibacter sp. DG15C	1379909	S	264	164	428	0.00003
Adhaeribacter swui	2086471	S	264	33	297	0.00002
Adhaeribacter radiodurans	2745197	S	185	20	205	0.00001
Nibribacter ruber	2698458	S	274	170	444	0.00003
Spirosoma sp. CJU-R4	2728024	S	830	68	898	0.00006
Spirosoma sp. KUDC1026	2745947	S	561	52	613	0.00004
Spirosoma sp. RHs26	2898794	S	372	28	400	0.00003
Spirosoma sp. KCTC 42546	2520506	S	360	50	410	0.00003
Spirosoma sp. KCTC 72228	2710596	S	247	34	281	0.00002
Spirosoma rigui	564064	S	620	45	665	0.00004
Spirosoma montaniterrae	1178516	S	525	33	558	0.00004
Spirosoma taeanense	2735870	S	515	49	564	0.00004
Spirosoma aerolatum	1211326	S	375	18	393	0.00002
Spirosoma radiotolerans	1379870	S	325	24	349	0.00002
Spirosoma endbachense	2666025	S	308	153	461	0.00003
Spirosoma pollinicola	2057025	S	301	37	338	0.00002
Spirosoma aureum	2692134	S	228	137	365	0.00002
Rhodocytophaga rosea	2704465	S	260	9	269	0.00002
Aquirufa sp. 9H-EGSE	2696560	S	66	25	91	0.00001
Aquirufa nivalisilvae	2516557	S	41	12	53	0.00000
Cytophaga hutchinsonii	985	S	99	8	107	0.00001
Dyadobacter fermentans	94254	S	1020	100	1120	0.00007
Dyadobacter sp. LJ419	2906456	S	259	21	280	0.00002
Dyadobacter sp. NIV53	2861765	S	118	8	126	0.00001
Dyadobacter sandarakinus	2747268	S	334	34	368	0.00002
Fibrella aestuarina	651143	S	1126	101	1227	0.00008
Fibrella sp. ES10-3-2-2	1834519	S	458	36	494	0.00003
Runella slithyformis	106	S	371	35	406	0.00003
Runella rosea	2259595	S	228	25	253	0.00002
Runella sp. SP2	2268026	S	172	10	182	0.00001
Larkinella sp. IE-0392	2907205	S	311	23	334	0.00002
Leadbetterella byssophila	316068	S	75	29	104	0.00001
Arcticibacterium luteifluviistationis	1784714	S	35	2	37	0.00000
Chryseolinea soli	2321403	S	2921	89	3010	0.00019
Fulvivirga sp. SS9-22	2904245	S	176	11	187	0.00001
Fulvivirga sp. W9P-11	2904246	S	98	17	115	0.00001
Fulvivirga sp. SW1-E11	2904247	S	86	21	107	0.00001
Fulvivirga lutea	2810512	S	96	9	105	0.00001
Echinicola rosea	1807691	S	151	60	211	0.00001
Echinicola sp. SCS 3-6	2859768	S	73	28	101	0.00001
Echinicola sp. 20G	2781961	S	60	7	67	0.00000
Echinicola strongylocentroti	1795355	S	121	19	140	0.00001
Echinicola vietnamensis	390884	S	117	51	168	0.00001
Echinicola soli	2591634	S	89	7	96	0.00001
Algoriphagus sp. Y33	2772483	S	108	8	116	0.00001
Algoriphagus sp. NBT04N3	2705473	S	57	16	73	0.00000
Algoriphagus sanaruensis	1727163	S	97	10	107	0.00001
Algoriphagus machipongonensis	388413	S	64	4	68	0.00000
Cyclobacterium marinum	104	S	53	12	65	0.00000
Cyclobacterium amurskyense	320787	S	49	6	55	0.00000
Aquiflexum balticum	280473	S	98	13	111	0.00001
Belliella baltica	232259	S	58	23	81	0.00001
Mongoliitalea daihaiensis	2782006	S	52	5	57	0.00000
Candidatus Amoebophilus asiaticus	281120	S	112	5	117	0.00001
Cardinium endosymbiont of Oedothorax gibbosus	931101	S	12	32	44	0.00000
Flammeovirga pectinis	2494373	S	29	5	34	0.00000
Flammeovirga sp. MY04	1191459	S	26	22	48	0.00000
Flammeovirga yaeyamensis	367791	S	21	18	39	0.00000
Flammeovirga kamogawensis	373891	S	18	3	21	0.00000
Mangrovivirga cuniculi	2715131	S	96	6	102	0.00001
Marivirga tractuosa	1006	S	83	31	114	0.00001
Bernardetia litoralis	999	S	41	2	43	0.00000
Rhodocaloribacter litoris	2558931	S	7438	853	8291	0.00052
Rhodothermus marinus	29549	S	6520	404	6924	0.00044
Salinibacter ruber	146919	S	3883	70	3953	0.00025
Chitinophaga sp. XS-30	2604421	S	672	208	880	0.00006
Chitinophaga sp. KRA15-503	2829818	S	387	180	567	0.00004
Chitinophaga oryzae	2725414	S	740	97	837	0.00005
Chitinophaga filiformis	104663	S	415	57	472	0.00003
Chitinophaga alhagiae	2203219	S	402	7	409	0.00003
Chitinophaga pinensis	79329	S	347	64	411	0.00003
Chitinophaga agri	2703787	S	259	58	317	0.00002
Chitinophaga caeni	2029983	S	205	26	231	0.00001
Niastella koreensis	354356	S	3284	304	3588	0.00023
Flavisolibacter tropicus	1492898	S	963	129	1092	0.00007
Flavisolibacter ginsenosidimutans	661481	S	854	46	900	0.00006
Paraflavitalea soli	2315862	S	1186	79	1265	0.00008
Pseudocnuella soli	2502779	S	1029	110	1139	0.00007
Flavihumibacter sp. IMCC34838	2838156	S	533	43	576	0.00004
Flavihumibacter sp. IMCC34837	2838157	S	308	19	327	0.00002
Niabella soli	446683	S	353	39	392	0.00002
Niabella ginsenosidivorans	1176587	S	351	33	384	0.00002
Pseudobacter ginsenosidimutans	661488	S	726	55	781	0.00005
Arachidicoccus sp. BS20	1850526	S	149	37	186	0.00001
Arachidicoccus sp. 5GH13-10	2875539	S	107	14	121	0.00001
Arachidicoccus sp. B3-10	2545455	S	61	4	65	0.00000
Arachidicoccus ginsenosidivorans	496057	S	86	10	96	0.00001
Arachidicoccus soli	2341117	S	81	7	88	0.00001
Lacibacter sp. S13-6-6	2760713	S	387	15	402	0.00003
Phnomibacter ginsenosidimutans	2676868	S	386	40	426	0.00003
Filimonas lacunae	477680	S	359	38	397	0.00003
Ferruginibacter sp. KIS38-8	2875540	S	184	13	197	0.00001
Ferruginibacter lapsinanis	563172	S	139	9	148	0.00001
Panacibacter ginsenosidivorans	1813871	S	284	12	296	0.00002
Alistipes communis	2585118	S	846	477	1323	0.00008
Alistipes onderdonkii	328813	S	836	802	1638	0.00010
Alistipes dispar	2585119	S	790	101	891	0.00006
Alistipes senegalensis	1288121	S	719	178	897	0.00006
Alistipes finegoldii	214856	S	659	562	1221	0.00008
Alistipes megaguti	2364787	S	618	71	689	0.00004
Alistipes sp. dk3624	2662363	S	547	96	643	0.00004
Alistipes indistinctus	626932	S	495	80	575	0.00004
Alistipes shahii	328814	S	467	278	745	0.00005
Prevotella sp. Rep29	2691580	S	120	11	131	0.00001
Prevotella sp. oral taxon 475	712471	S	105	8	113	0.00001
Prevotella sp. E13-17	2913616	S	104	6	110	0.00001
Prevotella sp. E15-22	2937774	S	75	8	83	0.00001
Prevotella sp. E9-3	2913621	S	62	10	72	0.00000
Prevotella sp. E2-28	2913620	S	56	4	60	0.00000
Prevotella sp. E13-3	2913617	S	16	114	130	0.00001
Prevotella sp. oral taxon 299	652716	S	11	1	12	0.00000
Prevotella dentalis	52227	S	392	78	470	0.00003
Prevotella denticola	28129	S	156	44	200	0.00001
Prevotella multiformis	282402	S	122	44	166	0.00001
Prevotella melaninogenica	28132	S	118	35	153	0.00001
Prevotella ruminicola	839	S	117	4	121	0.00001
Prevotella copri	165179	S	88	32	120	0.00001
Prevotella intermedia	28131	S	84	31	115	0.00001
Prevotella buccalis	28127	S	75	60	135	0.00001
Prevotella enoeca	76123	S	57	9	66	0.00000
Prevotella fusca	589436	S	37	7	44	0.00000
Prevotella nigrescens	28133	S	32	16	48	0.00000
Prevotella jejuni	1177574	S	30	10	40	0.00000
Prevotella oris	28135	S	24	2	26	0.00000
Prevotella bryantii	77095	S	17	1	18	0.00000
Prevotella herbatica	2801997	S	16	0	16	0.00000
Prevotella veroralis	28137	S	13	2	15	0.00000
Prevotella histicola	470565	S	13	2	15	0.00000
Prevotella scopos	589437	S	12	5	17	0.00000
Pseudoprevotella muciniphila	2133944	S	99	9	108	0.00001
Paraprevotella xylaniphila	454155	S	93	60	153	0.00001
Bacteroides cellulosilyticus	246787	S	136	38	174	0.00001
Bacteroides fragilis	817	S	114	172	286	0.00002
Bacteroides sp. CBA7301	2715212	S	61	17	78	0.00000
Bacteroides sp. M10	2763022	S	21	39	60	0.00000
Bacteroides thetaiotaomicron	818	S	105	56	161	0.00001
Bacteroides stercoris	46506	S	96	68	164	0.00001
Bacteroides eggerthii	28111	S	88	74	162	0.00001
Bacteroides zoogleoformans	28119	S	82	20	102	0.00001
Bacteroides salyersiae	291644	S	75	52	127	0.00001
Bacteroides heparinolyticus	28113	S	74	17	91	0.00001
Bacteroides helcogenes	290053	S	72	3	75	0.00000
Bacteroides caccae	47678	S	60	12	72	0.00000
Bacteroides intestinalis	329854	S	51	8	59	0.00000
Bacteroides uniformis	820	S	51	136	187	0.00001
Bacteroides xylanisolvens	371601	S	48	108	156	0.00001
Bacteroides faecis	674529	S	46	29	75	0.00000
Bacteroides nordii	291645	S	43	23	66	0.00000
Bacteroides zhangwenhongii	2650157	S	37	20	57	0.00000
Bacteroides ovatus	28116	S	32	59	91	0.00001
Bacteroides caecimuris	1796613	S	26	29	55	0.00000
Bacteroides luhongzhouii	2650158	S	24	10	34	0.00000
Bacteroides coprosuis	151276	S	16	1	17	0.00000
Phocaeicola salanitronis	376805	S	130	42	172	0.00001
Phocaeicola coprophilus	387090	S	77	35	112	0.00001
Phocaeicola vulgatus	821	S	44	49	93	0.00001
Phocaeicola dorei	357276	S	32	54	86	0.00001
Tannerella serpentiformis	712710	S	540	22	562	0.00004
Tannerella forsythia	28112	S	184	12	196	0.00001
Parabacteroides goldsteinii	328812	S	136	27	163	0.00001
Parabacteroides merdae	46503	S	120	96	216	0.00001
Parabacteroides johnsonii	387661	S	82	47	129	0.00001
Parabacteroides distasonis	823	S	68	221	289	0.00002
Sodaliphilus pleomorphus	2606626	S	355	126	481	0.00003
Duncaniella dubosii	2518971	S	119	21	140	0.00001
Muribaculum gordoncarteri	2530390	S	141	16	157	0.00001
Muribaculum intestinale	1796646	S	119	13	132	0.00001
Porphyromonas sp. oral taxon 275	712435	S	484	40	524	0.00003
Porphyromonas gingivalis	837	S	136	17	153	0.00001
Porphyromonas asaccharolytica	28123	S	108	7	115	0.00001
Porphyromonas somerae	322095	S	50	10	60	0.00000
Porphyromonas cangingivalis	36874	S	39	5	44	0.00000
Porphyromonas crevioricanis	393921	S	34	6	40	0.00000
Porphyromonas endodontalis	28124	S	23	2	25	0.00000
Petrimonas mucosa	1642646	S	151	11	162	0.00001
Proteiniphilum saccharofermentans	1642647	S	103	6	109	0.00001
Proteiniphilum sp. JNU-WLY501	2829812	S	46	1	47	0.00000
Barnesiella viscericola	397865	S	253	232	485	0.00003
Coprobacter secundus	1501392	S	38	25	63	0.00000
Butyricimonas faecalis	2093856	S	63	58	121	0.00001
Butyricimonas virosa	544645	S	62	13	75	0.00000
Odoribacter splanchnicus	28118	S	59	6	65	0.00000
Tenuifilum thalassicum	2590900	S	72	1	73	0.00000
Paludibacter propionicigenes	185300	S	55	1	56	0.00000
Salinivirga cyanobacteriivorans	1307839	S	53	1	54	0.00000
Draconibacterium orientale	1168034	S	95	11	106	0.00001
Draconibacterium halophilum	2706887	S	68	6	74	0.00000
Maribellus comscasis	2681766	S	81	6	87	0.00001
Alkalitalea saponilacus	889453	S	79	4	83	0.00001
Labilibaculum antarcticum	1717717	S	43	2	45	0.00000
Flavobacterium sp. HJ-32-4	1160795	S	259	17	276	0.00002
Flavobacterium sp. MDT1-60	1979344	S	104	19	123	0.00001
Flavobacterium sp. CJ74	2294119	S	77	5	82	0.00001
Flavobacterium sp. CLA17	2724135	S	74	12	86	0.00001
Flavobacterium sp. B183	907046	S	47	10	57	0.00000
Flavobacterium sp. KBS0721	1179672	S	46	13	59	0.00000
Flavobacterium sp. MMS21-Er5	2937442	S	45	18	63	0.00000
Flavobacterium sp. F-29	2893883	S	42	8	50	0.00000
Flavobacterium sp. F-323	2893885	S	40	8	48	0.00000
Flavobacterium sp. IGB 4-14	1871076	S	38	3	41	0.00000
Flavobacterium sp. SLB02	2665645	S	36	6	42	0.00000
Flavobacterium sp. Sr18	935222	S	30	5	35	0.00000
Flavobacterium sp. xlx-214	2654325	S	29	5	34	0.00000
Flavobacterium sp. M31R6	2739062	S	29	4	33	0.00000
Flavobacterium sp. K5-23	2746225	S	29	6	35	0.00000
Flavobacterium sp. CS20	2775246	S	29	10	39	0.00000
Flavobacterium sp. 140616W15	2478552	S	28	5	33	0.00000
Flavobacterium sp. KSM-R2A30	2897181	S	28	9	37	0.00000
Flavobacterium sp. LPB0248	2614441	S	23	11	34	0.00000
Flavobacterium sp. KSM-R2A25	2895947	S	23	5	28	0.00000
Flavobacterium sp. WSW3-B6	2856519	S	23	2	25	0.00000
Flavobacterium sp. F-70	2893884	S	20	3	23	0.00000
Flavobacterium sp. F-340	2893886	S	20	5	25	0.00000
Flavobacterium sp. I3-2	2748319	S	19	26	45	0.00000
Flavobacterium sp. GENT5	1751095	S	18	3	21	0.00000
Flavobacterium sp. CECT 9288	2845819	S	13	12	25	0.00000
Flavobacterium sp. CHNK8	2871165	S	11	10	21	0.00000
Flavobacterium album	2175091	S	203	14	217	0.00001
Flavobacterium magnum	2162713	S	200	21	221	0.00001
Flavobacterium pallidum	2172098	S	138	13	151	0.00001
Flavobacterium anhuiense	459526	S	135	51	186	0.00001
Flavobacterium commune	1306519	S	83	12	95	0.00001
Flavobacterium nackdongense	2547394	S	81	6	87	0.00001
Flavobacterium johnsoniae	986	S	58	25	83	0.00001
Flavobacterium inviolabile	2748320	S	55	8	63	0.00000
Flavobacterium gilvum	1492737	S	54	7	61	0.00000
Flavobacterium alkalisoli	2602769	S	54	4	58	0.00000
Flavobacterium enshiense	1341165	S	52	5	57	0.00000
Flavobacterium kingsejongi	1678728	S	51	7	58	0.00000
Flavobacterium endoglycinae	2816357	S	46	9	55	0.00000
Flavobacterium nitrogenifigens	1617283	S	42	21	63	0.00000
Flavobacterium sangjuense	2518177	S	40	4	44	0.00000
Flavobacterium crocinum	2183896	S	38	11	49	0.00000
Flavobacterium faecale	1355330	S	34	4	38	0.00000
Flavobacterium fluviale	2249356	S	32	11	43	0.00000
Flavobacterium branchiophilum	55197	S	29	2	31	0.00000
Flavobacterium psychrophilum	96345	S	25	4	29	0.00000
Flavobacterium davisii	2906077	S	22	8	30	0.00000
Flavobacterium sediminis	2201181	S	22	21	43	0.00000
Flavobacterium indicum	312277	S	21	3	24	0.00000
Flavobacterium columnare	996	S	20	22	42	0.00000
Flavobacterium arcticum	1784713	S	20	2	22	0.00000
Flavobacterium sediminilitoris	2024526	S	19	2	21	0.00000
Flavobacterium oreochromis	2906078	S	18	7	25	0.00000
Flavobacterium haoranii	683124	S	17	6	23	0.00000
Flavobacterium jumunjinense	998845	S	16	2	18	0.00000
Flavobacterium covae	2906076	S	12	15	27	0.00000
Capnocytophaga gingivalis	1017	S	111	14	125	0.00001
Capnocytophaga sp. oral taxon 902	2748316	S	18	48	66	0.00000
Capnocytophaga sp. oral taxon 878	1316596	S	17	6	23	0.00000
Capnocytophaga sp. FDAARGOS_737	2545799	S	14	10	24	0.00000
Capnocytophaga haemolytica	45243	S	71	6	77	0.00000
Capnocytophaga sputigena	1019	S	69	28	97	0.00001
Capnocytophaga canimorsus	28188	S	56	16	72	0.00000
Capnocytophaga stomatis	1848904	S	37	8	45	0.00000
Capnocytophaga endodontalis	2708117	S	24	14	38	0.00000
Capnocytophaga leadbetteri	327575	S	21	14	35	0.00000
Capnocytophaga ochracea	1018	S	15	26	41	0.00000
Capnocytophaga cynodegmi	28189	S	10	3	13	0.00000
Muricauda sp. SCSIO 65647	2908843	S	100	3	103	0.00001
Muricauda sp. SCSIO 64092	2908842	S	73	2	75	0.00000
Muricauda aquimarina	254955	S	114	53	167	0.00001
Muricauda oceani	2698672	S	112	51	163	0.00001
Muricauda ruestringensis	111501	S	94	7	101	0.00001
Muricauda lutaonensis	516051	S	73	16	89	0.00001
Muricauda aurantiaca	1383885	S	26	2	28	0.00000
Robiginitalea biformata	252307	S	481	30	511	0.00003
Gramella fulva	2126553	S	123	10	133	0.00001
Gramella sp. GC03-9	2920386	S	64	16	80	0.00001
Gramella sp. MT6	2705471	S	34	4	38	0.00000
Gramella sp. MAR_2010_147	1250205	S	22	2	24	0.00000
Gramella flava	1486245	S	102	30	132	0.00001
Gramella echinicola	279359	S	34	4	38	0.00000
Gramella forsetii	411153	S	34	8	42	0.00000
Gramella salexigens	1913577	S	23	2	25	0.00000
Nonlabens sp. Hel1_33_55	1336802	S	52	8	60	0.00000
Nonlabens sp. MB-3u-79	2058134	S	17	8	25	0.00000
Nonlabens sp. Ci31	2608253	S	17	7	24	0.00000
Nonlabens spongiae	331648	S	56	24	80	0.00001
Nonlabens ponticola	2496866	S	54	7	61	0.00000
Nonlabens marinus	930802	S	23	7	30	0.00000
Nonlabens dokdonensis	328515	S	22	4	26	0.00000
Polaribacter sp. SM13	2818493	S	24	6	30	0.00000
Polaribacter sp. G4M1	2808900	S	22	5	27	0.00000
Polaribacter sp. Q13	2806551	S	13	9	22	0.00000
Polaribacter sp. Hel1_33_78	1336804	S	11	2	13	0.00000
Polaribacter sp. SA4-10	754397	S	10	2	12	0.00000
Polaribacter sp. NJDZ03	2855841	S	10	14	24	0.00000
Polaribacter sp. ALD11	2058137	S	10	4	14	0.00000
Polaribacter sp. SA4-12	1312072	S	10	3	13	0.00000
Polaribacter litorisediminis	1908341	S	16	2	18	0.00000
Polaribacter vadi	1774273	S	13	2	15	0.00000
Polaribacter reichenbachii	996801	S	12	1	13	0.00000
Polaribacter haliotis	1888915	S	10	6	16	0.00000
Aequorivita sublithincola	101385	S	58	57	115	0.00001
Aequorivita sp. H23M31	2494375	S	58	26	84	0.00001
Antarcticibacterium flavum	2058175	S	70	14	84	0.00001
Antarcticibacterium sp. 1MA-6-2	2908210	S	70	9	79	0.00000
Antarcticibacterium arcticum	2585771	S	47	6	53	0.00000
Maribacter sp. HTCC2170	313603	S	41	5	46	0.00000
Maribacter sp. MJ134	2496865	S	33	8	41	0.00000
Maribacter cobaltidurans	1178778	S	50	44	94	0.00001
Maribacter hydrothermalis	1836467	S	24	17	41	0.00000
Winogradskyella sp. PC-19	754417	S	27	7	34	0.00000
Winogradskyella sp. PG-2	754409	S	17	1	18	0.00000
Winogradskyella sp. J14-2	1936080	S	15	2	17	0.00000
Winogradskyella sp. HaHa_3_26	2749995	S	13	6	19	0.00000
Winogradskyella sp. MH6	2929510	S	11	1	12	0.00000
Winogradskyella forsetii	2686077	S	31	12	43	0.00000
Winogradskyella sediminis	1382466	S	20	6	26	0.00000
Winogradskyella helgolandensis	2697010	S	17	5	22	0.00000
Winogradskyella schleiferi	2686078	S	11	7	18	0.00000
Kordia antarctica	1218801	S	116	8	124	0.00001
Kordia sp. SMS9	2282170	S	39	2	41	0.00000
Sinomicrobium sp. HD2P242	2900738	S	142	5	147	0.00001
Myroides odoratus	256	S	44	18	62	0.00000
Myroides fluvii	2572594	S	22	11	33	0.00000
Myroides phaeus	702745	S	12	11	23	0.00000
Formosa sp. Hel3_A1_48	1336795	S	26	6	32	0.00000
Formosa sp. Hel1_33_131	1336794	S	24	2	26	0.00000
Formosa sp. Hel1_31_208	1798225	S	18	2	20	0.00000
Formosa sp. L2A11	2686363	S	18	5	23	0.00000
Formosa agariphila	320324	S	18	3	21	0.00000
Formosa sediminum	2594004	S	11	2	13	0.00000
Tenacibaculum sp. SZ-18	754423	S	21	15	36	0.00000
Tenacibaculum jejuense	584609	S	15	1	16	0.00000
Tenacibaculum todarodis	1850252	S	13	4	17	0.00000
Tenacibaculum mesophilum	104268	S	12	15	27	0.00000
Tenacibaculum maritimum	107401	S	10	3	13	0.00000
Tenacibaculum dicentrarchi	669041	S	10	5	15	0.00000
Salegentibacter salegens	143223	S	40	6	46	0.00000
Salegentibacter mishustinae	270918	S	31	27	58	0.00000
Salegentibacter sp. T436	1729720	S	28	27	55	0.00000
Dokdonia sp. 4H-3-7-5	983548	S	22	13	35	0.00000
Dokdonia sp. PRO95	1239415	S	20	7	27	0.00000
Dokdonia sp. MED134	313590	S	11	15	26	0.00000
Dokdonia sp. Dokd-P16	2173169	S	11	5	16	0.00000
Cellulophaga sp. L1A9	2686362	S	18	22	40	0.00000
Cellulophaga sp. HaHaR_3_176	1942464	S	13	4	17	0.00000
Cellulophaga lytica	979	S	21	9	30	0.00000
Cellulophaga algicola	59600	S	13	7	20	0.00000
Zunongwangia sp. SCSIO 43204	2779359	S	44	29	73	0.00000
Zunongwangia profunda	398743	S	41	31	72	0.00000
Zobellia galactanivorans	63186	S	77	5	82	0.00001
Aggregatimonas sangjinii	2583587	S	71	3	74	0.00000
Leeuwenhoekiella palythoae	573501	S	27	28	55	0.00000
Leeuwenhoekiella sp. ZYFB001	2719912	S	16	14	30	0.00000
Aquimarina sp. TRL1	2736252	S	21	1	22	0.00000
Aquimarina sp. AD10	1714849	S	20	1	21	0.00000
Aquimarina sp. BL5	1714860	S	18	1	19	0.00000
Flagellimonas sp. CMM7	2654676	S	40	3	43	0.00000
Flagellimonas sp. HMM57	2905121	S	26	2	28	0.00000
Algibacter sp. L3A6	2686366	S	24	10	34	0.00000
Algibacter sp. L1A34	2686365	S	14	6	20	0.00000
Algibacter alginicilyticus	1736674	S	20	5	25	0.00000
Psychroflexus sp. ALD_RP9	2777186	S	34	3	37	0.00000
Psychroflexus torquis	57029	S	27	1	28	0.00000
Zhouia spongiae	2202721	S	54	12	66	0.00000
Euzebyella marina	1761453	S	53	27	80	0.00001
Constantimarinum furrinae	2562285	S	52	4	56	0.00000
Gilvibacter sp. SZ-19	754429	S	49	6	55	0.00000
Pukyongia salina	2094025	S	48	3	51	0.00000
Lacinutrix sp. 5H-3-7-4	983544	S	14	6	20	0.00000
Lacinutrix sp. Bg11-31	2057808	S	14	3	17	0.00000
Lacinutrix sp. WUR7	2653681	S	11	2	13	0.00000
Muriicola soli	2507538	S	46	3	49	0.00000
Arenibacter algicola	616991	S	46	14	60	0.00000
Galbibacter sp. BG1	1170699	S	45	5	50	0.00000
Lutibacter sp. A80	2918453	S	11	6	17	0.00000
Lutibacter profundi	1622118	S	17	3	20	0.00000
Changchengzhania lutea	2049305	S	42	5	47	0.00000
Mariniflexile sp. TRM1-10	2027857	S	41	3	44	0.00000
Tamlana carrageenivorans	2069432	S	18	6	24	0.00000
Tamlana sp. s12	1630406	S	16	6	22	0.00000
Costertonia aggregata	343403	S	38	8	46	0.00000
Seonamhaeicola sp. S2-3	1936081	S	19	4	23	0.00000
Seonamhaeicola sp. ML3	2937786	S	17	2	19	0.00000
Amniculibacterium sp. G2-70	2767188	S	33	40	73	0.00000
Aegicerativicinus sediminis	2893202	S	32	2	34	0.00000
Flavobacteriaceae bacterium 10Alg115	2584122	S	32	2	34	0.00000
Wenyingzhuangia fucanilytica	1790137	S	31	5	36	0.00000
Gillisia sp. Hel1_33_143	1336796	S	30	9	39	0.00000
Mesoflavibacter sp. SCSIO 43206	2779362	S	14	19	33	0.00000
Marixanthomonas sp. SCSIO 43207	2779360	S	27	7	34	0.00000
Croceibacter atlanticus	313588	S	26	4	30	0.00000
Sediminicola sp. YIK13	1453352	S	26	2	28	0.00000
Flavivirga eckloniae	1803846	S	24	1	25	0.00000
Oceanihabitans sp. IOP_32	2529032	S	21	8	29	0.00000
Siansivirga zeaxanthinifaciens	762954	S	21	4	25	0.00000
Olleya aquimaris	639310	S	10	4	14	0.00000
Bizionia sp. M204	2675331	S	17	3	20	0.00000
Urechidicola croceus	1850246	S	12	6	18	0.00000
Sabulilitoribacter sp. BrNp1-15	2916754	S	11	2	13	0.00000
Chryseobacterium sp. 6424	2039166	S	85	19	104	0.00001
Chryseobacterium sp. SC2-2	2929800	S	72	43	115	0.00001
Chryseobacterium sp. cx-624	2758037	S	72	15	87	0.00001
Chryseobacterium sp.	1871047	S	60	25	85	0.00001
Chryseobacterium sp. F4	2852098	S	57	3	60	0.00000
Chryseobacterium sp. POL2	2713414	S	43	30	73	0.00000
Chryseobacterium sp. Y16C	2920939	S	42	26	68	0.00000
Chryseobacterium sp. G0201	2487065	S	42	10	52	0.00000
Chryseobacterium sp. PCH239	2825845	S	41	26	67	0.00000
Chryseobacterium sp. T16E-39	2015076	S	35	4	39	0.00000
Chryseobacterium sp. LJ668	2864040	S	31	5	36	0.00000
Chryseobacterium sp. ZHDP1	2838877	S	31	22	53	0.00000
Chryseobacterium sp. IHB B 17019	1721091	S	30	5	35	0.00000
Chryseobacterium sp. DH-B6	2759528	S	29	13	42	0.00000
Chryseobacterium sp. MEBOG06	2879938	S	28	6	34	0.00000
Chryseobacterium sp. G0186	2487064	S	27	17	44	0.00000
Chryseobacterium sp. StRB126	878220	S	24	7	31	0.00000
Chryseobacterium sp. ADR-1	2929799	S	23	7	30	0.00000
Chryseobacterium sp. G0162	2487063	S	22	21	43	0.00000
Chryseobacterium sp. MEBOG07	2879939	S	20	5	25	0.00000
Chryseobacterium sp. C-17	2898076	S	19	11	30	0.00000
Chryseobacterium sp. SNU WT5	2594269	S	18	6	24	0.00000
Chryseobacterium sp. 3008163	2478663	S	16	9	25	0.00000
Chryseobacterium gallinarum	1324352	S	145	48	193	0.00001
Chryseobacterium cucumeris	1813611	S	135	57	192	0.00001
Chryseobacterium indologenes	253	S	108	45	153	0.00001
Chryseobacterium taklimakanense	536441	S	102	50	152	0.00001
Chryseobacterium camelliae	1265445	S	75	39	114	0.00001
Chryseobacterium arthrosphaerae	651561	S	71	32	103	0.00001
Chryseobacterium shandongense	1493872	S	59	31	90	0.00001
Chryseobacterium gleum	250	S	47	52	99	0.00001
Chryseobacterium indoltheticum	254	S	47	10	57	0.00000
Chryseobacterium daecheongense	192389	S	45	7	52	0.00000
Chryseobacterium salivictor	2547600	S	44	6	50	0.00000
Chryseobacterium manosquense	2754694	S	34	24	58	0.00000
Chryseobacterium carnipullorum	1124835	S	34	11	45	0.00000
Chryseobacterium lactis	1241981	S	33	30	63	0.00000
Chryseobacterium joostei	112234	S	32	10	42	0.00000
Chryseobacterium nepalense	1854498	S	29	4	33	0.00000
Chryseobacterium aureum	2497456	S	29	6	35	0.00000
Chryseobacterium balustinum	246	S	26	8	34	0.00000
Chryseobacterium nakagawai	1241982	S	20	25	45	0.00000
Chryseobacterium piperi	558152	S	19	2	21	0.00000
Chryseobacterium bernardetii	1241978	S	14	94	108	0.00001
Chryseobacterium glaciei	1685010	S	14	2	16	0.00000
Kaistella sp. 97-N-M2	2908645	S	75	10	85	0.00001
Kaistella sp. GW4-15	2878534	S	29	3	32	0.00000
Kaistella daneshvariae	2487074	S	54	6	60	0.00000
Kaistella antarctica	266748	S	35	4	39	0.00000
Candidatus Kaistella beijingensis	2820270	S	35	12	47	0.00000
Kaistella flava (ex Peng et al. 2021)	2038776	S	31	6	37	0.00000
Kaistella jeonii	266749	S	27	2	29	0.00000
Kaistella carnis	1241979	S	26	9	35	0.00000
Epilithonimonas vandammei	2487072	S	52	80	132	0.00001
Epilithonimonas zeae	1416779	S	19	2	21	0.00000
Elizabethkingia anophelis	1117645	S	247	281	528	0.00003
Elizabethkingia sp. JS20170427COW	2583851	S	18	2	20	0.00000
Elizabethkingia sp. 2-6	2575699	S	12	24	36	0.00000
Elizabethkingia meningoseptica	238	S	23	2	25	0.00000
Elizabethkingia miricola	172045	S	23	15	38	0.00000
Cruoricaptor ignavus	1118202	S	119	14	133	0.00001
Ornithobacterium rhinotracheale	28251	S	73	46	119	0.00001
Empedobacter brevis	247	S	31	13	44	0.00000
Empedobacter falsenii	343874	S	19	15	34	0.00000
Empedobacter stercoris	1628248	S	18	7	25	0.00000
Apibacter raozihei	2500547	S	23	11	34	0.00000
Cloacibacterium caeni	2004710	S	33	34	67	0.00000
Cloacibacterium normanense	237258	S	14	9	23	0.00000
Riemerella anatipestifer	34085	S	49	20	69	0.00000
Bergeyella cardium	1585976	S	39	8	47	0.00000
Faecalibacter bovis	2898187	S	21	3	24	0.00000
Weeksella virosa	1014	S	18	6	24	0.00000
Blattabacterium cuenoti	1653831	S	139	50	189	0.00001
Fluviicola taffensis	191579	S	86	5	91	0.00001
Crocinitomix sp. GM2_3_6_6	2862509	S	62	2	64	0.00000
Croceimicrobium hydrocarbonivorans	2761580	S	67	13	80	0.00001
Owenweeksia hongkongensis	253245	S	58	6	64	0.00000
Candidatus Sulcia muelleri	336810	S	45	14	59	0.00000
Candidatus Walczuchella monophlebidarum	1415657	S	12	2	14	0.00000
Ichthyobacterium seriolicida	242600	S	12	0	12	0.00000
Mucilaginibacter sp. 14171R-50	2703789	S	161	6	167	0.00001
Mucilaginibacter sp. SMC90	2929803	S	154	7	161	0.00001
Mucilaginibacter sp. 21P	2778902	S	118	5	123	0.00001
Mucilaginibacter sp. F39-2	2728022	S	94	5	99	0.00001
Mucilaginibacter mali	2740462	S	325	9	334	0.00002
Mucilaginibacter ginsenosidivorans	398053	S	292	8	300	0.00002
Mucilaginibacter daejeonensis	398049	S	275	14	289	0.00002
Mucilaginibacter gotjawali	1550579	S	222	5	227	0.00001
Mucilaginibacter paludis	423351	S	209	8	217	0.00001
Mucilaginibacter celer	2305508	S	194	6	200	0.00001
Mucilaginibacter ginsenosidivorax	862126	S	178	6	184	0.00001
Mucilaginibacter xinganensis	1234841	S	150	5	155	0.00001
Mucilaginibacter ginkgonis	2682091	S	138	5	143	0.00001
Mucilaginibacter rubeus	2027860	S	130	330	460	0.00003
Mucilaginibacter mallensis	652787	S	126	3	129	0.00001
Mucilaginibacter gossypii	551996	S	88	68	156	0.00001
Sphingobacterium thalpophilum	259	S	1861	1559	3420	0.00022
Sphingobacterium sp. DR205	2713573	S	147	12	159	0.00001
Sphingobacterium sp. CZ-2	2557994	S	81	15	96	0.00001
Sphingobacterium sp. dk4302	2662364	S	41	3	44	0.00000
Sphingobacterium sp. UDSM-2020	2795738	S	31	7	38	0.00000
Sphingobacterium sp. PCS056	2931400	S	31	4	35	0.00000
Sphingobacterium sp. ML3W	1538644	S	30	7	37	0.00000
Sphingobacterium sp. SRCM116780	2907623	S	29	3	32	0.00000
Sphingobacterium sp. G1-14	2003121	S	14	44	58	0.00000
Sphingobacterium spiritivorum	258	S	153	80	233	0.00001
Sphingobacterium lactis	797291	S	109	70	179	0.00001
Sphingobacterium daejeonense	371142	S	95	20	115	0.00001
Sphingobacterium mizutaii	1010	S	90	10	100	0.00001
Sphingobacterium hotanense	649196	S	63	16	79	0.00000
Sphingobacterium psychroaquaticum	561061	S	60	9	69	0.00000
Sphingobacterium multivorum	28454	S	57	90	147	0.00001
Sphingobacterium paramultivorum	2886510	S	20	14	34	0.00000
Sphingobacterium siyangense	459529	S	11	33	44	0.00000
Pedobacter sp. KBS0701	2578106	S	92	25	117	0.00001
Pedobacter sp. HDW13	2714940	S	90	11	101	0.00001
Pedobacter sp. PACM 27299	1727164	S	84	12	96	0.00001
Pedobacter sp. SW-16	2766984	S	65	11	76	0.00000
Pedobacter sp. G11	2482728	S	63	8	71	0.00000
Pedobacter sp. Q8-18	2895286	S	50	3	53	0.00000
Pedobacter sp. D749	2856523	S	49	13	62	0.00000
Pedobacter endophyticus	2789740	S	117	11	128	0.00001
Pedobacter heparinus	984	S	116	10	126	0.00001
Pedobacter schmidteae	2201271	S	97	8	105	0.00001
Pedobacter steynii	430522	S	88	8	96	0.00001
Pedobacter roseus	336820	S	83	27	110	0.00001
Pedobacter suwonensis	332999	S	73	16	89	0.00001
Pedobacter cryoconitis	188932	S	49	4	53	0.00000
Pedobacter aquae	2605747	S	43	3	46	0.00000
Pedobacter ginsengisoli	363852	S	41	5	46	0.00000
Olivibacter sp. LS-1	2592345	S	623	33	656	0.00004
Olivibacter sp. SDN3	2764720	S	64	7	71	0.00000
Anseongella ginsenosidimutans	496056	S	344	12	356	0.00002
Solitalea canadensis	995	S	78	6	84	0.00001
Solitalea sp. S2-8	2911172	S	74	8	82	0.00001
Pseudopedobacter saltans	151895	S	70	43	113	0.00001
Haliscomenobacter hydrossis	2350	S	458	7	465	0.00003
Saprospira grandis	1008	S	70	2	72	0.00000
Candidatus Sulfidibacterium hydrothermale	2875962	S	109	3	112	0.00001
Chlorobaculum limnaeum	274537	S	1230	208	1438	0.00009
Chlorobaculum tepidum	1097	S	714	207	921	0.00006
Chlorobaculum parvum	274539	S	677	135	812	0.00005
Pelodictyon luteolum	1100	S	636	101	737	0.00005
Pelodictyon phaeoclathratiforme	34090	S	139	8	147	0.00001
Chlorobium limicola	1092	S	314	24	338	0.00002
Chlorobium phaeovibrioides	1094	S	170	34	204	0.00001
Chlorobium phaeobacteroides	1096	S	137	17	154	0.00001
Prosthecochloris sp. GSB1	281093	S	564	42	606	0.00004
Prosthecochloris sp. CIB 2401	1868325	S	187	53	240	0.00002
Prosthecochloris sp. HL-130-GSB	1974213	S	141	29	170	0.00001
Prosthecochloris aestuarii	1102	S	167	16	183	0.00001
Chloroherpeton thalassium	100716	S	266	5	271	0.00002
Candidatus Cyclonatronum proteinivorum	1457365	S	415	48	463	0.00003
Melioribacter roseus	1134405	S	202	20	222	0.00001
Ignavibacterium album	591197	S	89	11	100	0.00001
Gemmatirosa kalamazoonesis	861299	S	76439	8275	84714	0.00535
Gemmatimonas groenlandica	2732249	S	11767	1496	13263	0.00084
Gemmatimonas aurantiaca	173480	S	8927	1015	9942	0.00063
Gemmatimonas phototrophica	1379270	S	7197	1109	8306	0.00052
Fibrobacter succinogenes	833	S	267	5	272	0.00002
Candidatus Cloacimonas acidaminovorans	456827	S	140	4	144	0.00001
Luteitalea sp. TBR-22	2802971	S	56571	11515	68086	0.00430
Luteitalea pratensis	1855912	S	47928	6344	54272	0.00343
Granulicella sp. WH15	2602070	S	4096	833	4929	0.00031
Granulicella sp. 5B5	1617967	S	3250	594	3844	0.00024
Granulicella mallensis	940614	S	2712	366	3078	0.00019
Granulicella tundricola	940615	S	2155	320	2475	0.00016
Terriglobus roseus	392734	S	3675	898	4573	0.00029
Terriglobus albidus	1592106	S	2865	310	3175	0.00020
Terriglobus saanensis	870903	S	1826	274	2100	0.00013
Acidobacterium capsulatum	33075	S	3679	520	4199	0.00027
Acidobacterium sp. 4Y35	2763107	S	3188	256	3444	0.00022
Candidatus Koribacter versatilis	658062	S	5651	216	5867	0.00037
Edaphobacter sp. 12200R-103	2703788	S	2296	450	2746	0.00017
Edaphobacter sp. 4G125	2763071	S	1341	224	1565	0.00010
Acidisarcina polymorpha	2211140	S	2417	199	2616	0.00017
Paludibaculum fermentans	1473598	S	10814	352	11166	0.00071
Chloracidobacterium aggregatum	2851959	S	1723	1426	3149	0.00020
Chloracidobacterium validum	2821543	S	1453	30	1483	0.00009
Chloracidobacterium sp. D	2821536	S	136	577	713	0.00005
Chloracidobacterium thermophilum	458033	S	102	399	501	0.00003
Sulfidibacter corallicola	2818388	S	3342	81	3423	0.00022
Thermotomaculum hydrothermale	981385	S	129	7	136	0.00001
Nitrospira moscoviensis	42253	S	7787	669	8456	0.00053
Nitrospira japonica	1325564	S	4590	531	5121	0.00032
Nitrospira sp. KM1	1936990	S	3298	297	3595	0.00023
Candidatus Nitrospira inopinata	1715989	S	2959	250	3209	0.00020
Leptospirillum ferrooxidans	180	S	179	4	183	0.00001
Leptospirillum ferriphilum	178606	S	97	179	276	0.00002
Leptospirillum sp. Group II 'CF-1'	1660083	S	50	110	160	0.00001
Thermodesulfovibrio yellowstonii	28262	S	187	5	192	0.00001
Dissulfurispira thermophila	2715679	S	143	7	150	0.00001
Treponema brennaborense	81028	S	228	80	308	0.00002
Treponema azotonutricium	150829	S	177	5	182	0.00001
Treponema primitia	88058	S	169	6	175	0.00001
Treponema socranskii	53419	S	132	6	138	0.00001
Treponema sp. Marseille-Q4132	2766701	S	91	3	94	0.00001
Treponema sp. OMZ 838	1539298	S	31	6	37	0.00000
Treponema caldarium	215591	S	119	11	130	0.00001
Treponema parvum	138851	S	79	2	81	0.00001
Treponema vincentii	69710	S	61	6	67	0.00000
Treponema succinifaciens	167	S	47	36	83	0.00001
Treponema denticola	158	S	37	2	39	0.00000
Treponema peruense	2787628	S	36	3	39	0.00000
Treponema phagedenis	162	S	35	13	48	0.00000
Treponema medium	58231	S	33	3	36	0.00000
Treponema pedis	409322	S	28	3	31	0.00000
Treponema pallidum	160	S	10	290	300	0.00002
Spirochaeta thermophila	154	S	886	21	907	0.00006
Spirochaeta africana	46355	S	337	13	350	0.00002
Salinispira pacifica	1307761	S	130	3	133	0.00001
Sediminispirochaeta smaragdinae	55206	S	111	2	113	0.00001
Oceanispirochaeta crateris	2518645	S	36	1	37	0.00000
Thiospirochaeta perfilievii	252967	S	16	1	17	0.00000
Sphaerochaeta associata	1129264	S	140	14	154	0.00001
Sphaerochaeta coccoides	273376	S	115	4	119	0.00001
Sphaerochaeta globosa	1131703	S	77	8	85	0.00001
Sphaerochaeta pleomorpha	1131707	S	51	7	58	0.00000
Breznakiella homolactica	2798577	S	241	15	256	0.00002
Borrelia sp. HM	1882662	S	12	83	95	0.00001
Leptospira santarosai	28183	S	141	1	142	0.00001
Leptospira kmetyi	408139	S	117	1	118	0.00001
Leptospira tipperaryensis	2564040	S	63	0	63	0.00000
Leptospira mayottensis	1137606	S	55	0	55	0.00000
Leptospira weilii	28184	S	54	0	54	0.00000
Leptospira kobayashii	1917830	S	39	0	39	0.00000
Leptospira noguchii	28182	S	30	0	30	0.00000
Leptospira borgpetersenii	174	S	29	0	29	0.00000
Leptospira interrogans	173	S	27	233	260	0.00002
Leptospira biflexa	172	S	23	0	23	0.00000
Turneriella parva	29510	S	473	4	477	0.00003
Brachyspira pilosicoli	52584	S	15	60	75	0.00000
Pyramidobacter piscolens	638849	S	950	66	1016	0.00006
Fretibacterium fastidiosum	651822	S	895	14	909	0.00006
Aminomonas paucivorans	81412	S	808	103	911	0.00006
Thermanaerovibrio acidaminovorans	81462	S	405	164	569	0.00004
Thermanaerovibrio velox	108007	S	242	65	307	0.00002
Cloacibacillus porcorum	1197717	S	593	133	726	0.00005
Jonquetella anthropi	428712	S	432	73	505	0.00003
Acetomicrobium mobile	97477	S	137	4	141	0.00001
Aminobacterium colombiense	81468	S	80	5	85	0.00001
Thermovirga lienii	336261	S	63	57	120	0.00001
Candidatus Bipolaricaulis anaerobius	2026885	S	880	41	921	0.00006
Candidatus Nanosynbacter featherlites	2572088	S	53	19	72	0.00000
Candidatus Nanosynbacter lyticus	2093824	S	34	54	88	0.00001
Nanosynbacter sp. HMT-352	2899133	S	22	38	60	0.00000
Candidatus Nanosynbacter sp. HMT352	2902423	S	11	25	36	0.00000
Candidatus Saccharimonas aalborgensis	1332188	S	106	1	107	0.00001
Candidatus Minimicrobia vallesae	2841264	S	16	64	80	0.00001
Candidatus Babela massiliensis	673862	S	109	2	111	0.00001
Candidatus Chazhemtobacterium aquaticus	2715735	S	69	0	69	0.00000
Candidatus Absconditicoccus praedator	2735562	S	46	0	46	0.00000
Thermotoga caldifontis	1508419	S	138	47	185	0.00001
Thermotoga sp. 2812B	1157948	S	16	200	216	0.00001
Thermotoga profunda	1508420	S	22	6	28	0.00000
Pseudothermotoga hypogea	57487	S	79	41	120	0.00001
Pseudothermotoga thermarum	119394	S	22	6	28	0.00000
Fervidobacterium nodosum	2424	S	31	35	66	0.00000
Fervidobacterium pennivorans	93466	S	25	57	82	0.00001
Thermosipho ferrireducens	2571116	S	30	31	61	0.00000
Kosmotoga pacifica	1330330	S	47	66	113	0.00001
Kosmotoga olearia	651457	S	39	52	91	0.00001
Mesotoga infera	1236046	S	72	16	88	0.00001
Mesotoga prima	1184387	S	43	10	53	0.00000
Defluviitoga tunisiensis	1006576	S	20	38	58	0.00000
Petrotoga mobilis	69499	S	19	25	44	0.00000
Tepiditoga spiralis	2108365	S	17	5	22	0.00000
Athalassotoga saccharophila	1441386	S	87	4	91	0.00001
Thermocrinis minervae	381751	S	75	10	85	0.00001
Thermocrinis albus	136094	S	34	4	38	0.00000
Thermocrinis ruber	75906	S	28	3	31	0.00000
Hydrogenobacter sp. T-8	1632019	S	53	22	75	0.00000
Hydrogenobacter thermophilus	940	S	26	13	39	0.00000
Aquifex aeolicus	63363	S	68	4	72	0.00000
Sulfurihydrogenibium azorense	309806	S	119	22	141	0.00001
Persephonella marina	309805	S	84	11	95	0.00001
Thermosulfidibacter takaii	412593	S	119	5	124	0.00001
Thermovibrio ammonificans	228745	S	153	33	186	0.00001
Desulfurobacterium thermolithotrophum	64160	S	56	9	65	0.00000
Thermosulfurimonas marina	2047767	S	296	37	333	0.00002
Thermosulfuriphilus ammonigenes	1936021	S	191	8	199	0.00001
Thermodesulfatator indicus	171695	S	92	12	104	0.00001
Thermodesulfobacterium commune	1741	S	21	9	30	0.00000
Thermodesulfobacterium geofontis	1295609	S	19	7	26	0.00000
Thermodesulfobacterium sp. TA1	2234087	S	14	5	19	0.00000
Caldimicrobium thiodismutans	1653476	S	44	7	51	0.00000
Caldithrix abyssi	187145	S	597	6	603	0.00004
Geovibrio thiophilus	139438	S	130	16	146	0.00001
Flexistipes sinusarabici	2352	S	83	6	89	0.00001
Calditerrivibrio nitroreducens	477976	S	68	7	75	0.00000
Mucispirillum schaedleri	248039	S	56	5	61	0.00000
Denitrovibrio acetiphilus	118000	S	49	4	53	0.00000
Deferribacter desulfuricans	197162	S	43	5	48	0.00000
Desulfurispirillum indicum	936456	S	448	233	681	0.00004
Fusobacterium gonidiaformans	849	S	33	15	48	0.00000
Fusobacterium sp. NSJ-57	2764326	S	22	36	58	0.00000
Fusobacterium nucleatum	851	S	20	37	57	0.00000
Fusobacterium canifelinum	285729	S	15	19	34	0.00000
Fusobacterium ulcerans	861	S	11	2	13	0.00000
Ilyobacter polytropus	167642	S	12	1	13	0.00000
Leptotrichia sp. oral taxon 212	712357	S	11	6	17	0.00000
Leptotrichia shahii	157691	S	14	14	28	0.00000
Leptotrichia wadei	157687	S	12	8	20	0.00000
Leptotrichia buccalis	40542	S	10	7	17	0.00000
Leptotrichia hofstadii	157688	S	10	7	17	0.00000
Pseudoleptotrichia goodfellowii	157692	S	21	3	24	0.00000
Sebaldella termitidis	826	S	16	0	16	0.00000
Streptobacillus moniliformis	34105	S	10	6	16	0.00000
Elusimicrobium minutum	423605	S	164	2	166	0.00001
Endomicrobium proavitum	1408281	S	77	25	102	0.00001
Candidatus Endomicrobium trichonymphae	1408204	S	48	15	63	0.00000
Dictyoglomus thermophilum	14	S	17	141	158	0.00001
Caldisericum exile	693075	S	146	0	146	0.00001
Coprothermobacter proteolyticus	35786	S	144	33	177	0.00001
Atribacter laminatus	2847778	S	93	2	95	0.00001
Fusarium acuminatum	5515	S	4573	256	4829	0.00031
Fusarium avenaceum	40199	S	128	5	133	0.00001
Fusarium sambucinum	5128	S	3830	536	4366	0.00028
Fusarium poae	36050	S	163	38	201	0.00001
Fusarium longipes	694270	S	158	5	163	0.00001
Fusarium pseudograminearum	101028	S	115	10	125	0.00001
Fusarium sporotrichioides	5514	S	104	4	108	0.00001
Fusarium venenatum	56646	S	69	99	168	0.00001
Fusarium culmorum	5516	S	56	9	65	0.00000
Fusarium graminearum	5518	S	41	99	140	0.00001
Fusarium oxysporum	5507	S	756	279	1035	0.00007
Fusarium nygamai	42673	S	145	45	190	0.00001
Fusarium fujikuroi	5127	S	113	11	124	0.00001
Fusarium thapsinum	120644	S	82	18	100	0.00001
Fusarium pseudonygamai	47755	S	80	19	99	0.00001
Fusarium verticillioides	117187	S	34	53	87	0.00001
Fusarium decemcellulare	57161	S	396	8	404	0.00003
Fusarium heterosporum	42747	S	143	22	165	0.00001
Fusarium graminum	86546	S	140	22	162	0.00001
Fusarium equiseti	61235	S	104	33	137	0.00001
Fusarium scirpi	2211609	S	99	29	128	0.00001
Fusarium lateritium	5523	S	231	6	237	0.00002
Fusarium nelsonii	77846	S	101	22	123	0.00001
Fusarium chlamydosporum	86545	S	77	16	93	0.00001
Fusarium dimerum	57145	S	201	5	206	0.00001
Fusarium musae	1042133	S	35	52	87	0.00001
Beauveria pseudobassiana	931006	S	923	138	1061	0.00007
Beauveria felina	37994	S	787	40	827	0.00005
Beauveria brongniartii	118266	S	296	75	371	0.00002
Beauveria rudraprayagi	1481906	S	191	242	433	0.00003
Beauveria bassiana	176275	S	123	164	287	0.00002
Cordyceps fumosorosea	114497	S	1042	65	1107	0.00007
Trichoderma erinaceum	202914	S	481	75	556	0.00004
Trichoderma reesei	51453	S	387	35	422	0.00003
Trichoderma citrinoviride	58853	S	335	38	373	0.00002
Trichoderma pleuroti	500994	S	265	28	293	0.00002
Trichoderma atroviride	63577	S	221	53	274	0.00002
Trichoderma afroharzianum	1567482	S	184	41	225	0.00001
Trichoderma asperellum	101201	S	177	13	190	0.00001
Trichoderma hamatum	49224	S	154	12	166	0.00001
Trichoderma gamsii	398673	S	150	21	171	0.00001
Trichoderma koningiopsis	337941	S	118	18	136	0.00001
Trichoderma harzianum	5544	S	105	23	128	0.00001
Trichoderma longibrachiatum	5548	S	29	320	349	0.00002
Trichoderma virens	29875	S	27	303	330	0.00002
Trichoderma koningii	97093	S	21	223	244	0.00002
Trichoderma viride	5547	S	13	192	205	0.00001
Metarhizium album	92629	S	577	18	595	0.00004
Metarhizium guizhouense	169041	S	340	184	524	0.00003
Metarhizium rileyi	1649241	S	324	55	379	0.00002
Metarhizium acridum	92637	S	216	137	353	0.00002
Metarhizium majus	1650735	S	154	70	224	0.00001
Metarhizium brunneum	500148	S	139	117	256	0.00002
Metarhizium anisopliae	5530	S	115	166	281	0.00002
Metarhizium humberi	2596975	S	106	65	171	0.00001
Metarhizium robertsii	568076	S	81	58	139	0.00001
Ustilaginoidea virens	1159556	S	964	47	1011	0.00006
Pochonia chlamydosporia	280754	S	204	12	216	0.00001
Purpureocillium lilacinum	33203	S	1227	80	1307	0.00008
Drechmeria coniospora	98403	S	943	41	984	0.00006
Clonostachys rosea	29856	S	387	27	414	0.00003
Colletotrichum higginsianum	80884	S	1315	263	1578	0.00010
Thermothielavioides terrestris	2587410	S	1668	117	1785	0.00011
Thermothelomyces thermophilus	78579	S	1397	72	1469	0.00009
Neurospora crassa	5141	S	497	24	521	0.00003
Pyricularia pennisetigena	1578925	S	463	69	532	0.00003
Pyricularia oryzae	318829	S	437	111	548	0.00003
Pyricularia grisea	148305	S	291	42	333	0.00002
Neopestalotiopsis rosae	1562205	S	211	165	376	0.00002
Neopestalotiopsis clavispora	289240	S	181	154	335	0.00002
Botrytis cinerea	40559	S	330	2	332	0.00002
Aspergillus chevalieri	182096	S	848	89	937	0.00006
Aspergillus luchuensis	1069201	S	790	62	852	0.00005
Aspergillus fumigatus	746128	S	308	18	326	0.00002
Aspergillus oryzae	5062	S	48	139	187	0.00001
Aspergillus flavus	5059	S	15	47	62	0.00000
Aspergillus puulaauensis	1220207	S	228	9	237	0.00002
Penicillium chrysogenum	5076	S	174	26	200	0.00001
Penicillium citrinum	5077	S	141	19	160	0.00001
Penicillium aurantiogriseum	36655	S	138	37	175	0.00001
Penicillium expansum	27334	S	129	38	167	0.00001
Penicillium italicum	40296	S	110	30	140	0.00001
Penicillium digitatum	36651	S	81	12	93	0.00001
Paecilomyces variotii	264951	S	177	17	194	0.00001
Paecilomyces niveus	5093	S	157	6	163	0.00001
Talaromyces rugulosus	121627	S	246	16	262	0.00002
Paraphaeosphaeria minitans	565426	S	547	192	739	0.00005
Ampelomyces quisqualis	50730	S	404	45	449	0.00003
Zymoseptoria tritici	1047171	S	313	5	318	0.00002
Cercospora beticola	122368	S	202	0	202	0.00001
Eremothecium gossypii	33169	S	188	130	318	0.00002
Eremothecium cymbalariae	45285	S	28	1	29	0.00000
Eremothecium sinecaudum	45286	S	14	7	21	0.00000
Lachancea thermotolerans	381046	S	95	5	100	0.00001
Kazachstania naganishii	588726	S	71	2	73	0.00000
Kazachstania africana	432096	S	17	0	17	0.00000
Kluyveromyces marxianus	4911	S	58	9	67	0.00000
Kluyveromyces lactis	28985	S	13	1	14	0.00000
Saccharomyces cerevisiae	4932	S	25	4	29	0.00000
Saccharomyces eubayanus	1080349	S	24	1	25	0.00000
Saccharomyces paradoxus	27291	S	18	1	19	0.00000
Naumovozyma dairenensis	27289	S	38	1	39	0.00000
Naumovozyma castellii	27288	S	31	1	32	0.00000
Tetrapisispora blattae	1071379	S	44	1	45	0.00000
Tetrapisispora phaffii	113608	S	23	0	23	0.00000
[Candida] glabrata	5478	S	56	2	58	0.00000
Torulaspora globosa	48254	S	41	2	43	0.00000
Torulaspora delbrueckii	4950	S	14	1	15	0.00000
Zygotorulaspora mrakii	42260	S	30	3	33	0.00000
Zygosaccharomyces rouxii	4956	S	29	1	30	0.00000
Ogataea parapolymorpha	1005962	S	75	1	76	0.00000
Brettanomyces bruxellensis	5007	S	37	1	38	0.00000
Brettanomyces nanus	13502	S	35	3	38	0.00000
Pichia kudriavzevii	4909	S	32	0	32	0.00000
Candida dubliniensis	42374	S	55	4	59	0.00000
Candida albicans	5476	S	28	2	30	0.00000
Candida orthopsilosis	273371	S	28	0	28	0.00000
Scheffersomyces stipitis	4924	S	40	1	41	0.00000
Debaryomyces hansenii	4959	S	15	0	15	0.00000
Yarrowia lipolytica	4952	S	167	1	168	0.00001
Sugiyamaella lignohabitans	796027	S	60	5	65	0.00000
Saccharomycodes ludwigii	36035	S	26	3	29	0.00000
Komagataella phaffii	460519	S	15	0	15	0.00000
Schizosaccharomyces pombe	4896	S	54	1	55	0.00000
Pseudozyma flocculosa	84751	S	1905	19	1924	0.00012
Ustilago maydis	5270	S	553	20	573	0.00004
Sporisorium graminicola	280036	S	398	70	468	0.00003
Malassezia restricta	76775	S	161	30	191	0.00001
Phlebiopsis gigantea	82310	S	633	25	658	0.00004
Rhizoctonia solani	456999	S	132	14	146	0.00001
Marasmius oreades	181124	S	457	41	498	0.00003
Cryptococcus neoformans	5207	S	116	4	120	0.00001
Cryptococcus gattii VGI	37769	S	57	54	111	0.00001
Phytophthora cryptogea	4786	S	2823	186	3009	0.00019
Phytophthora cinnamomi	4785	S	1322	177	1499	0.00009
Phytophthora fragariae	53985	S	871	98	969	0.00006
Phytophthora infestans	4787	S	409	471	880	0.00006
Phytophthora cactorum	29920	S	354	42	396	0.00003
Phytophthora boehmeriae	109152	S	331	28	359	0.00002
Phytophthora parasitica	4792	S	235	24	259	0.00002
Pythium aphanidermatum	65070	S	489	5	494	0.00003
