name	taxonomy_id	taxonomy_lvl	kraken_assigned_reads	added_reads	new_est_reads	fraction_total_reads
Bradyrhizobium sp. 200	2782665	S	55481	9318	64799	0.00463
Bradyrhizobium sp. CCGE-LA001	1223566	S	41703	11199	52902	0.00378
Bradyrhizobium sp. 170	2782641	S	40883	7814	48697	0.00348
Bradyrhizobium sp. CCBAU 051011	858422	S	27266	3666	30932	0.00221
Bradyrhizobium sp. CCBAU 53351	1325114	S	14236	5147	19383	0.00138
Bradyrhizobium sp. CCBAU 51753	1325100	S	13542	2043	15585	0.00111
Bradyrhizobium sp. 195	2782662	S	12733	3355	16088	0.00115
Bradyrhizobium sp. 1(2017)	1404888	S	10828	2429	13257	0.00095
Bradyrhizobium sp. CCBAU 51765	1325102	S	8759	6350	15109	0.00108
Bradyrhizobium sp. SK17	2057741	S	8706	2061	10767	0.00077
Bradyrhizobium sp. 191	2782659	S	8634	6788	15422	0.00110
Bradyrhizobium sp. 186	2782654	S	8387	1675	10062	0.00072
Bradyrhizobium sp. A19	2898149	S	8257	992	9249	0.00066
Bradyrhizobium sp. BTAi1	288000	S	7967	1007	8974	0.00064
Bradyrhizobium sp. ORS 285	115808	S	7871	1248	9119	0.00065
Bradyrhizobium sp. ORS 278	114615	S	7662	1225	8887	0.00063
Bradyrhizobium sp. I71	2590772	S	7538	5296	12834	0.00092
Bradyrhizobium sp. CCBAU 53340	1325112	S	6764	1868	8632	0.00062
Bradyrhizobium sp. CCBAU 53338	1325111	S	6730	1958	8688	0.00062
Bradyrhizobium sp. CCBAU 53421	1325120	S	6723	1512	8235	0.00059
Bradyrhizobium sp. S2-11-2	2840472	S	5191	3204	8395	0.00060
Bradyrhizobium sp. 6(2017)	1197460	S	5072	1779	6851	0.00049
Bradyrhizobium sp. S2-11-4	2840473	S	4388	3207	7595	0.00054
Bradyrhizobium sp. S2-20-1	2840469	S	4296	2846	7142	0.00051
Bradyrhizobium sp. 41S5	1404443	S	3918	1923	5841	0.00042
Bradyrhizobium sp. C-145	574727	S	2948	2112	5060	0.00036
Bradyrhizobium sp.	376	S	2087	5007	7094	0.00051
Bradyrhizobium sp. 40	2782674	S	1871	3460	5331	0.00038
Bradyrhizobium sp. 4	2782678	S	1585	3301	4886	0.00035
Bradyrhizobium sp. 192	2782660	S	1507	2700	4207	0.00030
Bradyrhizobium sp. 323S2	1404649	S	1478	2775	4253	0.00030
Bradyrhizobium sp. 144S4	2823807	S	1444	2667	4111	0.00029
Bradyrhizobium sp. LCT2	2493093	S	874	1757	2631	0.00019
Bradyrhizobium sp. TM102	2599819	S	766	3918	4684	0.00033
Bradyrhizobium sp. SG09	2599805	S	761	4051	4812	0.00034
Bradyrhizobium sp. 187	2782655	S	516	1952	2468	0.00018
Bradyrhizobium sp. 38S5	2819348	S	222	2114	2336	0.00017
Bradyrhizobium sp. 131	2782609	S	210	2677	2887	0.00021
Bradyrhizobium sp. CW1	2782686	S	203	2458	2661	0.00019
Bradyrhizobium sp. 1S5	2816456	S	196	1720	1916	0.00014
Bradyrhizobium sp. 172	2782643	S	192	1820	2012	0.00014
Bradyrhizobium sp. 155	2782629	S	146	2048	2194	0.00016
Bradyrhizobium sp. CCBAU 21365	1325083	S	20	701	721	0.00005
Bradyrhizobium diazoefficiens	1355477	S	27638	33844	61482	0.00439
Bradyrhizobium erythrophlei	1437360	S	27427	1484	28911	0.00207
Bradyrhizobium paxllaeri	190148	S	22871	2892	25763	0.00184
Bradyrhizobium icense	1274631	S	21243	1970	23213	0.00166
Bradyrhizobium vignae	1549949	S	9772	1573	11345	0.00081
Bradyrhizobium lablabi	722472	S	9578	7880	17458	0.00125
Bradyrhizobium japonicum	375	S	9127	9882	19009	0.00136
Bradyrhizobium daqingense	993502	S	9112	3449	12561	0.00090
Bradyrhizobium canariense	255045	S	8834	10006	18840	0.00135
Bradyrhizobium guangxiense	1325115	S	8657	2642	11299	0.00081
Bradyrhizobium genosp. L	83637	S	8413	1143	9556	0.00068
Bradyrhizobium arachidis	858423	S	8304	1648	9952	0.00071
Bradyrhizobium oligotrophicum	44255	S	6453	751	7204	0.00051
Bradyrhizobium cosmicum	1404864	S	6311	1424	7735	0.00055
Bradyrhizobium guangdongense	1325090	S	6307	1647	7954	0.00057
Bradyrhizobium genosp. B	83627	S	5580	812	6392	0.00046
Bradyrhizobium guangzhouense	1325095	S	5411	1442	6853	0.00049
Bradyrhizobium amphicarpaeae	1404768	S	5188	1501	6689	0.00048
Bradyrhizobium symbiodeficiens	1404367	S	5047	5408	10455	0.00075
Bradyrhizobium quebecense	2748629	S	4979	1973	6952	0.00050
Bradyrhizobium septentrionale	1404411	S	4047	1726	5773	0.00041
Bradyrhizobium betae	244734	S	3878	1459	5337	0.00038
Bradyrhizobium zhanjiangense	1325107	S	2211	1578	3789	0.00027
Bradyrhizobium elkanii	29448	S	1441	3659	5100	0.00036
Bradyrhizobium ottawaense	931866	S	1341	5975	7316	0.00052
Rhodopseudomonas palustris	1076	S	22406	5300	27706	0.00198
Rhodopseudomonas sp. SK50-23	340268	S	3835	633	4468	0.00032
Rhodopseudomonas boonkerdii	475937	S	3388	692	4080	0.00029
Nitrobacter hamburgensis	912	S	6988	859	7847	0.00056
Nitrobacter winogradskyi	913	S	6839	865	7704	0.00055
Tardiphaga sp. 37S4	1404741	S	1962	1356	3318	0.00024
Tardiphaga sp. vice154	2592814	S	118	2065	2183	0.00016
Tardiphaga sp. vice278	2592815	S	61	1684	1745	0.00012
Tardiphaga sp. vice304	2592817	S	41	882	923	0.00007
Tardiphaga sp. vice352	2592816	S	14	481	495	0.00004
Tardiphaga robiniae	943830	S	1914	1185	3099	0.00022
Afipia carboxidovorans	40137	S	5179	233	5412	0.00039
Afipia sp. GAS231	1882747	S	4122	1990	6112	0.00044
Variibacter gotjawalensis	1333996	S	6807	344	7151	0.00051
Rhizobium sp. BG4	2613770	S	22334	2719	25053	0.00179
Rhizobium sp. WYJ-E13	2849093	S	20086	1642	21728	0.00155
Rhizobium sp. NXC24	2048897	S	2263	213	2476	0.00018
Rhizobium sp. WL3	2603277	S	2160	270	2430	0.00017
Rhizobium sp. SL42	2806346	S	1973	225	2198	0.00016
Rhizobium sp. ACO-34A	1571470	S	1913	265	2178	0.00016
Rhizobium sp. 11515TR	2028343	S	1734	310	2044	0.00015
Rhizobium sp. NZLR1	2731096	S	1647	399	2046	0.00015
Rhizobium sp. AB2/73	2795216	S	1644	663	2307	0.00016
Rhizobium sp. CIAT894	2020312	S	1630	507	2137	0.00015
Rhizobium sp. NXC14	1981173	S	1444	436	1880	0.00013
Rhizobium sp. NLR16a	2731112	S	1290	424	1714	0.00012
Rhizobium sp. C104	2917727	S	1253	498	1751	0.00013
Rhizobium sp. K102	2918527	S	1167	580	1747	0.00012
Rhizobium sp. L51/94	2819999	S	763	841	1604	0.00011
Rhizobium sp. Y9	1914541	S	626	1831	2457	0.00018
Rhizobium sp. X9	2815360	S	527	743	1270	0.00009
Rhizobium sp. Kim5	2020311	S	414	713	1127	0.00008
Rhizobium sp. IE4771	1301032	S	405	641	1046	0.00007
Rhizobium sp. 007	2785056	S	405	524	929	0.00007
Rhizobium sp. TAL182	2020313	S	312	694	1006	0.00007
Rhizobium sp. ZX09	2291939	S	263	836	1099	0.00008
Rhizobium sp. NIBRBAC000502774	2590777	S	141	483	624	0.00004
Rhizobium sp. B230/85	2819994	S	94	899	993	0.00007
Rhizobium sp. N324	1703969	S	63	1139	1202	0.00009
Rhizobium sp. CCGE531	2364271	S	59	1842	1901	0.00014
Rhizobium sp. T136	555319	S	40	818	858	0.00006
Rhizobium sp. B21/90	2819993	S	37	1157	1194	0.00009
Rhizobium sp. BG6	2613771	S	19	2537	2556	0.00018
Rhizobium sp. CCGE532	2364272	S	16	1059	1075	0.00008
Rhizobium sp. N113	1703960	S	12	1450	1462	0.00010
Rhizobium leguminosarum	384	S	13154	12799	25953	0.00185
Rhizobium etli	29449	S	4014	3454	7468	0.00053
Rhizobium jaguaris	1312183	S	2387	191	2578	0.00018
Rhizobium pseudoryzae	379684	S	2324	312	2636	0.00019
Rhizobium phaseoli	396	S	2296	3595	5891	0.00042
Rhizobium gallicum	56730	S	2207	2094	4301	0.00031
Rhizobium bangladeshense	1138189	S	1897	315	2212	0.00016
Rhizobium tropici	398	S	1649	300	1949	0.00014
Rhizobium lentis	1138194	S	1638	353	1991	0.00014
Rhizobium daejeonense	240521	S	1421	275	1696	0.00012
Rhizobium binae	1138190	S	1391	365	1756	0.00013
Rhizobium pusense	648995	S	1382	3938	5320	0.00038
Rhizobium rosettiformans	1368430	S	1335	398	1733	0.00012
Rhizobium rhizoryzae	451876	S	1158	107	1265	0.00009
Rhizobium indicum	2583231	S	1046	684	1730	0.00012
Rhizobium acidisoli	1538158	S	814	494	1308	0.00009
Rhizobium hidalgonense	1538159	S	473	825	1298	0.00009
Rhizobium oryzihabitans	2267833	S	453	437	890	0.00006
Rhizobium laguerreae	1076926	S	334	433	767	0.00005
Rhizobium ruizarguesonis	2081791	S	258	1447	1705	0.00012
Rhizobium favelukesii	348824	S	18	453	471	0.00003
Agrobacterium tumefaciens	358	S	7604	5379	12983	0.00093
Agrobacterium fabrum	1176649	S	690	716	1406	0.00010
Agrobacterium fabacearum	1183401	S	185	1763	1948	0.00014
Agrobacterium vitis	373	S	3240	269	3509	0.00025
Agrobacterium sp. T29	2580515	S	408	248	656	0.00005
Agrobacterium sp. MA01	2664893	S	354	589	943	0.00007
Agrobacterium sp. RAC06	1842536	S	317	539	856	0.00006
Agrobacterium sp. CGMCC 11546	2579248	S	171	289	460	0.00003
Agrobacterium sp. S7/73	2820002	S	122	514	636	0.00005
Agrobacterium vaccinii	2735528	S	1319	128	1447	0.00010
Agrobacterium larrymoorei	160699	S	1024	123	1147	0.00008
Agrobacterium rubi	28099	S	823	180	1003	0.00007
Agrobacterium salinitolerans	1183413	S	687	187	874	0.00006
Agrobacterium rhizogenes	359	S	607	1202	1809	0.00013
Neorhizobium galegae	399	S	11472	2135	13607	0.00097
Neorhizobium sp. SOG26	2060726	S	2434	331	2765	0.00020
Neorhizobium sp. NCHU2750	1825976	S	2001	330	2331	0.00017
Pseudorhizobium flavum	1335061	S	4435	1505	5940	0.00042
Pseudorhizobium banfieldiae	1125847	S	2817	872	3689	0.00026
Sinorhizobium meliloti	382	S	78412	37482	115894	0.00828
Sinorhizobium fredii	380	S	7144	5901	13045	0.00093
Sinorhizobium medicae	110321	S	4316	461	4777	0.00034
Sinorhizobium sp. BG8	2613773	S	2483	257	2740	0.00020
Sinorhizobium sp. CCBAU 05631	794846	S	385	352	737	0.00005
Sinorhizobium americanum	194963	S	2716	632	3348	0.00024
Ensifer adhaerens	106592	S	37674	7359	45033	0.00322
Ensifer sp. PDNC004	2811423	S	4887	1183	6070	0.00043
Ensifer sp. T173	555315	S	526	1215	1741	0.00012
Ensifer mexicanus	375549	S	3389	307	3696	0.00026
Ensifer alkalisoli	1752398	S	2224	253	2477	0.00018
Ensifer sojae	716925	S	2033	389	2422	0.00017
Shinella sp. HZN7	879274	S	7929	4564	12493	0.00089
Shinella sp. PSBB067	2715959	S	3918	1890	5808	0.00041
Shinella sp. XGS7	2877941	S	2372	1626	3998	0.00029
Shinella sp. H4-D48	2925841	S	1654	446	2100	0.00015
Shinella zoogloeoides	352475	S	4380	4130	8510	0.00061
Shinella oryzae	2871820	S	2297	679	2976	0.00021
Ciceribacter thiooxidans	1969821	S	2224	265	2489	0.00018
Georhizobium profundi	2341112	S	2111	287	2398	0.00017
Peteryoungia desertarenae	1813451	S	808	84	892	0.00006
Candidatus Liberibacter americanus	309868	S	18	2	20	0.00000
Candidatus Liberibacter asiaticus	34021	S	17	3	20	0.00000
Liberibacter crescens	1273132	S	14	1	15	0.00000
Candidatus Liberibacter africanus	34020	S	13	12	25	0.00000
Mesorhizobium sp. 8	2584466	S	21690	3595	25285	0.00181
Mesorhizobium sp. DCY119	2108445	S	11544	1894	13438	0.00096
Mesorhizobium sp. B2-1-1	2589974	S	7852	1377	9229	0.00066
Mesorhizobium sp. B2-8-5	2589903	S	7217	1985	9202	0.00066
Mesorhizobium sp. M1A.F.Ca.IN.022.06.1.1	2493680	S	7120	2014	9134	0.00065
Mesorhizobium sp. J8	2777475	S	6975	1884	8859	0.00063
Mesorhizobium sp. Pch-S	2082387	S	6953	658	7611	0.00054
Mesorhizobium sp. M3A.F.Ca.ET.080.04.2.1	2493676	S	5822	1470	7292	0.00052
Mesorhizobium sp. B1-1-8	2589976	S	5713	1140	6853	0.00049
Mesorhizobium sp. M1B.F.Ca.ET.045.04.1.1	2493673	S	5362	1795	7157	0.00051
Mesorhizobium sp. 131-2-1	2744518	S	5232	2423	7655	0.00055
Mesorhizobium sp. M1D.F.Ca.ET.043.01.1.1	2493669	S	5221	2862	8083	0.00058
Mesorhizobium sp. M1E.F.Ca.ET.045.02.1.1	2493672	S	4992	2230	7222	0.00052
Mesorhizobium sp. INR15	2654248	S	4979	549	5528	0.00039
Mesorhizobium sp. M4B.F.Ca.ET.058.02.1.1	2493675	S	4918	1795	6713	0.00048
Mesorhizobium sp. PAMC28654	2880934	S	4878	699	5577	0.00040
Mesorhizobium sp. M9A.F.Ca.ET.002.03.1.2	2493668	S	4477	1862	6339	0.00045
Mesorhizobium sp. L-2-11	2744521	S	4341	1385	5726	0.00041
Mesorhizobium sp. M6A.T.Cr.TU.016.01.1.1	2493677	S	3753	1072	4825	0.00034
Mesorhizobium sp. B4-1-4	2589888	S	3690	706	4396	0.00031
Mesorhizobium sp. B2-1-8	2589967	S	3389	875	4264	0.00030
Mesorhizobium sp. M2A.F.Ca.ET.043.05.1.1	2493671	S	3358	2802	6160	0.00044
Mesorhizobium sp. NBSH29	2654249	S	3234	171	3405	0.00024
Mesorhizobium sp. M7D.F.Ca.US.005.01.1.1	2493678	S	3231	938	4169	0.00030
Mesorhizobium sp. M8A.F.Ca.ET.057.01.1.1	2493679	S	3059	1035	4094	0.00029
Mesorhizobium sp. M7A.F.Ce.TU.012.03.2.1	2493681	S	2724	876	3600	0.00026
Mesorhizobium sp. NZP2077	2483404	S	2702	765	3467	0.00025
Mesorhizobium sp. 113-3-3	2744516	S	2579	1274	3853	0.00028
Mesorhizobium sp. 113-1-2	2744515	S	2331	1021	3352	0.00024
Mesorhizobium sp. L-8-10	2744523	S	2329	7900	10229	0.00073
Mesorhizobium sp. L-8-3	2744522	S	2243	7799	10042	0.00072
Mesorhizobium sp. M2A.F.Ca.ET.046.03.2.1	2493674	S	1835	5114	6949	0.00050
Mesorhizobium sp. 113-3-9	2744517	S	1835	1309	3144	0.00022
Mesorhizobium sp. NZP2298	2483403	S	1761	984	2745	0.00020
Mesorhizobium sp. AA22	1854057	S	1673	928	2601	0.00019
Mesorhizobium sp. M2A.F.Ca.ET.043.02.1.1	2493670	S	1624	4299	5923	0.00042
Mesorhizobium sp. WSM1497	278153	S	618	1167	1785	0.00013
Mesorhizobium sp. 131-3-5	2744520	S	282	827	1109	0.00008
Mesorhizobium sp. NZP2234	2483402	S	220	747	967	0.00007
Mesorhizobium sp. 131-2-5	2744519	S	147	953	1100	0.00008
Mesorhizobium terrae	2725666	S	6568	1400	7968	0.00057
Mesorhizobium opportunistum	593909	S	4680	1466	6146	0.00044
Mesorhizobium amorphae	71433	S	4044	684	4728	0.00034
Mesorhizobium loti	381	S	2730	20641	23371	0.00167
Mesorhizobium australicum	536018	S	2538	631	3169	0.00023
Mesorhizobium ciceri	39645	S	2386	5383	7769	0.00056
Mesorhizobium erdmanii	1777866	S	2333	512	2845	0.00020
Mesorhizobium huakuii	28104	S	2139	1238	3377	0.00024
Mesorhizobium japonicum	2066070	S	1969	1158	3127	0.00022
Aminobacter sp. MSH1	374606	S	6202	2850	9052	0.00065
Aminobacter sp. SR38	2774562	S	1057	3728	4785	0.00034
Aminobacter sp. MDW-2	2666139	S	974	4269	5243	0.00037
Aminobacter aminovorans	83263	S	621	2015	2636	0.00019
Aquibium microcysteis	675281	S	7806	1647	9453	0.00068
Aquibium oceanicum	1670800	S	6005	1066	7071	0.00051
Nitratireductor sp. SY7	2599600	S	4960	687	5647	0.00040
Nitratireductor sp. OM-1	1756988	S	2397	327	2724	0.00019
Nitratireductor kimnyeongensis	430679	S	1495	180	1675	0.00012
Phyllobacterium sp. T1018	555316	S	1580	146	1726	0.00012
Phyllobacterium sp. 628	2718938	S	860	91	951	0.00007
Phyllobacterium sp. T1293	555317	S	784	72	856	0.00006
Phyllobacterium zundukense	1867719	S	1446	146	1592	0.00011
Roseitalea porphyridii	1852022	S	2769	332	3101	0.00022
Hoeflea sp. IMCC20628	1620421	S	1332	106	1438	0.00010
Hoeflea phototrophica	244596	S	1136	112	1248	0.00009
Oricola thermophila	2742145	S	2224	213	2437	0.00017
Salaquimonas pukyongi	2712698	S	878	27	905	0.00006
Lentilitoribacter sp. Alg239-R112	2305987	S	58	0	58	0.00000
Methylobacterium nodulans	114616	S	6685	644	7329	0.00052
Methylobacterium sp. 17Sr1-1	2202826	S	2658	1162	3820	0.00027
Methylobacterium sp. WL1	2603276	S	2580	456	3036	0.00022
Methylobacterium sp. C1	1479019	S	281	2271	2552	0.00018
Methylobacterium sp. XJLW	739141	S	150	2085	2235	0.00016
Methylobacterium aquaticum	270351	S	5409	2208	7617	0.00054
Methylobacterium durans	2202825	S	4887	552	5439	0.00039
Methylobacterium radiodurans	2202828	S	3881	763	4644	0.00033
Methylobacterium currus	2051553	S	3559	1374	4933	0.00035
Methylobacterium organophilum	410	S	3189	1668	4857	0.00035
Methylobacterium terrae	2202827	S	2789	1179	3968	0.00028
Methylobacterium brachiatum	269660	S	2710	902	3612	0.00026
Methylobacterium tardum	374432	S	2625	883	3508	0.00025
Methylobacterium mesophilicum	39956	S	2623	505	3128	0.00022
Methylobacterium indicum	1775910	S	2456	1147	3603	0.00026
Methylobacterium oryzae	334852	S	2230	3217	5447	0.00039
Methylobacterium radiotolerans	31998	S	877	5020	5897	0.00042
Methylobacterium phyllosphaerae	418223	S	345	1339	1684	0.00012
Microvirga sp. VF16	2807101	S	25738	3120	28858	0.00206
Microvirga sp. 17 mud 1-3	2082949	S	7114	1160	8274	0.00059
Microvirga ossetica	1882682	S	21224	2899	24123	0.00172
Microvirga thermotolerans	2651334	S	7545	1568	9113	0.00065
Methylorubrum populi	223967	S	4874	1856	6730	0.00048
Methylorubrum extorquens	408	S	4200	5922	10122	0.00072
Methylorubrum sp. B1-46	2897334	S	1813	691	2504	0.00018
Methylorubrum zatmanii	29429	S	140	630	770	0.00006
Brucella intermedia	94625	S	59025	6554	65579	0.00468
Brucella anthropi	529	S	26219	35022	61241	0.00437
[Ochrobactrum] quorumnocens	271865	S	12635	1169	13804	0.00099
Brucella pseudogrignonensis	419475	S	12627	2609	15236	0.00109
Brucella sp. BTU1	2840456	S	2835	356	3191	0.00023
Brucella sp. 09RB8910	1844051	S	216	134	350	0.00003
Brucella sp. 6810	2769351	S	180	172	352	0.00003
Brucella sp. 10RB9215	1149953	S	116	75	191	0.00001
Brucella sp. 2280	2592625	S	109	131	240	0.00002
Brucella sp. BO3	2691913	S	103	100	203	0.00001
Brucella sp. BO2	693750	S	88	120	208	0.00001
Brucella sp. 458	2821140	S	72	93	165	0.00001
Brucella sp. 09RB8471	1149952	S	54	58	112	0.00001
Brucella pituitosa	571256	S	3979	902	4881	0.00035
Brucella inopinata	1218315	S	92	61	153	0.00001
Brucella melitensis	29459	S	58	768	826	0.00006
Brucella suis	29461	S	35	13149	13184	0.00094
Brucella abortus	235	S	30	2104	2134	0.00015
Brucella ovis	236	S	16	28	44	0.00000
Pseudochrobactrum sp. XF203	2879116	S	590	386	976	0.00007
Pseudochrobactrum sp. Wa41.01b-1	2864102	S	516	376	892	0.00006
Pseudochrobactrum algeriensis	2834768	S	487	339	826	0.00006
Pseudolabrys sp. FHR47	2562284	S	19543	2458	22001	0.00157
Pseudolabrys taiwanensis	331696	S	15295	1800	17095	0.00122
Starkeya sp. ORNL1	2709380	S	5459	814	6273	0.00045
Starkeya novella	921	S	4733	1409	6142	0.00044
Xanthobacter dioxanivorans	2528964	S	4353	1281	5634	0.00040
Xanthobacter sp. YC-JY1	2419844	S	1513	1418	2931	0.00021
Xanthobacter autotrophicus	280	S	1335	1369	2704	0.00019
Ancylobacter polymorphus	223390	S	3242	1381	4623	0.00033
Ancylobacter sp. TS-1	1850374	S	3156	1039	4195	0.00030
Ancylobacter pratisalsi	1745854	S	2750	469	3219	0.00023
Labrys sp. KNU-23	2789216	S	3757	258	4015	0.00029
Azorhizobium caulinodans	7	S	3260	491	3751	0.00027
Devosia sp. A16	1736675	S	24333	2275	26608	0.00190
Devosia sp. JXJ CY 41	2917991	S	3792	669	4461	0.00032
Devosia sp. SL43	2806348	S	3708	660	4368	0.00031
Devosia sp. 1566	2499144	S	2726	259	2985	0.00021
Devosia sp. I507	2083786	S	2196	669	2865	0.00020
Devosia sp. MC521	2759954	S	986	143	1129	0.00008
Devosia ginsengisoli	400770	S	4816	806	5622	0.00040
Devosia oryziradicis	2801335	S	4573	785	5358	0.00038
Devosia beringensis	2657486	S	3352	442	3794	0.00027
Devosia salina	2860336	S	3350	1103	4453	0.00032
Devosia rhizoryzae	2774137	S	2701	242	2943	0.00021
Youhaiella tibetensis	1447062	S	4362	880	5242	0.00037
Paradevosia shaoguanensis	1335043	S	4162	1309	5471	0.00039
Pelagibacterium halotolerans	531813	S	1624	137	1761	0.00013
Maritalea myrionectae	454601	S	332	8	340	0.00002
Rhodoplanes sp. Z2-YC6860	674703	S	34059	2158	36217	0.00259
Hyphomicrobium denitrificans	53399	S	5251	510	5761	0.00041
Hyphomicrobium nitrativorans	1427356	S	4625	327	4952	0.00035
Hyphomicrobium sp. MC1	717785	S	2362	171	2533	0.00018
Methyloceanibacter sp. wino2	2170729	S	1658	333	1991	0.00014
Methyloceanibacter caenitepidi	1384459	S	1561	296	1857	0.00013
Aquabacter sp. L1I39	2820278	S	2782	294	3076	0.00022
Methyloligella sp. GL2	2742204	S	2602	233	2835	0.00020
Caenibius sp. WL	2872646	S	1204	202	1406	0.00010
Caenibius tardaugens	169176	S	905	618	1523	0.00011
Rhodomicrobium vannielii	1069	S	2154	109	2263	0.00016
Candidatus Filomicrobium marinum	1608628	S	1152	27	1179	0.00008
Bosea sp. ANAM02	2020412	S	15727	3980	19707	0.00141
Bosea sp. F3-2	2599640	S	8662	1884	10546	0.00075
Bosea sp. Tri-49	1867715	S	8531	1328	9859	0.00070
Bosea sp. AS-1	2015316	S	6646	1426	8072	0.00058
Bosea sp. RAC05	1842539	S	5250	1151	6401	0.00046
Bosea sp. PAMC 26642	1792307	S	4023	592	4615	0.00033
Bosea vaviloviae	1526658	S	4682	817	5499	0.00039
Aureimonas sp. SA4125	2826993	S	3274	436	3710	0.00027
Aureimonas sp. AU20	1349819	S	2849	295	3144	0.00022
Aureimonas sp. OT7	2816454	S	1575	1097	2672	0.00019
Aureimonas populi	1701758	S	2453	338	2791	0.00020
Aureimonas mangrovi	2758041	S	2225	337	2562	0.00018
Aureimonas altamirensis	370622	S	1489	452	1941	0.00014
Martelella sp. AD-3	686597	S	929	2528	3457	0.00025
Martelella mediterranea	293089	S	1646	462	2108	0.00015
Martelella endophytica	1486262	S	1476	222	1698	0.00012
Martelella lutilitoris	2583532	S	856	661	1517	0.00011
Aurantimonas sp. HBX-1	2906072	S	4175	901	5076	0.00036
Pseudorhodoplanes sinuspersici	1235591	S	10996	513	11509	0.00082
Nordella sp. HKS 07	2712222	S	9677	353	10030	0.00072
Terrihabitans soli	708113	S	2695	199	2894	0.00021
Candidatus Hodgkinia cicadicola	573658	S	24	0	24	0.00000
Methylocystis parvus	134	S	2062	179	2241	0.00016
Methylocystis bryophila	655015	S	1929	143	2072	0.00015
Methylocystis heyeri	391905	S	1770	146	1916	0.00014
Methylocystis sp. SC2	187303	S	1204	301	1505	0.00011
Methylocystis sp. SB2	743836	S	452	733	1185	0.00008
Methylocystis rosea	173366	S	1299	994	2293	0.00016
Methylosinus trichosporium	426	S	2691	451	3142	0.00022
Methylosinus sp. C49	2699395	S	2121	343	2464	0.00018
Stappia indica	538381	S	3818	657	4475	0.00032
Stappia sp. ES.058	1881061	S	2087	198	2285	0.00016
Pannonibacter phragmitetus	121719	S	3202	1533	4735	0.00034
Roseibium aggregatum	187304	S	2447	284	2731	0.00020
Roseibium alexandrii	388408	S	620	54	674	0.00005
Labrenzia sp. VG12	2021862	S	1317	141	1458	0.00010
Labrenzia sp. PHM005	2590016	S	573	42	615	0.00004
Labrenzia sp. THAF82	2587861	S	495	30	525	0.00004
Pseudovibrio sp. FO-BEG1	911045	S	216	87	303	0.00002
Pseudovibrio brasiliensis	1898042	S	180	71	251	0.00002
Phreatobacter stygius	1940610	S	5673	616	6289	0.00045
Phreatobacter cathodiphilus	1868589	S	5125	1117	6242	0.00045
Phreatobacter sp. NMCR1094	2570229	S	3759	540	4299	0.00031
Kaustia mangrovi	2593653	S	4694	311	5005	0.00036
Parvibaculum lavamentivorans	256618	S	2391	1231	3622	0.00026
Pyruvatibacter mobilis	1712261	S	1576	163	1739	0.00012
Candidatus Phaeomarinobacter ectocarpi	1458461	S	687	32	719	0.00005
Chelatococcus sp. CO-6	1702325	S	4579	2314	6893	0.00049
Chelatococcus daeguensis	444444	S	2412	1284	3696	0.00026
Blastochloris tepida	2233851	S	4042	995	5037	0.00036
Blastochloris viridis	1079	S	3438	703	4141	0.00030
Methylocella silvestris	199596	S	1984	176	2160	0.00015
Methylocella tundrae	227605	S	1718	132	1850	0.00013
Methylovirgula ligni	569860	S	1704	151	1855	0.00013
Methylovirgula sp. HY1	2822761	S	1276	62	1338	0.00010
Beijerinckia indica	533	S	896	57	953	0.00007
Kaistia sp. 32K	2795690	S	5407	873	6280	0.00045
Acuticoccus sp. I52.16.1	2928472	S	4299	324	4623	0.00033
Hartmannibacter diazotrophicus	1482074	S	3264	377	3641	0.00026
Breoghania sp. L-A4	2304600	S	3043	270	3313	0.00024
Lichenihabitans psoromatis	2528642	S	946	519	1465	0.00010
Lichenihabitans sp. PAMC28606	2880932	S	853	545	1398	0.00010
Bartonella apis	1686310	S	232	10	242	0.00002
Bartonella sp. HY038	2759660	S	60	8	68	0.00000
Bartonella sp. 46A	2893471	S	16	17	33	0.00000
Bartonella australis	388640	S	33	3	36	0.00000
Bartonella vinsonii	33047	S	21	12	33	0.00000
Bartonella quintana	803	S	18	3	21	0.00000
Bartonella ancashensis	1318743	S	18	2	20	0.00000
Bartonella birtlesii	111504	S	17	5	22	0.00000
Bartonella grahamii	33045	S	15	11	26	0.00000
Bartonella alsatica	52764	S	14	3	17	0.00000
Bartonella bacilliformis	774	S	14	2	16	0.00000
Bartonella bovis	155194	S	13	6	19	0.00000
Bartonella henselae	38323	S	11	3	14	0.00000
Bartonella tribocorum	85701	S	10	32	42	0.00000
Cohaesibacter sp. ES.047	1798205	S	574	17	591	0.00004
Sphingomonas sp. HDW15A	2714942	S	10013	731	10744	0.00077
Sphingomonas sp. S8-45	2938948	S	9776	1112	10888	0.00078
Sphingomonas sp. DM2-R-LB4	2899123	S	8613	2720	11333	0.00081
Sphingomonas sp. Cra20	1327635	S	6220	994	7214	0.00052
Sphingomonas sp. MM-1	745310	S	5789	6491	12280	0.00088
Sphingomonas sp. LM7	1938607	S	5459	1213	6672	0.00048
Sphingomonas sp. CL5.1	2653203	S	5381	1673	7054	0.00050
Sphingomonas sp. AK-PDB1-5	2872652	S	5289	826	6115	0.00044
Sphingomonas sp. AP4-R1	2735134	S	4908	587	5495	0.00039
Sphingomonas sp. S2-65	2903960	S	4516	856	5372	0.00038
Sphingomonas sp. AAP5	1523415	S	4065	1014	5079	0.00036
Sphingomonas sp. NBWT7	2596913	S	3946	1231	5177	0.00037
Sphingomonas sp. FARSPH	2219696	S	3667	2920	6587	0.00047
Sphingomonas sp. PAMC26645	2565555	S	3184	1129	4313	0.00031
Sphingomonas sp. KC8	1030157	S	3088	362	3450	0.00025
Sphingomonas sp. HMP9	1517554	S	2991	1404	4395	0.00031
Sphingomonas sp. HMP6	1517551	S	2648	538	3186	0.00023
Sphingomonas sp. LK11	1390395	S	1939	2108	4047	0.00029
Sphingomonas sp. NIC1	1961362	S	1678	5765	7443	0.00053
Sphingomonas sp. IC081	304378	S	594	3353	3947	0.00028
Sphingomonas sediminicola	386874	S	27637	2538	30175	0.00216
Sphingomonas daechungensis	1176646	S	27498	2550	30048	0.00215
Sphingomonas lutea	1045317	S	19940	2394	22334	0.00160
Sphingomonas sabuli	2764186	S	17483	1971	19454	0.00139
Sphingomonas sinipercae	2714944	S	15756	1957	17713	0.00127
Sphingomonas ginsengisoli An et al. 2013	363835	S	13565	1737	15302	0.00109
Sphingomonas rhizophila	2071607	S	11546	2941	14487	0.00103
Sphingomonas piscis	2714943	S	10651	904	11555	0.00083
Sphingomonas xanthus	2594473	S	8759	1967	10726	0.00077
Sphingomonas alpina	653931	S	7454	594	8048	0.00057
Sphingomonas sanxanigenens	397260	S	6321	2822	9143	0.00065
Sphingomonas profundi	2681549	S	6194	933	7127	0.00051
Sphingomonas koreensis	93064	S	4949	3677	8626	0.00062
Sphingomonas changnyeongensis	2698679	S	4731	833	5564	0.00040
Sphingomonas hengshuiensis	1609977	S	4702	596	5298	0.00038
Sphingomonas panacisoli	1813879	S	4327	564	4891	0.00035
Sphingomonas panacis	1560345	S	4313	608	4921	0.00035
Sphingomonas taxi	1549858	S	4190	1306	5496	0.00039
Sphingomonas suaedae	2599297	S	3904	491	4395	0.00031
Sphingomonas radiodurans	2890321	S	3242	408	3650	0.00026
Sphingomonas aliaeris	2759526	S	3020	357	3377	0.00024
Sphingomonas insulae	424800	S	2890	830	3720	0.00027
Sphingomonas paucimobilis	13689	S	2453	1639	4092	0.00029
Sphingomonas sanguinis	33051	S	2000	1908	3908	0.00028
Sphingomonas melonis	152682	S	1836	7426	9262	0.00066
Sphingomonas lacunae	2698828	S	1473	163	1636	0.00012
Sphingomonas paeninsulae	2319844	S	1226	45	1271	0.00009
Sphingopyxis sp. YF1	2482763	S	26433	4943	31376	0.00224
Sphingopyxis sp. PAMC25046	2565556	S	14823	5476	20299	0.00145
Sphingopyxis sp. BSN-002	2911495	S	7107	1026	8133	0.00058
Sphingopyxis sp. QXT-31	1357916	S	7064	1538	8602	0.00061
Sphingopyxis sp. OPL5	2486273	S	6617	1001	7618	0.00054
Sphingopyxis sp. EG6	1874061	S	6237	2479	8716	0.00062
Sphingopyxis sp. FD7	1914525	S	4967	1700	6667	0.00048
Sphingopyxis sp. 113P3	292913	S	4287	1403	5690	0.00041
Sphingopyxis sp. MG	1866325	S	215	1481	1696	0.00012
Sphingopyxis fribergensis	1515612	S	14540	4809	19349	0.00138
Sphingopyxis macrogoltabida	33050	S	11777	4882	16659	0.00119
Sphingopyxis lindanitolerans	2054227	S	4721	1944	6665	0.00048
Sphingopyxis terrae	33052	S	4577	2089	6666	0.00048
Sphingopyxis alaskensis	117207	S	3697	691	4388	0.00031
Sphingopyxis granuli	267128	S	2878	6078	8956	0.00064
Sphingobium sp. SYK-6	627192	S	4778	1122	5900	0.00042
Sphingobium sp. TKS	1315974	S	2879	3494	6373	0.00046
Sphingobium sp. YG1	2082188	S	2184	814	2998	0.00021
Sphingobium sp. CAP-1	2676077	S	2126	1158	3284	0.00023
Sphingobium sp. EP60837	1855519	S	1956	477	2433	0.00017
Sphingobium sp. SCG-1	2072936	S	1929	121	2050	0.00015
Sphingobium sp. RAC03	1843368	S	1911	302	2213	0.00016
Sphingobium sp. Cam5-1	2789327	S	1764	596	2360	0.00017
Sphingobium sp. KCTC 72723	2733867	S	1614	241	1855	0.00013
Sphingobium sp. MI1205	407020	S	1413	1723	3136	0.00022
Sphingobium sp. PAMC28499	2565554	S	533	954	1487	0.00011
Sphingobium sp. YBL2	484429	S	331	2075	2406	0.00017
Sphingobium sp. RSMS	520734	S	277	1555	1832	0.00013
Sphingobium sp. LF-16	2185111	S	28	418	446	0.00003
Sphingobium indicum	332055	S	4571	2910	7481	0.00053
Sphingobium yanoikuyae	13690	S	3355	5682	9037	0.00065
Sphingobium chlorophenolicum	46429	S	2594	1027	3621	0.00026
Sphingobium phenoxybenzoativorans	1592790	S	2525	891	3416	0.00024
Sphingobium amiense	135719	S	2491	2703	5194	0.00037
Sphingobium cloacae	120107	S	2082	2653	4735	0.00034
Sphingobium xenophagum	121428	S	1863	1075	2938	0.00021
Sphingobium baderi	1332080	S	1621	1376	2997	0.00021
Sphingobium herbicidovorans	76947	S	1397	1008	2405	0.00017
Sphingobium fuliginis	336203	S	1151	4264	5415	0.00039
Novosphingobium sp. Gsoil 351	2675225	S	5928	428	6356	0.00045
Novosphingobium sp. Sx8-5	2896849	S	4520	599	5119	0.00037
Novosphingobium sp. EMRT-2	2571749	S	4331	2210	6541	0.00047
Novosphingobium sp. P6W	1609758	S	3095	444	3539	0.00025
Novosphingobium sp. THN1	1016987	S	2772	1018	3790	0.00027
Novosphingobium sp. ES2-1	2780074	S	2617	1368	3985	0.00028
Novosphingobium sp. PP1Y	702113	S	1396	1884	3280	0.00023
Novosphingobium sp. KA1	164608	S	728	3363	4091	0.00029
Novosphingobium resinovorum	158500	S	4115	1806	5921	0.00042
Novosphingobium aromaticivorans	48935	S	3620	1543	5163	0.00037
Novosphingobium decolorationis	2698673	S	3323	1572	4895	0.00035
Novosphingobium ginsenosidimutans	1176536	S	3016	264	3280	0.00023
Novosphingobium pentaromativorans	205844	S	1228	2280	3508	0.00025
Rhizorhabdus wittichii	160791	S	8220	4308	12528	0.00089
Rhizorhabdus dicambivorans	1850238	S	5030	3706	8736	0.00062
Rhizorhabdus phycosphaerae	2711156	S	3386	377	3763	0.00027
Allosphingosinicella indica	941907	S	9161	961	10122	0.00072
Sphingosinithalassobacter sp. CS137	2762748	S	3694	673	4367	0.00031
Sphingosinithalassobacter tenebrarum	2711215	S	2812	766	3578	0.00026
Parasphingopyxis algicola	2026624	S	3289	197	3486	0.00025
Parasphingopyxis sp. CP4	2724527	S	1059	44	1103	0.00008
Sphingorhabdus sp. YGSMI21	2077182	S	1194	190	1384	0.00010
Sphingorhabdus sp. SMR4y	2584094	S	968	155	1123	0.00008
Sphingorhabdus sp. M41	1806885	S	913	107	1020	0.00007
Sphingorhabdus lacus	392610	S	802	31	833	0.00006
Sphingorhabdus lutea	1913578	S	92	6	98	0.00001
Blastomonas sp. RAC04	1842535	S	942	1407	2349	0.00017
Blastomonas fulva	1550728	S	705	1326	2031	0.00015
Citromicrobium sp. JL477	1634516	S	2462	973	3435	0.00025
Tardibacter chloracetimidivorans	1921510	S	2240	1578	3818	0.00027
Hankyongella ginsenosidimutans	1763828	S	2118	355	2473	0.00018
Novosphingopyxis iocasae	2762729	S	1833	877	2710	0.00019
Aquisediminimonas profunda	1550733	S	1123	35	1158	0.00008
Parasphingorhabdus sp. JHSY0214	2806553	S	399	27	426	0.00003
Parasphingorhabdus halotolerans	2725558	S	365	12	377	0.00003
Parasphingorhabdus litoris	394733	S	309	22	331	0.00002
Erythrobacter sp. HL-111	1798193	S	3194	581	3775	0.00027
Erythrobacter sp. HKB08	2502843	S	3099	654	3753	0.00027
Erythrobacter sp. SDW2	2907154	S	2899	712	3611	0.00026
Erythrobacter sp. JK5	2829500	S	2703	835	3538	0.00025
Erythrobacter sp. THAF29	2587851	S	1465	350	1815	0.00013
Erythrobacter sp. 3-20A1M	2653850	S	1241	2044	3285	0.00023
Erythrobacter sp. LQ02-29	2920384	S	1166	1396	2562	0.00018
Erythrobacter sp. A30-3	2785907	S	1165	932	2097	0.00015
Erythrobacter sp. KY5	2011159	S	1143	81	1224	0.00009
Erythrobacter sp. SCSIO 43205	2779361	S	509	89	598	0.00004
Erythrobacter litoralis	39960	S	4380	1896	6276	0.00045
Erythrobacter mangrovi	2739433	S	2066	764	2830	0.00020
Erythrobacter neustonensis	1112	S	1934	427	2361	0.00017
Erythrobacter aureus	2182384	S	1371	232	1603	0.00011
Porphyrobacter sp. CACIAM 03H1	2003315	S	3745	1064	4809	0.00034
Porphyrobacter sp. LM 6	1896196	S	2049	684	2733	0.00020
Porphyrobacter sp. HT-58-2	2023229	S	1682	393	2075	0.00015
Porphyrobacter sp. GA68	2883480	S	1468	559	2027	0.00014
Qipengyuania flava	192812	S	5125	2706	7831	0.00056
Qipengyuania sediminis	1532023	S	3097	382	3479	0.00025
Qipengyuania soli	2782568	S	2178	367	2545	0.00018
Qipengyuania aurantiaca	2867233	S	1853	581	2434	0.00017
Qipengyuania gelatinilytica	2867231	S	1407	255	1662	0.00012
Qipengyuania seohaensis	266951	S	1231	258	1489	0.00011
Qipengyuania aquimaris	255984	S	1009	1049	2058	0.00015
Qipengyuania xiapuensis	2867236	S	958	981	1939	0.00014
Qipengyuania psychrotolerans	2867238	S	876	97	973	0.00007
Altererythrobacter sp. B11	2060312	S	6680	3139	9819	0.00070
Altererythrobacter sp. TH136	2067415	S	4331	726	5057	0.00036
Altererythrobacter sp. BO-6	2604537	S	1854	284	2138	0.00015
Altererythrobacter sp. ZODW24	2185142	S	754	31	785	0.00006
Altererythrobacter epoxidivorans	361183	S	1423	410	1833	0.00013
Altererythrobacter ishigakiensis	476157	S	513	36	549	0.00004
Tsuneonella amylolytica	2338327	S	4892	1372	6264	0.00045
Tsuneonella dongtanensis	692370	S	4828	943	5771	0.00041
Tsuneonella mangrovi	1982042	S	3414	504	3918	0.00028
Tsuneonella flava	2055955	S	1187	348	1535	0.00011
Croceicoccus sp. YJ47	2798724	S	1761	827	2588	0.00018
Croceicoccus sp. Ery5	1703340	S	679	813	1492	0.00011
Croceicoccus sp. Ery15	1703338	S	492	831	1323	0.00009
Croceicoccus marinus	450378	S	3502	1871	5373	0.00038
Croceicoccus naphthovorans	1348774	S	1674	1807	3481	0.00025
Croceibacterium atlanticum	1267766	S	2953	1327	4280	0.00031
Aurantiacibacter gangjinensis	502682	S	1749	160	1909	0.00014
Aurantiacibacter atlanticus	1648404	S	719	256	975	0.00007
Pelagerythrobacter marensis	543877	S	2371	310	2681	0.00019
Paraurantiacibacter namhicola	645517	S	2271	269	2540	0.00018
Sphingosinicella sp. BN140058	1892855	S	9792	765	10557	0.00075
Sphingosinicella flava	2771430	S	4330	556	4886	0.00035
Sphingosinicella microcystinivorans	335406	S	2559	283	2842	0.00020
Polymorphobacter sp. PAMC 29362	2835787	S	1382	852	2234	0.00016
Polymorphobacter sp. PAMC 29334	2862331	S	1271	808	2079	0.00015
Sandaracinobacter sp. M6	2759707	S	2003	119	2122	0.00015
Zymomonas mobilis	542	S	157	105	262	0.00002
Azospirillum sp. B510	137722	S	2151	739	2890	0.00021
Azospirillum sp. TSH100	652764	S	2083	888	2971	0.00021
Azospirillum sp. TSA2s	709810	S	1874	1354	3228	0.00023
Azospirillum sp. TSH58	664962	S	1371	1725	3096	0.00022
Azospirillum brasilense	192	S	7310	6008	13318	0.00095
Azospirillum thermophilum	2202148	S	4852	913	5765	0.00041
Azospirillum thiophilum	528244	S	2672	776	3448	0.00025
Azospirillum ramasamyi	682998	S	1688	884	2572	0.00018
Azospirillum oryzae	286727	S	1362	1108	2470	0.00018
Azospirillum humicireducens	1226968	S	1334	729	2063	0.00015
Azospirillum lipoferum	193	S	1299	894	2193	0.00016
Azospirillum baldaniorum	1064539	S	861	1670	2531	0.00018
Skermanella mucosa	1789672	S	4393	2483	6876	0.00049
Skermanella sp. TT6	2775420	S	4073	3410	7483	0.00053
Skermanella pratensis	2233999	S	3672	1653	5325	0.00038
Skermanella rosea	1817965	S	3469	2568	6037	0.00043
Nitrospirillum amazonense	28077	S	3488	329	3817	0.00027
Indioceanicola profundi	2220096	S	2500	282	2782	0.00020
Niveispirillum cyanobacteriorum	1612173	S	1639	145	1784	0.00013
Roseomonas sp. S08	1750527	S	6559	327	6886	0.00049
Roseomonas sp. OT10	2897332	S	5715	1172	6887	0.00049
Roseomonas sp. FDAARGOS_362	2018065	S	372	1920	2292	0.00016
Roseomonas gilardii	257708	S	4314	1775	6089	0.00044
Roseomonas haemaphysalidis	2768162	S	3884	352	4236	0.00030
Roseomonas marmotae	2768161	S	3644	330	3974	0.00028
Roseomonas mucosa	207340	S	338	1997	2335	0.00017
Rhodovastum atsumiense	504468	S	5098	406	5504	0.00039
Komagataeibacter xylinus	28448	S	1049	1776	2825	0.00020
Komagataeibacter saccharivorans	265959	S	430	141	571	0.00004
Komagataeibacter nataicola	265960	S	326	141	467	0.00003
Komagataeibacter oboediens	65958	S	311	135	446	0.00003
Komagataeibacter europaeus	33995	S	240	113	353	0.00003
Komagataeibacter medellinensis	1177712	S	226	172	398	0.00003
Komagataeibacter rhaeticus	215221	S	17	293	310	0.00002
Roseococcus microcysteis	2771361	S	3625	272	3897	0.00028
Acidiphilium multivorum	62140	S	645	2432	3077	0.00022
Acidiphilium cryptum	524	S	170	998	1168	0.00008
Sediminicoccus rosea	1225128	S	2906	121	3027	0.00022
Lichenicola cladoniae	1484109	S	2283	88	2371	0.00017
Acetobacter aceti	435	S	848	295	1143	0.00008
Acetobacter persici	1076596	S	219	27	246	0.00002
Acetobacter sp. KACC 21233	2592655	S	205	38	243	0.00002
Acetobacter ghanensis	431306	S	133	30	163	0.00001
Acetobacter pasteurianus	438	S	97	216	313	0.00002
Acetobacter tropicalis	104102	S	63	78	141	0.00001
Acetobacter senegalensis	446692	S	63	82	145	0.00001
Acetobacter orientalis	146474	S	55	6	61	0.00000
Acetobacter ascendens	481146	S	53	61	114	0.00001
Acetobacter oryzoeni	2500548	S	17	36	53	0.00000
Acidibrevibacterium fodinaquatile	1969806	S	2034	142	2176	0.00016
Gluconobacter oxydans	442	S	554	525	1079	0.00008
Gluconobacter albidus	318683	S	279	44	323	0.00002
Gluconobacter sphaericus	574987	S	214	45	259	0.00002
Gluconobacter frateurii	38308	S	138	32	170	0.00001
Gluconobacter thailandicus	257438	S	92	64	156	0.00001
Gluconacetobacter diazotrophicus	33996	S	1457	266	1723	0.00012
Granulibacter bethesdensis	364410	S	1033	74	1107	0.00008
Asaia bogorensis	91915	S	683	95	778	0.00006
Neoasaia chiangmaiensis	320497	S	640	116	756	0.00005
Kozakia baliensis	153496	S	408	131	539	0.00004
Novacetimonas hansenii	436	S	379	164	543	0.00004
Oecophyllibacter saccharovorans	2558360	S	255	6	261	0.00002
Parasaccharibacter sp. TMW 2.1888	2268025	S	31	104	135	0.00001
Parasaccharibacter apium	1510841	S	17	54	71	0.00001
Swingsia sp. F3b2	2558361	S	146	3	149	0.00001
Swingsia samuiensis	1293412	S	29	4	33	0.00000
Neokomagataea tanensis	661191	S	74	10	84	0.00001
Entomobacter blattae	2762277	S	47	2	49	0.00000
Bombella sp. KACC 21507	2697033	S	12	1	13	0.00000
Hypericibacter adhaerens	2602016	S	7459	1215	8674	0.00062
Hypericibacter terrae	2602015	S	6005	789	6794	0.00049
Magnetospirillum sp. XM-1	1663591	S	1561	513	2074	0.00015
Magnetospirillum sp. ME-1	1639348	S	1333	477	1810	0.00013
Magnetospirillum gryphiswaldense	55518	S	2096	125208	127304	0.00909
Magnetospirillum magneticum	84159	S	1512	127	1639	0.00012
Ferrovibrio terrae	2594003	S	7838	395	8233	0.00059
Rhodospirillum centenum	34018	S	3124	351	3475	0.00025
Rhodospirillum rubrum	1085	S	1666	96	1762	0.00013
Tistrella mobilis	171437	S	3470	1155	4625	0.00033
Defluviicoccus vanus	111831	S	1651	118	1769	0.00013
Pararhodospirillum photometricum	1084	S	952	56	1008	0.00007
Haematospirillum jordaniae	1549855	S	176	11	187	0.00001
Candidatus Endolissoclinum faulkneri	1263979	S	86	0	86	0.00001
Stella humosa	94	S	8441	466	8907	0.00064
Elioraea tepida	2843330	S	3092	123	3215	0.00023
Thalassospira marina	2048283	S	326	16	342	0.00002
Thalassospira sp. A40-3	2785908	S	204	82	286	0.00002
Thalassospira sp. B30-1	2785911	S	114	174	288	0.00002
Thalassospira indica	1891279	S	235	133	368	0.00003
Thalassospira xiamenensis	220697	S	128	188	316	0.00002
Magnetospira sp. QH-2	1288970	S	678	17	695	0.00005
Terasakiella sp. SH-1	2560057	S	96	1	97	0.00001
Paracoccus sp. MC1862	2760307	S	1257	126	1383	0.00010
Paracoccus sp. S8-55	2903900	S	1170	149	1319	0.00009
Paracoccus sp. AK26	2589076	S	1152	183	1335	0.00010
Paracoccus sp. MA	2895796	S	1096	540	1636	0.00012
Paracoccus sp. H4-D09	2812658	S	722	138	860	0.00006
Paracoccus sp. Arc7-R13	2500532	S	399	377	776	0.00006
Paracoccus sanguinis	1545044	S	1841	444	2285	0.00016
Paracoccus yeei	147645	S	1408	1978	3386	0.00024
Paracoccus zhejiangensis	1077935	S	1287	287	1574	0.00011
Paracoccus denitrificans	266	S	1281	1307	2588	0.00018
Paracoccus pantotrophus	82367	S	1277	655	1932	0.00014
Paracoccus liaowanqingii	2560053	S	1256	133	1389	0.00010
Paracoccus aminovorans	34004	S	1223	321	1544	0.00011
Paracoccus suum	2259340	S	1102	177	1279	0.00009
Paracoccus jeotgali	2065379	S	1009	186	1195	0.00009
Paracoccus contaminans	1945662	S	970	206	1176	0.00008
Paracoccus aminophilus	34003	S	894	86	980	0.00007
Paracoccus kondratievae	135740	S	650	114	764	0.00005
Paracoccus tegillarcae	1529068	S	572	32	604	0.00004
Paracoccus marcusii	59779	S	422	348	770	0.00006
Paracoccus mutanolyticus	1499308	S	136	418	554	0.00004
Cereibacter sphaeroides	1063	S	3908	1788	5696	0.00041
Cereibacter azotoformans	43057	S	350	1322	1672	0.00012
Rhodobacter sp. CZR27	2033869	S	1667	534	2201	0.00016
Rhodobacter sp. N10	2807096	S	1349	159	1508	0.00011
Rhodobacter sp. LPB0142	1850250	S	1070	656	1726	0.00012
Rhodobacter capsulatus	1061	S	1616	318	1934	0.00014
Rhodovulum sp. MB263	308754	S	787	301	1088	0.00008
Rhodovulum sp. P5	1564506	S	785	84	869	0.00006
Rhodovulum sulfidophilum	35806	S	1184	725	1909	0.00014
Polymorphum gilvum	991904	S	2782	580	3362	0.00024
Paroceanicella profunda	2579971	S	2662	667	3329	0.00024
Thioclava electrotropha	1549850	S	818	221	1039	0.00007
Thioclava nitratireducens	1915078	S	761	272	1033	0.00007
Pikeienuella piscinae	2748098	S	1844	154	1998	0.00014
Pontivivens ytuae	2789856	S	1706	117	1823	0.00013
Silicimonas algicola	1826607	S	1657	93	1750	0.00013
Pelagovum pacificum	2588711	S	1509	176	1685	0.00012
Frigidibacter mobilis	1335048	S	1286	490	1776	0.00013
Pukyongiella litopenaei	2605946	S	1145	275	1420	0.00010
Brevirhabdus pacifica	1267768	S	1091	509	1600	0.00011
Fuscovulum blasticum	1075	S	1004	125	1129	0.00008
Haematobacter massiliensis	195105	S	923	336	1259	0.00009
Gymnodinialimonas ceratoperidinii	2856823	S	880	80	960	0.00007
Pseudopuniceibacterium antarcticum	2613965	S	845	64	909	0.00006
Falsirhodobacter sp. PG104	2692330	S	838	115	953	0.00007
Pacificitalea manganoxidans	1411902	S	819	180	999	0.00007
Gemmobacter aquarius	2169400	S	809	143	952	0.00007
Tabrizicola piscis	2494374	S	798	70	868	0.00006
Pseudooceanicola algae	1537215	S	667	63	730	0.00005
Monaibacterium sp. h42	2758038	S	642	151	793	0.00006
Roseicitreum antarcticum	564137	S	609	30	639	0.00005
Tritonibacter mobilis	379347	S	519	233	752	0.00005
Yoonia vestfoldensis	245188	S	421	96	517	0.00004
Qingshengfaniella alkalisoli	2599296	S	421	21	442	0.00003
Rhodophyticola sp. CCM32	2916397	S	345	9	354	0.00003
Pseudohalocynthiibacter aestuariivivens	1591409	S	342	69	411	0.00003
Rhodobaca barguzinensis	441209	S	332	13	345	0.00002
Profundibacter amoris	2171755	S	321	10	331	0.00002
Pseudorhodobacter turbinis	2500533	S	289	17	306	0.00002
Parasedimentitalea marina	2483033	S	251	10	261	0.00002
Cognatishimia activa	1715691	S	229	9	238	0.00002
Aestuarium zhoushanense	2820523	S	228	94	322	0.00002
Planktomarina temperata	1284658	S	151	3	154	0.00001
Roseovarius sp. SCSIO 43702	2823043	S	1301	91	1392	0.00010
Roseovarius sp. THAF9	2587847	S	660	158	818	0.00006
Roseovarius sp. THAF8	2587846	S	258	440	698	0.00005
Roseovarius sp. THAF27	2587850	S	243	441	684	0.00005
Roseovarius sp. TM1035	391613	S	126	251	377	0.00003
Roseovarius indicus	540747	S	1572	470	2042	0.00015
Roseovarius faecimaris	2494550	S	644	25	669	0.00005
Roseovarius mucosus	215743	S	108	217	325	0.00002
Sulfitobacter sp. THAF37	2587855	S	677	265	942	0.00007
Sulfitobacter sp. JK7-1	2829501	S	644	31	675	0.00005
Sulfitobacter sp. JL08	2070369	S	363	7	370	0.00003
Sulfitobacter sp. D7	1968541	S	315	113	428	0.00003
Sulfitobacter sp. DSM 110093	2883127	S	234	64	298	0.00002
Sulfitobacter sp. SK011	1389004	S	228	5	233	0.00002
Sulfitobacter sp. BSw21498	664426	S	210	30	240	0.00002
Sulfitobacter sp. SK012	1389005	S	198	3	201	0.00001
Sulfitobacter sp. SK025	1389011	S	72	143	215	0.00002
Sulfitobacter sp. CB2047	1525218	S	65	173	238	0.00002
Sulfitobacter sp. B30-2	2785912	S	43	89	132	0.00001
Sulfitobacter alexandrii	1917485	S	984	463	1447	0.00010
Sulfitobacter mediterraneus	83219	S	543	52	595	0.00004
Sulfitobacter indolifex	225422	S	317	67	384	0.00003
Sulfitobacter dubius	218673	S	268	113	381	0.00003
Sulfitobacter pontiacus	60137	S	131	279	410	0.00003
Salipiger profundus	1229727	S	1748	729	2477	0.00018
Salipiger abyssi	1250539	S	1298	483	1781	0.00013
Salipiger sp. CCB-MM3	1792508	S	1261	164	1425	0.00010
Roseivivax sp. THAF30	2587852	S	941	183	1124	0.00008
Roseivivax sp. THAF197b	2588299	S	33	440	473	0.00003
Roseivivax sp. THAF40	2587858	S	28	482	510	0.00004
Roseivivax marinus	1379903	S	1672	254	1926	0.00014
Celeribacter indicus	1208324	S	1437	660	2097	0.00015
Celeribacter ethanolicus	1758178	S	581	193	774	0.00006
Celeribacter baekdonensis	875171	S	287	75	362	0.00003
Celeribacter marinus	1397108	S	205	6	211	0.00002
Phaeobacter gallaeciensis	60890	S	745	1410	2155	0.00015
Phaeobacter inhibens	221822	S	640	177	817	0.00006
Phaeobacter piscinae	1580596	S	308	144	452	0.00003
Phaeobacter porticola	1844006	S	155	27	182	0.00001
Phaeobacter sp. LSS9	681157	S	55	37	92	0.00001
Leisingera aquaemixtae	1396826	S	772	133	905	0.00006
Leisingera sp. NJS201	2508306	S	138	232	370	0.00003
Leisingera sp. NJS204	2508307	S	128	227	355	0.00003
Leisingera methylohalidivorans	133924	S	576	126	702	0.00005
Ruegeria sp. TM1040	292414	S	360	57	417	0.00003
Ruegeria sp. THAF33	2587853	S	286	64	350	0.00003
Ruegeria sp. AD91A	2293862	S	243	23	266	0.00002
Ruegeria sp. SCSIO 43209	2793010	S	243	41	284	0.00002
Ruegeria pomeroyi	89184	S	880	148	1028	0.00007
Sulfitobacter pseudonitzschiae	1402135	S	1198	402	1600	0.00011
Pseudosulfitobacter sp. DSM 107133	2883100	S	478	184	662	0.00005
Sagittula sp. P11	2009329	S	1550	592	2142	0.00015
Yangia pacifica	311180	S	1488	225	1713	0.00012
Ponticoccus alexandrii	1943633	S	1246	170	1416	0.00010
Roseobacter ponti	1891787	S	429	10	439	0.00003
Roseobacter denitrificans	2434	S	331	37	368	0.00003
Roseobacter litoralis	42443	S	288	35	323	0.00002
Mameliella alba	561184	S	1069	184	1253	0.00009
Dinoroseobacter shibae	215813	S	1007	347	1354	0.00010
Ketogulonicigenium vulgare	92945	S	561	83	644	0.00005
Ketogulonicigenium robustum	92947	S	394	45	439	0.00003
Octadecabacter sp. SW4	2602067	S	360	49	409	0.00003
Octadecabacter antarcticus	1217908	S	213	16	229	0.00002
Octadecabacter arcticus	53946	S	211	19	230	0.00002
Octadecabacter temperatus	1458307	S	161	2	163	0.00001
Oceanicola sp. D3	2587163	S	893	41	934	0.00007
Roseibacterium elongatum	159346	S	886	67	953	0.00007
Actibacterium sp. EMB200-NS6	1609966	S	836	389	1225	0.00009
Maribius sp. THAF1	2587842	S	638	29	667	0.00005
Thalassococcus sp. S3	2017482	S	608	14	622	0.00004
Antarctobacter heliothermus	74033	S	550	26	576	0.00004
Tateyamaria omphalii	299262	S	546	16	562	0.00004
Jannaschia sp. CCS1	290400	S	495	12	507	0.00004
Thalassobius gelatinovorus	53501	S	345	16	361	0.00003
Falsihalocynthiibacter arcticus	1579316	S	132	3	135	0.00001
Caulobacter sp. S6	2823693	S	5949	539	6488	0.00046
Caulobacter sp. FWC26	69665	S	2162	886	3048	0.00022
Caulobacter segnis	88688	S	7648	3344	10992	0.00079
Caulobacter mirabilis	69666	S	6670	1058	7728	0.00055
Caulobacter vibrioides	155892	S	4748	1838	6586	0.00047
Caulobacter flavus	1679497	S	4735	1195	5930	0.00042
Caulobacter rhizosphaerae	2010972	S	4652	1259	5911	0.00042
Caulobacter soli	2708539	S	3812	1128	4940	0.00035
Caulobacter henricii	69395	S	2011	309	2320	0.00017
Brevundimonas sp. M20	2591463	S	3628	453	4081	0.00029
Brevundimonas sp. LM2	1938605	S	2271	313	2584	0.00018
Brevundimonas sp. MF30-B	2561924	S	2162	275	2437	0.00017
Brevundimonas sp. PAMC22021	2861285	S	2051	362	2413	0.00017
Brevundimonas sp. AJA228-03	2752515	S	1592	167	1759	0.00013
Brevundimonas sp. SGAir0440	2579977	S	495	398	893	0.00006
Brevundimonas sp. CS1	2813778	S	449	377	826	0.00006
Brevundimonas sp. Bb-A	2560058	S	417	846	1263	0.00009
Brevundimonas sp. DS20	1532555	S	412	964	1376	0.00010
Brevundimonas sp. GW460-12-10-14-LB2	1827469	S	411	602	1013	0.00007
Brevundimonas sp. 'scallop'	2562582	S	399	597	996	0.00007
Brevundimonas naejangsanensis	588932	S	4779	1304	6083	0.00043
Brevundimonas goettingensis	2774190	S	2683	335	3018	0.00022
Brevundimonas albigilva	1312364	S	2459	1067	3526	0.00025
Brevundimonas diminuta	293	S	2002	2999	5001	0.00036
Brevundimonas subvibrioides	74313	S	1938	276	2214	0.00016
Brevundimonas pondensis	2774189	S	1807	439	2246	0.00016
Brevundimonas vitisensis	2800818	S	1606	157	1763	0.00013
Brevundimonas mediterranea	74329	S	1427	438	1865	0.00013
Brevundimonas nasdae	172043	S	1265	646	1911	0.00014
Brevundimonas vancanneytii	1325724	S	496	1520	2016	0.00014
Brevundimonas vesicularis	41276	S	354	616	970	0.00007
Phenylobacterium zucineum	284016	S	18497	3218	21715	0.00155
Phenylobacterium parvum	2201350	S	3717	357	4074	0.00029
Terricaulis silvestris	2686094	S	4435	123	4558	0.00033
Asticcacaulis excentricus	78587	S	1259	185	1444	0.00010
Asticcacaulis sp. AND118	2840468	S	1211	176	1387	0.00010
Hyphomonas sp. CACIAM 19H1	1873716	S	805	110	915	0.00007
Hyphomonas sp. KY3	2016196	S	512	47	559	0.00004
Hyphomonas sp. Mor2	1906738	S	492	8	500	0.00004
Hyphomonas neptunium	81032	S	748	82	830	0.00006
Candidatus Viadribacter manganicus	1759059	S	2589	57	2646	0.00019
Hirschia baltica	2724	S	66	1	67	0.00000
Marinicauda algicola	2029849	S	2004	286	2290	0.00016
Maricaulis maris	74318	S	873	48	921	0.00007
Glycocaulis alkaliphilus	1434191	S	719	33	752	0.00005
Hyphobacterium sp. CCMP332	2749086	S	637	21	658	0.00005
Aquisalinus flavus	1526572	S	1065	40	1105	0.00008
Parvularcula bermudensis	208216	S	311	30	341	0.00002
Anaplasma ovis	142058	S	65	29	94	0.00001
Anaplasma platys	949	S	18	4	22	0.00000
Anaplasma phagocytophilum	948	S	12	2	14	0.00000
Wolbachia endosymbiont of Cruorifilaria tuberocauda	1812111	S	14	47	61	0.00000
Ehrlichia ruminantium	779	S	16	12	28	0.00000
Neorickettsia helminthoeca	33994	S	14	6	20	0.00000
Rickettsia tillamookensis	2761623	S	18	45	63	0.00000
Rickettsia endosymbiont of Oedothorax gibbosus	931099	S	23	4	27	0.00000
Rickettsia endosymbiont of Bemisia tabaci	337479	S	10	13	23	0.00000
Rickettsia typhi	785	S	14	4	18	0.00000
Rickettsia canadensis	788	S	10	5	15	0.00000
Orientia tsutsugamushi	784	S	18	1	19	0.00000
Candidatus Sneabacter namystus	2601646	S	13	1	14	0.00000
Candidatus Phycorickettsia trachydisci	2115978	S	13	1	14	0.00000
Candidatus Fokinia solitaria	1802984	S	26	2	28	0.00000
Rickettsiales endosymbiont of Stachyamoeba lipophora	2486578	S	29	4	33	0.00000
Candidatus Deianiraea vastatrix	2163644	S	24	0	24	0.00000
Micavibrio aeruginosavorus	349221	S	566	5	571	0.00004
Candidatus Puniceispirillum marinum	767892	S	99	2	101	0.00001
Paremcibacter congregatus	2043170	S	329	7	336	0.00002
Luteithermobacter gelatinilyticus	2582913	S	298	40	338	0.00002
endosymbiont of Acanthamoeba sp. UWC8	86106	S	41	0	41	0.00000
Candidatus Cytomitobacter indipagum	2601575	S	27	2	29	0.00000
Candidatus Cytomitobacter primus	2066024	S	11	0	11	0.00000
Candidatus Nesciobacter abundans	2601668	S	20	1	21	0.00000
Candidatus Hydrogenosomobacter endosymbioticus	2558174	S	20	0	20	0.00000
Candidatus Paracaedibacter acanthamoebae	91604	S	66	3	69	0.00000
Candidatus Nucleicultrix amoebiphila	1509244	S	58	2	60	0.00000
Magnetococcus marinus	1124597	S	160	3	163	0.00001
Candidatus Pelagibacter sp. IMCC9063	1002672	S	13	24	37	0.00000
Candidatus Fonsibacter ubiquis	1925548	S	44	1	45	0.00000
Kordiimonas pumila	2161677	S	95	1	96	0.00001
Lysobacter soli	453783	S	103823	17177	121000	0.00864
Lysobacter sp. KIS68-7	2904252	S	16354	2585	18939	0.00135
Lysobacter sp. S4-A87	2925843	S	8535	2483	11018	0.00079
Lysobacter sp. TY2-98	2290922	S	7710	978	8688	0.00062
Lysobacter sp. 5GHs7-4	2904253	S	7471	1910	9381	0.00067
Lysobacter sp. CECT 30171	2822368	S	6438	1259	7697	0.00055
Lysobacter sp. CW239	2762611	S	4902	2204	7106	0.00051
Lysobacter sp. K5869	2820808	S	3593	1610	5203	0.00037
Lysobacter sp. H21R4	2781021	S	1059	2122	3181	0.00023
Lysobacter sp. CJ11	2764185	S	942	75	1017	0.00007
Lysobacter sp. HDW10	2714936	S	664	153	817	0.00006
Lysobacter sp. H23M47	2781024	S	616	3136	3752	0.00027
Lysobacter enzymogenes	69	S	14551	4677	19228	0.00137
Lysobacter capsici	435897	S	9945	10409	20354	0.00145
Lysobacter solisilvae (ex Woo and Kim 2022)	2865112	S	8658	2036	10694	0.00076
Lysobacter solisilvae (ex Kim et al. 2021)	2763317	S	8394	1339	9733	0.00070
Lysobacter lycopersici	1324796	S	8320	1374	9694	0.00069
Lysobacter arenosi	2795387	S	8302	2334	10636	0.00076
Lysobacter maris	1605891	S	6492	1241	7733	0.00055
Lysobacter antibioticus	84531	S	6373	1141	7514	0.00054
Lysobacter alkalisoli	2591633	S	5460	775	6235	0.00045
Lysobacter oculi	2698682	S	4958	1030	5988	0.00043
Lysobacter ciconiae	2781022	S	1096	1993	3089	0.00022
Lysobacter gummosus	262324	S	702	5952	6654	0.00048
Lysobacter avium	2781023	S	543	2500	3043	0.00022
Pseudoxanthomonas suwonensis	314722	S	72447	26367	98814	0.00706
Pseudoxanthomonas daejeonensis	266062	S	60225	11379	71604	0.00512
Pseudoxanthomonas mexicana	128785	S	12481	12883	25364	0.00181
Pseudoxanthomonas sp. X-1	2571115	S	5303	3563	8866	0.00063
Pseudoxanthomonas sp. F37	2932492	S	79	4151	4230	0.00030
Pseudoxanthomonas spadix	415229	S	3367	984	4351	0.00031
Stenotrophomonas maltophilia	40324	S	44108	54725	98833	0.00706
Stenotrophomonas sp. ESTM1D_MKCIP4_1	2072414	S	1159	418	1577	0.00011
Stenotrophomonas sp. SAU14A_NAIMI4_5	2072413	S	1107	617	1724	0.00012
Stenotrophomonas sp. ZAC14D2_NAIMI4_7	2072405	S	549	546	1095	0.00008
Stenotrophomonas sp. ZAC14A_NAIMI4_1	2072412	S	388	681	1069	0.00008
Stenotrophomonas sp. YAU14D1_LEIMI4_1	2072407	S	363	584	947	0.00007
Stenotrophomonas sp. ZAC14D2_NAIMI4_6	2072406	S	344	632	976	0.00007
Stenotrophomonas sp. SAU14A_NAIMI4_8	2072409	S	130	703	833	0.00006
Stenotrophomonas sp. YAU14A_MKIMI4_1	2072408	S	111	601	712	0.00005
Stenotrophomonas sp. LM091	1904944	S	2270	694	2964	0.00021
Stenotrophomonas sp. 169	2770322	S	2163	279	2442	0.00017
Stenotrophomonas sp. SXG-1	2682487	S	1749	19078	20827	0.00149
Stenotrophomonas sp. NY11291	2939415	S	1593	15869	17462	0.00125
Stenotrophomonas sp. 364	2691571	S	1391	467	1858	0.00013
Stenotrophomonas sp. NA06056	2742129	S	924	403	1327	0.00009
Stenotrophomonas sp. WZN-1	2005046	S	511	569	1080	0.00008
Stenotrophomonas sp. DR822	2871174	S	460	743	1203	0.00009
Stenotrophomonas sp. Pemsol	2040586	S	236	716	952	0.00007
Stenotrophomonas sp. pho	2211160	S	229	973	1202	0.00009
Stenotrophomonas sp. SI-NJAU-1	2886359	S	199	888	1087	0.00008
Stenotrophomonas sp. MYb57	1827305	S	178	766	944	0.00007
Stenotrophomonas sp. G4	2303750	S	141	613	754	0.00005
Stenotrophomonas sp. ASS1	2282124	S	101	459	560	0.00004
Stenotrophomonas sp. CW117	2775920	S	82	1602	1684	0.00012
Stenotrophomonas rhizophila	216778	S	7458	1803	9261	0.00066
Stenotrophomonas acidaminiphila	128780	S	5079	10336	15415	0.00110
Stenotrophomonas indicatrix	2045451	S	421	1663	2084	0.00015
Xanthomonas translucens	343	S	6043	6006	12049	0.00086
Xanthomonas campestris	339	S	5093	3520	8613	0.00062
Xanthomonas sacchari	56458	S	3911	1022	4933	0.00035
Xanthomonas sp. GW	2724121	S	814	1001	1815	0.00013
Xanthomonas sp. SS	2724122	S	664	953	1617	0.00012
Xanthomonas sp. SI	2724123	S	637	924	1561	0.00011
Xanthomonas sp. MLO165	2081477	S	168	237	405	0.00003
Xanthomonas arboricola	56448	S	2750	2612	5362	0.00038
Xanthomonas theicola	56464	S	2343	598	2941	0.00021
Xanthomonas oryzae	347	S	2113	927	3040	0.00022
Xanthomonas hyacinthi	56455	S	1899	912	2811	0.00020
Xanthomonas albilineans	29447	S	1739	165	1904	0.00014
Xanthomonas citri	346	S	1541	15271	16812	0.00120
Xanthomonas vesicatoria	56460	S	1502	674	2176	0.00016
Xanthomonas cucurbitae	56453	S	1477	219	1696	0.00012
Xanthomonas hortorum	56454	S	1407	913	2320	0.00017
Xanthomonas fragariae	48664	S	1392	252	1644	0.00012
Xanthomonas vasicola	56459	S	1061	348	1409	0.00010
Xanthomonas cassavae	56450	S	1030	228	1258	0.00009
Xanthomonas euroxanthea	2259622	S	792	881	1673	0.00012
Xanthomonas axonopodis	53413	S	675	481	1156	0.00008
Xanthomonas hydrangeae	2775159	S	675	217	892	0.00006
Xanthomonas phaseoli	1985254	S	434	1162	1596	0.00011
Xanthomonas euvesicatoria	456327	S	353	1382	1735	0.00012
Xanthomonas perforans	442694	S	43	2653	2696	0.00019
Luteimonas sp. JM171	1896164	S	6562	1049	7611	0.00054
Luteimonas sp. MC1750	2799326	S	6185	1922	8107	0.00058
Luteimonas sp. S4-F44	2925842	S	4681	732	5413	0.00039
Luteimonas sp. MC1572	2799325	S	4669	2061	6730	0.00048
Luteimonas sp. MC1825	2761107	S	4511	2058	6569	0.00047
Luteimonas sp. YGD11-2	2508168	S	4507	1727	6234	0.00045
Luteimonas sp. D4P002	2901869	S	4401	948	5349	0.00038
Luteimonas granuli	1176533	S	5390	1589	6979	0.00050
Luteimonas yindakuii	2565782	S	4097	1442	5539	0.00040
Luteimonas chenhongjianii	2006110	S	3678	675	4353	0.00031
Thermomonas brevis	215691	S	12044	3793	15837	0.00113
Thermomonas sp. XSG	2771436	S	4868	1665	6533	0.00047
Thermomonas sp. HDW16	2714945	S	4193	892	5085	0.00036
Thermomonas aquatica	2202149	S	8906	3631	12537	0.00090
Thermomonas carbonis	1463158	S	5108	829	5937	0.00042
Arenimonas daejeonensis	370777	S	11355	1750	13105	0.00094
Pseudolysobacter antarcticus	2511995	S	2774	59	2833	0.00020
Xylella fastidiosa	2371	S	261	40	301	0.00002
Xylella taiwanensis	1444770	S	234	9	243	0.00002
Rhodanobacter sp. FDAARGOS 1247	2778082	S	20026	5001	25027	0.00179
Rhodanobacter denitrificans	666685	S	17978	5232	23210	0.00166
Rhodanobacter thiooxydans	416169	S	10670	3837	14507	0.00104
Rhodanobacter glycinis	582702	S	5756	742	6498	0.00046
Luteibacter sp. 321	2911537	S	26562	5377	31939	0.00228
Luteibacter sp. 335	2911538	S	5030	703	5733	0.00041
Luteibacter sp. EIF3	2780091	S	3744	389	4133	0.00030
Luteibacter sp. 353	2911539	S	2932	590	3522	0.00025
Luteibacter pinisoli	2589080	S	3426	586	4012	0.00029
Luteibacter rhizovicinus	242606	S	3218	304	3522	0.00025
Luteibacter anthropi	564369	S	2730	330	3060	0.00022
Frateuria sp. 5GH9-34	2898793	S	18365	4123	22488	0.00161
Frateuria sp. 5GH9-11	1542730	S	13882	3960	17842	0.00127
Frateuria aurantia	81475	S	1162	112	1274	0.00009
Dyella thiooxydans	445710	S	5889	1318	7207	0.00051
Dyella japonica	231455	S	3341	996	4337	0.00031
Dyella telluris	2763498	S	3214	848	4062	0.00029
Dyella terrae	522259	S	2356	317	2673	0.00019
Dyella caseinilytica	1849581	S	1837	116	1953	0.00014
Dyella sp. M7H15-1	2501295	S	1236	101	1337	0.00010
Dokdonella koreensis	323415	S	9766	1249	11015	0.00079
Aerosticca soli	2010829	S	4078	3976	8054	0.00058
Ahniella affigens	2021234	S	1780	36	1816	0.00013
Pseudomonas sp. LS.1a	2920387	S	1744	660	2404	0.00017
Pseudomonas sp. ATCC 13867	1294143	S	924	265	1189	0.00008
Pseudomonas sp. PDNC002	2811422	S	911	177	1088	0.00008
Pseudomonas sp. SCB32	2653853	S	887	159	1046	0.00007
Pseudomonas sp. KNUC1026	2893890	S	883	70	953	0.00007
Pseudomonas sp. TCU-HL1	1856685	S	862	102	964	0.00007
Pseudomonas sp. FGI182	1259844	S	853	846	1699	0.00012
Pseudomonas sp. DY-1	1755504	S	829	88	917	0.00007
Pseudomonas sp. Ost2	2678260	S	797	98	895	0.00006
Pseudomonas sp. LPB0260	2614442	S	796	134	930	0.00007
Pseudomonas sp. CC6-YY-74	1930532	S	787	78	865	0.00006
Pseudomonas sp. Leaf58	1736226	S	738	121	859	0.00006
Pseudomonas sp. ABC1	2748080	S	715	85	800	0.00006
Pseudomonas sp. 7SR1	1881017	S	711	108	819	0.00006
Pseudomonas sp. MTM4	2705472	S	710	103	813	0.00006
Pseudomonas sp. MM211	2866808	S	679	52	731	0.00005
Pseudomonas sp. StFLB209	1028989	S	678	140	818	0.00006
Pseudomonas sp. Marseille-Q3773	2866592	S	660	190	850	0.00006
Pseudomonas sp. HN2-3	2886360	S	589	112	701	0.00005
Pseudomonas sp. p1(2021b)	2874628	S	565	251	816	0.00006
Pseudomonas sp. L5B5	2883205	S	546	85	631	0.00005
Pseudomonas sp. OIL-1	2706126	S	542	102	644	0.00005
Pseudomonas sp. Pc102	2678261	S	518	240	758	0.00005
Pseudomonas sp. gcc21	2726989	S	489	184	673	0.00005
Pseudomonas sp. LAB-08	143813	S	480	77	557	0.00004
Pseudomonas sp. MSPm1	2726956	S	468	88	556	0.00004
Pseudomonas sp. B11D7D	2735906	S	462	76	538	0.00004
Pseudomonas sp. CMR5c	658630	S	420	107	527	0.00004
Pseudomonas sp. MPC6	2498848	S	418	78	496	0.00004
Pseudomonas sp. S34	1573718	S	404	84	488	0.00003
Pseudomonas sp. 3-2	2867408	S	400	496	896	0.00006
Pseudomonas sp. DG56-2	2320270	S	375	35	410	0.00003
Pseudomonas sp. HLS-6	2049589	S	365	92	457	0.00003
Pseudomonas sp. 14181154	2662033	S	360	338	698	0.00005
Pseudomonas sp. MM213	2866807	S	351	67	418	0.00003
Pseudomonas sp. 15A4	2804761	S	345	76	421	0.00003
Pseudomonas sp. URMO17WK12:I11	1283291	S	344	207	551	0.00004
Pseudomonas sp. ADAK13	2730847	S	338	70	408	0.00003
Pseudomonas sp. S09G 359	2054919	S	331	71	402	0.00003
Pseudomonas sp. DTU12.3	2073078	S	327	74	401	0.00003
Pseudomonas sp. UW4	1207075	S	313	184	497	0.00004
Pseudomonas sp. RtIB026	2749999	S	292	153	445	0.00003
Pseudomonas sp. Tri1	2823875	S	291	61	352	0.00003
Pseudomonas sp. 31-12	2201356	S	275	62	337	0.00002
Pseudomonas sp. DR 5-09	1534110	S	272	353	625	0.00004
Pseudomonas sp. A2	107445	S	271	1224	1495	0.00011
Pseudomonas sp. Seg1	2678259	S	267	54	321	0.00002
Pseudomonas sp. NIBR-H-19	2901380	S	257	50	307	0.00002
Pseudomonas sp. SK	2729423	S	257	197	454	0.00003
Pseudomonas sp. M30-35	1981174	S	257	12	269	0.00002
Pseudomonas sp. S35	1573719	S	253	60	313	0.00002
Pseudomonas sp. R5-89-07	658644	S	247	70	317	0.00002
Pseudomonas sp. PP3	2815936	S	247	82	329	0.00002
Pseudomonas sp. RC3H12	2834406	S	245	134	379	0.00003
Pseudomonas sp. LG1E9	2219057	S	244	64	308	0.00002
Pseudomonas sp. DR48	2871095	S	241	137	378	0.00003
Pseudomonas sp. ACM7	2052956	S	228	36	264	0.00002
Pseudomonas sp. 2hn	2866626	S	228	137	365	0.00003
Pseudomonas sp. OE 28.3	2745519	S	228	48	276	0.00002
Pseudomonas sp. ADPe	2774873	S	210	433	643	0.00005
Pseudomonas sp. NS1(2017)	2025658	S	208	49	257	0.00002
Pseudomonas sp. HS6	2850559	S	208	50	258	0.00002
Pseudomonas sp. DNDY-54	2870860	S	206	89	295	0.00002
Pseudomonas sp. St316	2678257	S	203	59	262	0.00002
Pseudomonas sp. M1	95619	S	200	399	599	0.00004
Pseudomonas sp. ADAK18	2730848	S	198	30	228	0.00002
Pseudomonas sp. HN11	1344094	S	183	37	220	0.00002
Pseudomonas sp. IzPS59	2774459	S	183	77	260	0.00002
Pseudomonas sp. R84	1573712	S	177	77	254	0.00002
Pseudomonas sp. CCOS 191	1649877	S	171	129	300	0.00002
Pseudomonas sp. SCA2728.1_7	2825975	S	168	86	254	0.00002
Pseudomonas sp. R2A2	2213057	S	161	168	329	0.00002
Pseudomonas sp. SDM007	2812000	S	151	88	239	0.00002
Pseudomonas sp. NIBRBAC000502773	2590776	S	148	67	215	0.00002
Pseudomonas sp. FIT81	2837969	S	145	77	222	0.00002
Pseudomonas sp. SK3(2021)	2841064	S	142	80	222	0.00002
Pseudomonas sp. AO-1	2855434	S	139	126	265	0.00002
Pseudomonas sp. CYM-20-01	2870750	S	137	60	197	0.00001
Pseudomonas sp. HS-18	2879114	S	134	237	371	0.00003
Pseudomonas sp. SWI36	2083052	S	131	336	467	0.00003
Pseudomonas sp. MRSN12121	1611770	S	128	156	284	0.00002
Pseudomonas sp. LTJR-52	2479392	S	125	36	161	0.00001
Pseudomonas sp. S07E 245	2866278	S	125	294	419	0.00003
Pseudomonas sp. LPH1	1898684	S	122	98	220	0.00002
Pseudomonas sp. 02C 26	2054914	S	121	268	389	0.00003
Pseudomonas sp. RBPA9	2746321	S	117	219	336	0.00002
Pseudomonas sp. Z003-0.4C(8344-21)	1855380	S	115	72	187	0.00001
Pseudomonas sp. B10	118613	S	113	73	186	0.00001
Pseudomonas sp. R76	1573711	S	108	47	155	0.00001
Pseudomonas sp. THAF7b	2587845	S	108	189	297	0.00002
Pseudomonas sp. HN2	2884805	S	103	81	184	0.00001
Pseudomonas sp. SORT22	2813842	S	102	243	345	0.00002
Pseudomonas sp. phDV1	253237	S	92	258	350	0.00003
Pseudomonas sp. Cab53	2678258	S	91	128	219	0.00002
Pseudomonas sp. BIGb0427	2724470	S	87	195	282	0.00002
Pseudomonas sp. MYb193	1827300	S	82	83	165	0.00001
Pseudomonas sp. AN-B15	2697023	S	81	219	300	0.00002
Pseudomonas sp. PONIH3	1636610	S	81	365	446	0.00003
Pseudomonas sp. SC3(2021)	2871493	S	80	77	157	0.00001
Pseudomonas sp. MPFS	2795724	S	79	124	203	0.00001
Pseudomonas sp. RU47	2005388	S	77	196	273	0.00002
Pseudomonas sp. A214	1855331	S	76	204	280	0.00002
Pseudomonas sp. Y5-11	2749808	S	71	204	275	0.00002
Pseudomonas sp. BJP69	2597770	S	70	349	419	0.00003
Pseudomonas sp. C27(2019)	2604941	S	69	8	77	0.00001
Pseudomonas sp. MPDS	2762896	S	68	238	306	0.00002
Pseudomonas sp. ATCC 43928	676210	S	67	163	230	0.00002
Pseudomonas sp. ArH3a	2862945	S	61	152	213	0.00002
Pseudomonas sp. FDAARGOS_380	2018067	S	61	44	105	0.00001
Pseudomonas sp. ADAK22	2730851	S	60	151	211	0.00002
Pseudomonas sp. CIP-10	2892442	S	60	465	525	0.00004
Pseudomonas sp. CFSAN084952	2664899	S	59	156	215	0.00002
Pseudomonas sp. XWY-1	2069256	S	58	303	361	0.00003
Pseudomonas sp. 09C 129	2054915	S	57	62	119	0.00001
Pseudomonas sp. S150	2559074	S	55	77	132	0.00001
Pseudomonas sp. BC42	2933816	S	55	270	325	0.00002
Pseudomonas sp. J380	2605424	S	53	64	117	0.00001
Pseudomonas sp. S49	1573720	S	52	134	186	0.00001
Pseudomonas sp. GR 6-02	1659194	S	46	110	156	0.00001
Pseudomonas sp. LBUM920	2126069	S	46	115	161	0.00001
Pseudomonas sp. IAC-BECa141	2793103	S	46	84	130	0.00001
Pseudomonas sp. BIOMIG1BAC	1758730	S	42	120	162	0.00001
Pseudomonas sp. CFA	2651048	S	42	185	227	0.00002
Pseudomonas sp. St29	1500687	S	41	165	206	0.00001
Pseudomonas sp. NC02	2067572	S	41	120	161	0.00001
Pseudomonas sp. R4-39-08	1173288	S	40	233	273	0.00002
Pseudomonas sp. Os17	1500686	S	38	186	224	0.00002
Pseudomonas sp. LG1D9	2083054	S	38	140	178	0.00001
Pseudomonas sp. R3-18-08	1173283	S	38	109	147	0.00001
Pseudomonas sp. SXM-1	2169583	S	37	102	139	0.00001
Pseudomonas sp. Y39-6	2749807	S	37	107	144	0.00001
Pseudomonas sp. DR208	2870840	S	37	79	116	0.00001
Pseudomonas sp. SWI44	2083053	S	36	302	338	0.00002
Pseudomonas sp. R4-34-07	658642	S	33	189	222	0.00002
Pseudomonas sp. TKP	1415630	S	33	101	134	0.00001
Pseudomonas sp. 13159349	2662034	S	32	269	301	0.00002
Pseudomonas sp. B14-6	2738843	S	32	78	110	0.00001
Pseudomonas sp. R2-37-08W	1173273	S	32	149	181	0.00001
Pseudomonas sp. Colony2	2861799	S	31	118	149	0.00001
Pseudomonas sp. R32	1573704	S	31	70	101	0.00001
Pseudomonas sp. HN8-3	2886361	S	30	53	83	0.00001
Pseudomonas sp. 7-41	2898483	S	30	118	148	0.00001
Pseudomonas sp. So3.2b	2864101	S	28	79	107	0.00001
Pseudomonas sp. DTU12.1	2654238	S	28	110	138	0.00001
Pseudomonas sp. R11-23-07	658632	S	27	239	266	0.00002
Pseudomonas sp. R3-52-08	1173284	S	25	150	175	0.00001
Pseudomonas sp. R4-35-07	658643	S	25	167	192	0.00001
Pseudomonas sp. IB20	1702250	S	25	144	169	0.00001
Pseudomonas sp. R1-43-08	1173270	S	23	134	157	0.00001
Pseudomonas sp. TMW 2.1634	1886807	S	22	50	72	0.00001
Pseudomonas sp. I3-I5	2926671	S	21	73	94	0.00001
Pseudomonas sp. LH1G9	2083055	S	21	64	85	0.00001
Pseudomonas sp. SW-3	147212	S	20	67	87	0.00001
Pseudomonas sp. PS1(2021)	2866282	S	20	480	500	0.00004
Pseudomonas sp. OST1909	2777367	S	19	51	70	0.00001
Pseudomonas sp. VLB120	69328	S	18	243	261	0.00002
Pseudomonas sp. R2-60-08W	1173280	S	18	124	142	0.00001
Pseudomonas sp. R2-7-07	658641	S	17	158	175	0.00001
Pseudomonas sp. SWI6	2083051	S	16	264	280	0.00002
Pseudomonas sp. SWI7	2587597	S	15	84	99	0.00001
Pseudomonas sp. JY-Q	1338689	S	14	97	111	0.00001
Pseudomonas sp. BYT-1	2816906	S	13	92	105	0.00001
Pseudomonas sp. St290	1602166	S	13	44	57	0.00000
Pseudomonas sp. FDAARGOS_761	2545800	S	12	209	221	0.00002
Pseudomonas sp. Eqa60	2799184	S	12	60	72	0.00001
Pseudomonas sp. SK2	2841063	S	11	198	209	0.00001
Pseudomonas aeruginosa	287	S	16763	110589	127352	0.00910
Pseudomonas alcaligenes	43263	S	4619	2394	7013	0.00050
Pseudomonas mendocina	300	S	2454	728	3182	0.00023
Pseudomonas furukawaii	1149133	S	1079	251	1330	0.00010
Pseudomonas oleovorans	301	S	243	590	833	0.00006
Pseudomonas resinovorans	53412	S	1156	205	1361	0.00010
Pseudomonas multiresinivorans	95301	S	644	171	815	0.00006
Pseudomonas nitroreducens	46680	S	164	271	435	0.00003
Pseudomonas citronellolis	53408	S	486	581	1067	0.00008
Pseudomonas putida	303	S	11170	12252	23422	0.00167
Pseudomonas oryzihabitans	47885	S	1900	334	2234	0.00016
Pseudomonas fulva	47880	S	1310	2820	4130	0.00030
Pseudomonas plecoglossicida	70775	S	602	385	987	0.00007
Pseudomonas monteilii	76759	S	470	906	1376	0.00010
Pseudomonas mosselii	78327	S	266	405	671	0.00005
Pseudomonas sp. SGAir0191	2217867	S	148	77	225	0.00002
Pseudomonas shirazica	1940636	S	62	648	710	0.00005
Pseudomonas fluorescens	294	S	5935	3989	9924	0.00071
Pseudomonas protegens	380021	S	1192	878	2070	0.00015
Pseudomonas orientalis	76758	S	934	220	1154	0.00008
Pseudomonas mediterranea	183795	S	925	214	1139	0.00008
Pseudomonas azotoformans	47878	S	819	277	1096	0.00008
Pseudomonas corrugata	47879	S	604	119	723	0.00005
Pseudomonas synxantha	47883	S	593	377	970	0.00007
Pseudomonas rhodesiae	76760	S	494	156	650	0.00005
Pseudomonas poae	200451	S	423	190	613	0.00004
Pseudomonas trivialis	200450	S	398	127	525	0.00004
Pseudomonas tolaasii	29442	S	398	65	463	0.00003
Pseudomonas mucidolens	46679	S	306	37	343	0.00002
Pseudomonas migulae	78543	S	299	129	428	0.00003
Pseudomonas cedrina	651740	S	268	62	330	0.00002
Pseudomonas congelans	200452	S	253	63	316	0.00002
Pseudomonas brenneri	129817	S	188	59	247	0.00002
Pseudomonas libanensis	75588	S	168	175	343	0.00002
Pseudomonas mandelii	75612	S	133	321	454	0.00003
Pseudomonas ogarae	1114970	S	117	74	191	0.00001
Pseudomonas veronii	76761	S	101	221	322	0.00002
Pseudomonas extremorientalis	169669	S	31	62	93	0.00001
Pseudomonas stutzeri	316	S	10229	5392	15621	0.00112
Pseudomonas chloritidismutans	203192	S	132	162	294	0.00002
Pseudomonas balearica	74829	S	1578	1590	3168	0.00023
Pseudomonas xanthomarina	271420	S	523	73	596	0.00004
Pseudomonas luteola	47886	S	123	46	169	0.00001
Pseudomonas syringae	317	S	1816	2091	3907	0.00028
Pseudomonas viridiflava	33069	S	1149	119	1268	0.00009
Pseudomonas cichorii	36746	S	648	48	696	0.00005
Pseudomonas asturiensis	1190415	S	424	38	462	0.00003
Pseudomonas amygdali	47877	S	175	692	867	0.00006
Pseudomonas savastanoi	29438	S	69	242	311	0.00002
Pseudomonas syringae group genomosp. 7	251699	S	284	19	303	0.00002
Pseudomonas fuscovaginae	50340	S	175	84	259	0.00002
Pseudomonas avellanae	46257	S	85	130	215	0.00002
Pseudomonas coronafaciens	53409	S	73	199	272	0.00002
Pseudomonas syringae group genomosp. 3	251701	S	52	696	748	0.00005
Pseudomonas sp. Lz4W	1206777	S	35	51	86	0.00001
Pseudomonas tremae	200454	S	17	41	58	0.00000
Pseudomonas chlororaphis	587753	S	2935	2526	5461	0.00039
Pseudomonas lundensis	86185	S	384	39	423	0.00003
Pseudomonas fragi	296	S	265	176	441	0.00003
Pseudomonas otitidis	319939	S	1974	363	2337	0.00017
Pseudomonas knackmussii	65741	S	1910	1169	3079	0.00022
Pseudomonas psychrotolerans	237610	S	1895	344	2239	0.00016
Pseudomonas oryzae	1392877	S	1762	470	2232	0.00016
Pseudomonas entomophila	312306	S	1449	516	1965	0.00014
Pseudomonas campi	2731681	S	1366	158	1524	0.00011
Pseudomonas cavernae	2320867	S	1210	160	1370	0.00010
Pseudomonas guangdongensis	1245526	S	1104	302	1406	0.00010
Pseudomonas saudiphocaensis	1499686	S	996	173	1169	0.00008
Pseudomonas lalkuanensis	2604832	S	991	151	1142	0.00008
Pseudomonas vanderleydeniana	2745495	S	896	102	998	0.00007
Pseudomonas eucalypticola	2599595	S	835	87	922	0.00007
Pseudomonas parafulva	157782	S	833	194	1027	0.00007
Pseudomonas nanhaiensis	2830842	S	814	82	896	0.00006
Pseudomonas qingdaonensis	2056231	S	786	129	915	0.00007
Pseudomonas cremoricolorata	157783	S	684	84	768	0.00005
Pseudomonas rhizosphaerae	216142	S	649	65	714	0.00005
Pseudomonas brassicacearum	930166	S	623	957	1580	0.00011
Pseudomonas pohangensis	364197	S	618	37	655	0.00005
Pseudomonas alkylphenolica	237609	S	614	97	711	0.00005
Pseudomonas phragmitis	1931241	S	589	40	629	0.00004
Pseudomonas frederiksbergensis	104087	S	588	141	729	0.00005
Pseudomonas umsongensis	198618	S	561	72	633	0.00005
Pseudomonas zhaodongensis	1176257	S	541	196	737	0.00005
Pseudomonas yamanorum	515393	S	530	95	625	0.00004
Pseudomonas argentinensis	289370	S	521	97	618	0.00004
Pseudomonas alvandae	2842348	S	509	65	574	0.00004
Pseudomonas tohonis	2725477	S	475	307	782	0.00006
Pseudomonas palleroniana	191390	S	475	62	537	0.00004
Pseudomonas koreensis	198620	S	471	148	619	0.00004
Pseudomonas muyukensis	2842357	S	467	112	579	0.00004
Pseudomonas marincola	437900	S	455	56	511	0.00004
Pseudomonas xantholysinigenes	2745490	S	428	95	523	0.00004
Pseudomonas vancouverensis	95300	S	427	54	481	0.00003
Pseudomonas fakonensis	2842355	S	426	108	534	0.00004
Pseudomonas tructae	2518644	S	420	59	479	0.00003
Pseudomonas promysalinigenes	485898	S	410	51	461	0.00003
Pseudomonas xanthosomae	2842356	S	403	104	507	0.00004
Pseudomonas prosekii	1148509	S	401	53	454	0.00003
Pseudomonas thivervalensis	86265	S	393	68	461	0.00003
Pseudomonas agarici	46677	S	378	15	393	0.00003
Pseudomonas silesiensis	1853130	S	371	63	434	0.00003
Pseudomonas hamedanensis	2745504	S	352	51	403	0.00003
Pseudomonas granadensis	1421430	S	344	132	476	0.00003
Pseudomonas antarctica	219572	S	341	69	410	0.00003
Pseudomonas atacamensis	2565368	S	320	253	573	0.00004
Pseudomonas arsenicoxydans	702115	S	314	54	368	0.00003
Pseudomonas wenzhouensis	2906062	S	310	98	408	0.00003
Pseudomonas extremaustralis	359110	S	308	55	363	0.00003
Pseudomonas azerbaijanoriens	2842350	S	307	166	473	0.00003
Pseudomonas sediminis	1691904	S	306	71	377	0.00003
Pseudomonas graminis	158627	S	304	68	372	0.00003
Pseudomonas viciae	2505979	S	272	53	325	0.00002
Pseudomonas maumuensis	2842354	S	270	105	375	0.00003
Pseudomonas psychrophila	122355	S	270	30	300	0.00002
Pseudomonas asgharzadehiana	2842349	S	269	50	319	0.00002
Pseudomonas taetrolens	47884	S	265	27	292	0.00002
Pseudomonas lini	163011	S	263	41	304	0.00002
Pseudomonas versuta	1788301	S	259	33	292	0.00002
Pseudomonas lurida	244566	S	245	44	289	0.00002
Pseudomonas simiae	321846	S	229	45	274	0.00002
Pseudomonas anuradhapurensis	485870	S	225	162	387	0.00003
Pseudomonas allokribbensis	2774460	S	215	67	282	0.00002
Pseudomonas reinekei	395598	S	214	49	263	0.00002
Pseudomonas moraviensis	321662	S	194	282	476	0.00003
Pseudomonas kribbensis	1628086	S	183	141	324	0.00002
Pseudomonas alcaliphila	101564	S	181	157	338	0.00002
Pseudomonas toyotomiensis	554344	S	180	134	314	0.00002
Pseudomonas oryziphila	2894079	S	167	107	274	0.00002
Pseudomonas asplenii	53407	S	164	82	246	0.00002
Pseudomonas sihuiensis	1274359	S	163	172	335	0.00002
Pseudomonas khazarica	2502979	S	151	150	301	0.00002
Pseudomonas kunmingensis	1211807	S	149	176	325	0.00002
Pseudomonas gozinkensis	2774461	S	148	55	203	0.00001
Pseudomonas tritici	2745518	S	146	37	183	0.00001
Pseudomonas chengduensis	489632	S	141	226	367	0.00003
Pseudomonas zeae	2745510	S	138	56	194	0.00001
Pseudomonas asiatica	2219225	S	132	598	730	0.00005
Pseudomonas germanica	2815720	S	125	55	180	0.00001
Pseudomonas tensinigenes	2745511	S	122	52	174	0.00001
Pseudomonas iranensis	2745503	S	116	71	187	0.00001
Pseudomonas juntendi	2666183	S	96	666	762	0.00005
Pseudomonas monsensis	2745509	S	90	78	168	0.00001
Pseudomonas zarinae	2745498	S	84	51	135	0.00001
Pseudomonas soli	1306993	S	78	231	309	0.00002
Pseudomonas salmasensis	2745514	S	68	35	103	0.00001
Pseudomonas rhizophila	2045200	S	66	140	206	0.00001
Pseudomonas glycinae	1785145	S	58	83	141	0.00001
Pseudomonas lactis	1615674	S	45	26	71	0.00001
Pseudomonas bijieensis	2681983	S	41	125	166	0.00001
Pseudomonas sessilinigenes	658629	S	35	72	107	0.00001
Pseudomonas cerasi	1583341	S	32	54	86	0.00001
Pseudomonas taiwanensis	470150	S	30	303	333	0.00002
Pseudomonas donghuensis	1163398	S	25	56	81	0.00001
Candidatus Pseudomonas adelgestsugas	1302376	S	24	0	24	0.00000
Pseudomonas shahriarae	2745512	S	13	41	54	0.00000
Azotobacter chroococcum	353	S	1268	783	2051	0.00015
Azotobacter vinelandii	354	S	867	0	867	0.00006
Azotobacter salinestris	69964	S	788	426	1214	0.00009
Halopseudomonas xinjiangensis	487184	S	558	50	608	0.00004
Halopseudomonas sabulinigri	472181	S	498	45	543	0.00004
Halopseudomonas aestusnigri	857252	S	425	278	703	0.00005
Halopseudomonas sp. RR6	2918528	S	417	69	486	0.00003
Halopseudomonas litoralis	797277	S	379	85	464	0.00003
Halopseudomonas salegens	1434072	S	339	22	361	0.00003
Permianibacter aggregans	1510150	S	695	17	712	0.00005
Thiopseudomonas alkaliphila	1697053	S	84	14	98	0.00001
Entomomonas moraniae	2213226	S	16	3	19	0.00000
Entomomonas sp. F2A	2785331	S	15	3	18	0.00000
Marinobacter sp. CA1	2817656	S	547	37	584	0.00004
Marinobacter sp. NP-4(2019)	2488665	S	368	68	436	0.00003
Marinobacter sp. Arc7-DN-1	2304594	S	353	51	404	0.00003
Marinobacter sp. LPB0319	2769486	S	325	19	344	0.00002
Marinobacter sp. LV10R510-11A	1415568	S	189	7	196	0.00001
Marinobacter sp. LQ44	1749259	S	154	255	409	0.00003
Marinobacter sp. es.042	1761794	S	141	163	304	0.00002
Marinobacter sp. JH2	2547598	S	130	36	166	0.00001
Marinobacter sp. CP1	1671721	S	106	239	345	0.00002
Marinobacter sp. BSs20148	490759	S	98	74	172	0.00001
Marinobacter fonticola	2603215	S	467	21	488	0.00003
Marinobacter nauticus	2743	S	413	115	528	0.00004
Marinobacter salarius	1420917	S	373	50	423	0.00003
Marinobacter similis	1420916	S	351	32	383	0.00003
Marinobacter salsuginis	418719	S	239	39	278	0.00002
Marinobacter salinus	1874317	S	230	14	244	0.00002
Marinobacter adhaerens	1033846	S	96	182	278	0.00002
Marinobacter psychrophilus	330734	S	46	35	81	0.00001
Klebsiella pneumoniae	573	S	635	30252	30887	0.00221
Klebsiella variicola	244366	S	522	1911	2433	0.00017
Klebsiella quasipneumoniae	1463165	S	466	1551	2017	0.00014
Klebsiella sp. MPUS7	2697371	S	47	522	569	0.00004
Klebsiella sp. A52	2834819	S	32	48	80	0.00001
Klebsiella aerogenes	548	S	299	610	909	0.00006
Klebsiella oxytoca	571	S	286	172	458	0.00003
Klebsiella michiganensis	1134687	S	187	1106	1293	0.00009
Klebsiella grimontii	2058152	S	100	621	721	0.00005
Klebsiella quasivariicola	2026240	S	81	81	162	0.00001
Klebsiella africana	2489010	S	69	38	107	0.00001
Klebsiella huaxiensis	2153354	S	57	46	103	0.00001
Raoultella sp. HC6	2923366	S	141	94	235	0.00002
Raoultella planticola	575	S	131	124	255	0.00002
Raoultella ornithinolytica	54291	S	90	697	787	0.00006
Raoultella terrigena	577	S	68	145	213	0.00002
Raoultella electrica	1259973	S	38	95	133	0.00001
Enterobacter cloacae	550	S	680	997	1677	0.00012
Enterobacter asburiae	61645	S	303	1333	1636	0.00012
Enterobacter hormaechei	158836	S	236	3065	3301	0.00024
Enterobacter cancerogenus	69218	S	212	67	279	0.00002
Enterobacter roggenkampii	1812935	S	147	584	731	0.00005
Enterobacter ludwigii	299767	S	90	215	305	0.00002
Enterobacter chengduensis	2494701	S	89	59	148	0.00001
Enterobacter chuandaensis	2497875	S	74	45	119	0.00001
Enterobacter cloacae complex sp.	2027919	S	18	441	459	0.00003
Enterobacter sp. BIDMC 29	1329841	S	13	45	58	0.00000
Enterobacter kobei	208224	S	58	616	674	0.00005
Enterobacter sichuanensis	2071710	S	28	26	54	0.00000
Enterobacter sp. SA187	1914861	S	177	28	205	0.00001
Enterobacter sp. JUb54	2724468	S	174	32	206	0.00001
Enterobacter sp. E76	2596949	S	91	158	249	0.00002
Enterobacter sp. RHBSTW-00175	2742639	S	85	71	156	0.00001
Enterobacter sp. RHBSTW-00994	2742676	S	75	17	92	0.00001
Enterobacter sp. Colony194	2866201	S	48	63	111	0.00001
Enterobacter sp. SGAir0187	2836161	S	39	45	84	0.00001
Enterobacter sp. JBIWA008	2831892	S	38	24	62	0.00000
Enterobacter sp. SES19	2705458	S	19	20	39	0.00000
Enterobacter sp. JBIWA005	2831891	S	17	33	50	0.00000
Enterobacter sp. JBIWA003	2831890	S	16	21	37	0.00000
Enterobacter sp. N18-03635	2500132	S	14	36	50	0.00000
Enterobacter sp. E20	1560339	S	12	101	113	0.00001
Enterobacter sp. HK169	1868135	S	10	44	54	0.00000
Enterobacter mori	539813	S	396	497	893	0.00006
Enterobacter huaxiensis	2494702	S	97	27	124	0.00001
Enterobacter oligotrophicus	2478464	S	80	22	102	0.00001
Enterobacter soli	885040	S	64	15	79	0.00001
Enterobacter bugandensis	881260	S	60	103	163	0.00001
Citrobacter freundii	546	S	228	982	1210	0.00009
Citrobacter werkmanii	67827	S	44	107	151	0.00001
Citrobacter braakii	57706	S	35	297	332	0.00002
Citrobacter freundii complex sp. CFNIH2	2066049	S	24	28	52	0.00000
Citrobacter portucalensis	1639133	S	27	270	297	0.00002
Citrobacter sedlakii	67826	S	19	55	74	0.00001
Citrobacter sp. R56	1573676	S	115	32	147	0.00001
Citrobacter sp. RHB25-C09	2742624	S	84	21	105	0.00001
Citrobacter sp. BDA59-3	2781952	S	23	11	34	0.00000
Citrobacter sp. MGH 55	1439319	S	14	64	78	0.00001
Citrobacter rodentium	67825	S	195	0	195	0.00001
Citrobacter amalonaticus	35703	S	127	647	774	0.00006
Citrobacter farmeri	67824	S	114	52	166	0.00001
Citrobacter koseri	545	S	91	128	219	0.00002
Citrobacter tructae	2562449	S	54	22	76	0.00001
Citrobacter pasteurii	1563222	S	40	35	75	0.00001
Citrobacter arsenatis	2546350	S	30	11	41	0.00000
Citrobacter cronae	1748967	S	11	92	103	0.00001
Cronobacter sakazakii	28141	S	307	236	543	0.00004
Cronobacter dublinensis	413497	S	223	80	303	0.00002
Cronobacter universalis	535744	S	165	120	285	0.00002
Cronobacter condimenti	1163710	S	140	38	178	0.00001
Cronobacter malonaticus	413503	S	114	119	233	0.00002
Cronobacter sp. JZ38	1906275	S	32	103	135	0.00001
Cronobacter muytjensii	413501	S	27	111	138	0.00001
Kosakonia sp. SMBL-WEM22	2725560	S	117	52	169	0.00001
Kosakonia sp. MUSA4	2067958	S	76	37	113	0.00001
Kosakonia sp. CCTCC M2018092	2492396	S	72	69	141	0.00001
Kosakonia cowanii	208223	S	253	168	421	0.00003
Kosakonia sacchari	1158459	S	226	106	332	0.00002
Kosakonia pseudosacchari	1646340	S	73	35	108	0.00001
Kosakonia radicincitans	283686	S	72	68	140	0.00001
Kosakonia oryzae	497725	S	68	44	112	0.00001
Kosakonia arachidis	551989	S	64	15	79	0.00001
Leclercia adecarboxylata	83655	S	401	643	1044	0.00007
Leclercia sp. 29361	2714951	S	127	47	174	0.00001
Leclercia sp. J807	2681307	S	33	51	84	0.00001
Leclercia sp. W6	2282310	S	26	51	77	0.00001
Leclercia sp. G3L	2898725	S	21	97	118	0.00001
Leclercia sp. W17	2282309	S	13	36	49	0.00000
Leclercia sp. Colony189	2681309	S	10	162	172	0.00001
Leclercia pneumoniae	2815358	S	113	45	158	0.00001
Salmonella enterica	28901	S	808	25960	26768	0.00191
Salmonella bongori	54736	S	104	21	125	0.00001
Pluralibacter gergoviae	61647	S	568	137	705	0.00005
[Enterobacter] lignolyticus	1334193	S	308	72	380	0.00003
Escherichia coli	562	S	531	11192	11723	0.00084
Escherichia albertii	208962	S	79	57	136	0.00001
Escherichia marmotae	1499973	S	54	26	80	0.00001
Escherichia fergusonii	564	S	49	66	115	0.00001
Escherichia sp. E4742	2044467	S	37	21	58	0.00000
Cedecea neteri	158822	S	521	100	621	0.00004
Cedecea lapagei	158823	S	128	31	159	0.00001
Cedecea sp. FDAARGOS_727	2545798	S	127	24	151	0.00001
Lelliottia amnigena	61646	S	330	80	410	0.00003
Lelliottia sp. WB101	2153385	S	52	55	107	0.00001
Lelliottia sp. AC1	2067959	S	48	43	91	0.00001
Kluyvera ascorbata	51288	S	127	114	241	0.00002
Kluyvera intermedia	61648	S	96	62	158	0.00001
Kluyvera sp. CRP	2873269	S	27	81	108	0.00001
Candidatus Symbiopectobacterium sp. SyEd1	2871826	S	105	11	116	0.00001
Blochmannia endosymbiont of Colobopsis nipponica	2681987	S	39	15	54	0.00000
Candidatus Hamiltonella defensa	138072	S	40	10	50	0.00000
secondary endosymbiont of Ctenarytaina eucalypti	1199245	S	16	0	16	0.00000
Candidatus Doolittlea endobia	1778262	S	18	1	19	0.00000
Candidatus Hoaglandella endobia	1778263	S	13	1	14	0.00000
Buttiauxella agrestis	82977	S	105	17	122	0.00001
Buttiauxella ferragutiae	82989	S	34	74	108	0.00001
Buttiauxella sp. 3AFRM03	2479367	S	11	21	32	0.00000
Plesiomonas shigelloides	703	S	208	56	264	0.00002
Jejubacter calystegiae	2579935	S	197	18	215	0.00002
Pseudescherichia vulneris	566	S	194	11	205	0.00001
Atlantibacter hermannii	565	S	191	35	226	0.00002
Pseudocitrobacter sp. G163CM	2891570	S	173	37	210	0.00002
Shimwellia blattae	563	S	145	24	169	0.00001
Scandinavium goeteborgense	1851514	S	142	23	165	0.00001
Yokenella regensburgei	158877	S	126	46	172	0.00001
Phytobacter ursingii	1972431	S	94	113	207	0.00001
Candidatus Profftia sp. (ex Adelges kitamiensis)	2864218	S	13	0	13	0.00000
Candidatus Profftia tarda	1177216	S	10	0	10	0.00000
Candidatus Moranella endobia	1048758	S	19	0	19	0.00000
Candidatus Schneideria nysicola	1081631	S	11	0	11	0.00000
Serratia marcescens	615	S	1216	2500	3716	0.00027
Serratia plymuthica	82996	S	407	231	638	0.00005
Serratia sp. FGI94	671990	S	81	93	174	0.00001
Serratia sp. FDAARGOS_506	2420306	S	79	81	160	0.00001
Serratia sp. ATCC 39006	104623	S	73	7	80	0.00001
Serratia sp. 1D1416	2447890	S	26	93	119	0.00001
Serratia sp. 3ACOL1	2448483	S	23	36	59	0.00000
Serratia sp. P2ACOL2	2482769	S	17	56	73	0.00001
Serratia sp. FS14	1327989	S	13	68	81	0.00001
Serratia sp. SCBI	488142	S	11	103	114	0.00001
Serratia sp. JUb9	2724469	S	10	98	108	0.00001
Serratia entomophila	42906	S	346	86	432	0.00003
Serratia rubidaea	61652	S	310	373	683	0.00005
Serratia odorifera	618	S	262	44	306	0.00002
Serratia proteamaculans	28151	S	178	43	221	0.00002
Serratia fonticola	47917	S	157	146	303	0.00002
Serratia surfactantfaciens	2741499	S	155	95	250	0.00002
Serratia liquefaciens	614	S	128	198	326	0.00002
Serratia quinivorans	137545	S	122	47	169	0.00001
Serratia symbiotica	138074	S	89	13	102	0.00001
Serratia grimesii	82995	S	85	10	95	0.00001
Serratia inhibens	2338073	S	78	44	122	0.00001
Serratia rhizosphaerae	2597702	S	61	60	121	0.00001
Serratia ureilytica	300181	S	49	686	735	0.00005
Serratia ficaria	61651	S	18	88	106	0.00001
Serratia nematodiphila	458197	S	12	126	138	0.00001
Rahnella aquatilis	34038	S	208	292	500	0.00004
Rahnella inusitata	58169	S	163	42	205	0.00001
Rahnella sp. ERMR1:05	1805933	S	157	22	179	0.00001
Rahnella victoriana	1510570	S	141	21	162	0.00001
Rahnella aceris	2703885	S	32	72	104	0.00001
Yersinia similis	367190	S	25	4	29	0.00000
Yersinia pseudotuberculosis	633	S	21	42	63	0.00000
Yersinia pestis	632	S	11	402	413	0.00003
Yersinia enterocolitica	630	S	87	97	184	0.00001
Yersinia entomophaga	935293	S	66	11	77	0.00001
Yersinia ruckeri	29486	S	64	11	75	0.00001
Yersinia aldovae	29483	S	43	9	52	0.00000
Yersinia frederiksenii	29484	S	42	42	84	0.00001
Yersinia mollaretii	33060	S	42	9	51	0.00000
Yersinia rohdei	29485	S	36	6	42	0.00000
Yersinia aleksiciae	263819	S	29	7	36	0.00000
Yersinia canariae	2607663	S	28	10	38	0.00000
Yersinia kristensenii	28152	S	23	75	98	0.00001
Yersinia intermedia	631	S	11	40	51	0.00000
Yersinia hibernica	2339259	S	10	19	29	0.00000
Nissabacter sp. SGAir0207	2126321	S	532	74	606	0.00004
Gibbsiella quercinecans	929813	S	293	40	333	0.00002
Ewingella americana	41202	S	191	26	217	0.00002
Rouxiella badensis	1646377	S	171	15	186	0.00001
Chania multitudinisentens	1639108	S	92	10	102	0.00001
Candidatus Fukatsuia symbiotica	1878942	S	34	1	35	0.00000
Pantoea sp. Z09	2886821	S	406	118	524	0.00004
Pantoea sp. SO10	2575375	S	250	42	292	0.00002
Pantoea sp. At-9b	592316	S	164	30	194	0.00001
Pantoea sp. MSR2	2052056	S	152	17	169	0.00001
Pantoea sp. CCBC3-3-1	2490851	S	130	24	154	0.00001
Pantoea sp. SM3640	2787629	S	16	105	121	0.00001
Pantoea sp. MT58	2768165	S	14	99	113	0.00001
Pantoea agglomerans	549	S	935	267	1202	0.00009
Pantoea dispersa	59814	S	731	178	909	0.00006
Pantoea vagans	470934	S	258	357	615	0.00004
Pantoea ananatis	553	S	241	79	320	0.00002
Pantoea deleyi	470932	S	230	49	279	0.00002
Pantoea alhagi	1891675	S	160	53	213	0.00002
Pantoea stewartii	66269	S	158	35	193	0.00001
Pantoea cypripedii	55209	S	132	8	140	0.00001
Pantoea rwandensis	1076550	S	124	24	148	0.00001
Pantoea eucalypti	470933	S	12	78	90	0.00001
Candidatus Pantoea carbekii	1235990	S	10	0	10	0.00000
Erwinia sp. E602	2675378	S	423	69	492	0.00004
Erwinia sp. J780	2681984	S	99	17	116	0.00001
Erwinia sp. Ejp617	215689	S	30	53	83	0.00001
Erwinia sp. QL-Z3	2547962	S	27	81	108	0.00001
Erwinia gerundensis	1619313	S	273	47	320	0.00002
Erwinia persicina	55211	S	152	29	181	0.00001
Erwinia rhapontici	55212	S	141	25	166	0.00001
Erwinia amylovora	552	S	117	44	161	0.00001
Erwinia tasmaniensis	338565	S	106	19	125	0.00001
Erwinia billingiae	182337	S	92	168	260	0.00002
Erwinia tracheiphila	65700	S	83	10	93	0.00001
Candidatus Erwinia haradaeae	1922217	S	62	1	63	0.00000
[Pantoea] beijingensis	1324864	S	58	9	67	0.00000
Erwinia pyrifoliae	79967	S	20	33	53	0.00000
Mixta gaviniae	665914	S	246	93	339	0.00002
Mixta calida	665913	S	234	121	355	0.00003
Mixta theicola	1458355	S	196	61	257	0.00002
Mixta sp. X22927	2872648	S	164	86	250	0.00002
Mixta intestinalis	1615494	S	118	32	150	0.00001
Buchnera aphidicola	9	S	213	22	235	0.00002
Tatumella ptyseos	82987	S	56	8	64	0.00000
Tatumella citrea	53336	S	39	4	43	0.00000
Dickeya dadantii	204038	S	317	200	517	0.00004
Dickeya zeae	204042	S	240	194	434	0.00003
Dickeya chrysanthemi	556	S	218	22	240	0.00002
Dickeya dianthicola	204039	S	203	143	346	0.00002
Dickeya fangzhongdai	1778540	S	109	359	468	0.00003
Dickeya poaceiphila	568768	S	83	12	95	0.00001
Dickeya solani	1089444	S	73	319	392	0.00003
Dickeya sp. NCPPB 3274	568766	S	46	26	72	0.00001
Pectobacterium carotovorum	554	S	149	348	497	0.00004
Pectobacterium brasiliense	180957	S	138	171	309	0.00002
Pectobacterium sp. LJ1	2878098	S	56	15	71	0.00001
Pectobacterium sp. PL64	2738983	S	27	18	45	0.00000
Pectobacterium atrosepticum	29471	S	82	25	107	0.00001
Pectobacterium polaris	2042057	S	58	43	101	0.00001
Pectobacterium parmentieri	1905730	S	57	16	73	0.00001
Pectobacterium wasabiae	55208	S	56	17	73	0.00001
Pectobacterium punjabense	2108399	S	45	11	56	0.00000
Pectobacterium odoriferum	78398	S	40	31	71	0.00001
Pectobacterium versatile	2488639	S	32	77	109	0.00001
Pectobacterium quasiaquaticum	2774015	S	27	27	54	0.00000
Pectobacterium parvum	2778550	S	25	35	60	0.00000
Pectobacterium aroidearum	1201031	S	16	26	42	0.00000
Brenneria izadpanahii	2722756	S	245	248	493	0.00004
Brenneria goodwinii	1109412	S	162	158	320	0.00002
Brenneria rubrifaciens	55213	S	147	52	199	0.00001
Lonsdalea populi	1172565	S	223	55	278	0.00002
Lonsdalea britannica	1082704	S	160	36	196	0.00001
Musicola paradisiaca	69223	S	204	44	248	0.00002
Morganella morganii	582	S	454	375	829	0.00006
Providencia rettgeri	587	S	112	169	281	0.00002
Providencia alcalifaciens	126385	S	53	19	72	0.00001
Providencia sp. R33	2828763	S	30	5	35	0.00000
Providencia heimbachae	333962	S	29	9	38	0.00000
Providencia rustigianii	158850	S	25	7	32	0.00000
Providencia sneebia	516075	S	24	1	25	0.00000
Providencia vermicola	333965	S	15	63	78	0.00001
Xenorhabdus bovienii	40576	S	79	17	96	0.00001
Xenorhabdus doucetiae	351671	S	62	8	70	0.00001
Xenorhabdus budapestensis	290110	S	30	3	33	0.00000
Xenorhabdus poinarii	40577	S	29	5	34	0.00000
Xenorhabdus nematophila	628	S	28	4	32	0.00000
Xenorhabdus hominickii	351679	S	28	4	32	0.00000
Photorhabdus laumondii	2218628	S	75	16	91	0.00001
Photorhabdus thracensis	230089	S	63	11	74	0.00001
Photorhabdus akhurstii	171438	S	30	5	35	0.00000
Photorhabdus asymbiotica	291112	S	23	2	25	0.00000
Proteus mirabilis	584	S	45	77	122	0.00001
Proteus vulgaris	585	S	21	27	48	0.00000
Proteus terrae	1574161	S	10	96	106	0.00001
Arsenophonus endosymbiont of Apis mellifera	1541805	S	12	3	15	0.00000
Arsenophonus nasoniae	638	S	20	5	25	0.00000
Moellerella wisconsensis	158849	S	29	18	47	0.00000
Edwardsiella tarda	636	S	313	218	531	0.00004
Edwardsiella hoshinae	93378	S	174	38	212	0.00002
Edwardsiella ictaluri	67780	S	154	82	236	0.00002
Edwardsiella piscicida	1263550	S	28	470	498	0.00004
Hafnia alvei	569	S	92	109	201	0.00001
Hafnia paralvei	546367	S	33	12	45	0.00000
Obesumbacterium proteus	82983	S	26	16	42	0.00000
Sodalis sp. dw_23	2697027	S	368	20	388	0.00003
Sodalis endosymbiont of Henestaris halophilus	1929246	S	15	0	15	0.00000
Sodalis praecaptivus	1239307	S	217	138	355	0.00003
Sodalis glossinidius	63612	S	170	21	191	0.00001
Candidatus Sodalis pierantonius	1486991	S	83	57	140	0.00001
Leminorella richardii	158841	S	100	13	113	0.00001
Pragia fontium	82985	S	37	7	44	0.00000
Limnobaculum parvum	2172103	S	21	13	34	0.00000
Jinshanibacter zhutongyuii	2498113	S	21	11	32	0.00000
Thioalkalivibrio sulfidiphilus	1033854	S	2022	1126	3148	0.00022
Thioalkalivibrio paradoxus	108010	S	1525	496	2021	0.00014
Thioalkalivibrio nitratireducens	186931	S	1503	448	1951	0.00014
Thioalkalivibrio sp. K90mix	396595	S	1290	179	1469	0.00010
Thioalkalivibrio versutus	106634	S	1159	168	1327	0.00009
Spiribacter sp. E85	2182432	S	3009	325	3334	0.00024
Spiribacter sp. 2438	2666185	S	672	81	753	0.00005
Spiribacter curvatus	1335757	S	792	50	842	0.00006
Spiribacter salinus	1335746	S	600	55	655	0.00005
Acidihalobacter aeolianus	2792603	S	1520	200	1720	0.00012
Acidihalobacter ferrooxydans	1765967	S	1324	123	1447	0.00010
Acidihalobacter yilgarnensis	2819280	S	818	55	873	0.00006
Halorhodospira halophila	1053	S	1451	185	1636	0.00012
Halorhodospira halochloris	1052	S	269	13	282	0.00002
Ectothiorhodospira sp. BSL-9	1442136	S	642	246	888	0.00006
Ectothiorhodospira haloalkaliphila	421628	S	604	235	839	0.00006
Aquisalimonas sp. 2447	2740807	S	1476	124	1600	0.00011
Alkalilimnicola ehrlichii	351052	S	1380	205	1585	0.00011
Ectothiorhodosinus mongolicus	233100	S	243	19	262	0.00002
Allochromatium vinosum	1049	S	1112	511	1623	0.00012
Allochromatium tepidum	553982	S	1074	599	1673	0.00012
Candidatus Thiodictyon syntrophicum	1166950	S	2104	116	2220	0.00016
Thioflavicoccus mobilis	80679	S	2057	184	2241	0.00016
Marichromatium purpuratum	37487	S	2031	400	2431	0.00017
Thiocapsa bogorovii	521689	S	1748	97	1845	0.00013
Thiocystis violascens	73141	S	1301	110	1411	0.00010
Thermochromatium tepidum	1050	S	836	212	1048	0.00007
Caldichromatium japonicum	2699430	S	556	61	617	0.00004
Nitrosococcus halophilus	133539	S	133	11	144	0.00001
Nitrosococcus watsonii	473531	S	131	20	151	0.00001
Nitrosococcus wardiae	1814290	S	123	10	133	0.00001
Nitrosococcus oceani	1229	S	106	15	121	0.00001
Rheinheimera sp. F8	1763998	S	106	5	111	0.00001
Rheinheimera sp. D18	2545632	S	26	18	44	0.00000
Rheinheimera mangrovi	2498451	S	51	5	56	0.00000
Candidatus Nitrosoglobus terrae	1630141	S	51	3	54	0.00000
Candidatus Nitrosacidococcus tergens	553981	S	37	1	38	0.00000
Wenzhouxiangella marina	1579979	S	1652	110	1762	0.00013
Wenzhouxiangella sp. AB-CW3	2771012	S	1091	52	1143	0.00008
Thiohalobacter sp. COW1	2795687	S	386	921	1307	0.00009
Thiohalobacter thiocyanaticus	585455	S	320	949	1269	0.00009
Sulfurivermis fontis	1972068	S	1722	622	2344	0.00017
Guyparkeria halophila	47960	S	1546	362	1908	0.00014
Woeseia oceani	1548547	S	1284	21	1305	0.00009
Halothiobacillus sp. LS2	1860122	S	767	107	874	0.00006
Halothiobacillus neapolitanus	927	S	292	45	337	0.00002
Sulfuriflexus mobilis	1811807	S	423	13	436	0.00003
Granulosicoccus antarcticus	437505	S	327	5	332	0.00002
Halomonas sp. THAF5a	2587844	S	947	345	1292	0.00009
Halomonas sp. 1513	1883416	S	945	200	1145	0.00008
Halomonas sp. MCCC 1A13316	2733487	S	817	98	915	0.00007
Halomonas sp. YLGW01	2773308	S	800	120	920	0.00007
Halomonas sp. HG01	1609967	S	753	339	1092	0.00008
Halomonas sp. THAF12	2587849	S	743	479	1222	0.00009
Halomonas sp. JS92-SW72	2306583	S	684	838	1522	0.00011
Halomonas sp. PGE1	2730360	S	465	678	1143	0.00008
Halomonas sp. Y2R2	2562282	S	303	14	317	0.00002
Halomonas sp. A40-4	2785909	S	296	72	368	0.00003
Halomonas sp. SH5A2	2749040	S	237	38	275	0.00002
Halomonas sp. R57-5	1610576	S	186	78	264	0.00002
Halomonas sp. KO116	1504981	S	148	59	207	0.00001
Halomonas sp. 18071143	2855441	S	132	287	419	0.00003
Halomonas sp. GFAJ-1	1118153	S	124	20	144	0.00001
Halomonas sp. FeN2	2832500	S	118	52	170	0.00001
Halomonas sp. SF2003	2136172	S	111	512	623	0.00004
Halomonas sp. SS10-MC5	2854257	S	101	927	1028	0.00007
Halomonas sp. NyZ770	2883106	S	83	354	437	0.00003
Halomonas sp. TD01	999141	S	51	27	78	0.00001
Halomonas sp. HL-93	1666906	S	47	344	391	0.00003
Halomonas sp. GT	1971364	S	37	27	64	0.00000
Halomonas sp. N3-2A	2014541	S	34	44	78	0.00001
Halomonas sp. hl-4	1761789	S	28	198	226	0.00002
Halomonas sp. A3H3	1346287	S	16	443	459	0.00003
Halomonas beimenensis	475662	S	1148	203	1351	0.00010
Halomonas aestuarii	1897729	S	950	183	1133	0.00008
Halomonas socia	1081866	S	841	151	992	0.00007
Halomonas sulfidivorans	2733488	S	839	160	999	0.00007
Halomonas tianxiuensis	2497861	S	835	177	1012	0.00007
Halomonas elongata	2746	S	758	69	827	0.00006
Halomonas chromatireducens	507626	S	626	45	671	0.00005
Halomonas subglaciescola	29571	S	453	42	495	0.00004
Halomonas huangheensis	1178482	S	433	21	454	0.00003
Halomonas meridiana	29570	S	398	298	696	0.00005
Halomonas piezotolerans	2609667	S	309	158	467	0.00003
Halomonas profundi	2852117	S	122	15	137	0.00001
Halomonas sulfidoxydans	2733484	S	81	731	812	0.00006
Halomonas titanicae	664683	S	80	413	493	0.00004
Halomonas hydrothermalis	115561	S	80	234	314	0.00002
Halomonas venusta	44935	S	57	73	130	0.00001
Halomonas campaniensis	213554	S	32	155	187	0.00001
Cobetia sp. L2A1	2686360	S	333	37	370	0.00003
Cobetia sp. cqz5-12	2609415	S	144	193	337	0.00002
Cobetia sp. AM6	2661553	S	88	490	578	0.00004
Cobetia sp. 4B	2758724	S	75	316	391	0.00003
Cobetia pacifica	1055101	S	92	261	353	0.00003
Cobetia amphilecti	1055104	S	61	371	432	0.00003
Cobetia marina	28258	S	11	136	147	0.00001
Halotalea alkalilenta	376489	S	1314	216	1530	0.00011
Salinicola tamaricis	1771309	S	1142	115	1257	0.00009
Kushneria phosphatilytica	657387	S	388	12	400	0.00003
Kushneria konosiri	698828	S	301	57	358	0.00003
Kushneria marisflavi	157779	S	293	54	347	0.00002
Chromohalobacter salexigens	158080	S	973	93	1066	0.00008
Pistricoccus aurantiacus	1883414	S	614	36	650	0.00005
Zymobacter palmae	33074	S	204	24	228	0.00002
Candidatus Portiera aleyrodidarum	91844	S	48	80	128	0.00001
Alcanivorax sp. N3-2A	2014542	S	1073	947	2020	0.00014
Alcanivorax sp. NBRC 101098	1113728	S	21	237	258	0.00002
Alcanivorax pacificus	1306787	S	1004	321	1325	0.00009
Alcanivorax xenomutans	1094342	S	462	199	661	0.00005
Alcanivorax dieselolei	285091	S	436	113	549	0.00004
Alcanivorax borkumensis	59754	S	11	120	131	0.00001
Ketobacter alkanivorans	1917421	S	189	16	205	0.00001
Marinobacterium aestuarii	1821621	S	579	40	619	0.00004
Marinobacterium sediminicola	518898	S	290	48	338	0.00002
Marinobacterium georgiense	48076	S	257	78	335	0.00002
Marinobacterium sp. LSUCC0821	2668067	S	40	2	42	0.00000
Marinomonas sp. A3A	2065312	S	45	5	50	0.00000
Marinomonas sp. CT5	2066133	S	27	2	29	0.00000
Marinomonas sp. FW-1	2071621	S	21	4	25	0.00000
Marinomonas mediterranea	119864	S	55	4	59	0.00000
Marinomonas arctica	383750	S	55	9	64	0.00000
Marinomonas algicola	2773454	S	54	9	63	0.00000
Marinomonas profundi	2726122	S	47	11	58	0.00000
Marinomonas primoryensis	178399	S	42	4	46	0.00000
Marinomonas foliarum	491950	S	24	6	30	0.00000
Marinomonas posidonica	936476	S	17	1	18	0.00000
Thalassolituus sp. C2-1	2597518	S	148	12	160	0.00001
Thalassolituus oleivorans	187493	S	83	21	104	0.00001
Venatorbacter cucullus	2661630	S	210	47	257	0.00002
Bacterioplanes sanyensis	1249553	S	172	9	181	0.00001
Nitrincola iocasae	2614693	S	112	18	130	0.00001
Neptunomonas concharum	1031538	S	36	3	39	0.00000
Neptunomonas phycophila	1572645	S	33	2	35	0.00000
Neptunomonas japonica	417574	S	32	2	34	0.00000
Amphritea japonica	452627	S	64	4	68	0.00000
Bermanella marisrubri	207949	S	53	2	55	0.00000
Saccharospirillum mangrovi	2161747	S	496	26	522	0.00004
Reinekea forsetii	1336806	S	211	9	220	0.00002
Gynuella sunshinyii	1445505	S	143	3	146	0.00001
Hahella chejuensis	158327	S	352	60	412	0.00003
Hahella sp. KA22	1628392	S	273	53	326	0.00002
Litoricola lipolytica	418701	S	307	12	319	0.00002
Oleiphilus messinensis	141451	S	116	9	125	0.00001
Endozoicomonas montiporae	1027273	S	91	4	95	0.00001
Spartinivicinus ruber	2683272	S	39	1	40	0.00000
Steroidobacter denitrificans	465721	S	9994	2452	12446	0.00089
Solimonas sp. K1W22B-7	2303331	S	4285	374	4659	0.00033
Flagellatimonas centrodinii	2806210	S	1480	97	1577	0.00011
Sinimarinibacterium sp. NLF-5-8	2698684	S	814	390	1204	0.00009
Methylococcus sp. EFPC2	2812648	S	1432	87	1519	0.00011
Methylococcus sp. Mc7	2860258	S	1265	417	1682	0.00012
Methylococcus capsulatus	414	S	1022	244	1266	0.00009
Methylococcus geothermalis	2681310	S	1014	284	1298	0.00009
Methylomonas sp. LL1	2785785	S	419	17	436	0.00003
Methylomonas sp. LW13	107637	S	191	110	301	0.00002
Methylomonas sp. EFPC1	2812647	S	186	114	300	0.00002
Methylomonas sp. DH-1	1727196	S	166	323	489	0.00003
Methylomonas koyamae	702114	S	378	395	773	0.00006
Methylomonas rhizoryzae	2608981	S	370	13	383	0.00003
Methylomonas denitrificans	1538553	S	342	23	365	0.00003
Methylomonas methanica	421	S	273	13	286	0.00002
Methylomonas paludis	1173101	S	109	4	113	0.00001
Methylomicrobium album	39775	S	1234	44	1278	0.00009
Methylomicrobium sp. wino1	2049332	S	233	220	453	0.00003
Methylomagnum ishizawai	1760988	S	1453	55	1508	0.00011
Methylogaea oryzae	1295382	S	1418	95	1513	0.00011
Methylocaldum marinum	1432792	S	1215	63	1278	0.00009
Candidatus Methylospira mobilis	1808979	S	497	18	515	0.00004
Methylotuvimicrobium buryatense	95641	S	168	182	350	0.00003
Methylotuvimicrobium alcaliphilum	271065	S	108	140	248	0.00002
Methylovulum psychrotolerans	1704499	S	197	4	201	0.00001
Methylobacter sp. S3L5C	2839024	S	89	4	93	0.00001
Aeromonas sp. FDAARGOS 1415	2778064	S	256	133	389	0.00003
Aeromonas sp. CA23	2033032	S	179	72	251	0.00002
Aeromonas sp. FDAARGOS 1409	2778058	S	170	237	407	0.00003
Aeromonas sp. CU5	2033033	S	139	55	194	0.00001
Aeromonas sp. FDAARGOS 1410	2778059	S	54	123	177	0.00001
Aeromonas sp. FDAARGOS 1405	2778054	S	54	88	142	0.00001
Aeromonas sp. FDAARGOS 1407	2778056	S	45	129	174	0.00001
Aeromonas sp. ASNIH4	1636609	S	39	170	209	0.00001
Aeromonas sp. 2692-1	2560029	S	38	180	218	0.00002
Aeromonas sp. FDAARGOS 1417	2778066	S	23	64	87	0.00001
Aeromonas sp. 1805	2560028	S	21	57	78	0.00001
Aeromonas sp. FDAARGOS 1402	2778051	S	21	196	217	0.00002
Aeromonas sp. FDAARGOS 1403	2778052	S	20	59	79	0.00001
Aeromonas sp. FDAARGOS 1419	2778068	S	19	55	74	0.00001
Aeromonas sp. FDAARGOS 1408	2778057	S	17	93	110	0.00001
Aeromonas sp. FDAARGOS 1404	2778053	S	16	53	69	0.00000
Aeromonas sp. ASNIH1	1636606	S	13	221	234	0.00002
Aeromonas sp. FDAARGOS 1406	2778055	S	11	101	112	0.00001
Aeromonas sp. FDAARGOS 1411	2778060	S	11	34	45	0.00000
Aeromonas sp. FDAARGOS 1416	2778065	S	11	31	42	0.00000
Aeromonas sp. ASNIH2	1636607	S	11	135	146	0.00001
Aeromonas sp. ASNIH3	1636608	S	10	441	451	0.00003
Aeromonas hydrophila	644	S	1150	2431	3581	0.00026
Aeromonas media	651	S	982	1737	2719	0.00019
Aeromonas veronii	654	S	779	1603	2382	0.00017
Aeromonas schubertii	652	S	598	158	756	0.00005
Aeromonas encheleia	73010	S	576	183	759	0.00005
Aeromonas salmonicida	645	S	494	2159	2653	0.00019
Aeromonas simiae	218936	S	419	352	771	0.00006
Aeromonas caviae	648	S	403	2947	3350	0.00024
Aeromonas enteropelogenes	29489	S	295	229	524	0.00004
Aeromonas rivuli	648794	S	289	73	362	0.00003
Aeromonas jandaei	650	S	226	223	449	0.00003
Aeromonas dhakensis	196024	S	224	433	657	0.00005
Aeromonas sanarellii	633415	S	96	441	537	0.00004
Aeromonas rivipollensis	948519	S	52	79	131	0.00001
Aeromonas allosaccharophila	656	S	32	48	80	0.00001
Zobellella denitrificans	347534	S	884	197	1081	0.00008
Oceanimonas sp. GK1	511062	S	448	92	540	0.00004
Oceanisphaera profunda	1416627	S	70	8	78	0.00001
Oceanisphaera avium	1903694	S	55	8	63	0.00000
Dongshaea marina	2047966	S	109	8	117	0.00001
Tolumonas auensis	43948	S	96	37	133	0.00001
Succinivibrio dextrinosolvens	83771	S	32	1	33	0.00000
Microbulbifer sp. YPW16	2904242	S	628	60	688	0.00005
Microbulbifer sp. SH-1	2681547	S	616	101	717	0.00005
Microbulbifer sp. YPW1	2745199	S	376	76	452	0.00003
Microbulbifer sp. ALW1	1516059	S	317	58	375	0.00003
Microbulbifer sp. A4B17	359370	S	149	38	187	0.00001
Microbulbifer sp. THAF38	2587856	S	122	50	172	0.00001
Microbulbifer sp. GL-2	2591606	S	121	22	143	0.00001
Microbulbifer aggregans	1769779	S	454	60	514	0.00004
Microbulbifer hydrolyticus	48074	S	405	91	496	0.00004
Microbulbifer thermotolerans	252514	S	391	24	415	0.00003
Microbulbifer celer	435905	S	338	49	387	0.00003
Microbulbifer elongatus	86173	S	319	63	382	0.00003
Microbulbifer agarilyticus	260552	S	241	32	273	0.00002
Microbulbifer variabilis	266805	S	94	45	139	0.00001
Cellvibrio sp. PSBB006	1987723	S	551	19	570	0.00004
Cellvibrio sp. KY-GH-1	2303332	S	276	26	302	0.00002
Cellvibrio sp. KY-YJ-3	454662	S	251	42	293	0.00002
Cellvibrio sp. PSBB023	1945512	S	225	25	250	0.00002
Cellvibrio japonicus	155077	S	273	20	293	0.00002
Simiduia agarivorans	447471	S	407	20	427	0.00003
Teredinibacter turnerae	2426	S	183	8	191	0.00001
Teredinibacter purpureus	2731756	S	84	4	88	0.00001
Teredinibacter haidensis	2731755	S	77	8	85	0.00001
Saccharophagus degradans	86304	S	72	2	74	0.00001
Marinagarivorans sp. GE09	2721545	S	65	7	72	0.00001
Agarilytica rhodophyticola	1737490	S	48	1	49	0.00000
Kineobactrum salinum	2708301	S	886	30	916	0.00007
Halioglobus japonicus	930805	S	410	21	431	0.00003
Halioglobus maricola	2601894	S	353	14	367	0.00003
Congregibacter litoralis	393662	S	393	139	532	0.00004
Aequoribacter fuscus	2518989	S	105	12	117	0.00001
Spongiibacter taiwanensis	1748242	S	348	18	366	0.00003
Spongiibacter nanhainus	2794344	S	264	34	298	0.00002
Spongiibacter sp. IMCC21906	1620392	S	103	32	135	0.00001
Zhongshania aliphaticivorans	1470434	S	135	12	147	0.00001
Oceanicoccus sagamiensis	716816	S	91	1	92	0.00001
Shewanella sp. FJAT-53555	2864204	S	58	50	108	0.00001
Shewanella sp. FJAT-52072	2864213	S	45	60	105	0.00001
Shewanella sp. FJAT-51860	2864212	S	43	6	49	0.00000
Shewanella sp. FJAT-53532	2864203	S	40	69	109	0.00001
Shewanella sp. FJAT-53681	2864205	S	39	63	102	0.00001
Shewanella sp. FJAT-53764	2864207	S	39	61	100	0.00001
Shewanella sp. FJAT-54031	2864209	S	38	57	95	0.00001
Shewanella sp. KX20019	2803864	S	37	4	41	0.00000
Shewanella sp. FJAT-52076	2864202	S	35	49	84	0.00001
Shewanella sp. WE21	2029986	S	32	16	48	0.00000
Shewanella sp. Scap07	2589987	S	32	3	35	0.00000
Shewanella sp. FJAT-53870	2864208	S	32	5	37	0.00000
Shewanella sp. FJAT-53749	2864206	S	25	4	29	0.00000
Shewanella sp. SNU WT4	2590015	S	24	5	29	0.00000
Shewanella sp. Arc9-LZ	2698686	S	23	9	32	0.00000
Shewanella sp. OM3-2	2908650	S	17	2	19	0.00000
Shewanella sp. MR-4	60480	S	14	15	29	0.00000
Shewanella sp. FJAT-51754	2864211	S	13	19	32	0.00000
Shewanella sp. FJAT-51649	2864210	S	12	18	30	0.00000
Shewanella sp. ANA-3	94122	S	11	28	39	0.00000
Shewanella sp. Pdp11	2059264	S	10	29	39	0.00000
Shewanella cyperi	2814292	S	181	97	278	0.00002
Shewanella algae	38313	S	171	144	315	0.00002
Shewanella khirikhana	1965282	S	170	24	194	0.00001
Shewanella putrefaciens	24	S	104	335	439	0.00003
Shewanella litorisediminis	1173586	S	103	23	126	0.00001
Shewanella baltica	62322	S	97	155	252	0.00002
Shewanella marisflavi	260364	S	90	16	106	0.00001
Shewanella avicenniae	2814294	S	88	12	100	0.00001
Shewanella amazonensis	60478	S	85	20	105	0.00001
Shewanella sedimentimangrovi	2814293	S	84	63	147	0.00001
Shewanella dokdonensis	712036	S	74	6	80	0.00001
Shewanella loihica	359303	S	70	121	191	0.00001
Shewanella yunxiaonensis	2829809	S	64	8	72	0.00001
Shewanella benthica	43661	S	54	11	65	0.00000
Shewanella denitrificans	192073	S	51	6	57	0.00000
Shewanella psychromarinicola	2487742	S	49	6	55	0.00000
Shewanella sediminis	271097	S	44	5	49	0.00000
Shewanella psychrophila	225848	S	43	5	48	0.00000
Shewanella decolorationis	256839	S	43	48	91	0.00001
Shewanella halifaxensis	271098	S	42	5	47	0.00000
Shewanella psychropiezotolerans	2593655	S	40	7	47	0.00000
Shewanella woodyi	60961	S	37	3	40	0.00000
Shewanella oneidensis	70863	S	37	10	47	0.00000
Shewanella xiamenensis	332186	S	33	165	198	0.00001
Shewanella carassii	1987584	S	33	36	69	0.00000
Shewanella pealeana	70864	S	33	5	38	0.00000
Shewanella donghaensis	238836	S	32	3	35	0.00000
Shewanella inventionis	1738770	S	28	13	41	0.00000
Shewanella chilikensis	558541	S	26	71	97	0.00001
Shewanella violacea	60217	S	26	4	30	0.00000
Shewanella aestuarii	1028752	S	25	8	33	0.00000
Shewanella piezotolerans	404011	S	24	2	26	0.00000
Shewanella maritima	2520507	S	21	1	22	0.00000
Shewanella indica	768528	S	21	29	50	0.00000
Shewanella vesiculosa	518738	S	20	5	25	0.00000
Shewanella livingstonensis	150120	S	18	3	21	0.00000
Shewanella frigidimarina	56812	S	17	9	26	0.00000
Shewanella glacialimarina	2590884	S	13	1	14	0.00000
Shewanella bicestrii	2018305	S	10	38	48	0.00000
Parashewanella spongiae	342950	S	28	1	29	0.00000
Parashewanella tropica	2547970	S	16	1	17	0.00000
Alteromonas sp. RKMC-009	2267264	S	87	10	97	0.00001
Alteromonas sp. BL110	1714845	S	33	7	40	0.00000
Alteromonas sp. RW2A1	1917158	S	16	92	108	0.00001
Alteromonas sp. 76-1	2358187	S	15	7	22	0.00000
Alteromonas macleodii	28108	S	131	60	191	0.00001
Alteromonas mediterranea	314275	S	72	41	113	0.00001
Alteromonas pelagimontana	1858656	S	61	7	68	0.00000
Alteromonas australica	589873	S	23	59	82	0.00001
Alteromonas naphthalenivorans	715451	S	10	7	17	0.00000
Salinimonas lutimaris	914153	S	111	21	132	0.00001
Salinimonas marina	2785918	S	78	8	86	0.00001
Salinimonas iocasae	2572577	S	63	14	77	0.00001
Salinimonas sediminis	2303538	S	59	13	72	0.00001
Hydrocarboniclastica marina	2259620	S	414	50	464	0.00003
Paraglaciecola sp. L1A13	2686359	S	42	3	45	0.00000
Paraglaciecola sp. L3A3	2686358	S	30	2	32	0.00000
Paraglaciecola mesophila	197222	S	41	5	46	0.00000
Paraglaciecola psychrophila	326544	S	28	2	30	0.00000
Lacimicrobium alkaliphilum	1526571	S	141	9	150	0.00001
Agarivorans gilvus	680279	S	38	3	41	0.00000
Agarivorans sp. TSD2052	2937286	S	30	4	34	0.00000
Agarivorans aestuarii	1563703	S	18	8	26	0.00000
Agarivorans albus	182262	S	10	11	21	0.00000
Saliniradius amylolyticus	2183582	S	103	9	112	0.00001
Paraneptunicella aestuarii	2831148	S	57	3	60	0.00000
Glaciecola nitratireducens	300231	S	36	3	39	0.00000
Saccharobesus litoralis	2172099	S	27	1	28	0.00000
Catenovulum sediminis	1740262	S	25	1	26	0.00000
Pseudoalteromonas sp. R3	1709477	S	46	7	53	0.00000
Pseudoalteromonas sp. A25	116092	S	33	4	37	0.00000
Pseudoalteromonas sp. THAF3	2587843	S	28	36	64	0.00000
Pseudoalteromonas sp. DL-6	1390185	S	11	34	45	0.00000
Pseudoalteromonas rubra	43658	S	150	17	167	0.00001
Pseudoalteromonas luteoviolacea	43657	S	62	8	70	0.00001
Pseudoalteromonas viridis	339617	S	59	17	76	0.00001
Pseudoalteromonas piscicida	43662	S	51	59	110	0.00001
Pseudoalteromonas shioyasakiensis	1190813	S	39	15	54	0.00000
Pseudoalteromonas xiamenensis	882626	S	37	3	40	0.00000
Pseudoalteromonas spongiae	298657	S	35	6	41	0.00000
Pseudoalteromonas ulvae	107327	S	30	1	31	0.00000
Pseudoalteromonas mariniglutinosa	206042	S	25	61	86	0.00001
Pseudoalteromonas piratica	1348114	S	24	3	27	0.00000
Pseudoalteromonas tunicata	314281	S	24	3	27	0.00000
Pseudoalteromonas aliena	247523	S	22	8	30	0.00000
Pseudoalteromonas translucida	166935	S	18	78	96	0.00001
Pseudoalteromonas carrageenovora	227	S	17	6	23	0.00000
Pseudoalteromonas prydzensis	182141	S	17	3	20	0.00000
Pseudoalteromonas ruthenica	151081	S	16	20	36	0.00000
Pseudoalteromonas espejiana	28107	S	15	4	19	0.00000
Pseudoalteromonas phenolica	161398	S	14	1	15	0.00000
Pseudoalteromonas agarivorans	176102	S	12	35	47	0.00000
Pseudoalteromonas distincta	77608	S	10	38	48	0.00000
Psychrosphaera ytuae	2820710	S	24	4	28	0.00000
Psychrosphaera aestuarii	1266052	S	16	2	18	0.00000
Flocculibacter collagenilyticus	2744479	S	30	2	32	0.00000
Ferrimonas balearica	44012	S	455	53	508	0.00004
Ferrimonas lipolytica	2724191	S	76	10	86	0.00001
Colwellia sp. PAMC 20917	1816218	S	31	3	34	0.00000
Colwellia sp. Arc7-635	2497879	S	28	5	33	0.00000
Colwellia sp. MT41	58049	S	23	3	26	0.00000
Colwellia sp. Arc7-D	2161872	S	21	6	27	0.00000
Colwellia sp. 20A7	2689569	S	16	2	18	0.00000
Colwellia psychrerythraea	28229	S	27	3	30	0.00000
Thalassotalea sp. PS06	2594005	S	48	5	53	0.00000
Thalassotalea sp. HSM 43	2552945	S	25	2	27	0.00000
Thalassotalea sp. LPB0316	2769490	S	25	6	31	0.00000
Thalassotalea crassostreae	1763536	S	21	2	23	0.00000
Cognaticolwellia beringensis	1967665	S	27	6	33	0.00000
Litorilituus sediminis	718192	S	18	1	19	0.00000
Idiomarina sp. OT37-5b	2100422	S	88	17	105	0.00001
Idiomarina sp. X4	2055892	S	23	11	34	0.00000
Idiomarina abyssalis	86102	S	41	5	46	0.00000
Idiomarina loihiensis	135577	S	38	0	38	0.00000
Idiomarina piscisalsi	1096243	S	23	10	33	0.00000
Moritella sp. 24	2746230	S	24	25	49	0.00000
Moritella yayanosii	69539	S	30	12	42	0.00000
Moritella marina	90736	S	19	7	26	0.00000
Psychromonas ingrahamii	357794	S	54	5	59	0.00000
Psychromonas sp. CNPT3	314282	S	16	2	18	0.00000
Sulfurifustis variabilis	1675686	S	4779	270	5049	0.00036
Sulfuricaulis limicola	1620215	S	2526	175	2701	0.00019
Acidiferrobacter sp. SPIII_3	1281578	S	663	176	839	0.00006
Acidiferrobacter thiooxydans	163359	S	600	161	761	0.00005
Vibrio parahaemolyticus	670	S	152	66	218	0.00002
Vibrio alginolyticus	663	S	47	156	203	0.00001
Vibrio diabolicus	50719	S	21	38	59	0.00000
Vibrio campbellii	680	S	37	81	118	0.00001
Vibrio owensii	696485	S	36	38	74	0.00001
Vibrio harveyi	669	S	35	17	52	0.00000
Vibrio rotiferianus	190895	S	35	18	53	0.00000
Vibrio natriegens	691	S	29	62	91	0.00001
Vibrio azureus	512649	S	22	2	24	0.00000
Vibrio sp. OG9-811	2841925	S	111	17	128	0.00001
Vibrio sp. HDW18	2714948	S	50	9	59	0.00000
Vibrio sp. B1FLJ16	2751178	S	47	11	58	0.00000
Vibrio sp. VB16	2785746	S	30	2	32	0.00000
Vibrio sp. THAF190c	2587865	S	28	4	32	0.00000
Vibrio sp. SS-MA-C1-2	2908646	S	25	3	28	0.00000
Vibrio sp. SCSIO 43132	2779363	S	19	16	35	0.00000
Vibrio sp. Scap24	2589990	S	14	12	26	0.00000
Vibrio sp. ED004	2785124	S	13	12	25	0.00000
Vibrio sp. B1REV9	2751179	S	12	12	24	0.00000
Vibrio fluvialis	676	S	217	48	265	0.00002
Vibrio vulnificus	672	S	216	45	261	0.00002
Vibrio furnissii	29494	S	201	81	282	0.00002
Vibrio cholerae	666	S	142	176	318	0.00002
Vibrio sinaloensis	379097	S	46	6	52	0.00000
Vibrio tubiashii	29498	S	29	14	43	0.00000
Vibrio europaeus	300876	S	23	9	32	0.00000
Vibrio navarrensis	29495	S	104	46	150	0.00001
Vibrio cyclitrophicus	47951	S	93	41	134	0.00001
Vibrio alfacsensis	1074311	S	68	49	117	0.00001
Vibrio coralliilyticus	190893	S	57	44	101	0.00001
Vibrio mimicus	674	S	55	19	74	0.00001
Vibrio penaeicida	104609	S	52	6	58	0.00000
Vibrio mediterranei	689	S	50	5	55	0.00000
Vibrio metoecus	1481663	S	49	28	77	0.00001
Vibrio nigripulchritudo	28173	S	48	22	70	0.00001
Vibrio astriarenae	1481923	S	46	5	51	0.00000
Vibrio zhugei	2479546	S	45	10	55	0.00000
Vibrio algicola	2662262	S	44	6	50	0.00000
Vibrio ponticus	265668	S	42	4	46	0.00000
Vibrio breoganii	553239	S	40	4	44	0.00000
Vibrio splendidus	29497	S	40	20	60	0.00000
Vibrio scophthalmi	45658	S	37	7	44	0.00000
Vibrio gazogenes	687	S	36	4	40	0.00000
Vibrio metschnikovii	28172	S	36	6	42	0.00000
Vibrio spartinae	1918945	S	36	4	40	0.00000
Vibrio maritimus	990268	S	34	3	37	0.00000
Vibrio bathopelagicus	2777577	S	31	11	42	0.00000
Vibrio crassostreae	246167	S	30	23	53	0.00000
Vibrio anguillarum	55601	S	30	12	42	0.00000
Vibrio ziniensis	2711221	S	29	3	32	0.00000
Vibrio tritonius	1435069	S	29	3	32	0.00000
Vibrio tapetis	52443	S	28	2	30	0.00000
Vibrio atlanticus	693153	S	26	13	39	0.00000
Vibrio chagasii	170679	S	26	6	32	0.00000
Vibrio taketomensis	2572923	S	26	3	29	0.00000
Vibrio panuliri	1381081	S	26	3	29	0.00000
Vibrio cincinnatiensis	675	S	22	4	26	0.00000
Vibrio cidicii	1763883	S	21	14	35	0.00000
Vibrio neptunius	170651	S	21	3	24	0.00000
Vibrio kanaloae	170673	S	20	6	26	0.00000
Vibrio rumoiensis	76258	S	19	10	29	0.00000
Vibrio casei	673372	S	18	5	23	0.00000
Vibrio aquimaris	2587862	S	18	1	19	0.00000
Vibrio aphrogenes	1891186	S	14	1	15	0.00000
Vibrio gigantis	296199	S	13	5	18	0.00000
Photobacterium sp. GJ3	2829502	S	115	14	129	0.00001
Photobacterium sp. TLY01	2907534	S	114	19	133	0.00001
Photobacterium ganghwense	320778	S	164	37	201	0.00001
Photobacterium gaetbulicola	1295392	S	148	13	161	0.00001
Photobacterium damselae	38293	S	71	30	101	0.00001
Photobacterium profundum	74109	S	25	2	27	0.00000
Salinivibrio kushneri	1908198	S	58	8	66	0.00000
Salinivibrio sp. YCSC6	2003370	S	19	38	57	0.00000
Salinivibrio costicola	51367	S	15	30	45	0.00000
Grimontia hollisae	673	S	86	10	96	0.00001
Thaumasiovibrio subtropicus	1891207	S	53	6	59	0.00000
Aliivibrio fischeri	668	S	21	4	25	0.00000
Aliivibrio salmonicida	40269	S	11	4	15	0.00000
Paraphotobacterium marinum	1755811	S	11	1	12	0.00000
Acinetobacter baumannii	470	S	378	2071	2449	0.00017
Acinetobacter pittii	48296	S	36	41	77	0.00001
Acinetobacter seifertii	1530123	S	33	11	44	0.00000
Acinetobacter calcoaceticus	471	S	27	2	29	0.00000
Acinetobacter nosocomialis	106654	S	16	5	21	0.00000
Acinetobacter sp. WCHAc010034	1879049	S	171	66	237	0.00002
Acinetobacter sp. CS-2	2798861	S	25	12	37	0.00000
Acinetobacter sp. 10FS3-1	2563897	S	22	13	35	0.00000
Acinetobacter sp. TGL-Y2	1407071	S	21	1	22	0.00000
Acinetobacter sp. ASP199	2773709	S	20	7	27	0.00000
Acinetobacter sp. TTH0-4	1646498	S	19	3	22	0.00000
Acinetobacter sp. LoGeW2-3	1808001	S	15	2	17	0.00000
Acinetobacter sp. Marseille-Q1620	2714110	S	15	1	16	0.00000
Acinetobacter sp. NyZ410	2929509	S	13	12	25	0.00000
Acinetobacter sp. NCu2D-2	1608473	S	12	3	15	0.00000
Acinetobacter sp. AS23	2871688	S	12	18	30	0.00000
Acinetobacter sp. WCHAc010052	2004647	S	10	5	15	0.00000
Acinetobacter indicus	756892	S	124	88	212	0.00002
Acinetobacter johnsonii	40214	S	72	56	128	0.00001
Acinetobacter lwoffii	28090	S	52	54	106	0.00001
Acinetobacter schindleri	108981	S	52	40	92	0.00001
Acinetobacter haemolyticus	29430	S	47	22	69	0.00000
Acinetobacter soli	487316	S	43	3	46	0.00000
Acinetobacter radioresistens	40216	S	35	4	39	0.00000
Acinetobacter guillouiae	106649	S	31	9	40	0.00000
Acinetobacter larvae	1789224	S	30	1	31	0.00000
Acinetobacter variabilis	70346	S	28	33	61	0.00000
Acinetobacter cumulans	2136182	S	22	8	30	0.00000
Acinetobacter bouvetii	202951	S	22	3	25	0.00000
Acinetobacter junii	40215	S	22	7	29	0.00000
Acinetobacter baylyi	202950	S	21	1	22	0.00000
Acinetobacter lanii	2715163	S	20	2	22	0.00000
Acinetobacter wuhouensis	1879050	S	19	8	27	0.00000
Acinetobacter towneri	202956	S	19	36	55	0.00000
Acinetobacter tandoii	202954	S	18	1	19	0.00000
Acinetobacter shaoyimingii	2715164	S	16	1	17	0.00000
Acinetobacter wanghuae	2662362	S	15	1	16	0.00000
Acinetobacter defluvii	1871111	S	13	8	21	0.00000
Acinetobacter piscicola	2006115	S	11	5	16	0.00000
Acinetobacter pseudolwoffii	2053287	S	11	23	34	0.00000
Acinetobacter gyllenbergii	134534	S	10	0	10	0.00000
Acinetobacter equi	1324350	S	10	0	10	0.00000
Acinetobacter ursingii	108980	S	10	7	17	0.00000
Acinetobacter chinensis	2004650	S	10	6	16	0.00000
Psychrobacter sp. DAB_AL43B	1028416	S	20	3	23	0.00000
Psychrobacter sp. 28M-43	2772254	S	18	26	44	0.00000
Psychrobacter sp. P11F6	1699621	S	17	48	65	0.00000
Psychrobacter sp. WY6	2708350	S	17	47	64	0.00000
Psychrobacter sp. P11G3	1699623	S	16	22	38	0.00000
Psychrobacter arenosus	256326	S	24	1	25	0.00000
Psychrobacter urativorans	45610	S	22	3	25	0.00000
Psychrobacter arcticus	334543	S	16	5	21	0.00000
Psychrobacter sanguinis	861445	S	14	5	19	0.00000
Psychrobacter cryohalolentis	330922	S	12	51	63	0.00000
Moraxella osloensis	34062	S	113	21	134	0.00001
Moraxella bovis	476	S	30	10	40	0.00000
Moraxella cuniculi	34061	S	22	2	24	0.00000
Moraxella catarrhalis	480	S	20	4	24	0.00000
Moraxella bovoculi	386891	S	18	44	62	0.00000
Moraxella nonliquefaciens	478	S	17	5	22	0.00000
Moraxella sp. ZY201115	2904121	S	10	1	11	0.00000
Aquirhabdus parva	2283318	S	100	4	104	0.00001
Candidatus Endoriftia persephone	393765	S	733	33	766	0.00005
Candidatus Vesicomyosocius sp. SY067_SCS001	2732590	S	10	22	32	0.00000
Bathymodiolus thermophilus thioautotrophic gill symbiont	2360	S	19	1	20	0.00000
Bathymodiolus septemdierum thioautotrophic gill symbiont	113267	S	19	3	22	0.00000
Candidatus Ruthia magnifica	386487	S	12	2	14	0.00000
Sedimenticola thiotaurini	1543721	S	494	21	515	0.00004
Candidatus Reidiella endopervernicosa	2738883	S	451	8	459	0.00003
Thiolapillus brandeum	1076588	S	376	9	385	0.00003
Pseudohongiella spirulinae	1249552	S	216	5	221	0.00002
Gallaecimonas mangrovi	2291597	S	132	8	140	0.00001
Candidatus Thioglobus autotrophicus	1705394	S	26	2	28	0.00000
Candidatus Thioglobus sp. NP1	2508687	S	22	6	28	0.00000
Ignatzschineria sp. HR5S32	2923279	S	35	2	37	0.00000
Celerinatantimonas diazotrophica	412034	S	30	1	31	0.00000
Candidatus Pseudothioglobus singularis	1427364	S	29	11	40	0.00000
Candidatus Steffania adelgidicola	1076626	S	13	0	13	0.00000
Legionella sp. MW5194	2662448	S	129	26	155	0.00001
Legionella sp. PC997	2755562	S	51	8	59	0.00000
Legionella sp. PC1000	2746060	S	45	7	52	0.00000
Legionella pneumophila	446	S	216	119	335	0.00002
Legionella geestiana	45065	S	146	11	157	0.00001
Legionella spiritensis	452	S	89	9	98	0.00001
Legionella fallonii	96230	S	82	6	88	0.00001
Legionella antarctica	2708020	S	76	3	79	0.00001
Legionella sainthelensi	28087	S	67	11	78	0.00001
Legionella israelensis	454	S	64	3	67	0.00000
Legionella waltersii	66969	S	52	10	62	0.00000
Legionella oakridgensis	29423	S	51	4	55	0.00000
Legionella clemsonensis	1867846	S	48	7	55	0.00000
Legionella hackeliae	449	S	48	8	56	0.00000
Legionella adelaidensis	45056	S	47	3	50	0.00000
Legionella longbeachae	450	S	47	8	55	0.00000
Legionella cherrii	28084	S	46	2	48	0.00000
Legionella jordanis	456	S	45	5	50	0.00000
Legionella lansingensis	45067	S	40	2	42	0.00000
Legionella anisa	28082	S	26	6	32	0.00000
Tatlockia micdadei	451	S	54	2	56	0.00000
Fluoribacter dumoffii	463	S	45	4	49	0.00000
Aquicella siphonis	254247	S	237	37	274	0.00002
Aquicella lusitana	254246	S	215	36	251	0.00002
Coxiella burnetii	777	S	185	47	232	0.00002
Coxiella endosymbiont of Amblyomma sculptum	2487929	S	21	7	28	0.00000
Coxiella endosymbiont of Amblyomma nuttalli	2749996	S	18	2	20	0.00000
Candidatus Coxiella mudrowiae	2054173	S	30	3	33	0.00000
Candidatus Rickettsiella viridis	676208	S	49	23	72	0.00001
Rickettsiella endosymbiont of Dermanyssus gallinae	2856608	S	26	10	36	0.00000
Immundisolibacter cernigliae	1810504	S	2413	353	2766	0.00020
Thiomicrospira cyclica	147268	S	68	4	72	0.00001
Thiomicrospira sp. S5	1803865	S	63	59	122	0.00001
Thiomicrospira microaerophila	406020	S	58	8	66	0.00000
Thiomicrospira aerophila	92245	S	45	5	50	0.00000
Thiomicrorhabdus xiamenensis	2739063	S	73	4	77	0.00001
Thiomicrorhabdus aquaedulcis	2211106	S	53	2	55	0.00000
Thiomicrorhabdus sediminis	2580412	S	53	2	55	0.00000
Thiomicrorhabdus sp. Am19	2791037	S	27	1	28	0.00000
Thiomicrorhabdus indica	2267253	S	25	1	26	0.00000
Methylophaga sp. TMB456	2881052	S	70	22	92	0.00001
Methylophaga nitratireducenticrescens	754476	S	64	10	74	0.00001
Methylophaga frappieri	754477	S	64	28	92	0.00001
Hydrogenovibrio thermophilus	265883	S	63	58	121	0.00001
Hydrogenovibrio marinus	28885	S	43	1	44	0.00000
Hydrogenovibrio crunogenus	39765	S	34	1	35	0.00000
Piscirickettsia salmonis	1238	S	74	4	78	0.00001
Thiosulfativibrio zosterae	2675053	S	56	2	58	0.00000
Thiosulfatimonas sediminis	2675054	S	52	2	54	0.00000
Thiothrix litoralis	2891210	S	236	17	253	0.00002
Thiothrix sp. CT3	96472	S	149	51	200	0.00001
Thiothrix subterranea	2735563	S	143	41	184	0.00001
Candidatus Thiothrix anitrata	2823902	S	88	55	143	0.00001
Thiothrix unzii	111769	S	82	45	127	0.00001
Beggiatoa leptomitoformis	288004	S	60	1	61	0.00000
Francisella tularensis	263	S	24	34	58	0.00000
Francisella philomiragia	28110	S	13	24	37	0.00000
Francisella orientalis	299583	S	11	18	29	0.00000
Allofrancisella guangzhouensis	594679	S	24	6	30	0.00000
Salinisphaera sp. LB1	2183911	S	1735	58	1793	0.00013
endosymbiont of unidentified scaly snail isolate Monju	1248727	S	1461	103	1564	0.00011
Isorropodon fossajaponicum symbiont	883811	S	10	2	12	0.00000
Haemophilus parainfluenzae	729	S	56	18	74	0.00001
Haemophilus influenzae	727	S	37	24	61	0.00000
Haemophilus parahaemolyticus	735	S	28	4	32	0.00000
Haemophilus haemolyticus	726	S	26	11	37	0.00000
[Haemophilus] ducreyi	730	S	16	7	23	0.00000
Haemophilus pittmaniae	249188	S	16	3	19	0.00000
Pasteurella multocida	747	S	125	575	700	0.00005
Pasteurella canis	753	S	13	2	15	0.00000
Pasteurella skyensis	97481	S	12	0	12	0.00000
Aggregatibacter actinomycetemcomitans	714	S	61	12	73	0.00001
Aggregatibacter aphrophilus	732	S	56	23	79	0.00001
Aggregatibacter sp. 2125159857	2820817	S	13	6	19	0.00000
Aggregatibacter sp. Marseille-P9115	2866570	S	10	12	22	0.00000
Actinobacillus sp. GY-402	2774188	S	69	28	97	0.00001
Actinobacillus pleuropneumoniae	715	S	22	27	49	0.00000
Actinobacillus suis	716	S	14	4	18	0.00000
Actinobacillus porcitonsillarum	189834	S	13	4	17	0.00000
Mannheimia haemolytica	75985	S	38	12	50	0.00000
Mannheimia varigena	85404	S	33	22	55	0.00000
Mannheimia granulomatis	85402	S	25	4	29	0.00000
Mannheimia sp. USDA-ARS-USMARC-1261	1432056	S	14	11	25	0.00000
Mannheimia bovis	2770636	S	10	5	15	0.00000
Avibacterium volantium	762	S	21	8	29	0.00000
Avibacterium sp. 20-132	2911526	S	10	10	20	0.00000
Avibacterium paragallinarum	728	S	16	5	21	0.00000
[Mannheimia] succiniciproducens	157673	S	11	40	51	0.00000
Glaesserella parasuis	738	S	28	8	36	0.00000
Glaesserella sp. 15-184	2030797	S	14	3	17	0.00000
Rodentibacter haemolyticus	2778911	S	21	1	22	0.00000
Rodentibacter heylii	1906744	S	18	1	19	0.00000
Histophilus somni	731	S	27	7	34	0.00000
Gallibacterium anatis	750	S	24	5	29	0.00000
Frederiksenia canicola	123824	S	24	4	28	0.00000
Bibersteinia trehalosi	47735	S	18	5	23	0.00000
Bisgaardia hudsonensis	109472	S	12	1	13	0.00000
Otariodibacter oris	1032623	S	11	1	12	0.00000
Vespertiliibacter pulmonis	1443036	S	10	1	11	0.00000
Cardiobacterium hominis	2718	S	452	73	525	0.00004
Cardiobacterium sp. Marseille-Q4385	2866573	S	347	51	398	0.00003
Suttonella sp. R2A3	2908648	S	51	2	53	0.00000
Dichelobacter nodosus	870	S	48	10	58	0.00000
Kangiella koreensis	261964	S	50	7	57	0.00000
Kangiella profundi	1561924	S	45	9	54	0.00000
Kangiella geojedonensis	914150	S	36	2	38	0.00000
Kangiella sediminilitoris	1144748	S	33	2	35	0.00000
Gilliamella apicola	1196095	S	30	7	37	0.00000
Zophobihabitans entericus	1635327	S	35	2	37	0.00000
Frischella perrara	1267021	S	11	2	13	0.00000
Variovorax sp. HW608	1034889	S	11918	1890	13808	0.00099
Variovorax sp. PBS-H4	434008	S	6427	3598	10025	0.00072
Variovorax sp. RA8	662548	S	6383	4457	10840	0.00077
Variovorax sp. PBL-H6	434009	S	6129	5393	11522	0.00082
Variovorax sp. WDL1	207745	S	5942	7924	13866	0.00099
Variovorax sp. RKNM96	2681552	S	5218	1870	7088	0.00051
Variovorax sp. PAMC 28711	1795631	S	5206	838	6044	0.00043
Variovorax sp. PAMC26660	2762322	S	4442	1062	5504	0.00039
Variovorax sp. PAMC28562	2762323	S	4108	329	4437	0.00032
Variovorax sp. 38R	2774875	S	2799	3107	5906	0.00042
Variovorax sp. SRS16	282217	S	2710	5827	8537	0.00061
Variovorax sp. PBL-E5	434014	S	2298	5729	8027	0.00057
Variovorax sp. PDNC026	2811425	S	91	3429	3520	0.00025
Variovorax sp. PMC12	2126319	S	48	2324	2372	0.00017
Variovorax paradoxus	34073	S	29152	23529	52681	0.00376
Variovorax boronicumulans	436515	S	3613	2442	6055	0.00043
Hydrogenophaga sp. PBC	795665	S	6305	6395	12700	0.00091
Hydrogenophaga sp. BA0156	2716225	S	5395	3673	9068	0.00065
Hydrogenophaga sp. YM1	2806262	S	5172	2646	7818	0.00056
Hydrogenophaga sp. BPS33	2651974	S	4304	2937	7241	0.00052
Hydrogenophaga sp. SL48	2806347	S	3587	883	4470	0.00032
Hydrogenophaga sp. RAC07	1842537	S	3144	1141	4285	0.00031
Hydrogenophaga sp. PBL-H3	434010	S	2915	2454	5369	0.00038
Hydrogenophaga sp. NH-16	2184519	S	1460	3336	4796	0.00034
Hydrogenophaga sp. PAMC20947	2565558	S	1418	92	1510	0.00011
Hydrogenophaga taeniospiralis	65656	S	2970	882	3852	0.00028
Hydrogenophaga pseudoflava	47421	S	1291	2402	3693	0.00026
Hydrogenophaga crassostreae	1763535	S	1238	75	1313	0.00009
Acidovorax sp. JMULE5	2518343	S	3791	1117	4908	0.00035
Acidovorax sp. KKS102	358220	S	3328	2268	5596	0.00040
Acidovorax sp. YS12	2738413	S	2910	2345	5255	0.00038
Acidovorax sp. RAC01	1842533	S	2730	2008	4738	0.00034
Acidovorax sp. 1608163	2478662	S	1934	425	2359	0.00017
Acidovorax sp. HDW3	2714923	S	1609	1019	2628	0.00019
Acidovorax sp. T1	1858609	S	1366	4238	5604	0.00040
Acidovorax avenae	80867	S	5965	3717	9682	0.00069
Acidovorax monticola	1926868	S	3876	1597	5473	0.00039
Acidovorax antarcticus	2743470	S	3195	2163	5358	0.00038
Acidovorax carolinensis	553814	S	2509	2060	4569	0.00033
Acidovorax radicis	758826	S	1886	384	2270	0.00016
Acidovorax citrulli	80869	S	1837	4022	5859	0.00042
Acidovorax cattleyae	80868	S	1380	957	2337	0.00017
Ramlibacter tataouinensis	94132	S	38078	15165	53243	0.00380
Rhodoferax sp. BAB1	2741720	S	3869	1103	4972	0.00036
Rhodoferax sp. AJA081-3	2752316	S	1191	91	1282	0.00009
Rhodoferax sp. PAMC 29310	2822760	S	719	79	798	0.00006
Rhodoferax sp. MIZ03	2798804	S	654	62	716	0.00005
Rhodoferax koreense	1842727	S	5573	2573	8146	0.00058
Rhodoferax sediminis	2509614	S	4444	702	5146	0.00037
Rhodoferax saidenbachensis	1484693	S	1650	191	1841	0.00013
Rhodoferax ferrireducens	192843	S	1491	102	1593	0.00011
Rhodoferax antarcticus	81479	S	842	64	906	0.00006
Rhodoferax aquaticus	2527691	S	498	49	547	0.00004
Comamonas sp. NLF-7-7	2597701	S	2045	1596	3641	0.00026
Comamonas sp. NLF-1-9	2853163	S	1800	1031	2831	0.00020
Comamonas sp. B21-038	2918299	S	1109	281	1390	0.00010
Comamonas sp. Y33R10-2	2853257	S	355	62	417	0.00003
Comamonas aquatica	225991	S	2648	2291	4939	0.00035
Comamonas serinivorans	1082851	S	2574	661	3235	0.00023
Comamonas testosteroni	285	S	1605	2150	3755	0.00027
Comamonas odontotermitis	379895	S	1114	206	1320	0.00009
Comamonas koreensis	160825	S	1024	570	1594	0.00011
Comamonas thiooxydans	363952	S	874	1908	2782	0.00020
Comamonas piscis	1562974	S	818	162	980	0.00007
Comamonas kerstersii	225992	S	675	315	990	0.00007
Comamonas fluminis	2796366	S	652	251	903	0.00006
Schlegelella thermodepolymerans	215580	S	9117	4086	13203	0.00094
Schlegelella brevitalea	413882	S	7156	959	8115	0.00058
Polaromonas sp. JS666	296591	S	4015	5242	9257	0.00066
Polaromonas naphthalenivorans	216465	S	2819	444	3263	0.00023
Polaromonas vacuolata	37448	S	320	31	351	0.00003
Diaphorobacter sp. HDW4A	2714924	S	1830	1502	3332	0.00024
Diaphorobacter sp. HDW4B	2714925	S	1730	216	1946	0.00014
Diaphorobacter sp. MNS-0	2866628	S	221	1723	1944	0.00014
Diaphorobacter sp. JS3050	2735554	S	216	2194	2410	0.00017
Diaphorobacter sp. JS3051	2792224	S	184	2634	2818	0.00020
Diaphorobacter ruginosibacter	1715720	S	2382	437	2819	0.00020
Diaphorobacter aerolatus	1288495	S	1782	2344	4126	0.00029
[Acidovorax] ebreus	721785	S	302	1632	1934	0.00014
Diaphorobacter nitroreducens	164759	S	272	755	1027	0.00007
Delftia tsuruhatensis	180282	S	2306	5964	8270	0.00059
Delftia acidovorans	80866	S	1767	3209	4976	0.00036
Delftia lacustris	558537	S	583	3098	3681	0.00026
Delftia sp. Cs1-4	742013	S	231	565	796	0.00006
Delftia sp. HK171	1920191	S	136	385	521	0.00004
Kinneretia sp. DAIF2	2714952	S	7118	2313	9431	0.00067
Kinneretia sp. XES5	2877940	S	2035	1995	4030	0.00029
Ottowia sp. 27C	2816950	S	3080	600	3680	0.00026
Ottowia sp. oral taxon 894	1658672	S	1062	144	1206	0.00009
Ottowia oryzae	2109914	S	2562	567	3129	0.00022
Alicycliphilus denitrificans	179636	S	5099	7495	12594	0.00090
Melaminivora sp. SC2-9	2109913	S	2576	2718	5294	0.00038
Melaminivora jejuensis	1267217	S	2023	1439	3462	0.00025
Hylemonella gracilis	80880	S	3099	433	3532	0.00025
Serpentinimonas maccroryi	1458426	S	1405	429	1834	0.00013
Serpentinimonas raichei	1458425	S	1376	454	1830	0.00013
Verminephrobacter eiseniae	364317	S	2618	314	2932	0.00021
Pulveribacter suum	2116657	S	2202	1147	3349	0.00024
Simplicispira suum	2109915	S	1831	628	2459	0.00018
Limnohabitans sp. 63ED37-2	1678128	S	1013	111	1124	0.00008
Limnohabitans sp. 103DPR2	1678129	S	339	25	364	0.00003
Curvibacter sp. AEP1-3	1844971	S	964	69	1033	0.00007
Candidatus Symbiobacter mobilis	1436290	S	583	18	601	0.00004
Burkholderia multivorans	87883	S	4746	12322	17068	0.00122
Burkholderia ubonensis	101571	S	4396	2141	6537	0.00047
Burkholderia cenocepacia	95486	S	3630	16149	19779	0.00141
Burkholderia cepacia	292	S	2964	3594	6558	0.00047
Burkholderia pyrrocinia	60550	S	1911	792	2703	0.00019
Burkholderia ambifaria	152480	S	1626	5838	7464	0.00053
Burkholderia contaminans	488447	S	1557	756	2313	0.00017
Burkholderia stagnalis	1503054	S	1466	400	1866	0.00013
Burkholderia stabilis	95485	S	1393	768	2161	0.00015
Burkholderia dolosa	152500	S	1349	431	1780	0.00013
Burkholderia anthina	179879	S	1343	932	2275	0.00016
Burkholderia lata	482957	S	1237	845	2082	0.00015
Burkholderia territorii	1503055	S	1031	381	1412	0.00010
Burkholderia seminalis	488731	S	919	327	1246	0.00009
Burkholderia vietnamiensis	60552	S	813	1580	2393	0.00017
Burkholderia metallica	488729	S	648	239	887	0.00006
Burkholderia diffusa	488732	S	486	182	668	0.00005
Burkholderia pseudomultivorans	1207504	S	366	307	673	0.00005
Burkholderia latens	488446	S	257	417	674	0.00005
Burkholderia aenigmatica	2015348	S	227	370	597	0.00004
Burkholderia pseudomallei	28450	S	1939	32352	34291	0.00245
Burkholderia mayonis	1385591	S	1460	246	1706	0.00012
Burkholderia thailandensis	57975	S	1337	1166	2503	0.00018
Burkholderia oklahomensis	342113	S	966	280	1246	0.00009
Burkholderia savannae	1637837	S	193	141	334	0.00002
Burkholderia sp. MSMB1588	1636423	S	89	146	235	0.00002
Burkholderia sp. MSMB617WGS	1637831	S	70	101	171	0.00001
Burkholderia mallei	13373	S	63	2844	2907	0.00021
Burkholderia humptydooensis	430531	S	10	4066	4076	0.00029
Burkholderia sp. DHOD12	2571746	S	2534	228	2762	0.00020
Burkholderia sp. Bp7605	1740163	S	1521	174	1695	0.00012
Burkholderia sp. NRF60-BP8	1637853	S	521	212	733	0.00005
Burkholderia sp. LA-2-3-30-S1-D2	1637862	S	514	237	751	0.00005
Burkholderia sp. MSMB0856	1637869	S	501	250	751	0.00005
Burkholderia sp. JP2-270	2217913	S	441	220	661	0.00005
Burkholderia sp. PAMC 26561	1795043	S	415	477	892	0.00006
Burkholderia sp. MS455	2811788	S	350	194	544	0.00004
Burkholderia sp. PAMC 28687	1795874	S	325	575	900	0.00006
Burkholderia sp. IDO3	1705310	S	210	232	442	0.00003
Burkholderia sp. KBS0801	1179675	S	96	149	245	0.00002
Burkholderia sp. LAS2	2813843	S	84	318	402	0.00003
Burkholderia sp. MBR-1	2732364	S	43	145	188	0.00001
Burkholderia sp. MS389	2811789	S	36	219	255	0.00002
Burkholderia sp. KJ006	416344	S	31	161	192	0.00001
Burkholderia sp. B21-007	2890407	S	10	360	370	0.00003
Burkholderia gladioli	28095	S	5796	1537	7333	0.00052
Burkholderia glumae	337	S	2018	35266	37284	0.00266
Burkholderia plantarii	41899	S	1574	450	2024	0.00014
Burkholderia perseverans	2615214	S	1235	379	1614	0.00012
Cupriavidus taiwanensis	164546	S	9135	7157	16292	0.00116
Cupriavidus pauculus	82633	S	7885	2839	10724	0.00077
Cupriavidus basilensis	68895	S	4195	1831	6026	0.00043
Cupriavidus oxalaticus	96344	S	4106	1582	5688	0.00041
Cupriavidus sp. EM10	2839983	S	1916	1000	2916	0.00021
Cupriavidus sp. MP-37	2884455	S	793	786	1579	0.00011
Cupriavidus sp. KK10	1478019	S	332	1037	1369	0.00010
Cupriavidus sp. ISTL7	2771360	S	277	1830	2107	0.00015
Cupriavidus sp. USMAA2-4	876364	S	195	1301	1496	0.00011
Cupriavidus sp. USMAHM13	1389192	S	140	1026	1166	0.00008
Cupriavidus necator	106590	S	3714	3855	7569	0.00054
Cupriavidus campinensis	151783	S	3547	1119	4666	0.00033
Cupriavidus metallidurans	119219	S	2550	1294	3844	0.00027
Cupriavidus pinatubonensis	248026	S	2203	324	2527	0.00018
Cupriavidus gilardii	82541	S	870	4302	5172	0.00037
Cupriavidus neocaledonicus	1040979	S	777	951	1728	0.00012
Cupriavidus nantongensis	1796606	S	667	1511	2178	0.00016
Cupriavidus malaysiensis	367825	S	152	1047	1199	0.00009
Paraburkholderia edwinii	2861782	S	4669	590	5259	0.00038
Paraburkholderia sp. SOS3	1926494	S	1987	268	2255	0.00016
Paraburkholderia sp. PGU16	2735433	S	1033	582	1615	0.00012
Paraburkholderia sp. PGU19	2735434	S	794	702	1496	0.00011
Paraburkholderia pallida	2547399	S	2742	451	3193	0.00023
Paraburkholderia aromaticivorans	2026199	S	2465	1008	3473	0.00025
Paraburkholderia graminis	60548	S	2397	558	2955	0.00021
Paraburkholderia caribensis	75105	S	2326	1728	4054	0.00029
Paraburkholderia acidisoli	2571748	S	2304	375	2679	0.00019
Paraburkholderia tropica	92647	S	2183	442	2625	0.00019
Paraburkholderia acidiphila	2571747	S	1985	348	2333	0.00017
Paraburkholderia phymatum	148447	S	1771	436	2207	0.00016
Paraburkholderia phytofirmans	261302	S	1762	722	2484	0.00018
Paraburkholderia terricola	169427	S	1747	483	2230	0.00016
Paraburkholderia atlantica	2654982	S	1735	394	2129	0.00015
Paraburkholderia phenoliruptrix	252970	S	1578	439	2017	0.00014
Paraburkholderia sprentiae	948107	S	1543	314	1857	0.00013
Paraburkholderia megapolitana	420953	S	1460	121	1581	0.00011
Paraburkholderia fungorum	134537	S	1460	326	1786	0.00013
Paraburkholderia caledonica	134536	S	1392	234	1626	0.00012
Paraburkholderia terrae	311230	S	1301	1530	2831	0.00020
Paraburkholderia ginsengisoli	311231	S	1280	366	1646	0.00012
Paraburkholderia dokdonella	2211211	S	1126	276	1402	0.00010
Paraburkholderia hospita	169430	S	1056	1226	2282	0.00016
Paraburkholderia xenovorans	36873	S	1038	1159	2197	0.00016
Paraburkholderia caffeinilytica	1761016	S	994	250	1244	0.00009
Paraburkholderia dioscoreae	2604047	S	688	465	1153	0.00008
Ralstonia solanacearum	305	S	5255	18903	24158	0.00173
Ralstonia insidiosa	190721	S	1690	957	2647	0.00019
Ralstonia pickettii	329	S	1115	343	1458	0.00010
Ralstonia mannitolilytica	105219	S	1111	942	2053	0.00015
Ralstonia sp. 56D2	2842456	S	1025	124	1149	0.00008
Ralstonia syzygii	28097	S	103	198	301	0.00002
Ralstonia pseudosolanacearum	1310165	S	24	351	375	0.00003
Pandoraea pnomenusa	93220	S	2167	898	3065	0.00022
Pandoraea thiooxydans	445709	S	1780	123	1903	0.00014
Pandoraea pulmonicola	93221	S	1773	363	2136	0.00015
Pandoraea faecigallinarum	656179	S	1254	330	1584	0.00011
Pandoraea norimbergensis	93219	S	1234	182	1416	0.00010
Pandoraea vervacti	656178	S	1227	349	1576	0.00011
Pandoraea sp. XY-2	2518599	S	1206	523	1729	0.00012
Pandoraea apista	93218	S	1004	483	1487	0.00011
Pandoraea fibrosis	1891094	S	983	324	1307	0.00009
Pandoraea oxalativorans	573737	S	859	410	1269	0.00009
Pandoraea sputorum	93222	S	803	359	1162	0.00008
Caballeronia sp. Lep1P3	2878150	S	1763	386	2149	0.00015
Caballeronia sp. TF1N1	2878153	S	1653	172	1825	0.00013
Caballeronia sp. SL2Y3	2878151	S	989	525	1514	0.00011
Caballeronia sp. Sq4a	2878152	S	747	511	1258	0.00009
Caballeronia sp. M1242	2814653	S	728	484	1212	0.00009
Caballeronia sp. SBC2	2705547	S	116	930	1046	0.00007
Caballeronia sp. SBC1	2705548	S	81	908	989	0.00007
Caballeronia zhejiangensis	871203	S	2514	553	3067	0.00022
Caballeronia insecticola	758793	S	1998	394	2392	0.00017
Caballeronia grimmiae	1071679	S	1768	768	2536	0.00018
Lautropia mirabilis	47671	S	2013	310	2323	0.00017
Polynucleobacter sp. MWH-UH24A	2689110	S	64	4	68	0.00000
Polynucleobacter sp. MWH-P3-07-1	1743173	S	51	9	60	0.00000
Polynucleobacter sp. MWH-CaK5	2689107	S	45	2	47	0.00000
Polynucleobacter sp. MWH-Aus1W21	1855880	S	43	12	55	0.00000
Polynucleobacter sp. MWH-Braz-FAM2G	1855883	S	40	5	45	0.00000
Polynucleobacter sp. AP-Ainpum-60-G11	2576926	S	36	11	47	0.00000
Polynucleobacter sp. MG-6-Vaara-E2	2576932	S	35	8	43	0.00000
Polynucleobacter sp. MWH-UH25E	1855616	S	35	8	43	0.00000
Polynucleobacter sp. AP-Nino-20-G2	2576917	S	34	9	43	0.00000
Polynucleobacter sp. MWH-UH35A	1855619	S	32	6	38	0.00000
Polynucleobacter sp. JS-JIR-II-b4	1758390	S	30	22	52	0.00000
Polynucleobacter sp. MWH-UH2A	1855617	S	30	7	37	0.00000
Polynucleobacter sp. AP-Kolm-20A-A1	2081041	S	29	20	49	0.00000
Polynucleobacter sp. JS-JIR-II-50	2576919	S	29	19	48	0.00000
Polynucleobacter sp. MWH-UH21B	1743174	S	29	7	36	0.00000
Polynucleobacter sp. VK25	1758398	S	29	9	38	0.00000
Polynucleobacter sp. MWH-Svant-W18	1855909	S	27	6	33	0.00000
Polynucleobacter sp. MWH-Spelu-300-X4	2689109	S	27	1	28	0.00000
Polynucleobacter sp. es-MAR-2	1819725	S	27	7	34	0.00000
Polynucleobacter sp. Adler-ghost	2770234	S	24	15	39	0.00000
Polynucleobacter sp. JS-Mosq-20-D10	2576922	S	22	11	33	0.00000
Polynucleobacter sp. AP-Melu-1000-A1	2081042	S	22	12	34	0.00000
Polynucleobacter sp. MG-Unter2-18	2081052	S	21	19	40	0.00000
Polynucleobacter sp. LimPoW16	1743162	S	21	1	22	0.00000
Polynucleobacter sp. MWH-S4W17	1855910	S	20	14	34	0.00000
Polynucleobacter sp. AP-Jannik-300A-C4	2576928	S	19	27	46	0.00000
Polynucleobacter sp. TSB-Sco08W16	1758374	S	19	3	22	0.00000
Polynucleobacter sp. AP-Sving-400A-A2	2081049	S	18	13	31	0.00000
Polynucleobacter sp. es-EL-1	1855652	S	12	2	14	0.00000
Polynucleobacter sp. AP-Elch-400A-B2	2576930	S	11	7	18	0.00000
Polynucleobacter sp. AM-7D1	2689102	S	11	16	27	0.00000
Polynucleobacter necessarius	576610	S	195	38	233	0.00002
Polynucleobacter asymbioticus	576611	S	115	20	135	0.00001
Polynucleobacter difficilis	556054	S	109	9	118	0.00001
Polynucleobacter acidiphobus	556053	S	62	4	66	0.00000
Polynucleobacter paneuropaeus	2527775	S	51	6	57	0.00000
Polynucleobacter wuianus	1743168	S	37	12	49	0.00000
Polynucleobacter duraquae	1835254	S	18	14	32	0.00000
Chitinimonas arctica	2594795	S	1180	80	1260	0.00009
Mycetohabitans rhizoxinica	412963	S	986	56	1042	0.00007
Mycoavidus sp. HKI	2840467	S	155	14	169	0.00001
Mycoavidus sp. B2-EB	2651972	S	78	18	96	0.00001
Mycoavidus cysteinexigens	1553431	S	84	13	97	0.00001
Limnobacter sp. SAORIC-580	2732163	S	241	9	250	0.00002
Candidatus Vallotia cooleyia	1177211	S	52	5	57	0.00000
Candidatus Vallotia tarda	1177213	S	46	7	53	0.00000
Candidatus Vallotia lariciata	2018052	S	39	17	56	0.00000
Candidatus Vallotia sp. (ex Adelges kitamiensis)	2864217	S	27	11	38	0.00000
Ephemeroptericola cinctiostellae	2268024	S	119	6	125	0.00001
Achromobacter insolitus	217204	S	72958	14803	87761	0.00627
Achromobacter xylosoxidans	85698	S	10382	12809	23191	0.00166
Achromobacter sp. AONIH1	1758194	S	2196	2194	4390	0.00031
Achromobacter sp. MFA1 R4	1881016	S	2155	475	2630	0.00019
Achromobacter sp. 77	2756133	S	749	1076	1825	0.00013
Achromobacter sp. B7	2282475	S	312	725	1037	0.00007
Achromobacter sp. ES-001	2860286	S	272	804	1076	0.00008
Achromobacter spanius	217203	S	6389	1925	8314	0.00059
Achromobacter denitrificans	32002	S	3167	1616	4783	0.00034
Achromobacter deleyi	1353891	S	2671	1285	3956	0.00028
Achromobacter pestifer	1353889	S	1928	983	2911	0.00021
Achromobacter mucicolens	1389922	S	1252	1094	2346	0.00017
Achromobacter ruhlandii	72557	S	30	791	821	0.00006
Bordetella sp. H567	1697043	S	2509	263	2772	0.00020
Bordetella sp. N	1746199	S	2001	191	2192	0.00016
Bordetella flabilis	463014	S	3081	222	3303	0.00024
Bordetella bronchialis	463025	S	2638	304	2942	0.00021
Bordetella genomosp. 13	463040	S	2630	1502	4132	0.00030
Bordetella genomosp. 8	1416806	S	2534	262	2796	0.00020
Bordetella genomosp. 9	1416803	S	2126	452	2578	0.00018
Bordetella hinzii	103855	S	1897	705	2602	0.00019
Bordetella petrii	94624	S	1877	2081	3958	0.00028
Bordetella trematum	123899	S	1364	476	1840	0.00013
Bordetella pseudohinzii	1331258	S	988	382	1370	0.00010
Bordetella bronchiseptica	518	S	946	4625	5571	0.00040
Bordetella avium	521	S	666	99	765	0.00005
Bordetella holmesii	35814	S	637	178	815	0.00006
Bordetella genomosp. 6	463024	S	312	667	979	0.00007
Bordetella pertussis	520	S	169	1737	1906	0.00014
Bordetella parapertussis	519	S	105	1262	1367	0.00010
Pigmentiphaga sp. H8	2488560	S	3711	409	4120	0.00029
Pigmentiphaga aceris	1940612	S	1197	71	1268	0.00009
Castellaniella defragrans	75697	S	2514	1367	3881	0.00028
Alcaligenes faecalis	511	S	1429	858	2287	0.00016
Alcaligenes sp. SORT26	2813780	S	160	20	180	0.00001
Alcaligenes sp. DN25	1367435	S	24	34	58	0.00000
Alcaligenes aquatilis	323284	S	104	255	359	0.00003
Alcaligenes ammonioxydans	2582914	S	12	88	100	0.00001
Orrella dioscoreae	1851544	S	1940	564	2504	0.00018
Orrella marina	2163011	S	323	53	376	0.00003
Orrella sp. f23	2782176	S	144	10	154	0.00001
Pusillimonas thiosulfatoxidans	2028345	S	717	161	878	0.00006
Pusillimonas sp. T7-7	1007105	S	481	61	542	0.00004
Pusillimonas sp. DMV24BSW_D	2716226	S	169	9	178	0.00001
Paralcaligenes sp. KSB-10	2901142	S	786	26	812	0.00006
Kerstersia gyiorum	206506	S	755	131	886	0.00006
Advenella mimigardefordensis	302406	S	329	14	343	0.00002
Advenella kashmirensis	310575	S	329	14	343	0.00002
Oligella urethralis	90245	S	56	4	60	0.00000
Oligella ureolytica	90244	S	40	23	63	0.00000
Paenalcaligenes hominis	643674	S	64	2	66	0.00000
Taylorella asinigenitalis	84590	S	21	1	22	0.00000
Taylorella equigenitalis	29575	S	20	44	64	0.00000
Basilea psittacipulmonis	1472345	S	31	2	33	0.00000
Pelistega ratti	2652177	S	19	2	21	0.00000
Massilia sp. HC52	2852099	S	5050	1386	6436	0.00046
Massilia sp. DM-R-R2A-13	2899220	S	4650	1010	5660	0.00040
Massilia sp. WG5	1707785	S	4258	1914	6172	0.00044
Massilia sp. LPB0304	2769491	S	3653	904	4557	0.00033
Massilia sp. YMA4	1593482	S	2938	1611	4549	0.00032
Massilia sp. NP310	2861282	S	2548	1768	4316	0.00031
Massilia sp. PAMC28688	2861283	S	2247	343	2590	0.00019
Massilia sp. NR 4-1	1678028	S	598	2336	2934	0.00021
Massilia sp. MB5	2919578	S	518	2095	2613	0.00019
Massilia sp. Dwa41.01b	2709302	S	39	1631	1670	0.00012
Massilia sp. Se16.2.3	2709303	S	36	1521	1557	0.00011
Massilia putida	1141883	S	5724	1881	7605	0.00054
Massilia flava	871742	S	4509	1102	5611	0.00040
Massilia violaceinigra	2045208	S	4493	1335	5828	0.00042
Massilia albidiflava	321983	S	2930	1212	4142	0.00030
Massilia lutea	321985	S	2812	878	3690	0.00026
Massilia umbonata	864828	S	2778	1149	3927	0.00028
Massilia plicata	321984	S	2672	704	3376	0.00024
Massilia armeniaca	2072590	S	2588	1441	4029	0.00029
Massilia oculi	945844	S	1969	1344	3313	0.00024
Massilia antarctica	2765360	S	1800	724	2524	0.00018
Duganella sp. AF9R3	2728021	S	3569	741	4310	0.00031
Duganella sp. GN2-R2	2728020	S	3356	1381	4737	0.00034
Herbaspirillum robiniae	2014887	S	2253	810	3063	0.00022
Herbaspirillum seropedicae	964	S	2017	860	2877	0.00021
Herbaspirillum frisingense	92645	S	1756	566	2322	0.00017
Herbaspirillum hiltneri	341045	S	1630	275	1905	0.00014
Herbaspirillum rubrisubalbicans	80842	S	1352	639	1991	0.00014
Herbaspirillum huttiense	863372	S	1065	434	1499	0.00011
Herbaspirillum sp. meg3	2025949	S	894	98	992	0.00007
Janthinobacterium sp. 17J80-10	2497863	S	1415	198	1613	0.00012
Janthinobacterium sp. 1_2014MBL_MicDiv	1644131	S	1204	435	1639	0.00012
Janthinobacterium sp. LM6	1938606	S	645	396	1041	0.00007
Janthinobacterium sp. Marseille	375286	S	509	126	635	0.00005
Janthinobacterium sp. PAMC25594	2861284	S	485	298	783	0.00006
Janthinobacterium sp. HH102	1537274	S	304	481	785	0.00006
Janthinobacterium sp. B9-8	1236179	S	103	26	129	0.00001
Janthinobacterium agaricidamnosum	55508	S	1979	3195	5174	0.00037
Janthinobacterium tructae	2590869	S	500	262	762	0.00005
Janthinobacterium lividum	29581	S	473	490	963	0.00007
Janthinobacterium svalbardensis	368607	S	442	226	668	0.00005
Collimonas fungivorans	158899	S	1881	507	2388	0.00017
Collimonas arenae	279058	S	1463	184	1647	0.00012
Collimonas pratensis	279113	S	1296	264	1560	0.00011
Noviherbaspirillum sp. UKPF54	2601898	S	3140	505	3645	0.00026
Undibacterium sp. KW1	2058624	S	184	80	264	0.00002
Undibacterium sp. YM2	2058625	S	163	71	234	0.00002
Undibacterium parvum	401471	S	210	25	235	0.00002
Herminiimonas arsenitoxidans	1809410	S	321	55	376	0.00003
Glaciimonas sp. PAMC28666	2807626	S	310	18	328	0.00002
Oxalobacter formigenes	847	S	154	12	166	0.00001
Rhizobacter sp. AJA081-3	2753607	S	12281	3393	15674	0.00112
Rhizobacter gummiphilus	946333	S	11381	2334	13715	0.00098
Sphaerotilus sp. FB-5	2914710	S	5467	3126	8593	0.00061
Sphaerotilus natans	34103	S	5038	2052	7090	0.00051
Rubrivivax gelatinosus	28068	S	10577	3418	13995	0.00100
Methylibium sp. Pch-M	2082386	S	3466	3398	6864	0.00049
Methylibium petroleiphilum	105560	S	3030	2990	6020	0.00043
Aquincola tertiaricarbonis	391953	S	8400	2885	11285	0.00081
Mitsuaria sp. 7	1658665	S	7056	1459	8515	0.00061
Leptothrix cholodnii	34029	S	6549	2220	8769	0.00063
Thiomonas sp. X19	1050370	S	2031	765	2796	0.00020
Thiomonas intermedia	926	S	1322	177	1499	0.00011
Thiomonas arsenitoxydans	426114	S	471	841	1312	0.00009
Ideonella dechloratans	36863	S	4017	2382	6399	0.00046
Xylophilus rhododendri	2697032	S	3776	1073	4849	0.00035
Roseateles depolymerans	76731	S	2935	579	3514	0.00025
Aquabacterium olei	1296669	S	2778	736	3514	0.00025
Tepidimonas taiwanensis	307486	S	2775	914	3689	0.00026
Inhella inkyongensis	392593	S	1934	304	2238	0.00016
Paucibacter sp. KCTC 42545	1768242	S	1862	312	2174	0.00016
Candidatus Ichthyocystis hellenicum	1561003	S	34	0	34	0.00000
Sutterella megalosphaeroides	2494234	S	706	131	837	0.00006
Sutterella faecalis	2584944	S	516	80	596	0.00004
Sutterella wadsworthensis	40545	S	220	28	248	0.00002
Turicimonas muris	1796652	S	93	6	99	0.00001
Usitatibacter rugosus	2732067	S	15127	1643	16770	0.00120
Usitatibacter palustris	2732487	S	11766	1364	13130	0.00094
Nitrosospira multiformis	1231	S	9252	264	9516	0.00068
Nitrosospira lacus	1288494	S	699	21	720	0.00005
Nitrosospira sp. NRS527	155925	S	296	187	483	0.00003
Nitrosospira briensis	35799	S	271	184	455	0.00003
Nitrosomonas communis	44574	S	4805	105	4910	0.00035
Nitrosomonas ureae	44577	S	1097	30	1127	0.00008
Nitrosomonas europaea	915	S	170	20	190	0.00001
Nitrosomonas eutropha	916	S	98	44	142	0.00001
Nitrosomonas stercoris	1444684	S	54	24	78	0.00001
Denitratisoma sp. DHT3	1981880	S	1771	1143	2914	0.00021
Denitratisoma oestradiolicum	311182	S	881	137	1018	0.00007
Sulfuritalea hydrogenivorans	748811	S	2271	310	2581	0.00018
Methyloversatilis sp. RAC08	1842540	S	2042	242	2284	0.00016
Sterolibacterium denitrificans	157592	S	1438	337	1775	0.00013
Sideroxydans sp. MIZ01	2764705	S	1150	235	1385	0.00010
Sideroxydans lithotrophicus	63745	S	832	127	959	0.00007
Ferrigenium kumadai	1682490	S	1423	280	1703	0.00012
Ferriphaselus amnicola	1188319	S	491	63	554	0.00004
Candidatus Nitrotoga arctica	453162	S	213	59	272	0.00002
Candidatus Nitrotoga sp. AM1P	2559597	S	147	44	191	0.00001
Gallionella capsiferriformans	370405	S	324	28	352	0.00003
Thiobacillus denitrificans	36861	S	2727	485	3212	0.00023
Sulfuritortus calidifontis	1914471	S	1852	706	2558	0.00018
Sulfuriferula plumbiphila	171865	S	979	162	1141	0.00008
Sulfuriferula sp. AH1	1985873	S	437	81	518	0.00004
Sulfuriferula nivalis	2675298	S	122	10	132	0.00001
Sulfurimicrobium lacus	2715678	S	1474	166	1640	0.00012
Sulfuricella denitrificans	649841	S	777	61	838	0.00006
Methylovorus sp. MP688	887061	S	150	142	292	0.00002
Methylovorus glucosotrophus	266009	S	137	117	254	0.00002
Methylobacillus flagellatus	405	S	448	96	544	0.00004
Methylophilus sp. TWE2	1662285	S	218	17	235	0.00002
Methylophilus medardicus	2588534	S	131	13	144	0.00001
Methylotenera mobilis	359408	S	111	13	124	0.00001
Methylotenera versatilis	1055487	S	57	7	64	0.00000
Candidatus Methylopumilus turicensis	1581680	S	43	6	49	0.00000
Candidatus Methylopumilus universalis	2588536	S	32	12	44	0.00000
Candidatus Methylopumilus planktonicus	1581557	S	24	10	34	0.00000
Candidatus Methylopumilus rimovensis	2588535	S	15	2	17	0.00000
Methyloradius palustris	2778876	S	107	8	115	0.00001
Thauera sp. MZ1T	85643	S	2964	2630	5594	0.00040
Thauera sp. K11	2005884	S	2939	1603	4542	0.00032
Thauera humireducens	1134435	S	1946	1009	2955	0.00021
Thauera chlorobenzoica	96773	S	1433	1284	2717	0.00019
Thauera aromatica	59405	S	1252	1546	2798	0.00020
Thauera hydrothermalis	2184083	S	850	212	1062	0.00008
Azoarcus sp. KH32C	748247	S	3493	603	4096	0.00029
Azoarcus sp. DD4	2027405	S	2311	1373	3684	0.00026
Azoarcus olearius	418699	S	2865	1026	3891	0.00028
Azoarcus communis	41977	S	2169	707	2876	0.00021
Nitrogeniibacter mangrovi	2016596	S	2325	439	2764	0.00020
Nitrogeniibacter aestuarii	2815343	S	1164	113	1277	0.00009
Aromatoleum petrolei	76116	S	2918	724	3642	0.00026
Aromatoleum aromaticum	551760	S	2258	1521	3779	0.00027
Aromatoleum pumilum	2067960	S	2155	685	2840	0.00020
Aromatoleum bremense	76115	S	2021	1079	3100	0.00022
Azospira restricta	404405	S	4806	2194	7000	0.00050
Azospira inquinata	2785627	S	474	35	509	0.00004
Azospira oryzae	146939	S	350	781	1131	0.00008
Azospira sp. I09	1765049	S	334	855	1189	0.00008
Niveibacterium microcysteis	2811415	S	1912	243	2155	0.00015
Oryzomicrobium terrae	1735038	S	1384	352	1736	0.00012
Rugosibacter aromaticivorans	1565605	S	444	65	509	0.00004
Dechloromonas denitrificans	281362	S	2044	467	2511	0.00018
Dechloromonas sp. HYN0024	2231055	S	579	109	688	0.00005
Dechloromonas sp. TW-R-39-2	2654218	S	397	166	563	0.00004
Ferribacterium limneticum	76259	S	2863	449	3312	0.00024
Quatrionicoccus australiensis	138118	S	1187	337	1524	0.00011
Fluviibacter phosphoraccumulans	1751046	S	241	68	309	0.00002
Chromobacterium sp. ATCC 53434	2059672	S	1173	388	1561	0.00011
Chromobacterium sp. Rain0013	2292447	S	269	333	602	0.00004
Chromobacterium sp. Beijing	2735795	S	168	481	649	0.00005
Chromobacterium violaceum	536	S	1238	735	1973	0.00014
Chromobacterium vaccinii	1108595	S	1221	514	1735	0.00012
Chromobacterium phragmitis	2202141	S	713	307	1020	0.00007
Chromobacterium paludis	2605945	S	708	270	978	0.00007
Chromobacterium rhizoryzae	1778675	S	187	1003	1190	0.00009
Chromobacterium haemolyticum	394935	S	128	858	986	0.00007
Iodobacter fluviatilis	537	S	86	22	108	0.00001
Iodobacter ciconiae	2496266	S	81	19	100	0.00001
Jeongeupia sp. USM3	1906741	S	1811	443	2254	0.00016
Jeongeupia sp. HS-3	1009682	S	828	153	981	0.00007
Paludibacterium paludis	1225769	S	927	165	1092	0.00008
Paludibacterium yongneupense	400061	S	798	102	900	0.00006
Paludibacterium sp. B53371	2806263	S	627	118	745	0.00005
Vogesella sp. LIG4	1192162	S	1134	294	1428	0.00010
Vogesella sp. XCS3	2877939	S	539	141	680	0.00005
Pseudogulbenkiania sp. NH8B	748280	S	1588	494	2082	0.00015
Aquitalea aquatilis	1537400	S	379	115	494	0.00004
Aquitalea denitrificans	519081	S	269	139	408	0.00003
Aquitalea magnusonii	332411	S	266	155	421	0.00003
Aquitalea sp. USM4	1590041	S	221	121	342	0.00002
Microvirgula aerodenitrificans	57480	S	1174	200	1374	0.00010
Laribacter hongkongensis	168471	S	1001	766	1767	0.00013
Aquaspirillum sp. LM1	1938604	S	594	79	673	0.00005
Chitinibacter bivalviorum	2739434	S	127	80	207	0.00001
Chitinibacter fontanus	1737446	S	115	14	129	0.00001
Deefgea sp. D25	2865840	S	83	11	94	0.00001
Deefgea sp. D17	2739061	S	62	22	84	0.00001
Deefgea sp. D13	2864875	S	48	15	63	0.00000
Neisseria sp. KEM232	655307	S	234	26	260	0.00002
Neisseria sp. oral taxon 014	641148	S	101	33	134	0.00001
Neisseria sp. ZJ785	2709396	S	74	7	81	0.00001
Neisseria sp. Dent CA1/247	2912675	S	41	12	53	0.00000
Neisseria bacilliformis	267212	S	287	53	340	0.00002
Neisseria shayeganii	607712	S	214	25	239	0.00002
Neisseria elongata	495	S	211	81	292	0.00002
Neisseria dentiae	194197	S	206	20	226	0.00002
Neisseria meningitidis	487	S	200	1825	2025	0.00014
Neisseria chenwenguii	1853278	S	155	15	170	0.00001
Neisseria musculi	1815583	S	138	10	148	0.00001
Neisseria animalis	492	S	103	12	115	0.00001
Neisseria gonorrhoeae	485	S	87	78	165	0.00001
Neisseria lactamica	486	S	85	73	158	0.00001
Neisseria sicca	490	S	77	115	192	0.00001
Neisseria weaveri	28091	S	74	23	97	0.00001
Neisseria animaloris	326522	S	61	9	70	0.00001
Neisseria arctica	1470200	S	53	4	57	0.00000
Neisseria zalophi	640030	S	53	4	57	0.00000
Neisseria weixii	1853276	S	50	4	54	0.00000
Neisseria brasiliensis	2666100	S	50	38	88	0.00001
Neisseria canis	493	S	50	8	58	0.00000
Neisseria wadsworthii	607711	S	46	7	53	0.00000
Neisseria dumasiana	1931275	S	41	11	52	0.00000
Neisseria flavescens	484	S	41	21	62	0.00000
Neisseria mucosa	488	S	34	57	91	0.00001
Neisseria macacae	496	S	30	48	78	0.00001
Neisseria zoodegmatis	326523	S	25	10	35	0.00000
Neisseria cinerea	483	S	20	8	28	0.00000
Neisseria subflava	28449	S	18	9	27	0.00000
Crenobacter cavernae	2290923	S	2127	632	2759	0.00020
Chitinolyticbacter meiyuanensis	682798	S	1441	157	1598	0.00011
Vitreoscilla filiformis	63	S	776	126	902	0.00006
Vitreoscilla massiliensis	1689272	S	77	35	112	0.00001
Kingella potus	265175	S	163	18	181	0.00001
Kingella denitrificans	502	S	144	75	219	0.00002
Kingella oralis	505	S	90	12	102	0.00001
Kingella kingae	504	S	51	7	58	0.00000
Eikenella corrodens	539	S	270	134	404	0.00003
Eikenella exigua	2528037	S	88	46	134	0.00001
Uruburuella suis	252130	S	186	27	213	0.00002
Uruburuella testudinis	1282863	S	152	26	178	0.00001
Paralysiella testudinis	2809020	S	168	31	199	0.00001
Conchiformibius steedae	153493	S	80	10	90	0.00001
Alysiella crassa	153491	S	44	8	52	0.00000
Alysiella filiformis	194196	S	30	5	35	0.00000
Neisseriaceae bacterium CCUG 44465	2917790	S	45	5	50	0.00000
Aquella oligotrophica	2067065	S	45	1	46	0.00000
Snodgrassella alvi	1196083	S	43	11	54	0.00000
Morococcus cerebrosus	1056807	S	21	85	106	0.00001
Simonsiella muelleri	72	S	16	2	18	0.00000
Casimicrobium huifangae	2591109	S	1709	642	2351	0.00017
Candidatus Kinetoplastibacterium sorsogonicusi	1576550	S	14	4	18	0.00000
Candidatus Kinetoplastibacterium desouzaii	994692	S	11	5	16	0.00000
Candidatus Profftella armatura	669502	S	11	4	15	0.00000
Sorangium cellulosum	56	S	126053	14261	140314	0.01002
Polyangium aurulentum	2567896	S	18940	1436	20376	0.00146
Chondromyces crocatus	52	S	9130	332	9462	0.00068
Pajaroellobacter abortibovis	1882918	S	262	6	268	0.00002
Sandaracinus amylolyticus	927083	S	31454	1414	32868	0.00235
Labilithrix luteola	1391654	S	17590	660	18250	0.00130
Archangium violaceum	83451	S	20196	3029	23225	0.00166
Archangium gephyra	48	S	18746	3090	21836	0.00156
Stigmatella aurantiaca	41	S	5831	429	6260	0.00045
Cystobacter fuscus	43	S	5622	1239	6861	0.00049
Melittangium boletus	83453	S	4289	863	5152	0.00037
Corallococcus coralloides	184914	S	7051	2592	9643	0.00069
Corallococcus sp. EGB	1521117	S	4119	1375	5494	0.00039
Corallococcus macrosporus	35	S	3696	602	4298	0.00031
Myxococcus xanthus	34	S	6468	23521	29989	0.00214
Myxococcus hansupus	1297742	S	3122	240	3362	0.00024
Myxococcus stipitatus	83455	S	2761	297	3058	0.00022
Myxococcus sp. SCHIC003	2813577	S	2502	270	2772	0.00020
Pyxidicoccus sp. SCPEA002	2813578	S	8046	341	8387	0.00060
Anaeromyxobacter sp. Red232	2918170	S	7480	783	8263	0.00059
Anaeromyxobacter sp. Fw109-5	404589	S	6458	812	7270	0.00052
Anaeromyxobacter sp. Red630	2918171	S	5875	712	6587	0.00047
Anaeromyxobacter sp. K	447217	S	1552	3406	4958	0.00035
Anaeromyxobacter dehalogenans	161493	S	4970	3702	8672	0.00062
Vulgatibacter incomptus	1391653	S	4477	296	4773	0.00034
Haliangium ochraceum	80816	S	12888	597	13485	0.00096
Geomonas sp. RF6	2897342	S	1714	199	1913	0.00014
Geomonas paludis	2740185	S	1169	560	1729	0.00012
Geomonas nitrogeniifigens	2847991	S	1106	543	1649	0.00012
Geomonas subterranea	2847989	S	984	435	1419	0.00010
Geomonas oryzisoli	2847992	S	929	485	1414	0.00010
Geobacter sp. FeAm09	2597769	S	948	107	1055	0.00008
Geobacter sp. SVR	2495594	S	778	104	882	0.00006
Geobacter sp. DSM 9736	1277350	S	424	28	452	0.00003
Geobacter sulfurreducens	35554	S	1099	206	1305	0.00009
Geobacter pickeringii	345632	S	981	244	1225	0.00009
Geobacter metallireducens	28232	S	621	145	766	0.00005
Geobacter benzoatilyticus	2815309	S	421	93	514	0.00004
Citrifermentans bremense	60035	S	1000	384	1384	0.00010
Citrifermentans bemidjiense	225194	S	929	328	1257	0.00009
Geotalea uraniireducens	351604	S	494	32	526	0.00004
Geotalea daltonii	1203471	S	284	19	303	0.00002
Geoalkalibacter subterraneus	483547	S	549	491	1040	0.00007
Trichlorobacter lovleyi	313985	S	335	43	378	0.00003
Desulfuromonas versatilis	2802975	S	1738	281	2019	0.00014
Desulfuromonas sp. DDH964	1823759	S	1270	222	1492	0.00011
Desulfuromonas sp. AOP6	1566351	S	402	41	443	0.00003
Desulfuromonas soudanensis	1603606	S	1010	103	1113	0.00008
Pelobacter propionicus	29543	S	722	215	937	0.00007
Syntrophotalea acetylenica	29542	S	361	64	425	0.00003
Syntrophotalea carbinolica	19	S	327	23	350	0.00003
Syntrophotalea acetylenivorans	1842532	S	260	34	294	0.00002
Desulfovibrio sp. IOR2	2583823	S	562	103	665	0.00005
Desulfovibrio sp. 86	2666132	S	200	41	241	0.00002
Desulfovibrio sp. G11	631220	S	140	98	238	0.00002
Desulfovibrio vulgaris	881	S	678	16	694	0.00005
Desulfovibrio sulfodismutans	63561	S	570	142	712	0.00005
Desulfovibrio desulfuricans	876	S	563	116	679	0.00005
Desulfovibrio piger	901	S	448	82	530	0.00004
Desulfovibrio fairfieldensis	44742	S	372	31	403	0.00003
Desulfovibrio ferrophilus	241368	S	230	17	247	0.00002
Candidatus Desulfovibrio trichonymphae	1725232	S	109	8	117	0.00001
Pseudodesulfovibrio indicus	1716143	S	772	171	943	0.00007
Pseudodesulfovibrio mercurii	641491	S	733	178	911	0.00007
Pseudodesulfovibrio aespoeensis	182210	S	557	400	957	0.00007
Pseudodesulfovibrio sp. zrk46	2725288	S	241	43	284	0.00002
Pseudodesulfovibrio sp. SF6	2810563	S	194	21	215	0.00002
Pseudodesulfovibrio cashew	2678688	S	436	85	521	0.00004
Pseudodesulfovibrio tunisiensis	463192	S	399	38	437	0.00003
Pseudodesulfovibrio profundus	57320	S	169	172	341	0.00002
Pseudodesulfovibrio piezophilus	879567	S	69	9	78	0.00001
Solidesulfovibrio carbinoliphilus	345370	S	1024	121	1145	0.00008
Solidesulfovibrio magneticus	184917	S	461	259	720	0.00005
Solidesulfovibrio carbinolicus	296842	S	415	307	722	0.00005
Oceanidesulfovibrio marinus	370038	S	1058	62	1120	0.00008
Desulfocurvibacter africanus	873	S	861	59	920	0.00007
Desulfolutivibrio sulfoxidireducens	2773299	S	706	192	898	0.00006
Megalodesulfovibrio gigas	879	S	637	30	667	0.00005
Oleidesulfovibrio alaskensis	58180	S	228	317	545	0.00004
Maridesulfovibrio salexigens	880	S	81	7	88	0.00001
Maridesulfovibrio hydrothermalis	191026	S	45	4	49	0.00000
Paradesulfovibrio bizertensis	376490	S	98	9	107	0.00001
Lawsonia intracellularis	29546	S	36	0	36	0.00000
Desulfomicrobium baculatum	899	S	567	50	617	0.00004
Desulfomicrobium orale	132132	S	282	78	360	0.00003
Desulfohalobium retbaense	45663	S	186	8	194	0.00001
Desulfosarcina ovata	83564	S	660	34	694	0.00005
Desulfosarcina alkanivorans	571177	S	556	244	800	0.00006
Desulfosarcina widdelii	947919	S	526	59	585	0.00004
Desulfococcus multivorans	897	S	421	76	497	0.00004
Desulfatibacillum aliphaticivorans	218208	S	383	13	396	0.00003
Desulfoluna sp. ASN36	2810562	S	374	19	393	0.00003
Desulfonema magnum	45655	S	141	3	144	0.00001
Desulfonema limicola	45656	S	44	3	47	0.00000
Desulfobacter hydrogenophilus	2291	S	85	14	99	0.00001
Desulfobacter postgatei	2293	S	77	11	88	0.00001
Desulforapulum autotrophicum	2296	S	116	13	129	0.00001
Desulfobacula toluolica	28223	S	39	3	42	0.00000
Desulfobulbus propionicus	894	S	618	35	653	0.00005
Desulfobulbus oralis	1986146	S	384	85	469	0.00003
Desulfobulbus oligotrophicus	1909699	S	106	92	198	0.00001
Desulfurivibrio alkaliphilus	427923	S	405	23	428	0.00003
Desulfomarina profundi	2772557	S	88	9	97	0.00001
Desulfosudis oleivorans	181663	S	382	29	411	0.00003
Desulfosediminicola ganghwensis	2569540	S	118	14	132	0.00001
Desulfosediminicola flagellatus	2569541	S	58	6	64	0.00000
Desulfotalea psychrophila	84980	S	66	12	78	0.00001
Desulfocapsa sulfexigens	65555	S	52	3	55	0.00000
Persicimonas caeni	2292766	S	3241	101	3342	0.00024
Bradymonas sediminis	1548548	S	1040	76	1116	0.00008
Bradymonadales bacterium V1718	2600177	S	416	19	435	0.00003
Syntrophobacter fumaroxidans	119484	S	734	308	1042	0.00007
Desulfoglaeba alkanexedens	361111	S	576	24	600	0.00004
Desulfarculus baarsii	453230	S	1144	677	1821	0.00013
Desulfobacca acetoxidans	60893	S	233	6	239	0.00002
Desulfomonile tiedjei	2358	S	214	3	217	0.00002
Syntrophus aciditrophicus	316277	S	200	10	210	0.00002
Dissulfurimicrobium hydrothermale	1750598	S	99	5	104	0.00001
Candidatus Desulfofervidus auxilii	1621989	S	38	0	38	0.00000
Hippea maritima	84405	S	20	0	20	0.00000
Campylobacter showae	204	S	87	6	93	0.00001
Campylobacter curvus	200	S	76	6	82	0.00001
Campylobacter gracilis	824	S	75	4	79	0.00001
Campylobacter concisus	199	S	63	7	70	0.00001
Campylobacter rectus	203	S	62	7	69	0.00000
Campylobacter sp. 19-13652	2840180	S	12	3	15	0.00000
Campylobacter jejuni	197	S	18	149	167	0.00001
Campylobacter mucosalis	202	S	14	0	14	0.00000
Candidatus Campylobacter infans	2561898	S	13	1	14	0.00000
Campylobacter cuniculorum	374106	S	11	0	11	0.00000
Campylobacter coli	195	S	10	6	16	0.00000
Campylobacter blaseri	2042961	S	10	1	11	0.00000
Campylobacter pinnipediorum	1965231	S	10	1	11	0.00000
Sulfurimonas sp. HSL-3221	2894755	S	345	37	382	0.00003
Sulfurimonas sp. B2	2590551	S	10	3	13	0.00000
Sulfurimonas paralvinellae	317658	S	16	9	25	0.00000
Sulfuricurvum kujiense	148813	S	49	3	52	0.00000
Helicobacter pylori	210	S	111	51	162	0.00001
Helicobacter sp. NHP19-0003	2849641	S	23	5	28	0.00000
Helicobacter sp. NHP19-0012	2849642	S	18	7	25	0.00000
Helicobacter bizzozeronii	56877	S	23	3	26	0.00000
Helicobacter canis	29419	S	18	5	23	0.00000
Helicobacter felis	214	S	16	2	18	0.00000
Helicobacter himalayensis	1591088	S	15	1	16	0.00000
Helicobacter heilmannii	35817	S	11	5	16	0.00000
Wolinella succinogenes	844	S	28	4	32	0.00000
Nitratifractor salsuginis	269261	S	168	9	177	0.00001
Sulfurovum sp. HSL1-3	2893889	S	29	8	37	0.00000
Sulfurovum sp. NBC37-1	387093	S	24	13	37	0.00000
Sulfurovum sp. XGS-02	2925411	S	15	1	16	0.00000
Sulfurovum indicum	2779528	S	38	4	42	0.00000
Sulfurovum lithotrophicum	206403	S	31	19	50	0.00000
Arcobacter suis	1278212	S	10	9	19	0.00000
Aliarcobacter cryaerophilus	28198	S	10	15	25	0.00000
Pseudoarcobacter acticola	1849015	S	18	18	36	0.00000
Hydrogenimonas urashimensis	2740515	S	181	16	197	0.00001
Sulfurospirillum cavolei	366522	S	32	2	34	0.00000
Sulfurospirillum halorespirans	194424	S	24	17	41	0.00000
Sulfurospirillum multivorans	66821	S	12	9	21	0.00000
Sulfurospirillum barnesii	44674	S	10	0	10	0.00000
Nitratiruptor sp. YY09-18	2724901	S	15	19	34	0.00000
Nitratiruptor sp. SB155-2	387092	S	10	20	30	0.00000
Nitrosophilus alvini	2714855	S	16	5	21	0.00000
Nitrosophilus labii	2706014	S	12	10	22	0.00000
Nautilia profundicola	244787	S	22	6	28	0.00000
Nautilia sp. PV-1	2579250	S	11	2	13	0.00000
Caminibacter pacificus	1424653	S	12	16	28	0.00000
Acidithiobacillus caldus	33059	S	353	52	405	0.00003
Acidithiobacillus ferrivorans	160808	S	308	83	391	0.00003
Acidithiobacillus ferrooxidans	920	S	232	231	463	0.00003
Acidithiobacillus ferriphilus	1689834	S	125	32	157	0.00001
Acidithiobacillus thiooxidans	930	S	93	6	99	0.00001
Acidithiobacillus ferridurans	1232575	S	12	145	157	0.00001
Bdellovibrio bacteriovorus	959	S	402	66	468	0.00003
Bdellovibrio sp. LBG001	2835041	S	104	14	118	0.00001
Bdellovibrio sp. NC01	2220073	S	70	10	80	0.00001
Bdellovibrio sp. ZAP7	2231053	S	61	34	95	0.00001
Bdellovibrio sp. KM01	2748865	S	46	27	73	0.00001
Pseudobdellovibrio exovorus	453816	S	112	7	119	0.00001
Bacteriovorax stolpii	960	S	71	16	87	0.00001
Halobacteriovorax marinus	97084	S	34	14	48	0.00000
Halobacteriovorax sp. BALOs_7	2109558	S	18	4	22	0.00000
Fluviispira sanaruensis	2493639	S	22	13	35	0.00000
Silvanigrella aquatica	1915309	S	19	11	30	0.00000
Hydrogenophilus thermoluteolus	297	S	487	75	562	0.00004
Mariprofundus ferrinatatus	1921087	S	170	15	185	0.00001
Mariprofundus aestuarium	1921086	S	129	13	142	0.00001
Streptomyces sp. BJ20	2930049	S	9156	3222	12378	0.00088
Streptomyces sp. CdTB01	1725411	S	8949	2235	11184	0.00080
Streptomyces sp. SN-593	659352	S	7728	1589	9317	0.00067
Streptomyces sp. P3	2135430	S	7512	1652	9164	0.00065
Streptomyces sp. WAC 01438	2203204	S	7093	2089	9182	0.00066
Streptomyces sp. A2-16	2781734	S	5325	1450	6775	0.00048
Streptomyces sp. So13.3	2136173	S	5223	850	6073	0.00043
Streptomyces sp. TN58	234612	S	5076	2012	7088	0.00051
Streptomyces sp. SCSIO 64649	2878388	S	4973	783	5756	0.00041
Streptomyces sp. ZYC-3	2797636	S	4743	826	5569	0.00040
Streptomyces sp. 3214.6	1882757	S	4217	1079	5296	0.00038
Streptomyces sp. CB01881	2078691	S	4142	706	4848	0.00035
Streptomyces sp. MA3_2.13	2867410	S	3880	434	4314	0.00031
Streptomyces sp. CB09001	2083284	S	3778	2111	5889	0.00042
Streptomyces sp. NHF165	2175864	S	3664	553	4217	0.00030
Streptomyces sp. SCUT-3	2684469	S	3636	1239	4875	0.00035
Streptomyces sp. LRE541	2931983	S	3571	713	4284	0.00031
Streptomyces sp. ST1015	1848900	S	3562	651	4213	0.00030
Streptomyces sp. BH-MK-02	2880933	S	3539	664	4203	0.00030
Streptomyces sp. Z423-1	2730915	S	3345	852	4197	0.00030
Streptomyces sp. SYP-A7193	2662065	S	3194	1639	4833	0.00035
Streptomyces sp. SAT1	1849967	S	3049	983	4032	0.00029
Streptomyces sp. NA02950	2742137	S	3042	528	3570	0.00026
Streptomyces sp. 3025	2923272	S	3011	466	3477	0.00025
Streptomyces sp. MG28	2865673	S	3007	937	3944	0.00028
Streptomyces sp. AMCC400023	2056258	S	2942	1048	3990	0.00029
Streptomyces sp. NEAU-sy36	2751189	S	2868	930	3798	0.00027
Streptomyces sp. GQFP	2907545	S	2813	422	3235	0.00023
Streptomyces sp. HM190	2695266	S	2812	777	3589	0.00026
Streptomyces sp. DSM 40868	2721173	S	2802	887	3689	0.00026
Streptomyces sp. NA04227	2742136	S	2763	552	3315	0.00024
Streptomyces sp. GMY02	1333528	S	2728	420	3148	0.00022
Streptomyces sp. 891-h	2720714	S	2714	431	3145	0.00022
Streptomyces sp. RPA4-2	2721244	S	2708	693	3401	0.00024
Streptomyces sp. CMB-StM0423	2059884	S	2696	1134	3830	0.00027
Streptomyces sp. MBT27	1488356	S	2641	670	3311	0.00024
Streptomyces sp. Go 40/10	2825844	S	2554	977	3531	0.00025
Streptomyces sp. JB150	2714844	S	2552	751	3303	0.00024
Streptomyces sp. YIM 121038	2136401	S	2542	650	3192	0.00023
Streptomyces sp. RTd22	1841249	S	2506	930	3436	0.00025
Streptomyces sp. 2114.2	1881022	S	2470	12950	15420	0.00110
Streptomyces sp. Go-475	2072505	S	2464	984	3448	0.00025
Streptomyces sp. MST-110588	2833628	S	2463	522	2985	0.00021
Streptomyces sp. C8S0	2585716	S	2448	606	3054	0.00022
Streptomyces sp. W1SF4	2305220	S	2437	750	3187	0.00023
Streptomyces sp. GS7	2692234	S	2383	560	2943	0.00021
Streptomyces sp. MG62	2838015	S	2298	746	3044	0.00022
Streptomyces sp. Rer75	2750011	S	2257	924	3181	0.00023
Streptomyces sp. QHH-9511	2684468	S	2217	531	2748	0.00020
Streptomyces sp. jing01	2726118	S	2211	1053	3264	0.00023
Streptomyces sp. HSG2	2797167	S	2106	395	2501	0.00018
Streptomyces sp. SirexAA-E	862751	S	2049	534	2583	0.00018
Streptomyces sp. 135	2838850	S	2032	574	2606	0.00019
Streptomyces sp. SM18	1736046	S	2011	486	2497	0.00018
Streptomyces sp. BHT-5-2	2866715	S	1982	538	2520	0.00018
Streptomyces sp. Tu 2975	2676871	S	1876	514	2390	0.00017
Streptomyces sp. HP-A2021	2927875	S	1815	860	2675	0.00019
Streptomyces sp. CCM_MD2014	1561022	S	1797	1390	3187	0.00023
Streptomyces sp. WAC 01529	2203205	S	1780	544	2324	0.00017
Streptomyces sp. fd1-xmd	1812480	S	1759	666	2425	0.00017
Streptomyces sp. WY228	2855836	S	1709	783	2492	0.00018
Streptomyces sp. INR7	2607753	S	1646	724	2370	0.00017
Streptomyces sp. S4.7	2705439	S	1639	467	2106	0.00015
Streptomyces sp. WAC 06738	2203210	S	1528	1340	2868	0.00020
Streptomyces sp. S1D4-11	2721246	S	1527	955	2482	0.00018
Streptomyces sp. CNQ-509	444103	S	1432	1231	2663	0.00019
Streptomyces sp. SUK 48	2582831	S	1353	715	2068	0.00015
Streptomyces sp. YPW6	2840373	S	1116	493	1609	0.00011
Streptomyces sp. HF10	2692233	S	1115	662	1777	0.00013
Streptomyces sp. ADI95-16	1522758	S	1047	810	1857	0.00013
Streptomyces sp. NA02536	2742133	S	993	2194	3187	0.00023
Streptomyces sp. Mg1	465541	S	991	816	1807	0.00013
Streptomyces sp. 769	1262452	S	979	620	1599	0.00011
Streptomyces sp. AgN23	1188315	S	975	724	1699	0.00012
Streptomyces sp. 2323.1	1938841	S	957	488	1445	0.00010
Streptomyces sp. RPA4-5	2721245	S	914	494	1408	0.00010
Streptomyces sp. S063	2005885	S	827	486	1313	0.00009
Streptomyces sp. S8	1837283	S	824	611	1435	0.00010
Streptomyces sp. HNA39	2850561	S	813	802	1615	0.00012
Streptomyces sp. EAS-AB2608	2779671	S	788	1133	1921	0.00014
Streptomyces sp. 3211	1964449	S	741	854	1595	0.00011
Streptomyces sp. PBH53	1577075	S	720	977	1697	0.00012
Streptomyces sp. WA6-1-16	2879427	S	676	584	1260	0.00009
Streptomyces sp. XC 2026	2782004	S	674	489	1163	0.00008
Streptomyces sp. M2	646637	S	671	3486	4157	0.00030
Streptomyces sp. ID38640	1265399	S	666	407	1073	0.00008
Streptomyces sp. NEAU-S7GS2	2202000	S	653	456	1109	0.00008
Streptomyces sp. CRSS-Y-16	2906474	S	640	3518	4158	0.00030
Streptomyces sp. RLB1-33	2721243	S	620	1553	2173	0.00016
Streptomyces sp. Sge12	1972846	S	584	829	1413	0.00010
Streptomyces sp. CFMR 7	1649184	S	566	838	1404	0.00010
Streptomyces sp. MOE7	1961713	S	566	566	1132	0.00008
Streptomyces sp. Tue 6075	1661694	S	531	517	1048	0.00007
Streptomyces sp. 11-1-2	1851167	S	484	762	1246	0.00009
Streptomyces sp. LBUM 1480	2609808	S	482	4172	4654	0.00033
Streptomyces sp. CB00271	2750025	S	421	483	904	0.00006
Streptomyces sp. M56	1495638	S	413	927	1340	0.00010
Streptomyces sp. WAC00303	2933779	S	390	473	863	0.00006
Streptomyces sp. CB04723	2748873	S	365	546	911	0.00007
Streptomyces sp. A144	2871487	S	357	1536	1893	0.00014
Streptomyces sp. CLI2509	1984801	S	354	1170	1524	0.00011
Streptomyces sp. Tu6071	355249	S	348	1026	1374	0.00010
Streptomyces sp. V17-9	2831149	S	345	1533	1878	0.00013
Streptomyces sp. SGAir0924	2109593	S	322	1506	1828	0.00013
Streptomyces sp. NA03103	2742134	S	317	1935	2252	0.00016
Streptomyces sp. CB09030	2913412	S	308	868	1176	0.00008
Streptomyces sp. BSE6.1	2605730	S	300	1291	1591	0.00011
Streptomyces sp. VN1	1821625	S	300	1072	1372	0.00010
Streptomyces sp. SS52	2563602	S	300	1354	1654	0.00012
Streptomyces sp. PAMC 26508	1265601	S	288	998	1286	0.00009
Streptomyces sp. WA1-19	2884220	S	276	1238	1514	0.00011
Streptomyces sp. endophyte_N2	2153485	S	269	655	924	0.00007
Streptomyces sp. S501	2420135	S	259	970	1229	0.00009
Streptomyces sp. WAC00288	2094021	S	238	833	1071	0.00008
Streptomyces sp. KPB2	2305221	S	217	1676	1893	0.00014
Streptomyces sp. HU2014	2939414	S	207	597	804	0.00006
Streptomyces sp. CC0208	2306165	S	201	4616	4817	0.00034
Streptomyces sp. S1A1-7	2594459	S	180	1668	1848	0.00013
Streptomyces sp. R527F	1664033	S	172	833	1005	0.00007
Streptomyces sp. A1-5	2738410	S	169	669	838	0.00006
Streptomyces sp. GF20	2692235	S	146	697	843	0.00006
Streptomyces sp. CA-256286	2801033	S	138	733	871	0.00006
Streptomyces sp. 604F	1476754	S	115	958	1073	0.00008
Streptomyces sp. RLB3-17	2594455	S	113	1749	1862	0.00013
Streptomyces sp. RLB3-6	2594457	S	109	3398	3507	0.00025
Streptomyces sp. LBUM 1482	2609809	S	108	2449	2557	0.00018
Streptomyces sp. FR-008	206662	S	100	696	796	0.00006
Streptomyces sp. LBUM 1475	2609807	S	100	2660	2760	0.00020
Streptomyces sp. NBU3104	2911367	S	99	553	652	0.00005
Streptomyces sp. OUCMDZ-3434	1535304	S	96	926	1022	0.00007
Streptomyces sp. GBA 94-10	1218177	S	82	968	1050	0.00008
Streptomyces sp. PLM4	2929798	S	81	570	651	0.00005
Streptomyces sp. PVA_94-07	1225337	S	66	900	966	0.00007
Streptomyces sp. S1D4-20	2594462	S	65	1753	1818	0.00013
Streptomyces sp. S1D4-23	2594463	S	52	2763	2815	0.00020
Streptomyces sp. RLB1-9	2594454	S	47	2572	2619	0.00019
Streptomyces sp. A10(2020)	2782013	S	46	456	502	0.00004
Streptomyces sp. S1D4-14	2594461	S	28	1814	1842	0.00013
Streptomyces sp. ICC4	2099584	S	19	1284	1303	0.00009
Streptomyces sp. ICC1	2099583	S	19	1110	1129	0.00008
Streptomyces sp. SM17	565560	S	18	626	644	0.00005
Streptomyces nigra	1827580	S	17325	5372	22697	0.00162
Streptomyces venezuelae	54571	S	13766	4489	18255	0.00130
Streptomyces tendae	1932	S	11758	3848	15606	0.00111
Streptomyces cadmiisoli	2184053	S	3170	635	3805	0.00027
Streptomyces aurantiacus	47760	S	2987	575	3562	0.00025
Streptomyces qaidamensis	1783515	S	1956	661	2617	0.00019
Streptomyces alboniger	132473	S	1420	424	1844	0.00013
Streptomyces koyangensis	188770	S	1133	917	2050	0.00015
Streptomyces hygroscopicus	1912	S	5048	5579	10627	0.00076
Streptomyces rapamycinicus	1226757	S	2787	527	3314	0.00024
Streptomyces violaceusniger	68280	S	1065	564	1629	0.00012
Streptomyces yatensis	155177	S	1000	584	1584	0.00011
Streptomyces malaysiensis	92644	S	290	716	1006	0.00007
Streptomyces griseorubiginosus	67304	S	5657	1479	7136	0.00051
Streptomyces chartreusis	1969	S	5558	1955	7513	0.00054
Streptomyces griseus	1911	S	2067	1481	3548	0.00025
Streptomyces sp. M54	2759525	S	209	441	650	0.00005
Streptomyces anulatus	1892	S	1645	1403	3048	0.00022
Streptomyces microflavus	1919	S	867	3174	4041	0.00029
Streptomyces globisporus	1908	S	584	3508	4092	0.00029
Streptomyces albus	1888	S	5437	2189	7626	0.00054
Streptomyces bathyalis	2710756	S	5336	699	6035	0.00043
Streptomyces calvus	67282	S	4924	1520	6444	0.00046
Streptomyces prasinus	67345	S	4694	1208	5902	0.00042
Streptomyces formicae	1616117	S	4685	1186	5871	0.00042
Streptomyces lydicus	47763	S	4352	2375	6727	0.00048
Streptomyces buecherae	2763006	S	4193	840	5033	0.00036
Streptomyces viridosporus	67581	S	4058	1300	5358	0.00038
Streptomyces bingchenggensis	379067	S	4012	606	4618	0.00033
Streptomyces capitiformicae	2014920	S	3914	493	4407	0.00031
Streptomyces tsukubensis	83656	S	3855	788	4643	0.00033
Streptomyces niveus	193462	S	3789	1362	5151	0.00037
Streptomyces cattleya	29303	S	3772	864	4636	0.00033
Streptomyces seoulensis	73044	S	3762	1138	4900	0.00035
Streptomyces aquilus	2548456	S	3762	883	4645	0.00033
Streptomyces armeniacus	83291	S	3740	425	4165	0.00030
Streptomyces spectabilis	68270	S	3638	944	4582	0.00033
Streptomyces lincolnensis	1915	S	3442	790	4232	0.00030
Streptomyces cyaneochromogenes	2496836	S	3218	750	3968	0.00028
Streptomyces ambofaciens	1889	S	3182	1958	5140	0.00037
Streptomyces ferrugineus	1413221	S	3161	806	3967	0.00028
Streptomyces roseirectus	2768066	S	3143	605	3748	0.00027
Streptomyces xanthii	2768069	S	3115	743	3858	0.00028
Streptomyces asoensis	249586	S	3105	732	3837	0.00027
Streptomyces coelicolor	1902	S	2597	24712	27309	0.00195
Streptomyces albidoflavus	1886	S	260	3200	3460	0.00025
Streptomyces sampsonii	42239	S	132	873	1005	0.00007
Streptomyces griseoviridis	45398	S	2985	762	3747	0.00027
Streptomyces rimosus	1927	S	2932	847	3779	0.00027
Streptomyces phaeolivaceus	2653200	S	2929	645	3574	0.00026
Streptomyces xinghaiensis	1038928	S	2915	697	3612	0.00026
Streptomyces actuosus	1885	S	2900	971	3871	0.00028
Streptomyces davaonensis	348043	S	2883	639	3522	0.00025
Streptomyces dengpaensis	2049881	S	2837	623	3460	0.00025
Streptomyces genisteinicus	2768068	S	2825	703	3528	0.00025
Streptomyces durmitorensis	319947	S	2815	482	3297	0.00024
Streptomyces griseochromogenes	68214	S	2756	607	3363	0.00024
Streptomyces liangshanensis	2717324	S	2728	544	3272	0.00023
Streptomyces avermitilis	33903	S	2685	610	3295	0.00024
Streptomyces nodosus	40318	S	2681	538	3219	0.00023
Streptomyces antibioticus	1890	S	2678	754	3432	0.00025
Streptomyces aureoverticillatus	66871	S	2657	570	3227	0.00023
Streptomyces albulus	68570	S	2572	620	3192	0.00023
Streptomyces vietnamensis	362257	S	2566	682	3248	0.00023
Streptomyces alboflavus	67267	S	2548	561	3109	0.00022
Streptomyces galilaeus	33899	S	2539	674	3213	0.00023
Streptomyces lividans	1916	S	2529	14759	17288	0.00124
Streptomyces atratus	1893	S	2520	406	2926	0.00021
Streptomyces pactum	68249	S	2512	804	3316	0.00024
Streptomyces parvulus	146923	S	2496	873	3369	0.00024
Streptomyces griseocarneus	51201	S	2489	688	3177	0.00023
Streptomyces paludis	2282738	S	2482	429	2911	0.00021
Streptomyces olivoreticuli	68246	S	2476	554	3030	0.00022
Streptomyces globosus	68209	S	2463	712	3175	0.00023
Streptomyces rectiverticillatus	173860	S	2387	605	2992	0.00021
Streptomyces collinus	42684	S	2364	1273	3637	0.00026
Streptomyces luteoverticillatus	66425	S	2359	618	2977	0.00021
Streptomyces harbinensis	1176198	S	2352	507	2859	0.00020
Streptomyces deccanensis	424188	S	2352	781	3133	0.00022
Streptomyces lunaelactis	1535768	S	2309	383	2692	0.00019
Streptomyces clavuligerus	1901	S	2308	440	2748	0.00020
Streptomyces ficellus	1977088	S	2265	641	2906	0.00021
Streptomyces glaucescens	1907	S	2230	760	2990	0.00021
Streptomyces broussonetiae	2686304	S	2204	527	2731	0.00020
Streptomyces exfoliatus	1905	S	2203	598	2801	0.00020
Streptomyces subrutilus	36818	S	2166	636	2802	0.00020
Streptomyces hundungensis	1077946	S	2147	530	2677	0.00019
Streptomyces kanamyceticus	1967	S	2143	578	2721	0.00019
Streptomyces lavendulae	1914	S	2123	585	2708	0.00019
Streptomyces chromofuscus	42881	S	2112	643	2755	0.00020
Streptomyces peucetius	1950	S	2086	451	2537	0.00018
Streptomyces dangxiongensis	1442032	S	2082	570	2652	0.00019
Streptomyces fodineus	1904616	S	2081	583	2664	0.00019
Streptomyces incarnatus	665007	S	2064	483	2547	0.00018
Streptomyces katrae	68223	S	2062	613	2675	0.00019
Streptomyces roseochromogenus	285450	S	2010	500	2510	0.00018
Streptomyces vinaceus	1960	S	1983	564	2547	0.00018
Streptomyces pristinaespiralis	38300	S	1977	615	2592	0.00019
Streptomyces cyanogenus	80860	S	1933	678	2611	0.00019
Streptomyces nitrosporeus	28894	S	1896	426	2322	0.00017
Streptomyces gilvosporeus	553510	S	1878	472	2350	0.00017
Streptomyces coeruleorubidus	116188	S	1871	715	2586	0.00018
Streptomyces fagopyri	2662397	S	1862	505	2367	0.00017
Streptomyces tirandamycinicus	2174846	S	1819	479	2298	0.00016
Streptomyces pratensis	1169025	S	1806	351	2157	0.00015
Streptomyces gobiensis	2875706	S	1782	265	2047	0.00015
Streptomyces pluripotens	1355015	S	1763	320	2083	0.00015
Streptomyces gardneri	66892	S	1715	554	2269	0.00016
Streptomyces finlayi	67296	S	1713	310	2023	0.00014
Streptomyces qinzhouensis	2599401	S	1701	322	2023	0.00014
Streptomyces mobaraensis	35621	S	1684	53708	55392	0.00396
Streptomyces spongiicola	1690221	S	1676	544	2220	0.00016
Streptomyces rutgersensis	53451	S	1676	647	2323	0.00017
Streptomyces hawaiiensis	67305	S	1669	581	2250	0.00016
Streptomyces tuirus	68278	S	1633	655	2288	0.00016
Streptomyces inhibens	2293571	S	1625	391	2016	0.00014
Streptomyces huasconensis	1854574	S	1581	491	2072	0.00015
Streptomyces leeuwenhoekii	1437453	S	1578	879	2457	0.00018
Streptomyces angustmyceticus	285578	S	1519	490	2009	0.00014
Streptomyces nojiriensis	66374	S	1420	486	1906	0.00014
Streptomyces cyaneogriseus	68192	S	1175	727	1902	0.00014
Streptomyces fungicidicus	68203	S	902	2144	3046	0.00022
Streptomyces antimycoticus	68175	S	828	690	1518	0.00011
Streptomyces decoyicus	249567	S	793	354	1147	0.00008
Streptomyces auratus	114687	S	753	402	1155	0.00008
Streptomyces lydicamycinicus	1546107	S	739	356	1095	0.00008
Streptomyces platensis	58346	S	723	435	1158	0.00008
Streptomyces xiamenensis	408015	S	719	498	1217	0.00009
Streptomyces cavourensis	67258	S	652	992	1644	0.00012
Streptomyces olivaceus	47716	S	484	1456	1940	0.00014
Streptomyces alfalfae	1642299	S	478	2231	2709	0.00019
Streptomyces filamentosus	67294	S	461	474	935	0.00007
Streptomyces scabiei	1930	S	454	3315	3769	0.00027
Streptomyces californicus	67351	S	368	989	1357	0.00010
Streptomyces fradiae	1906	S	323	4157	4480	0.00032
Streptomyces mirabilis	68239	S	312	1543	1855	0.00013
Streptomyces murinus	33900	S	242	564	806	0.00006
Streptomyces autolyticus	75293	S	219	609	828	0.00006
Streptomyces griseofuscus	146922	S	216	798	1014	0.00007
Streptomyces albireticuli	1940	S	213	740	953	0.00007
Streptomyces cinereoruber	67260	S	184	791	975	0.00007
Streptomyces noursei	1971	S	171	553	724	0.00005
Streptomyces rochei	1928	S	113	699	812	0.00006
Streptomyces rubrolavendulae	285473	S	103	614	717	0.00005
Streptomyces violaceoruber	1935	S	102	371	473	0.00003
Streptomyces sviceus	285530	S	10	724	734	0.00005
Yinghuangia sp. ASG 101	2896848	S	15589	2108	17697	0.00126
Kitasatospora sp. MMS16-BH015	2018025	S	2821	771	3592	0.00026
Kitasatospora sp. NA04385	2742135	S	2437	1169	3606	0.00026
Kitasatospora setae	2066	S	2509	1162	3671	0.00026
Kitasatospora aureofaciens	1894	S	2127	730	2857	0.00020
Kitasatospora albolonga	68173	S	796	553	1349	0.00010
Streptacidiphilus sp. P02-A3a	2704468	S	2714	709	3423	0.00024
Streptacidiphilus sp. PB12-B1b	2705012	S	2495	836	3331	0.00024
Streptacidiphilus bronchialis	2126346	S	2329	617	2946	0.00021
Mycolicibacterium fortuitum	1766	S	59157	11644	70801	0.00506
Mycolicibacterium alvei	67081	S	29536	4207	33743	0.00241
Mycolicibacterium boenickei	146017	S	27258	19109	46367	0.00331
Mycolicibacterium septicum	98668	S	13849	4994	18843	0.00135
Mycolicibacterium gadium	1794	S	9677	767	10444	0.00075
Mycolicibacterium smegmatis	1772	S	9280	3548	12828	0.00092
Mycolicibacterium rhodesiae	36814	S	6142	580	6722	0.00048
Mycolicibacterium farcinogenes	1802	S	6136	7679	13815	0.00099
Mycolicibacterium litorale	758802	S	5593	909	6502	0.00046
Mycolicibacterium gilvum	1804	S	5528	1056	6584	0.00047
Mycolicibacterium chitae	1792	S	5416	829	6245	0.00045
Mycolicibacterium mageritense	53462	S	5320	519	5839	0.00042
Mycolicibacterium neoaurum	1795	S	4518	637	5155	0.00037
Mycolicibacterium moriokaense	39691	S	4342	340	4682	0.00033
Mycolicibacterium rutilum	370526	S	4243	732	4975	0.00036
Mycolicibacterium sp. YH-1	2908837	S	2795	1338	4133	0.00030
Mycolicibacterium pulveris	36813	S	3245	338	3583	0.00026
Mycolicibacterium arabiense	1286181	S	3215	328	3543	0.00025
Mycolicibacterium vaccae	1810	S	3193	400	3593	0.00026
Mycolicibacterium phlei	1771	S	3062	653	3715	0.00027
Mycolicibacterium nivoides	2487344	S	3034	7410	10444	0.00075
Mycolicibacterium fluoranthenivorans	258505	S	2902	244	3146	0.00022
Mycolicibacterium celeriflavum	1249101	S	2894	319	3213	0.00023
Mycolicibacterium duvalii	39688	S	2844	356	3200	0.00023
Mycolicibacterium parafortuitum	39692	S	2774	358	3132	0.00022
Mycolicibacterium sediminis	1286180	S	2730	321	3051	0.00022
Mycolicibacterium chubuense	1800	S	2696	350	3046	0.00022
Mycolicibacterium hassiacum	46351	S	2690	462	3152	0.00023
Mycolicibacterium monacense	85693	S	2685	727	3412	0.00024
Mycolicibacterium baixiangningiae	2761578	S	2536	262	2798	0.00020
Mycolicibacterium madagascariense	212765	S	2534	257	2791	0.00020
Mycolicibacterium phocaicum	319706	S	2512	745	3257	0.00023
Mycolicibacterium thermoresistibile	1797	S	2479	356	2835	0.00020
Mycolicibacterium confluentis	28047	S	2447	245	2692	0.00019
Mycolicibacterium psychrotolerans	216929	S	2402	326	2728	0.00019
Mycolicibacterium poriferae	39694	S	2395	299	2694	0.00019
Mycolicibacterium aurum	1791	S	2311	199	2510	0.00018
Mycolicibacterium tokaiense	39695	S	2273	227	2500	0.00018
Mycolicibacterium mengxianglii	2736649	S	1882	134	2016	0.00014
Mycolicibacterium fallax	1793	S	1849	445	2294	0.00016
Mycolicibacterium anyangense	1431246	S	1747	179	1926	0.00014
Mycolicibacterium aichiense	1799	S	1682	172	1854	0.00013
Mycolicibacterium insubricum	444597	S	1618	268	1886	0.00013
Mycolicibacterium helvum	1534349	S	1600	119	1719	0.00012
Mycolicibacterium austroafricanum	39687	S	1550	3174	4724	0.00034
Mycolicibacterium mucogenicum	56689	S	1459	352	1811	0.00013
Mycobacterium doricum	126673	S	1443	204	1647	0.00012
Mycolicibacterium sarraceniae	1534348	S	1307	104	1411	0.00010
Mycolicibacterium vanbaalenii	110539	S	256	2064	2320	0.00017
Mycobacterium sp. DL440	2675523	S	37298	4034	41332	0.00295
Mycobacterium sp. JS623	212767	S	7265	398	7663	0.00055
Mycobacterium sp. YC-RL4	1682113	S	2123	423	2546	0.00018
Mycobacterium sp. IDR2000157661	2867005	S	2100	227	2327	0.00017
Mycobacterium sp. EPa45	1545728	S	1543	158	1701	0.00012
Mycobacterium sp. DL592	2675524	S	1473	153	1626	0.00012
Mycobacterium sp. MS1601	1936029	S	1433	122	1555	0.00011
Mycobacterium sp. TY59	2775496	S	1182	145	1327	0.00009
Mycobacterium sp. WY10	1920667	S	191	452	643	0.00005
Mycobacterium sp. PYR15	2051552	S	61	415	476	0.00003
Mycobacterium sp. 20KCMC460	2903536	S	33	1453	1486	0.00011
Mycobacterium sp. MOTT36Y	1168287	S	24	229	253	0.00002
Mycobacterium saskatchewanense	220927	S	1549	245	1794	0.00013
Mycobacterium parmense	185642	S	1533	209	1742	0.00012
Mycobacterium kubicae	120959	S	1379	152	1531	0.00011
Mycobacterium shigaense	722731	S	1205	132	1337	0.00010
Mycobacterium simiae	1784	S	1196	77	1273	0.00009
Mycobacterium florentinum	292462	S	1073	202	1275	0.00009
Mycobacterium lentiflavum	141349	S	1045	200	1245	0.00009
Mycobacterium stomatepiae	470076	S	1037	177	1214	0.00009
Mycobacterium heidelbergense	53376	S	942	163	1105	0.00008
Mycobacterium avium	1764	S	2348	1221	3569	0.00026
Mycobacterium mantenii	560555	S	1353	114	1467	0.00010
Mycobacterium colombiense	339268	S	1302	152	1454	0.00010
Mycobacterium intracellulare	1767	S	1094	12099	13193	0.00094
Mycobacterium marseillense	701042	S	1093	160	1253	0.00009
Mycobacterium paraintracellulare	1138383	S	246	1166	1412	0.00010
Mycobacterium diernhoferi	1801	S	7806	963	8769	0.00063
Mycobacterium goodii	134601	S	5117	862	5979	0.00043
Mycobacterium holsaticum	152142	S	3584	344	3928	0.00028
Mycobacterium dioxanotrophicus	482462	S	3026	396	3422	0.00024
Mycobacterium frederiksbergense	117567	S	2492	400	2892	0.00021
Mycobacterium grossiae	1552759	S	2417	431	2848	0.00020
Mycobacterium rufum	318424	S	2222	365	2587	0.00018
Mycobacterium senegalense	1796	S	1606	3205	4811	0.00034
Mycobacterium branderi	43348	S	1606	122	1728	0.00012
Mycobacterium conspicuum	44010	S	1540	128	1668	0.00012
Mycobacterium paragordonae	1389713	S	1405	106	1511	0.00011
Mycobacterium cookii	1775	S	1305	88	1393	0.00010
Mycobacterium canettii	78331	S	409	197	606	0.00004
Mycobacterium tuberculosis	1773	S	266	5745	6011	0.00043
Mycobacterium gordonae	1778	S	1266	63	1329	0.00009
Mycobacterium paraterrae	577492	S	1238	84	1322	0.00009
Mycobacterium koreense	1069220	S	1107	182	1289	0.00009
Mycobacterium noviomagense	459858	S	1103	61	1164	0.00008
Mycobacterium virginiense	1795032	S	1036	139	1175	0.00008
Mycobacterium heckeshornense	110505	S	1013	56	1069	0.00008
Mycobacterium vicinigordonae	1719132	S	1008	36	1044	0.00007
Mycobacterium paraseoulense	590652	S	963	138	1101	0.00008
Mycobacterium riyadhense	486698	S	914	26	940	0.00007
Mycobacterium kansasii	1768	S	894	57	951	0.00007
Mycobacterium shinjukuense	398694	S	871	60	931	0.00007
Mycobacterium lacus	169765	S	851	43	894	0.00006
Mycobacterium malmoense	1780	S	839	91	930	0.00007
Mycobacterium xenopi	1789	S	821	60	881	0.00006
Mycobacterium seoulense	386911	S	812	135	947	0.00007
Mycobacterium ostraviense	2738409	S	783	56	839	0.00006
Mycobacterium basiliense	2094119	S	751	19	770	0.00006
Mycobacterium spongiae	886343	S	707	14	721	0.00005
Mycobacterium crocinum	388459	S	658	243	901	0.00006
Mycobacterium haemophilum	29311	S	510	18	528	0.00004
Mycobacterium marinum	1781	S	229	681	910	0.00007
Mycobacterium novum	2492438	S	166	826	992	0.00007
Mycobacterium leprae	1769	S	117	16	133	0.00001
Mycobacterium lepromatosis	480418	S	105	2	107	0.00001
Mycobacterium ulcerans	1809	S	76	394	470	0.00003
Mycobacterium pallens	370524	S	67	450	517	0.00004
Mycobacterium shottsii	133549	S	49	66	115	0.00001
Mycobacterium pseudoshottsii	265949	S	23	107	130	0.00001
Mycolicibacter sp. MYC340	2855503	S	979	176	1155	0.00008
Mycolicibacter sp. MYC098	2872309	S	875	166	1041	0.00007
Mycolicibacter sp. MYC017	2875777	S	525	369	894	0.00006
Mycolicibacter sp. MYC123	2855502	S	157	644	801	0.00006
Mycolicibacter sp. MYC101	2872311	S	116	486	602	0.00004
Mycolicibacter terrae	1788	S	3689	688	4377	0.00031
Mycolicibacter hiberniae	29314	S	995	139	1134	0.00008
Mycolicibacter minnesotensis	1118379	S	673	77	750	0.00005
Mycolicibacter sinensis	875328	S	179	731	910	0.00007
Mycobacteroides chelonae	1774	S	1801	786	2587	0.00018
Mycobacteroides abscessus	36809	S	1583	778	2361	0.00017
Mycobacteroides immunogenum	83262	S	658	81	739	0.00005
Mycobacteroides saopaulense	1578165	S	649	61	710	0.00005
Mycobacteroides salmoniphilum	404941	S	566	42	608	0.00004
[Mycobacterium] stephanolepidis	1520670	S	319	67	386	0.00003
Mycolicibacillus parakoreensis	1069221	S	1125	177	1302	0.00009
Hoyosella subflava	639313	S	566	24	590	0.00004
Rhodococcus sp. W8901	2742603	S	2668	561	3229	0.00023
Rhodococcus sp. SGAir0479	2567884	S	2601	608	3209	0.00023
Rhodococcus sp. MTM3W5.2	1805827	S	2343	443	2786	0.00020
Rhodococcus sp. X156	2499145	S	2137	587	2724	0.00019
Rhodococcus sp. USK13	2806442	S	1892	1117	3009	0.00022
Rhodococcus sp. PBTS 1	1653478	S	1341	272	1613	0.00012
Rhodococcus sp. ABRD24	2507582	S	1295	183	1478	0.00011
Rhodococcus sp. R79	2811421	S	948	509	1457	0.00010
Rhodococcus sp. USK10	2789739	S	773	438	1211	0.00009
Rhodococcus sp. B7740	1564114	S	754	84	838	0.00006
Rhodococcus sp. P1Y	1302308	S	725	53	778	0.00006
Rhodococcus sp. WMMA185	679318	S	608	62	670	0.00005
Rhodococcus sp. RDE2	2885078	S	607	507	1114	0.00008
Rhodococcus sp. WAY2	2663121	S	532	389	921	0.00007
Rhodococcus sp. ZPP	2749906	S	259	607	866	0.00006
Rhodococcus sp. WB9	2594007	S	253	306	559	0.00004
Rhodococcus sp. S2-17	1990687	S	215	523	738	0.00005
Rhodococcus sp. DMU1	2722825	S	199	660	859	0.00006
Rhodococcus sp. M8	1925550	S	182	495	677	0.00005
Rhodococcus sp. P-2	2795031	S	130	147	277	0.00002
Rhodococcus sp. 21391	2683591	S	103	437	540	0.00004
Rhodococcus sp. 2G	1570939	S	96	340	436	0.00003
Rhodococcus sp. WB1	1033922	S	70	531	601	0.00004
Rhodococcus sp. LW-XY12	2856851	S	66	484	550	0.00004
Rhodococcus sp. DMF-1	2907624	S	55	388	443	0.00003
Rhodococcus sp. p52	935199	S	54	255	309	0.00002
Rhodococcus sp. YL-1	1045808	S	42	167	209	0.00001
Rhodococcus sp. PSBB049	2812863	S	40	515	555	0.00004
Rhodococcus sp. BH4	1807790	S	36	213	249	0.00002
Rhodococcus sp. 008	1723645	S	33	182	215	0.00002
Rhodococcus sp. NJ-530	2490853	S	30	153	183	0.00001
Rhodococcus sp. AQ5-07	2054902	S	28	88	116	0.00001
Rhodococcus sp. H-CA8f	1727214	S	27	107	134	0.00001
Rhodococcus sp. C1	644410	S	24	258	282	0.00002
Rhodococcus equi	43767	S	11830	3422	15252	0.00109
Rhodococcus opacus	37919	S	4186	3813	7999	0.00057
Rhodococcus rhodochrous	1829	S	2605	1276	3881	0.00028
Rhodococcus fascians	1828	S	2086	370	2456	0.00018
Rhodococcus coprophilus	38310	S	1194	165	1359	0.00010
Rhodococcus triatomae	300028	S	1164	277	1441	0.00010
Rhodococcus pyridinivorans	103816	S	1055	3506	4561	0.00033
Rhodococcus koreensis	99653	S	1049	273	1322	0.00009
Rhodococcus qingshengii	334542	S	357	1914	2271	0.00016
Rhodococcus erythropolis	1833	S	316	1239	1555	0.00011
Rhodococcus ruber	1830	S	706	1990	2696	0.00019
Rhodococcus jostii	132919	S	692	252	944	0.00007
Rhodococcus globerulus	33008	S	597	55	652	0.00005
Rhodococcus aetherivorans	191292	S	198	1625	1823	0.00013
Nocardia asteroides	1824	S	9066	2708	11774	0.00084
Nocardia brasiliensis	37326	S	4469	1057	5526	0.00039
Nocardia cyriacigeorgica	135487	S	3105	1165	4270	0.00031
Nocardia terpenica	455432	S	3018	453	3471	0.00025
Nocardia farcinica	37329	S	2499	1297	3796	0.00027
Nocardia wallacei	480035	S	1910	499	2409	0.00017
Nocardia arthritidis	228602	S	1855	197	2052	0.00015
Nocardia huaxiensis	2755382	S	1723	296	2019	0.00014
Nocardia nova	37330	S	1714	199	1913	0.00014
Nocardia yamanashiensis	209247	S	1680	294	1974	0.00014
Nocardia yunnanensis	2382165	S	1646	371	2017	0.00014
Nocardia gipuzkoensis	2749991	S	1645	578	2223	0.00016
Nocardia sp. CS682	1047172	S	1640	360	2000	0.00014
Nocardia otitidiscaviarum	1823	S	1636	275	1911	0.00014
Nocardia tengchongensis	2055889	S	1579	354	1933	0.00014
Nocardia mangyaensis	2213200	S	1493	350	1843	0.00013
Nocardia seriolae	37332	S	1477	363	1840	0.00013
Nocardia iowensis	204891	S	1434	285	1719	0.00012
Corynebacterium cyclohexanicum	322009	S	1360	415	1775	0.00013
Corynebacterium xerosis	1725	S	961	414	1375	0.00010
Corynebacterium sphenisci	191493	S	958	218	1176	0.00008
Corynebacterium frankenforstense	1230998	S	882	202	1084	0.00008
Corynebacterium bovis	36808	S	849	147	996	0.00007
Corynebacterium halotolerans	225326	S	708	126	834	0.00006
Corynebacterium freneyi	134034	S	707	219	926	0.00007
Corynebacterium nuruki	1032851	S	691	125	816	0.00006
Corynebacterium sp. CNCTC7651	2815361	S	308	47	355	0.00003
Corynebacterium sp. NML98-0116	702967	S	157	45	202	0.00001
Corynebacterium sp. 4H37-19	2684405	S	51	4	55	0.00000
Corynebacterium sp. 1864	2820399	S	44	81	125	0.00001
Corynebacterium sp. FDAARGOS 1242	2778078	S	35	78	113	0.00001
Corynebacterium sp. sy039	2599641	S	21	1	22	0.00000
Corynebacterium vitaeruminis	38305	S	612	140	752	0.00005
Corynebacterium humireducens	1223514	S	600	135	735	0.00005
Corynebacterium maris	575200	S	596	74	670	0.00005
Corynebacterium doosanense	1121358	S	509	183	692	0.00005
Corynebacterium timonense	441500	S	501	93	594	0.00004
Corynebacterium variabile	1727	S	477	212	689	0.00005
Corynebacterium marinum	349751	S	457	137	594	0.00004
Corynebacterium yudongzhengii	2080740	S	434	64	498	0.00004
Corynebacterium comes	2675218	S	423	84	507	0.00004
Corynebacterium provencense	1737425	S	412	73	485	0.00003
Corynebacterium liangguodongii	2079535	S	403	70	473	0.00003
Corynebacterium terpenotabidum	89154	S	377	84	461	0.00003
Corynebacterium jeikeium	38289	S	374	809	1183	0.00008
Corynebacterium imitans	156978	S	374	180	554	0.00004
Corynebacterium uterequi	1072256	S	362	47	409	0.00003
Corynebacterium mycetoides	38302	S	359	138	497	0.00004
Corynebacterium atypicum	191610	S	357	81	438	0.00003
Corynebacterium glyciniphilum	1404244	S	346	33	379	0.00003
Corynebacterium sanguinis	2594913	S	343	182	525	0.00004
Corynebacterium ureicelerivorans	401472	S	339	88	427	0.00003
Corynebacterium urealyticum	43771	S	332	253	585	0.00004
Corynebacterium lujinxingii	2763010	S	319	85	404	0.00003
Corynebacterium falsenii	108486	S	294	94	388	0.00003
Corynebacterium qintianiae	2709392	S	290	66	356	0.00003
Corynebacterium uberis	2883169	S	276	26	302	0.00002
Corynebacterium efficiens	152794	S	271	39	310	0.00002
Corynebacterium kroppenstedtii	161879	S	268	20	288	0.00002
Corynebacterium glaucum	187491	S	260	44	304	0.00002
Corynebacterium glucuronolyticum	39791	S	243	45	288	0.00002
Corynebacterium coyleae	53374	S	239	49	288	0.00002
Corynebacterium occultum	2675219	S	237	32	269	0.00002
Corynebacterium testudinoris	136857	S	232	37	269	0.00002
Corynebacterium aurimucosum	169292	S	229	87	316	0.00002
Corynebacterium genitalium	38288	S	227	39	266	0.00002
Corynebacterium incognita	2754725	S	223	40	263	0.00002
Corynebacterium striatum	43770	S	212	145	357	0.00003
Corynebacterium riegelii	156976	S	196	40	236	0.00002
Corynebacterium tuberculostearicum	38304	S	191	93	284	0.00002
Corynebacterium zhongnanshanii	2768834	S	183	19	202	0.00001
Corynebacterium lactis	1231000	S	177	22	199	0.00001
Corynebacterium aquilae	203263	S	170	20	190	0.00001
Corynebacterium renale	1724	S	170	15	185	0.00001
Corynebacterium matruchotii	43768	S	165	9	174	0.00001
Corynebacterium endometrii	2488819	S	160	24	184	0.00001
Corynebacterium urogenitale	2487892	S	155	22	177	0.00001
Corynebacterium kalinowskii	2675216	S	150	58	208	0.00001
Corynebacterium epidermidicanis	1050174	S	148	19	167	0.00001
Corynebacterium flavescens	28028	S	143	32	175	0.00001
Corynebacterium minutissimum	38301	S	143	125	268	0.00002
Corynebacterium camporealensis	161896	S	138	28	166	0.00001
Corynebacterium simulans	146827	S	131	84	215	0.00002
Corynebacterium gerontici	2079234	S	126	21	147	0.00001
Corynebacterium lizhenjunii	2709394	S	125	17	142	0.00001
Corynebacterium singulare	161899	S	123	85	208	0.00001
Corynebacterium cystitidis	35757	S	115	5	120	0.00001
Corynebacterium diphtheriae	1717	S	108	108	216	0.00002
Corynebacterium deserti	1408191	S	94	28	122	0.00001
Corynebacterium macginleyi	38290	S	93	18	111	0.00001
Corynebacterium choanae	1862358	S	89	7	96	0.00001
Corynebacterium argentoratense	42817	S	88	14	102	0.00001
Corynebacterium glutamicum	1718	S	86	1147	1233	0.00009
Corynebacterium propinquum	43769	S	86	30	116	0.00001
Corynebacterium phocae	161895	S	84	9	93	0.00001
Corynebacterium pseudodiphtheriticum	37637	S	82	22	104	0.00001
Corynebacterium ulcerans	65058	S	82	31	113	0.00001
Corynebacterium pelargi	1471400	S	81	23	104	0.00001
Corynebacterium pseudopelargi	2080757	S	81	24	105	0.00001
Corynebacterium kefirresidentii	1979527	S	75	41	116	0.00001
Corynebacterium stationis	1705	S	73	15	88	0.00001
Corynebacterium resistens	258224	S	71	31	102	0.00001
Corynebacterium casei	160386	S	66	60	126	0.00001
Corynebacterium ammoniagenes	1697	S	57	10	67	0.00000
Corynebacterium segmentosum	43990	S	55	118	173	0.00001
Corynebacterium mustelae	571915	S	50	3	53	0.00000
Corynebacterium callunae	1721	S	50	13	63	0.00000
Corynebacterium anserum	2684406	S	49	4	53	0.00000
Corynebacterium rouxii	2719119	S	45	23	68	0.00000
Corynebacterium accolens	38284	S	44	94	138	0.00001
Corynebacterium hindlerae	699041	S	37	65	102	0.00001
Corynebacterium pseudotuberculosis	1719	S	36	6	42	0.00000
Corynebacterium silvaticum	2320431	S	36	13	49	0.00000
Corynebacterium amycolatum	43765	S	35	229	264	0.00002
Corynebacterium suranareeae	2506452	S	31	7	38	0.00000
Corynebacterium crudilactis	1652495	S	20	18	38	0.00000
Corynebacterium kutscheri	35755	S	12	1	13	0.00000
Gordonia sp. PP30	2935861	S	1265	268	1533	0.00011
Gordonia sp. YC-JH1	2059875	S	1005	498	1503	0.00011
Gordonia sp. KTR9	337191	S	914	153	1067	0.00008
Gordonia sp. PDNC005	2811424	S	845	96	941	0.00007
Gordonia sp. WA4-43	2878678	S	161	501	662	0.00005
Gordonia sp. JH63	2698900	S	126	385	511	0.00004
Gordonia sp. 135	2676309	S	81	507	588	0.00004
Gordonia sp. 1D	1737359	S	39	552	591	0.00004
Gordonia polyisoprenivorans	84595	S	2132	329	2461	0.00018
Gordonia terrae	2055	S	1556	769	2325	0.00017
Gordonia insulae	2420509	S	1286	143	1429	0.00010
Gordonia amarae	36821	S	1186	178	1364	0.00010
Gordonia phthalatica	1136941	S	1168	358	1526	0.00011
Gordonia bronchialis	2054	S	1113	1590	2703	0.00019
Gordonia jinghuaiqii	2758710	S	1052	158	1210	0.00009
Gordonia iterans	1004901	S	1047	260	1307	0.00009
Gordonia rubripertincta	36822	S	1042	505	1547	0.00011
Gordonia pseudoamarae	2831662	S	924	133	1057	0.00008
Gordonia otitidis	249058	S	889	114	1003	0.00007
Gordonia zhaorongruii	2597659	S	622	86	708	0.00005
Gordonia alkanivorans	84096	S	241	821	1062	0.00008
Gordonia amicalis	89053	S	175	1188	1363	0.00010
Gordonia hongkongensis	1701090	S	127	377	504	0.00004
Skermania piniformis	39122	S	1144	103	1247	0.00009
Tsukamurella paurometabola	2061	S	2170	920	3090	0.00022
Tsukamurella tyrosinosolvens	57704	S	1724	662	2386	0.00017
Tsukamurella pulmonis	47312	S	1314	389	1703	0.00012
Tsukamurella sp. PLM1	2929795	S	1297	354	1651	0.00012
Dietzia sp. oral taxon 368	712270	S	692	1285	1977	0.00014
Dietzia lutea	546160	S	888	450	1338	0.00010
Dietzia psychralcaliphila	139021	S	820	190	1010	0.00007
Dietzia timorensis	499555	S	705	273	978	0.00007
Tomitella gaofuii	2760083	S	1301	335	1636	0.00012
Tomitella fengzijianii	2597660	S	1208	335	1543	0.00011
Segniliparus rotundus	286802	S	600	27	627	0.00004
Lawsonella clevelandensis	1528099	S	108	9	117	0.00001
Microbacterium sp. 4R-513	2567934	S	5539	904	6443	0.00046
Microbacterium sp. No. 7	1714373	S	2899	1097	3996	0.00029
Microbacterium sp. 10M-3C3	2483401	S	2619	711	3330	0.00024
Microbacterium sp. JZ31	1906274	S	2293	554	2847	0.00020
Microbacterium sp. YJN-G	2763257	S	2268	642	2910	0.00021
Microbacterium sp. ABRD_28	2268461	S	2074	246	2320	0.00017
Microbacterium sp. SSW1-51	2851650	S	1995	442	2437	0.00017
Microbacterium sp. BH-3-3-3	1906742	S	1825	384	2209	0.00016
Microbacterium sp. SSW1-36	2851648	S	1740	337	2077	0.00015
Microbacterium sp. A18JL241	2782166	S	1689	340	2029	0.00014
Microbacterium sp. XT11	367477	S	1651	311	1962	0.00014
Microbacterium sp. H1-D42	2925844	S	1643	238	1881	0.00013
Microbacterium sp. Y-01	2048898	S	1575	546	2121	0.00015
Microbacterium sp. cx-55	2875948	S	1562	202	1764	0.00013
Microbacterium sp. NIBRBAC000506063	2734618	S	1558	519	2077	0.00015
Microbacterium sp. CBA3102	2603598	S	1536	334	1870	0.00013
Microbacterium sp. LKL04	912630	S	1533	320	1853	0.00013
Microbacterium sp. PM5	2014534	S	1504	244	1748	0.00012
Microbacterium sp. TPU 3598	1938334	S	1267	299	1566	0.00011
Microbacterium sp. 1S1	2606451	S	1076	411	1487	0.00011
Microbacterium sp. Nx66	2766784	S	866	507	1373	0.00010
Microbacterium sp. RG1	2489212	S	709	499	1208	0.00009
Microbacterium sp. CGR1	1696072	S	267	939	1206	0.00009
Microbacterium sp. 1.5R	1916917	S	240	814	1054	0.00008
Microbacterium sp. PAMC22086	2861281	S	233	447	680	0.00005
Microbacterium sp. SGAir0570	2070348	S	232	762	994	0.00007
Microbacterium sp. str. 'China'	2103230	S	126	599	725	0.00005
Microbacterium sp. PAMC 28756	1795053	S	45	655	700	0.00005
Microbacterium sp. Se5.02b	2864103	S	25	1992	2017	0.00014
Microbacterium sp. PAMC21962	2861280	S	18	686	704	0.00005
Microbacterium sp. KUDC0405	2909587	S	14	1093	1107	0.00008
Microbacterium sp. KUDC0406	2909588	S	13	1019	1032	0.00007
Microbacterium cremeum	2782169	S	5799	1078	6877	0.00049
Microbacterium atlanticum	2782168	S	5136	995	6131	0.00044
Microbacterium hominis	162426	S	3979	10232	14211	0.00102
Microbacterium foliorum	104336	S	3312	615	3927	0.00028
Microbacterium oleivorans	273677	S	2956	506	3462	0.00025
Microbacterium lemovicicum	1072463	S	2543	509	3052	0.00022
Microbacterium pygmaeum	370764	S	2392	261	2653	0.00019
Microbacterium aurum	36805	S	1897	517	2414	0.00017
Microbacterium resistens	156977	S	1850	295	2145	0.00015
Microbacterium sediminis	904291	S	1827	719	2546	0.00018
Microbacterium chocolatum	84292	S	1818	352	2170	0.00016
Microbacterium wangchenii	2541726	S	1774	355	2129	0.00015
Microbacterium testaceum	2033	S	1760	284	2044	0.00015
Microbacterium caowuchunii	2614638	S	1759	291	2050	0.00015
Microbacterium luteum	2782167	S	1729	599	2328	0.00017
Microbacterium lushaniae	2614639	S	1710	349	2059	0.00015
Microbacterium oryzae	743009	S	1635	420	2055	0.00015
Microbacterium protaetiae	2509458	S	1601	305	1906	0.00014
Microbacterium esteraromaticum	57043	S	1582	310	1892	0.00014
Microbacterium oxydans	82380	S	1453	1019	2472	0.00018
Microbacterium schleiferi	69362	S	1186	334	1520	0.00011
Microbacterium hydrocarbonoxydans	273678	S	1116	179	1295	0.00009
Microbacterium fandaimingii	2708079	S	631	45	676	0.00005
Microbacterium binotii	462710	S	618	427	1045	0.00007
Microbacterium amylolyticum	936337	S	459	82	541	0.00004
Microbacterium chengjingii	2769067	S	454	21	475	0.00003
Microbacterium endophyticum	1526412	S	403	24	427	0.00003
Microbacterium paludicola	300019	S	212	728	940	0.00007
Microbacterium paraoxydans	199592	S	175	1086	1261	0.00009
Agromyces sp. H17E-10	2932244	S	4324	1437	5761	0.00041
Agromyces sp. LHK192	2498704	S	2622	758	3380	0.00024
Agromyces sp. CFWR-12	2929802	S	2107	1331	3438	0.00025
Agromyces flavus	589382	S	4109	1278	5387	0.00038
Agromyces aureus	453304	S	2745	772	3517	0.00025
Agromyces soli	659012	S	2463	888	3351	0.00024
Agromyces marinus	1389020	S	2304	820	3124	0.00022
Agromyces badenianii	2080742	S	2284	749	3033	0.00022
Agromyces protaetiae	2509455	S	2208	623	2831	0.00020
Agromyces laixinhei	2585717	S	2141	489	2630	0.00019
Agromyces intestinalis	2592652	S	2107	1267	3374	0.00024
Agromyces archimandritae	2781962	S	1913	527	2440	0.00017
Curtobacterium sp. L6-1	2841594	S	1256	386	1642	0.00012
Curtobacterium sp. BH-2-1-1	1905847	S	1207	392	1599	0.00011
Curtobacterium sp. MR_MD2014	1561023	S	905	412	1317	0.00009
Curtobacterium sp. YC1	2795488	S	871	400	1271	0.00009
Curtobacterium sp. 24E2	2804758	S	792	439	1231	0.00009
Curtobacterium sp. TC1	2862880	S	779	407	1186	0.00008
Curtobacterium sp. SGAir0471	2070337	S	606	502	1108	0.00008
Curtobacterium sp. TXMA1	2876939	S	553	474	1027	0.00007
Curtobacterium sp. C1	2898151	S	213	700	913	0.00007
Curtobacterium sp. Csp2	2495430	S	173	651	824	0.00006
Curtobacterium sp. Csp1	2495429	S	38	949	987	0.00007
Curtobacterium flaccumfaciens	2035	S	1923	901	2824	0.00020
Curtobacterium luteum	33881	S	1157	412	1569	0.00011
Rathayibacter sp. VKM Ac-2759	2609252	S	1709	578	2287	0.00016
Rathayibacter sp. VKM Ac-2760	2609253	S	1380	708	2088	0.00015
Rathayibacter sp. VKM Ac-2804	2609257	S	1039	774	1813	0.00013
Rathayibacter sp. VKM Ac-2801	2609255	S	638	593	1231	0.00009
Rathayibacter sp. VKM Ac-2762	2609254	S	276	747	1023	0.00007
Rathayibacter sp. VKM Ac-2805	2609258	S	202	565	767	0.00005
Rathayibacter festucae	110937	S	1501	1575	3076	0.00022
Rathayibacter tanaceti	1671680	S	979	246	1225	0.00009
Rathayibacter tritici	33888	S	659	202	861	0.00006
Rathayibacter iranicus	59737	S	613	79	692	0.00005
Rathayibacter rathayi	33887	S	557	150	707	0.00005
Rathayibacter toxicus	145458	S	204	15	219	0.00002
Protaetiibacter sp. SSC-01	2759943	S	4939	1985	6924	0.00049
Protaetiibacter intestinalis	2419774	S	4326	1706	6032	0.00043
Protaetiibacter larvae	2592654	S	2850	977	3827	0.00027
Leifsonia sp. 21MFCrub1.1	1798223	S	1910	2525	4435	0.00032
Leifsonia sp. PS1209	2724914	S	1780	514	2294	0.00016
Leifsonia sp. ZF2019	2781978	S	1754	508	2262	0.00016
Leifsonia shinshuensis	150026	S	2541	772	3313	0.00024
Leifsonia xyli	1575	S	1373	186	1559	0.00011
Agrococcus sp. Marseille-Q4369	2810513	S	2254	789	3043	0.00022
Agrococcus sp. SCSIO52902	2933290	S	1804	862	2666	0.00019
Agrococcus sp. SGAir0287	2070347	S	1704	521	2225	0.00016
Agrococcus jejuensis	399736	S	1942	618	2560	0.00018
Agrococcus carbonis	684552	S	1913	857	2770	0.00020
Leucobacter sp. NB 10	2873270	S	1086	294	1380	0.00010
Leucobacter sp. H25R-14	2932245	S	1073	172	1245	0.00009
Leucobacter sp. Psy1	2875729	S	918	108	1026	0.00007
Leucobacter sp. CX169	2813744	S	743	185	928	0.00007
Leucobacter sp. H21R-36	2932246	S	320	913	1233	0.00009
Leucobacter sp. H21R-40	2932247	S	267	764	1031	0.00007
Leucobacter triazinivorans	1784719	S	1144	581	1725	0.00012
Leucobacter muris	1935379	S	1136	419	1555	0.00011
Leucobacter luti	340320	S	448	39	487	0.00003
Leucobacter insecticola	2714934	S	319	25	344	0.00002
Leucobacter viscericola	2714935	S	293	30	323	0.00002
Leucobacter denitrificans	683042	S	284	37	321	0.00002
Leucobacter coleopterorum	2714933	S	252	26	278	0.00002
Clavibacter michiganensis	28447	S	6783	6260	13043	0.00093
Clavibacter zhangzhiyongii	2768071	S	879	439	1318	0.00009
Clavibacter sp. A6099	2860285	S	470	331	801	0.00006
Salinibacterium sp. ZJ70	2708084	S	1964	504	2468	0.00018
Salinibacterium sp. ZJ450	2708338	S	1565	238	1803	0.00013
Salinibacterium sp. dk2585	2603292	S	1156	195	1351	0.00010
Salinibacterium sp. UTAS2018	2508880	S	446	46	492	0.00004
Salinibacterium sp. M195	2583374	S	327	39	366	0.00003
Salinibacterium hongtaonis	2079791	S	573	61	634	0.00005
Cryobacterium sp. LW097	1978566	S	1046	226	1272	0.00009
Cryobacterium sp. PAMC25264	2861288	S	528	349	877	0.00006
Cryobacterium soli	2220095	S	822	460	1282	0.00009
Cryobacterium arcticum	670052	S	581	479	1060	0.00008
Frondihabitans sp. PAMC 28766	1795630	S	1598	223	1821	0.00013
Frondihabitans sp. 762G35	1446794	S	1424	321	1745	0.00012
Microcella flavibacter	1804990	S	1824	857	2681	0.00019
Microcella alkaliphila	279828	S	1228	213	1441	0.00010
Microterricola viridarii	412690	S	3059	753	3812	0.00027
Plantibacter sp. PA-3-X8	2480625	S	497	524	1021	0.00007
Plantibacter sp. M259	2583822	S	470	482	952	0.00007
Plantibacter flavus	150123	S	530	513	1043	0.00007
Herbiconiux sp. SALV-R1	2735133	S	2022	406	2428	0.00017
Cnuibacter physcomitrellae	1619308	S	1969	429	2398	0.00017
Subtercola sp. AK-R2A1-2	2895559	S	1039	99	1138	0.00008
Subtercola sp. PAMC28395	2846775	S	695	72	767	0.00005
Frigoribacterium sp. NBH87	2596916	S	1756	519	2275	0.00016
Mycetocola zhujimingii	2079792	S	692	81	773	0.00006
Mycetocola sp. JXN-3	2116510	S	581	85	666	0.00005
Mycetocola spongiae	2859226	S	463	59	522	0.00004
Gryllotalpicola protaetiae	2419771	S	1739	329	2068	0.00015
Chryseoglobus sp. 28M-23	2772253	S	321	694	1015	0.00007
Chryseoglobus indicus	2750620	S	310	696	1006	0.00007
Humibacter sp. WJ7-1	2599293	S	1621	344	1965	0.00014
Amnibacterium sp. L3-i23	2905871	S	1560	369	1929	0.00014
Marisediminicola antarctica	674079	S	1353	165	1518	0.00011
Diaminobutyricimonas sp. LJ205	2683590	S	1213	224	1437	0.00010
Gulosibacter sediminis	1729695	S	1124	303	1427	0.00010
Glaciihabitans sp. INWT7	2596912	S	1122	88	1210	0.00009
Agreia sp. COWG	2773266	S	939	113	1052	0.00008
Rhodoluna limnophila	232537	S	73	8	81	0.00001
Rhodoluna lacicola	529884	S	50	6	56	0.00000
Candidatus Rhodoluna planktonica	535712	S	48	3	51	0.00000
Aquiluna borgnonia	2499157	S	101	9	110	0.00001
Candidatus Aquiluna sp. UB-MaderosW2red	1855377	S	36	2	38	0.00000
Pseudoclavibacter sp. Marseille-Q3772	2866588	S	223	36	259	0.00002
Aurantimicrobium photophilum	1987356	S	91	7	98	0.00001
Aurantimicrobium sp. MWH-Uga1	2079575	S	44	11	55	0.00000
Aurantimicrobium minutum	708131	S	37	10	47	0.00000
Pontimonas salivibrio	1159327	S	97	4	101	0.00001
Arthrobacter sp. FW305-BF8	2879617	S	4876	1173	6049	0.00043
Arthrobacter sp. NicSoilC5	2831000	S	3445	1581	5026	0.00036
Arthrobacter sp. QXT-31	1357915	S	2284	556	2840	0.00020
Arthrobacter sp. QL17	2895818	S	1261	254	1515	0.00011
Arthrobacter sp. PM3	2017685	S	1260	177	1437	0.00010
Arthrobacter sp. NtRootA1	2830983	S	1255	341	1596	0.00011
Arthrobacter sp. PGP41	2079227	S	1212	379	1591	0.00011
Arthrobacter sp. NicSoilB8	2830998	S	1131	258	1389	0.00010
Arthrobacter sp. 24S4-2	2575374	S	1034	205	1239	0.00009
Arthrobacter sp. U41	1849032	S	1008	253	1261	0.00009
Arthrobacter sp. NicSoilB4	2830997	S	994	275	1269	0.00009
Arthrobacter sp. UKPF54-2	2600159	S	987	367	1354	0.00010
Arthrobacter sp. KBS0702	2578107	S	953	333	1286	0.00009
Arthrobacter sp. PAMC25564	2565366	S	931	222	1153	0.00008
Arthrobacter sp. FB24	290399	S	930	266	1196	0.00009
Arthrobacter sp. ERGS1:01	1704044	S	808	136	944	0.00007
Arthrobacter sp. FW306-2-2C-D06B	2879618	S	742	125	867	0.00006
Arthrobacter sp. PAMC25284	2861279	S	704	160	864	0.00006
Arthrobacter sp. Helios	2828862	S	683	97	780	0.00006
Arthrobacter sp. PAMC 25486	1494608	S	513	74	587	0.00004
Arthrobacter sp. zg-Y462	2886936	S	512	91	603	0.00004
Arthrobacter sp. zg-Y809	2886940	S	502	165	667	0.00005
Arthrobacter sp. StoSoilB5	2830992	S	473	120	593	0.00004
Arthrobacter sp. StoSoilB20	2830995	S	432	107	539	0.00004
Arthrobacter sp. D5-1	1477518	S	353	209	562	0.00004
Arthrobacter sp. FW306-06-A	2879621	S	324	1008	1332	0.00010
Arthrobacter sp. YN	2020486	S	304	113	417	0.00003
Arthrobacter sp. FW306-07-I	2879622	S	267	1327	1594	0.00011
Arthrobacter sp. NicSoilB11	2830999	S	251	887	1138	0.00008
Arthrobacter sp. StoSoilB19	2830994	S	248	1007	1255	0.00009
Arthrobacter sp. FW306-05-C	2879620	S	239	1114	1353	0.00010
Arthrobacter sp. StoSoilB13	2830993	S	186	305	491	0.00004
Arthrobacter sp. C1-1	2813727	S	165	20	185	0.00001
Arthrobacter sp. StoSoilA2	2830990	S	135	215	350	0.00003
Arthrobacter sp. AQ5-05	2184581	S	15	270	285	0.00002
Arthrobacter sulfonylureivorans	2486855	S	4677	642	5319	0.00038
Arthrobacter crystallopoietes	37928	S	3021	471	3492	0.00025
Arthrobacter agilis	37921	S	1879	238	2117	0.00015
Arthrobacter woluwensis	156980	S	931	180	1111	0.00008
Arthrobacter dokdonellae	2211210	S	827	122	949	0.00007
Arthrobacter jiangjiafuii	2817475	S	644	155	799	0.00006
Arthrobacter alpinus	656366	S	588	892	1480	0.00011
Arthrobacter sunyaminii	2816859	S	430	131	561	0.00004
Kocuria rosea	1275	S	3807	1005	4812	0.00034
Kocuria flava	446860	S	1534	627	2161	0.00015
Kocuria turfanensis	388357	S	1510	435	1945	0.00014
Kocuria palustris	71999	S	926	298	1224	0.00009
Kocuria rhizophila	72000	S	670	865	1535	0.00011
Kocuria varians	1272	S	572	329	901	0.00006
Kocuria sp. TGY1127_2	2711328	S	248	33	281	0.00002
Kocuria sp. KD4	2719588	S	152	217	369	0.00003
Kocuria sp. BT304	1702043	S	84	358	442	0.00003
Kocuria indica	1049583	S	129	214	343	0.00002
Pseudarthrobacter sp. L1SW	2851598	S	1012	366	1378	0.00010
Pseudarthrobacter sp. BIM B-2242	2772401	S	930	204	1134	0.00008
Pseudarthrobacter sp. NBSH8	2596911	S	426	153	579	0.00004
Pseudarthrobacter sp. NIBRBAC000502772	2590775	S	388	286	674	0.00005
Pseudarthrobacter sp. SSS035	2931399	S	353	321	674	0.00005
Pseudarthrobacter sp. NIBRBAC000502770	2590785	S	321	882	1203	0.00009
Pseudarthrobacter sp. NIBRBAC000502771	2590774	S	314	963	1277	0.00009
Pseudarthrobacter phenanthrenivorans	361575	S	1105	470	1575	0.00011
Pseudarthrobacter chlorophenolicus	85085	S	1070	363	1433	0.00010
Pseudarthrobacter equi	728066	S	887	318	1205	0.00009
Pseudarthrobacter psychrotolerans	2697569	S	547	211	758	0.00005
Pseudarthrobacter sulfonivorans	121292	S	338	372	710	0.00005
Micrococcus luteus	1270	S	1998	3133	5131	0.00037
Micrococcus sp. KD337-16	2856555	S	822	410	1232	0.00009
Micrococcus sp. KBS0714	1179670	S	28	191	219	0.00002
Micrococcus yunnanensis	566027	S	24	154	178	0.00001
Paenarthrobacter ureafaciens	37931	S	1215	1782	2997	0.00021
Paenarthrobacter aurescens	43663	S	455	250	705	0.00005
Paenarthrobacter sp. YJN-5	2735316	S	232	480	712	0.00005
Paenarthrobacter sp. YJN-D	2735317	S	99	184	283	0.00002
Paenarthrobacter nicotinovorans	29320	S	114	188	302	0.00002
Sinomonas atrocyanea	37927	S	1674	460	2134	0.00015
Sinomonas sp. R1AF57	2020377	S	1512	297	1809	0.00013
Glutamicibacter protophormiae	37930	S	690	357	1047	0.00007
Glutamicibacter creatinolyticus	162496	S	592	119	711	0.00005
Glutamicibacter halophytocola	1933880	S	369	59	428	0.00003
Glutamicibacter mishrai	1775880	S	259	51	310	0.00002
Glutamicibacter arilaitensis	256701	S	217	68	285	0.00002
Glutamicibacter nicotianae	37929	S	168	467	635	0.00005
Glutamicibacter sp. ZJUTW	1155384	S	62	254	316	0.00002
Citricoccus sp. SGAir0253	2567881	S	2431	557	2988	0.00021
Rothia kristinae	37923	S	1010	480	1490	0.00011
Rothia mucilaginosa	43675	S	302	50	352	0.00003
Rothia nasimurium	85336	S	153	62	215	0.00002
Rothia aeria	172042	S	119	41	160	0.00001
Rothia dentocariosa	2047	S	89	34	123	0.00001
Rothia terrae	396015	S	88	30	118	0.00001
Rothia amarae	169480	S	47	17	64	0.00000
Rothia sp. ZJ932	2810516	S	47	6	53	0.00000
Nesterenkonia sp. NBAIMH1	2600320	S	553	30	583	0.00004
Paeniglutamicibacter sp. Y32M11	2853258	S	295	39	334	0.00002
Neomicrococcus aestuarii	556325	S	208	77	285	0.00002
Psychromicrobium lacuslunae	1618207	S	197	23	220	0.00002
Auritidibacter sp. NML130574	2170745	S	154	13	167	0.00001
Renibacterium salmoninarum	1646	S	133	6	139	0.00001
Cellulomonas sp. H30R-01	2704467	S	7179	2723	9902	0.00071
Cellulomonas sp. zg-ZUI188	2819978	S	3183	831	4014	0.00029
Cellulomonas sp. Y8	2591145	S	3081	1246	4327	0.00031
Cellulomonas sp. JZ18	2654191	S	2461	1012	3473	0.00025
Cellulomonas sp. C5510	2871170	S	2392	909	3301	0.00024
Cellulomonas sp. zg-ZUI157	2819979	S	2154	732	2886	0.00021
Cellulomonas sp. zg-ZUI222	2816956	S	2047	750	2797	0.00020
Cellulomonas sp. EW123	2608402	S	1885	1171	3056	0.00022
Cellulomonas sp. PSBB021	2003551	S	1656	1351	3007	0.00021
Cellulomonas fimi	1708	S	2888	1980	4868	0.00035
Cellulomonas iranensis	76862	S	2191	985	3176	0.00023
Cellulomonas shaoxiangyii	2566013	S	2135	848	2983	0.00021
Cellulomonas flavigena	1711	S	2043	755	2798	0.00020
Cellulomonas gilvus	11	S	1852	764	2616	0.00019
Cellulomonas taurus	2729175	S	1566	456	2022	0.00014
Actinotalea sp. JY-7876	2758442	S	2585	856	3441	0.00025
Oerskovia sp. KBS0722	1179673	S	1869	543	2412	0.00017
Pseudactinotalea sp. HY158	2654547	S	1517	197	1714	0.00012
Paraoerskovia marina	545619	S	1211	284	1495	0.00011
Cellulosimicrobium cellulans	1710	S	25049	17246	42295	0.00302
Cellulosimicrobium sp. BI34T	2587808	S	5764	2083	7847	0.00056
Cellulosimicrobium sp. JZ28	1906273	S	798	1170	1968	0.00014
Cellulosimicrobium sp. TH-20	1980001	S	393	1122	1515	0.00011
Cellulosimicrobium sp. 72-3	2731680	S	371	1037	1408	0.00010
Xylanimonas protaetiae	2509457	S	1895	778	2673	0.00019
Xylanimonas cellulosilytica	186189	S	1719	557	2276	0.00016
Xylanimonas allomyrinae	2509459	S	1684	485	2169	0.00015
Isoptericola variabilis	139208	S	2389	1088	3477	0.00025
Isoptericola dokdonensis	372663	S	2215	750	2965	0.00021
Janibacter melonis	262209	S	2639	813	3452	0.00025
Janibacter limosus	53458	S	1838	446	2284	0.00016
Janibacter indicus	857417	S	907	1390	2297	0.00016
Janibacter sp. YB324	2761047	S	480	1014	1494	0.00011
Phycicoccus sp. HDW14	2714941	S	4117	1276	5393	0.00039
Phycicoccus endophyticus	1690220	S	3027	837	3864	0.00028
Pedococcus dokdonensis	443156	S	6836	1886	8722	0.00062
Tetrasphaera sp. HKS02	1813880	S	4488	1094	5582	0.00040
Intrasporangium calvum	53358	S	3460	808	4268	0.00030
Arsenicicoccus sp. oral taxon 190	1658671	S	2361	808	3169	0.00023
Ornithinimicrobium avium	2283195	S	2567	623	3190	0.00023
Ornithinimicrobium sp. HY006	2508882	S	1697	555	2252	0.00016
Ornithinimicrobium sp. INDO-MA30-4	2908651	S	354	55	409	0.00003
Ornithinimicrobium flavum	1288636	S	1859	572	2431	0.00017
Ornithinimicrobium ciconiae	2594265	S	1515	211	1726	0.00012
Ornithinimicrobium pratense	2593973	S	1248	346	1594	0.00011
Serinicoccus chungangensis	767452	S	1845	584	2429	0.00017
Serinicoccus hydrothermalis	1758689	S	1705	747	2452	0.00018
Serinicoccus profundi	1078471	S	1496	494	1990	0.00014
Serinicoccus marinus	247333	S	1333	612	1945	0.00014
Brachybacterium sp. SGAir0954	2571029	S	1452	376	1828	0.00013
Brachybacterium sp. CBA3105	2887346	S	1425	300	1725	0.00012
Brachybacterium sp. P6-10-X1	1903186	S	1224	203	1427	0.00010
Brachybacterium ginsengisoli	1331682	S	1123	328	1451	0.00010
Brachybacterium saurashtrense	556288	S	1117	312	1429	0.00010
Brachybacterium faecium	43669	S	1088	331	1419	0.00010
Brachybacterium vulturis	2017484	S	876	341	1217	0.00009
Brachybacterium avium	2017485	S	722	279	1001	0.00007
Dermabacter vaginalis	1630135	S	415	244	659	0.00005
Dermabacter jinjuensis	1667168	S	365	271	636	0.00005
Devriesea agamarum	472569	S	170	8	178	0.00001
Brevibacterium sp. CS2	2575923	S	1334	469	1803	0.00013
Brevibacterium sp. SMBL_HHYL_HB1	2777556	S	597	125	722	0.00005
Brevibacterium sp. HY170	2898795	S	271	83	354	0.00003
Brevibacterium sp. 'Marine'	2725563	S	216	150	366	0.00003
Brevibacterium sp. W7.2	2823518	S	181	902	1083	0.00008
Brevibacterium casei	33889	S	1446	985	2431	0.00017
Brevibacterium luteolum	199591	S	771	270	1041	0.00007
Brevibacterium linens	1703	S	736	456	1192	0.00009
Brevibacterium aurantiacum	273384	S	555	349	904	0.00006
Brevibacterium atlanticum	2697563	S	471	98	569	0.00004
Brevibacterium oceani	358099	S	454	101	555	0.00004
Brevibacterium sandarakinum	629680	S	424	77	501	0.00004
Brevibacterium limosum	2697565	S	386	143	529	0.00004
Brevibacterium siliguriense	1136497	S	253	76	329	0.00002
Brevibacterium pigmentatum	1496080	S	203	157	360	0.00003
Georgenia yuyongxinii	2589797	S	2980	658	3638	0.00026
Georgenia sp. TF02-10	2917725	S	2612	858	3470	0.00025
Georgenia wutianyii	2585135	S	2398	749	3147	0.00022
Georgenia faecalis	2483799	S	2113	528	2641	0.00019
Dermacoccus nishinomiyaensis	1274	S	1645	629	2274	0.00016
Dermacoccus sp. PAMC28757	2762331	S	1152	373	1525	0.00011
Luteipulveratus mongoliensis	571913	S	2252	280	2532	0.00018
Allobranchiibius sp. GilTou73	2904523	S	1841	360	2201	0.00016
Yimella sp. cx-51	2770551	S	1179	209	1388	0.00010
Haloactinobacterium kanbiaonis	2675754	S	2487	322	2809	0.00020
Ruania sp. LR1S40	2897774	S	1235	239	1474	0.00011
Ruania sp. M4N3S171	2897773	S	815	121	936	0.00007
Ruania zhangjianzhongii	2603206	S	1344	121	1465	0.00010
Ruania alkalisoli	2779775	S	989	177	1166	0.00008
Pengzhenrongella sicca	2819238	S	2688	661	3349	0.00024
Luteimicrobium xylanilyticum	1133546	S	2201	601	2802	0.00020
Beutenbergia cavernae	84757	S	2771	410	3181	0.00023
Miniimonas sp. S16	2171623	S	1961	908	2869	0.00021
Sanguibacter keddieii	60920	S	1849	489	2338	0.00017
Sanguibacter sp. HDW7	2714931	S	1499	417	1916	0.00014
Gephyromycinifex aptenodytis	2716227	S	785	78	863	0.00006
Austwickia chelonae	100225	S	609	40	649	0.00005
Dermatophilus congolensis	1863	S	157	12	169	0.00001
Kytococcus sedentarius	1276	S	1466	976	2442	0.00017
Demequina sp. TMPB413	2881056	S	752	51	803	0.00006
Jonesia denitrificans	43674	S	100	15	115	0.00001
Tropheryma whipplei	2039	S	34	0	34	0.00000
Micromonospora echinofusca	47858	S	22815	8652	31467	0.00225
Micromonospora sp. WMMC415	2675222	S	5284	1661	6945	0.00050
Micromonospora sp. B006	2201999	S	4376	2831	7207	0.00051
Micromonospora sp. HM134	2583243	S	4173	1553	5726	0.00041
Micromonospora sp. WMMA2032	2039870	S	3825	2091	5916	0.00042
Micromonospora sp. L5	648999	S	401	3516	3917	0.00028
Micromonospora echinospora	1877	S	9283	2703	11986	0.00086
Micromonospora krabiensis	307121	S	6009	1727	7736	0.00055
Micromonospora carbonacea	47853	S	5960	2211	8171	0.00058
Micromonospora maris	1003110	S	5721	1472	7193	0.00051
Micromonospora echinaurantiaca	47857	S	5696	2301	7997	0.00057
Micromonospora sagamiensis	47875	S	5498	1756	7254	0.00052
Micromonospora chokoriensis	356851	S	5424	1464	6888	0.00049
Micromonospora terminaliae	1914461	S	5422	2277	7699	0.00055
Micromonospora zamorensis	709883	S	5202	1389	6591	0.00047
Micromonospora coriariae	285665	S	5052	1503	6555	0.00047
Micromonospora endophytica (Xie et al. 2001) Li et al. 2019	515350	S	5050	1304	6354	0.00045
Micromonospora tulbaghiae	479978	S	4855	4329	9184	0.00066
Micromonospora inositola	47865	S	4292	1761	6053	0.00043
Micromonospora siamensis	299152	S	4211	1680	5891	0.00042
Micromonospora coxensis	356852	S	4190	1934	6124	0.00044
Micromonospora purpureochromogenes	47872	S	4141	1826	5967	0.00043
Micromonospora ferruginea	2749844	S	4129	1983	6112	0.00044
Micromonospora auratinigra	261654	S	4092	1793	5885	0.00042
Micromonospora viridifaciens	1881	S	4024	1463	5487	0.00039
Micromonospora rifamycinica	291594	S	3617	1352	4969	0.00036
Micromonospora narathiwatensis	299146	S	3553	1389	4942	0.00035
Micromonospora craniellae	2294034	S	3306	1808	5114	0.00037
Micromonospora aurantiaca	47850	S	2116	12186	14302	0.00102
Actinoplanes sp. N902-109	649831	S	16502	3117	19619	0.00140
Actinoplanes sp. L3-i22	2836373	S	16335	3653	19988	0.00143
Actinoplanes sp. OR16	946334	S	13550	3311	16861	0.00120
Actinoplanes sp. SE50/110	134676	S	15	15553	15568	0.00111
Actinoplanes friuliensis	196914	S	20564	2906	23470	0.00168
Actinoplanes ianthinogenes	122358	S	12641	4438	17079	0.00122
Actinoplanes missouriensis	1866	S	11978	3427	15405	0.00110
Actinoplanes teichomyceticus	1867	S	11394	4195	15589	0.00111
Actinoplanes derwentensis	113562	S	10648	1418	12066	0.00086
Plantactinospora sp. KBS50	2024580	S	5944	1298	7242	0.00052
Plantactinospora sp. BB1	2071627	S	3075	6421	9496	0.00068
Plantactinospora sp. BC1	2108470	S	3015	6366	9381	0.00067
Dactylosporangium vinaceum	53362	S	21423	2089	23512	0.00168
Couchioplanes caeruleus	56438	S	20671	4641	25312	0.00181
Phytohabitans suffuscus	624315	S	9866	2383	12249	0.00088
Phytohabitans flavus	1076124	S	7811	1475	9286	0.00066
Catellatospora sp. IY07-71	2728827	S	18972	3668	22640	0.00162
Actinocatenispora sera	390989	S	4452	1220	5672	0.00041
Actinocatenispora thailandica	227318	S	3983	1037	5020	0.00036
Polymorphospora rubra	338584	S	6827	1331	8158	0.00058
Natronosporangium hydrolyticum	2811111	S	3176	189	3365	0.00024
Verrucosispora sp. NA02020	2742132	S	2929	2027	4956	0.00035
Salinispora tropica	168695	S	2034	301	2335	0.00017
Nocardioides sp. zg-1228	2763008	S	13665	5941	19606	0.00140
Nocardioides sp. G188	2849501	S	12626	3679	16305	0.00116
Nocardioides sp. LMS-CY	2840457	S	12421	3998	16419	0.00117
Nocardioides sp. S5	2017486	S	11905	6056	17961	0.00128
Nocardioides sp. JS614	196162	S	10591	3113	13704	0.00098
Nocardioides sp. TF02-7	2917724	S	8068	2526	10594	0.00076
Nocardioides sp. HDW12B	2714939	S	8062	2495	10557	0.00075
Nocardioides sp. W7	2931390	S	7460	2509	9969	0.00071
Nocardioides sp. cx-173	2898796	S	6950	2350	9300	0.00066
Nocardioides sp. SCSIO 67246	2872154	S	6898	1767	8665	0.00062
Nocardioides sp. zg-579	2663857	S	6827	3432	10259	0.00073
Nocardioides sp. S-1144	2582905	S	6571	2473	9044	0.00065
Nocardioides sp. InS609-2	2760705	S	6071	1361	7432	0.00053
Nocardioides sp. 603	2483798	S	5485	2514	7999	0.00057
Nocardioides sp. CF8	110319	S	5444	2282	7726	0.00055
Nocardioides sp. MC1495	2736757	S	4953	1716	6669	0.00048
Nocardioides sp. JQ2195	2592334	S	4476	903	5379	0.00038
Nocardioides sp. zg-536	2803858	S	4127	1754	5881	0.00042
Nocardioides sp. WS12	2486272	S	3805	650	4455	0.00032
Nocardioides sp. dk884	2662361	S	3558	4121	7679	0.00055
Nocardioides sp. ZJ1313	2685869	S	3496	4086	7582	0.00054
Nocardioides sp. Kera G14	2884264	S	3179	626	3805	0.00027
Nocardioides anomalus	2712223	S	10891	3184	14075	0.00101
Nocardioides okcheonensis	2894081	S	10112	4556	14668	0.00105
Nocardioides mesophilus	433659	S	8823	2518	11341	0.00081
Nocardioides cynanchi	2558918	S	8746	1979	10725	0.00077
Nocardioides ungokensis	1643322	S	7965	2714	10679	0.00076
Nocardioides euryhalodurans	2518370	S	7671	2267	9938	0.00071
Nocardioides dongkuii	2760089	S	6083	2978	9061	0.00065
Nocardioides humi	449461	S	5880	1924	7804	0.00056
Nocardioides aromaticivorans	200618	S	5535	2059	7594	0.00054
Nocardioides seonyuensis	2518371	S	5519	1451	6970	0.00050
Nocardioides rotundus	1774216	S	4679	1726	6405	0.00046
Nocardioides aquaticus	160826	S	4634	1376	6010	0.00043
Nocardioides marinisabuli	419476	S	4590	2528	7118	0.00051
Nocardioides sambongensis	2589074	S	4107	1129	5236	0.00037
Nocardioides dokdonensis	450734	S	4106	1932	6038	0.00043
Nocardioides piscis	2714938	S	3662	1417	5079	0.00036
Nocardioides panacisoli	627624	S	3498	819	4317	0.00031
Nocardioides houyundeii	2045452	S	3490	1030	4520	0.00032
Nocardioides daphniae	402297	S	2625	1173	3798	0.00027
Nocardioides jishulii	2575440	S	2295	824	3119	0.00022
Nocardioides yefusunii	2500546	S	1640	450	2090	0.00015
Nocardioides baekrokdamisoli	1804624	S	1557	183	1740	0.00012
Aeromicrobium sp. Leaf245	1736306	S	2524	762	3286	0.00023
Aeromicrobium sp. A1-2	2107713	S	2136	295	2431	0.00017
Aeromicrobium sp. zg-629	2663859	S	1801	584	2385	0.00017
Aeromicrobium chenweiae	2079793	S	2646	914	3560	0.00025
Aeromicrobium erythreum	2041	S	2609	750	3359	0.00024
Aeromicrobium choanae	1736691	S	2600	755	3355	0.00024
Aeromicrobium yanjiei	2662028	S	2272	734	3006	0.00021
Aeromicrobium marinum	219314	S	2196	448	2644	0.00019
Pimelobacter simplex	2045	S	5129	1808	6937	0.00050
Marmoricola scoriae	642780	S	4918	1721	6639	0.00047
Friedmanniella luteola	546871	S	3511	643	4154	0.00030
Mumia sp. ZJ1417	2708082	S	2927	464	3391	0.00024
Micropruina glycogenica	75385	S	1321	174	1495	0.00011
Microlunatus sagamiharensis	546874	S	3069	636	3705	0.00026
Microlunatus sp. Gsoil 973	2672569	S	2337	158	2495	0.00018
Microlunatus soli	630515	S	2055	178	2233	0.00016
Microlunatus phosphovorus	29405	S	1968	207	2175	0.00016
Microlunatus elymi	2596828	S	1716	163	1879	0.00013
Tessaracoccus sp. J1M15	2829499	S	1180	326	1506	0.00011
Tessaracoccus sp. MC1865	2760310	S	875	215	1090	0.00008
Tessaracoccus defluvii	1285901	S	1207	726	1933	0.00014
Tessaracoccus aquimaris	1332264	S	1175	509	1684	0.00012
Tessaracoccus flavescens	399497	S	1007	726	1733	0.00012
Tessaracoccus flavus	1610493	S	917	585	1502	0.00011
Tessaracoccus timonensis	2161816	S	556	202	758	0.00005
Brevilactibacter sp. MC1595	2819349	S	1759	624	2383	0.00017
Brevilactibacter coleopterorum	2714937	S	1664	676	2340	0.00017
Acidipropionibacterium acidipropionici	1748	S	999	525	1524	0.00011
Acidipropionibacterium jensenii	1749	S	997	565	1562	0.00011
Acidipropionibacterium virtanenii	2057246	S	638	113	751	0.00005
Propionibacterium acidifaciens	556499	S	982	202	1184	0.00008
Propionibacterium freudenreichii	1744	S	793	588	1381	0.00010
Propionibacterium australiense	119981	S	721	112	833	0.00006
Auraticoccus monumenti	675864	S	2174	356	2530	0.00018
Arachnia propionica	1750	S	810	95	905	0.00006
Arachnia rubra	1547448	S	492	64	556	0.00004
Cutibacterium avidum	33010	S	595	147	742	0.00005
Cutibacterium granulosum	33011	S	291	55	346	0.00002
Cutibacterium acnes	1747	S	199	224	423	0.00003
Cutibacterium modestum	2559073	S	146	20	166	0.00001
Raineyella fluvialis	2662261	S	1239	148	1387	0.00010
Vaginimicrobium propionicum	1871034	S	47	15	62	0.00000
Kribbella flavida	182640	S	8412	1725	10137	0.00072
Kribbella qitaiheensis	1544730	S	6181	858	7039	0.00050
Actinopolymorpha singaporensis	117157	S	3822	382	4204	0.00030
Actinomadura sp. NAK00032	2742128	S	146207	33142	179349	0.01281
Actinomadura sp. WMMA1423	2591108	S	12591	2414	15005	0.00107
Actinomadura sp. WMMB 499	1219491	S	8531	1477	10008	0.00071
Actinomadura madurae	1993	S	15643	3077	18720	0.00134
Actinomadura verrucosospora	46165	S	10737	2266	13003	0.00093
Actinomadura graeca	2750812	S	6394	1059	7453	0.00053
Thermomonospora amylolytica	1411117	S	4542	1365	5907	0.00042
Thermomonospora curvata	2020	S	2955	723	3678	0.00026
Nonomuraea coxensis	404386	S	27973	6692	34665	0.00248
Nonomuraea gerenzanensis	93944	S	20007	5640	25647	0.00183
Nonomuraea sp. ATCC 55076	1909395	S	19878	5340	25218	0.00180
Nonomuraea nitratireducens	2656914	S	19734	3548	23282	0.00166
Streptosporangium roseum	2001	S	7960	1868	9828	0.00070
Streptosporangium sp. 'caverna'	2202249	S	7957	1490	9447	0.00067
Thermobispora bispora	2006	S	3242	624	3866	0.00028
Nocardiopsis sp. MT53	2865672	S	2646	555	3201	0.00023
Nocardiopsis sp. HDS12	2831968	S	796	694	1490	0.00011
Nocardiopsis gilva	280236	S	1973	355	2328	0.00017
Nocardiopsis alba	53437	S	1494	242	1736	0.00012
Nocardiopsis dassonvillei	2014	S	1430	1519	2949	0.00021
Thermobifida halotolerans	483545	S	1613	474	2087	0.00015
Thermobifida alba	53522	S	1556	562	2118	0.00015
Thermobifida fusca	2021	S	895	138	1033	0.00007
Streptomonospora litoralis	2498135	S	2146	382	2528	0.00018
Spiractinospora alimapuensis	2820884	S	1467	85	1552	0.00011
Amycolatopsis sp. Hca4	2742131	S	7473	2325	9798	0.00070
Amycolatopsis sp. WQ 127309	2932773	S	5894	1433	7327	0.00052
Amycolatopsis sp. DSM 110486	2865832	S	5809	1054	6863	0.00049
Amycolatopsis sp. FDAARGOS 1241	2778070	S	4493	890	5383	0.00038
Amycolatopsis sp. CA-230715	2745196	S	4032	551	4583	0.00033
Amycolatopsis sp. YIM 10	2653857	S	3728	935	4663	0.00033
Amycolatopsis sp. FU40	2914159	S	2465	1028	3493	0.00025
Amycolatopsis sp. AA4	1896961	S	2176	1057	3233	0.00023
Amycolatopsis sp. BJA-103	1911175	S	2053	701	2754	0.00020
Amycolatopsis sp. TNS106	2861750	S	1623	812	2435	0.00017
Amycolatopsis sp. EV170708-02-1	2919322	S	1305	1053	2358	0.00017
Amycolatopsis mediterranei	33910	S	7607	9622	17229	0.00123
Amycolatopsis pretoriensis	218821	S	6247	1676	7923	0.00057
Amycolatopsis acidiphila	715473	S	4388	832	5220	0.00037
Amycolatopsis keratiniphila	129921	S	2031	1376	3407	0.00024
Amycolatopsis japonica	208439	S	1175	914	2089	0.00015
Amycolatopsis thermalba	944492	S	3418	1219	4637	0.00033
Amycolatopsis albispora	1804986	S	3390	1734	5124	0.00037
Amycolatopsis methanolica	1814	S	3274	1115	4389	0.00031
Amycolatopsis aidingensis	2842453	S	2653	283	2936	0.00021
Amycolatopsis orientalis	31958	S	2190	606	2796	0.00020
Pseudonocardia sp. DSM 110487	2865833	S	19858	2498	22356	0.00160
Pseudonocardia sp. CGMCC 4.1532	2761535	S	6156	3419	9575	0.00068
Pseudonocardia sp. HH130630-07	1690815	S	3858	1079	4937	0.00035
Pseudonocardia sp. AL041005-10	445576	S	3191	1075	4266	0.00030
Pseudonocardia sp. HH130629-09	1641402	S	2716	1093	3809	0.00027
Pseudonocardia sp. EC080625-04	1096868	S	77	1923	2000	0.00014
Pseudonocardia sp. EC080610-09	1688404	S	18	1409	1427	0.00010
Pseudonocardia sp. EC080619-01	1096856	S	13	2995	3008	0.00021
Pseudonocardia broussonetiae	2736640	S	9052	2807	11859	0.00085
Pseudonocardia dioxanivorans	240495	S	8738	2111	10849	0.00078
Pseudonocardia abyssalis	2792008	S	4533	2271	6804	0.00049
Pseudonocardia autotrophica	2074	S	4452	1104	5556	0.00040
Saccharothrix syringae	103733	S	5615	1802	7417	0.00053
Saccharothrix sp. 6-C	2781735	S	5059	1602	6661	0.00048
Saccharothrix espanaensis	103731	S	4223	1153	5376	0.00038
Saccharopolyspora erythraea	1836	S	5559	1754	7313	0.00052
Saccharopolyspora gregorii	33914	S	2424	452	2876	0.00021
Saccharopolyspora spinosa	60894	S	1268	760	2028	0.00014
Saccharopolyspora pogona	333966	S	1026	1171	2197	0.00016
Saccharopolyspora sp. ASAGF58	2719023	S	700	887	1587	0.00011
Lentzea guizhouensis	1586287	S	11675	2253	13928	0.00099
Saccharomonospora marina	632569	S	2152	492	2644	0.00019
Saccharomonospora azurea	40988	S	1932	558	2490	0.00018
Saccharomonospora viridis	1852	S	1913	277	2190	0.00016
Saccharomonospora cyanea	40989	S	1427	513	1940	0.00014
Saccharomonospora xinjiangensis	75294	S	1335	210	1545	0.00011
Saccharomonospora glauca	40990	S	1122	389	1511	0.00011
Kutzneria sp. CA-103260	2802641	S	4875	956	5831	0.00042
Kutzneria albida	43357	S	3669	769	4438	0.00032
Allokutzneria albata	211114	S	5568	1211	6779	0.00048
Actinosynnema pretiosum	42197	S	1624	3216	4840	0.00035
Actinosynnema mirum	40567	S	158	1508	1666	0.00012
Actinoalloteichus hoggarensis	1470176	S	1684	204	1888	0.00013
Actinoalloteichus hymeniacidonis	340345	S	1378	118	1496	0.00011
Actinoalloteichus sp. GBA129-24	1612551	S	116	1198	1314	0.00009
Actinoalloteichus fjordicus	1612552	S	63	786	849	0.00006
Kibdelosporangium phytohabitans	860235	S	4366	481	4847	0.00035
Alloactinosynnema sp. L-07	1653480	S	3094	625	3719	0.00027
Prauserella marina	530584	S	1807	151	1958	0.00014
Allosaccharopolyspora coralli	2665642	S	1519	303	1822	0.00013
Blastococcus sp. PRF04-17	2933797	S	30639	9415	40054	0.00286
Blastococcus saxobsidens	138336	S	22732	6265	28997	0.00207
Geodermatophilus obscurus	1861	S	40395	11936	52331	0.00374
Modestobacter marinus	477641	S	24426	7601	32027	0.00229
Modestobacter sp. L9-4	2851567	S	13500	4644	18144	0.00130
Actinomyces sp. oral taxon 414	712122	S	727	134	861	0.00006
Actinomyces sp. MAS-1	2755559	S	519	91	610	0.00004
Actinomyces sp. Z16	2079536	S	465	151	616	0.00004
Actinomyces sp. Chiba101	1851395	S	386	164	550	0.00004
Actinomyces sp. 432	2057798	S	372	76	448	0.00003
Actinomyces sp. oral taxon 171	706438	S	200	141	341	0.00002
Actinomyces sp. oral taxon 169	712116	S	97	160	257	0.00002
Actinomyces sp. HMT897	2789424	S	76	230	306	0.00002
Actinomyces sp. HMT 175	2789425	S	73	274	347	0.00002
Actinomyces sp. oral taxon 897	2081702	S	69	213	282	0.00002
Actinomyces sp. zg-332	2708340	S	15	2	17	0.00000
Actinomyces radicidentis	111015	S	1003	359	1362	0.00010
Actinomyces howellii	52771	S	741	102	843	0.00006
Actinomyces respiraculi	2744574	S	540	119	659	0.00005
Actinomyces slackii	52774	S	523	78	601	0.00004
Actinomyces procaprae	2560010	S	449	150	599	0.00004
Actinomyces faecalis	2722820	S	402	51	453	0.00003
Actinomyces viscosus	1656	S	357	136	493	0.00004
Actinomyces weissii	675090	S	356	62	418	0.00003
Actinomyces qiguomingii	2057800	S	355	44	399	0.00003
Actinomyces naeslundii	1655	S	334	168	502	0.00004
Actinomyces marmotae	2737173	S	304	153	457	0.00003
Actinomyces oris	544580	S	268	716	984	0.00007
Actinomyces wuliandei	2057743	S	250	61	311	0.00002
Actinomyces gaoshouyii	1960083	S	243	114	357	0.00003
Actinomyces lilanjuaniae	2321394	S	211	47	258	0.00002
Actinomyces trachealis	2763540	S	198	34	232	0.00002
Actinomyces pacaensis	1852377	S	80	9	89	0.00001
Schaalia sp. 19OD2882	2794089	S	351	46	397	0.00003
Schaalia sp. JY-X169	2758572	S	118	3	121	0.00001
Schaalia sp. ZJ405	2709403	S	99	9	108	0.00001
Schaalia odontolytica	1660	S	534	119	653	0.00005
Schaalia meyeri	52773	S	278	49	327	0.00002
Schaalia cardiffensis	181487	S	172	24	196	0.00001
Schaalia turicensis	131111	S	99	89	188	0.00001
Flaviflexus salsibiostraticola	1282737	S	512	123	635	0.00005
Flaviflexus sp. dk850	2758573	S	253	82	335	0.00002
Flaviflexus ciconiae	2496867	S	208	24	232	0.00002
Trueperella pecoris	2733571	S	408	103	511	0.00004
Trueperella pyogenes	1661	S	281	136	417	0.00003
Trueperella bialowiezensis	312285	S	181	8	189	0.00001
Pauljensenia hongkongensis	178339	S	440	146	586	0.00004
Nanchangia anserum	2692125	S	438	43	481	0.00003
Actinobaculum sp. 313	2495645	S	194	10	204	0.00001
Arcanobacterium haemolyticum	28264	S	56	22	78	0.00001
Arcanobacterium phocisimile	1302235	S	42	11	53	0.00000
Arcanobacterium sp. 2701	2722751	S	25	5	30	0.00000
Arcanobacterium phocae	131112	S	22	6	28	0.00000
Actinotignum schaalii	59505	S	149	9	158	0.00001
Changpingibacter yushuensis	2758440	S	96	24	120	0.00001
Mobiluncus curtisii	2051	S	94	24	118	0.00001
Varibaculum sp. EMRHCC_39	2811781	S	51	13	64	0.00000
Boudabousia tangfeifanii	1912795	S	50	3	53	0.00000
Fannyhessea vaginae	82135	S	10	2	12	0.00000
Frankia inefficax	298654	S	5212	539	5751	0.00041
Frankia sp. QA3	710111	S	2027	826	2853	0.00020
Frankia sp. ArI3	1858	S	1557	1014	2571	0.00018
Candidatus Frankia datiscae	2716812	S	2011	233	2244	0.00016
Frankia alni	1859	S	1704	1174	2878	0.00021
Frankia casuarinae	106370	S	1704	162	1866	0.00013
Jiangella sp. DSM 45060	1798224	S	7049	1820	8869	0.00063
Jiangella alkaliphila	419479	S	5010	1242	6252	0.00045
Bifidobacterium pseudolongum	1694	S	603	206	809	0.00006
Bifidobacterium choerinum	35760	S	553	203	756	0.00005
Bifidobacterium longum	216816	S	551	884	1435	0.00010
Bifidobacterium scardovii	158787	S	520	43	563	0.00004
Bifidobacterium bifidum	1681	S	412	135	547	0.00004
Bifidobacterium pullorum	78448	S	346	119	465	0.00003
Bifidobacterium subtile	77635	S	341	43	384	0.00003
Bifidobacterium animalis	28025	S	334	171	505	0.00004
Bifidobacterium adolescentis	1680	S	265	55	320	0.00002
Bifidobacterium asteroides	1684	S	261	6	267	0.00002
Bifidobacterium lemurum	1603886	S	203	46	249	0.00002
Bifidobacterium breve	1685	S	195	202	397	0.00003
Bifidobacterium thermophilum	33905	S	192	37	229	0.00002
Bifidobacterium eulemuris	1765219	S	177	39	216	0.00002
Bifidobacterium dentium	1689	S	160	239	399	0.00003
Bifidobacterium actinocoloniiforme	638619	S	159	4	163	0.00001
Bifidobacterium angulatum	1683	S	159	36	195	0.00001
Bifidobacterium pseudocatenulatum	28026	S	99	65	164	0.00001
Bifidobacterium catenulatum	1686	S	96	152	248	0.00002
Bifidobacterium imperatoris	2020965	S	54	28	82	0.00001
Bifidobacterium saguini	762210	S	37	17	54	0.00000
Bifidobacterium indicum	1691	S	24	31	55	0.00000
Bifidobacterium coryneforme	1687	S	23	29	52	0.00000
Parascardovia denticolens	78258	S	122	18	140	0.00001
Gardnerella vaginalis	2702	S	15	31	46	0.00000
Scardovia inopinata	78259	S	17	5	22	0.00000
Nakamurella multipartita	53461	S	2894	478	3372	0.00024
Nakamurella panacisegetis	1090615	S	1648	214	1862	0.00013
Nakamurella sp. PAMC28650	2762325	S	1474	148	1622	0.00012
Nakamurella antarctica	1902245	S	313	20	333	0.00002
Catenulispora acidiphila	304895	S	3957	498	4455	0.00032
Jatrophihabitans telluris	2038343	S	1622	129	1751	0.00013
Jatrophihabitans sp. GAS493	1907575	S	1591	135	1726	0.00012
Stackebrandtia nassauensis	283811	S	2415	190	2605	0.00019
Natronoglycomyces albus	2811108	S	423	12	435	0.00003
Kineococcus radiotolerans	131568	S	2541	606	3147	0.00022
Epidermidibacterium keratini	1891644	S	1609	673	2282	0.00016
Actinopolyspora erythraea	414996	S	1217	107	1324	0.00009
Acidothermus cellulolyticus	28049	S	800	34	834	0.00006
Candidatus Planktophila versatilis	1884905	S	58	16	74	0.00001
Candidatus Planktophila lacus	1884913	S	57	10	67	0.00000
Candidatus Planktophila sulfonica	1884904	S	26	9	35	0.00000
Candidatus Planktophila vernalis	1884907	S	26	7	33	0.00000
Candidatus Planktophila dulcis	1884914	S	23	19	42	0.00000
Candidatus Planktophila limnetica	573600	S	16	3	19	0.00000
Candidatus Nanopelagicus hibericus	1884915	S	19	19	38	0.00000
Conexibacter sp. SYSU D00693	2812560	S	24674	5093	29767	0.00213
Conexibacter sp. S30A1	2937800	S	5461	521	5982	0.00043
Conexibacter sp. DBS9H8	2937801	S	5339	465	5804	0.00041
Conexibacter woesei	191495	S	29470	4464	33934	0.00242
Miltoncostaea oceani	2843216	S	5991	771	6762	0.00048
Miltoncostaea marina	2843215	S	5960	1281	7241	0.00052
Aquihabitans sp. G128	2849779	S	11671	2059	13730	0.00098
Aquihabitans sp. Kera 3	2884263	S	10103	1400	11503	0.00082
Iamia sp. SCSIO 61187	2722752	S	12844	1777	14621	0.00104
Actinomarinicola tropica	2789776	S	10869	1857	12726	0.00091
Ilumatobacter coccineus	467094	S	5099	269	5368	0.00038
Acidimicrobium ferrooxidans	53635	S	1008	68	1076	0.00008
Baekduia soli	496014	S	20180	2759	22939	0.00164
Rubrobacter xylanophilus	49319	S	6025	704	6729	0.00048
Rubrobacter tropicus	2653851	S	5410	402	5812	0.00042
Rubrobacter marinus	2653852	S	4265	381	4646	0.00033
Rubrobacter radiotolerans	42256	S	1743	243	1986	0.00014
Rubrobacter indicoceani	2051957	S	943	78	1021	0.00007
Eggerthella lenta	84112	S	588	347	935	0.00007
Eggerthella guodeyinii	2690837	S	562	245	807	0.00006
Eggerthella sp. YY7918	502558	S	167	62	229	0.00002
Gordonibacter urolithinfaciens	1335613	S	335	207	542	0.00004
Gordonibacter pamelaeae	471189	S	322	275	597	0.00004
Adlercreutzia equolifaciens	446660	S	259	138	397	0.00003
Adlercreutzia hattorii	2707299	S	175	200	375	0.00003
Arabiibacter massiliensis	1870985	S	614	107	721	0.00005
Raoultibacter timonensis	1907662	S	425	29	454	0.00003
Berryella intestinalis	1531429	S	272	248	520	0.00004
Slackia heliotrinireducens	84110	S	224	5	229	0.00002
Denitrobacterium detoxificans	79604	S	211	73	284	0.00002
Cryptobacterium curtum	84163	S	29	2	31	0.00000
Phoenicibacter congonensis	1944646	S	26	9	35	0.00000
Olsenella timonensis	1805478	S	529	149	678	0.00005
Olsenella uli	133926	S	279	32	311	0.00002
Olsenella sp. oral taxon 807	712411	S	199	13	212	0.00002
Parolsenella massiliensis	1871022	S	314	161	475	0.00003
Parolsenella catena	2003188	S	247	135	382	0.00003
Parafannyhessea umbonata	604330	S	394	202	596	0.00004
Thermophilibacter immobilis	2779519	S	372	127	499	0.00004
Atopobium sp. oral taxon 416	712157	S	90	8	98	0.00001
Lancefieldella parvula	1382	S	29	2	31	0.00000
Collinsella aerofaciens	74426	S	555	259	814	0.00006
Collinsella stercoris	147206	S	389	60	449	0.00003
Collinsella sp. zg1085	2844380	S	18	0	18	0.00000
Coriobacterium glomerans	33871	S	224	6	230	0.00002
Euzebya pacifica	1608957	S	2431	167	2598	0.00019
Egicoccus halophilus	1670830	S	2278	289	2567	0.00018
Egibacter rhizosphaerae	1670831	S	2220	108	2328	0.00017
Bacillus sp. S3	486398	S	169	44	213	0.00002
Bacillus sp. 1NLA3E	666686	S	122	39	161	0.00001
Bacillus sp. FJAT-18017	1705566	S	116	28	144	0.00001
Bacillus sp. FJAT-22090	1581038	S	107	28	135	0.00001
Bacillus sp. Y1	352858	S	85	29	114	0.00001
Bacillus sp. NSP9.1	1071078	S	68	5	73	0.00001
Bacillus sp. OxB-1	98228	S	64	15	79	0.00001
Bacillus sp. KH172YL63	2709784	S	60	18	78	0.00001
Bacillus sp. FJAT-42376	2014076	S	53	17	70	0.00001
Bacillus sp. SB49	1071080	S	50	7	57	0.00000
Bacillus sp. JY-23	2933872	S	41	14	55	0.00000
Bacillus sp. PAMC26568	2760090	S	41	3	44	0.00000
Bacillus sp. N3536	2666127	S	36	59	95	0.00001
Bacillus sp. M4U3P1	2592382	S	33	3	36	0.00000
Bacillus sp. THAF10	2587848	S	30	9	39	0.00000
Bacillus sp. Cs-700	2589818	S	21	24	45	0.00000
Bacillus sp. N1-1	2682541	S	15	16	31	0.00000
Bacillus sp. WP8	756828	S	12	16	28	0.00000
Bacillus mycoides	1405	S	220	294	514	0.00004
Bacillus cereus	1396	S	166	4932	5098	0.00036
Bacillus pseudomycoides	64104	S	158	65	223	0.00002
Bacillus thuringiensis	1428	S	71	2167	2238	0.00016
Bacillus wiedmannii	1890302	S	35	51	86	0.00001
Bacillus cytotoxicus	580165	S	29	16	45	0.00000
Bacillus toyonensis	155322	S	23	159	182	0.00001
Bacillus luti	2026191	S	17	15	32	0.00000
Bacillus nitratireducens	2026193	S	14	22	36	0.00000
Bacillus velezensis	492670	S	63	1076	1139	0.00008
Bacillus amyloliquefaciens	1390	S	53	884	937	0.00007
Bacillus paralicheniformis	1648923	S	115	70	185	0.00001
Bacillus subtilis	1423	S	72	1897	1969	0.00014
Bacillus licheniformis	1402	S	51	388	439	0.00003
Bacillus mojavensis	72360	S	27	29	56	0.00000
Bacillus halotolerans	260554	S	16	38	54	0.00000
Bacillus atrophaeus	1452	S	30	45	75	0.00001
Bacillus vallismortis	72361	S	27	30	57	0.00000
Bacillus tequilensis	227866	S	18	14	32	0.00000
[Brevibacterium] frigoritolerans	450367	S	503	177	680	0.00005
Bacillus safensis	561879	S	264	436	700	0.00005
Bacillus glycinifermentans	1664069	S	160	47	207	0.00001
Bacillus pumilus	1408	S	97	86	183	0.00001
Bacillus dafuensis	1742359	S	82	27	109	0.00001
Bacillus infantis	324767	S	75	19	94	0.00001
Bacillus badius	1455	S	60	22	82	0.00001
Bacillus methanolicus	1471	S	48	21	69	0.00000
Bacillus weihaiensis	1547283	S	47	14	61	0.00000
Bacillus gobiensis	1441095	S	43	11	54	0.00000
Bacillus aquiflavi	2672567	S	42	10	52	0.00000
Bacillus smithii	1479	S	39	22	61	0.00000
Bacillus fonticola	2728853	S	38	9	47	0.00000
Bacillus altitudinis	293387	S	36	135	171	0.00001
Bacillus shivajii	1983719	S	32	4	36	0.00000
Bacillus cabrialesii	2487276	S	19	16	35	0.00000
Priestia megaterium	1404	S	4075	3703	7778	0.00056
Priestia filamentosa	1402861	S	76	8	84	0.00001
Priestia flexa	86664	S	41	11	52	0.00000
Priestia aryabhattai	412384	S	35	180	215	0.00002
Priestia koreensis	284581	S	26	8	34	0.00000
Peribacillus asahii	228899	S	3764	1729	5493	0.00039
Peribacillus simplex	1478	S	158	86	244	0.00002
Peribacillus butanolivorans	421767	S	79	23	102	0.00001
Peribacillus psychrosaccharolyticus	1407	S	54	17	71	0.00001
Peribacillus muralis	264697	S	45	9	54	0.00000
Cytobacillus kochii	859143	S	727	204	931	0.00007
Cytobacillus oceanisediminis	665099	S	269	130	399	0.00003
Cytobacillus firmus	1399	S	255	112	367	0.00003
Cytobacillus ciccensis	1670641	S	89	30	119	0.00001
Cytobacillus gottheilii	859144	S	70	21	91	0.00001
Cytobacillus sp. CY-G	2901381	S	48	15	63	0.00000
Geobacillus subterraneus	129338	S	257	224	481	0.00003
Geobacillus genomosp. 3	1921421	S	137	49	186	0.00001
Geobacillus stearothermophilus	1422	S	111	208	319	0.00002
Geobacillus sp. 46C-IIa	1963025	S	60	38	98	0.00001
Geobacillus sp. JS12	1813182	S	13	72	85	0.00001
Geobacillus thermocatenulatus	33938	S	47	66	113	0.00001
Geobacillus thermoleovorans	33941	S	12	192	204	0.00001
Geobacillus thermodenitrificans	33940	S	14	138	152	0.00001
Oceanobacillus kimchii	746691	S	1051	86	1137	0.00008
Oceanobacillus zhaokaii	2052660	S	72	12	84	0.00001
Oceanobacillus iheyensis	182710	S	31	5	36	0.00000
Alkalihalobacillus clausii	79880	S	843	151	994	0.00007
Alkalihalobacillus krulwichiae	199441	S	40	11	51	0.00000
Alkalihalobacillus sp. LMS39	2924032	S	28	5	33	0.00000
Alkalihalobacillus miscanthi	2598861	S	18	6	24	0.00000
Alkalihalobacillus lehensis	300825	S	17	6	23	0.00000
Hydrogenibacillus sp. N12	2866627	S	778	96	874	0.00006
Anoxybacillus sediminis	2613334	S	469	105	574	0.00004
Anoxybacillus amylolyticus	294699	S	61	15	76	0.00001
Anoxybacillus caldiproteolyticus	247480	S	48	10	58	0.00000
Anoxybacillus flavithermus	33934	S	36	46	82	0.00001
Neobacillus drentensis	220684	S	573	225	798	0.00006
Neobacillus mesonae	1193713	S	107	32	139	0.00001
Lysinibacillus sp. SGAir0095	2070463	S	128	55	183	0.00001
Lysinibacillus sp. 2017	2169540	S	60	28	88	0.00001
Lysinibacillus sp. PLM2	2929796	S	54	23	77	0.00001
Lysinibacillus sp. Ag94	2936682	S	23	4	27	0.00000
Lysinibacillus sp. CD3-6	2892541	S	18	9	27	0.00000
Lysinibacillus timonensis	2086577	S	71	35	106	0.00001
Lysinibacillus fusiformis	28031	S	38	58	96	0.00001
Lysinibacillus parviboronicapiens	436516	S	37	13	50	0.00000
Lysinibacillus sphaericus	1421	S	30	50	80	0.00001
Lysinibacillus agricola	2590012	S	29	9	38	0.00000
Metabacillus sp. KUDC1714	2745198	S	122	38	160	0.00001
Metabacillus sp. cB07	2806989	S	60	20	80	0.00001
Metabacillus sp. B2-18	2897333	S	22	26	48	0.00000
Metabacillus sediminilitoris	2567941	S	97	32	129	0.00001
Metabacillus dongyingensis	2874282	S	59	19	78	0.00001
Metabacillus litoralis	152268	S	24	19	43	0.00000
Metabacillus endolithicus	1535204	S	24	23	47	0.00000
Mesobacillus foraminis	279826	S	113	27	140	0.00001
Mesobacillus sp. S13	2880221	S	95	33	128	0.00001
Mesobacillus jeotgali	129985	S	92	29	121	0.00001
Parageobacillus caldoxylosilyticus	81408	S	68	25	93	0.00001
Parageobacillus thermoglucosidasius	1426	S	53	25	78	0.00001
Parageobacillus genomosp. 1	1295642	S	53	17	70	0.00001
Parageobacillus sp. KH3-4	2916802	S	39	15	54	0.00000
Parageobacillus toebii	153151	S	38	21	59	0.00000
Virgibacillus sp. NKC19-16	2831673	S	35	2	37	0.00000
Virgibacillus sp. SK37	403957	S	32	35	67	0.00000
Virgibacillus sp. MSP4-1	2700081	S	29	5	34	0.00000
Virgibacillus sp. Bac332	2419842	S	13	1	14	0.00000
Virgibacillus necropolis	163877	S	34	4	38	0.00000
Virgibacillus halodenitrificans	1482	S	28	21	49	0.00000
Virgibacillus phasianinus	2017483	S	19	2	21	0.00000
Niallia circulans	1397	S	157	44	201	0.00001
Niallia sp. Man26	2912824	S	54	13	67	0.00000
Weizmannia coagulans	1398	S	209	85	294	0.00002
Rossellomorea marisflavi	189381	S	155	54	209	0.00001
Rossellomorea vietnamensis	218284	S	52	18	70	0.00001
Salicibibacter cibarius	2743000	S	71	8	79	0.00001
Salicibibacter kimchii	2099786	S	47	3	50	0.00000
Salicibibacter halophilus	2502791	S	45	6	51	0.00000
Salicibibacter cibi	2743001	S	31	2	33	0.00000
Sutcliffiella horikoshii	79883	S	98	24	122	0.00001
Sutcliffiella cohnii	33932	S	94	36	130	0.00001
Heyndrickxia oleronia	38875	S	142	50	192	0.00001
Heyndrickxia vini	1476025	S	43	11	54	0.00000
Psychrobacillus sp. INOP01	2829187	S	77	24	101	0.00001
Psychrobacillus sp. AK 1817	2303505	S	41	66	107	0.00001
Psychrobacillus glaciei	2283160	S	50	17	67	0.00000
Halobacillus sp. SSBR10-3	2932257	S	30	3	33	0.00000
Halobacillus sp. SSTM10-2	2932258	S	24	3	27	0.00000
Halobacillus sp. SSHM10-5	2932259	S	21	3	24	0.00000
Halobacillus litoralis	45668	S	41	5	46	0.00000
Halobacillus halophilus	1570	S	25	2	27	0.00000
Halobacillus mangrovi	402384	S	16	2	18	0.00000
Caldibacillus thermoamylovorans	35841	S	146	50	196	0.00001
Salisediminibacterium selenitireducens	85683	S	76	12	88	0.00001
Salisediminibacterium beveridgei	632773	S	57	9	66	0.00000
Terribacillus goriensis	386490	S	81	13	94	0.00001
Terribacillus aidingensis	586416	S	34	5	39	0.00000
Alkalihalophilus pseudofirmus	79885	S	102	16	118	0.00001
Lentibacillus sp. CBA3610	2518176	S	51	3	54	0.00000
Lentibacillus amyloliquefaciens	1472767	S	43	4	47	0.00000
Gracilibacillus sp. SSPM10-3	2932255	S	30	8	38	0.00000
Gracilibacillus sp. SSWR10-1	2932256	S	20	5	25	0.00000
Gracilibacillus salitolerans	2663022	S	32	3	35	0.00000
Caldalkalibacillus thermarum	296745	S	68	12	80	0.00001
Fictibacillus arsenicus	255247	S	32	6	38	0.00000
Fictibacillus phosphorivorans	1221500	S	30	5	35	0.00000
Anaerobacillus isosaccharinicus	1532552	S	61	13	74	0.00001
Lederbergia lenta	1467	S	55	12	67	0.00000
Halalkalibacterium halodurans	86665	S	54	36	90	0.00001
Pontibacillus sp. ALD_SL1	2777185	S	25	4	29	0.00000
Pontibacillus sp. HMF3514	2692425	S	24	5	29	0.00000
Gottfriedia acidiceleris	371036	S	51	13	64	0.00000
Aeribacillus pallidus	33936	S	50	25	75	0.00001
Salimicrobium jeotgali	1230341	S	49	7	56	0.00000
Mangrovibacillus cuniculi	2593652	S	36	17	53	0.00000
Pradoshia sp. D12	2651284	S	36	9	45	0.00000
Sediminibacillus sp. DP4-553-S	2729421	S	29	4	33	0.00000
Radiobacillus sp. 80	2844358	S	16	3	19	0.00000
Radiobacillus deserti	2594883	S	10	2	12	0.00000
Paraliobacillus zengyii	2213194	S	26	4	30	0.00000
Amphibacillus xylanus	1449	S	23	3	26	0.00000
Evansella cellulosilytica	1413	S	22	3	25	0.00000
Paenibacillus sp. B01	2660554	S	1014	320	1334	0.00010
Paenibacillus sp. RUD330	2023772	S	642	63	705	0.00005
Paenibacillus sp. 32O-W	1695218	S	506	46	552	0.00004
Paenibacillus sp. R14(2021)	2859228	S	323	42	365	0.00003
Paenibacillus sp. JZ16	1906272	S	290	73	363	0.00003
Paenibacillus sp. sptzw28	715179	S	241	20	261	0.00002
Paenibacillus sp. H1-7	2282849	S	240	20	260	0.00002
Paenibacillus sp. HWE-109	1306526	S	168	13	181	0.00001
Paenibacillus sp. URB8-2	2741301	S	158	37	195	0.00001
Paenibacillus sp. BIHB4019	1870819	S	157	11	168	0.00001
Paenibacillus sp. FSL R7-0273	1536772	S	156	27	183	0.00001
Paenibacillus sp. PK3_47	2072642	S	151	20	171	0.00001
Paenibacillus sp. YPD9-1	2908839	S	133	15	148	0.00001
Paenibacillus sp. FSL H7-0357	1536774	S	131	17	148	0.00001
Paenibacillus sp. Y412MC10	481743	S	127	292	419	0.00003
Paenibacillus sp. PAMC21692	2762320	S	116	104	220	0.00002
Paenibacillus sp. FSL R7-0331	1536773	S	111	20	131	0.00001
Paenibacillus sp. JNUCC-32	2777984	S	111	271	382	0.00003
Paenibacillus sp. FSL R5-0912	1536771	S	93	54	147	0.00001
Paenibacillus sp. CAA11	1532905	S	89	16	105	0.00001
Paenibacillus sp. YPG26	2878915	S	85	15	100	0.00001
Paenibacillus sp. FSL P4-0081	1536769	S	70	45	115	0.00001
Paenibacillus sp. DCT19	2211212	S	66	10	76	0.00001
Paenibacillus sp. 481	2835869	S	65	5	70	0.00001
Paenibacillus sp. 19GGS1-52	2758563	S	60	5	65	0.00000
Paenibacillus sp. IHB B 3084	867076	S	55	33	88	0.00001
Paenibacillus sp. JNUCC-31	2777983	S	54	15	69	0.00000
Paenibacillus sp. IHBB 10380	1566358	S	50	8	58	0.00000
Paenibacillus sp. E222	2748863	S	41	14	55	0.00000
Paenibacillus sp. FSL H7-0737	1536775	S	34	11	45	0.00000
Paenibacillus sp. FSL R5-0345	1536770	S	24	7	31	0.00000
Paenibacillus sp. Cedars	1980674	S	20	125	145	0.00001
Paenibacillus sp. N3/727	2925845	S	19	24	43	0.00000
Paenibacillus mucilaginosus	61624	S	1008	66	1074	0.00008
Paenibacillus albicereus	2726185	S	878	254	1132	0.00008
Paenibacillus lycopersici	2704462	S	757	85	842	0.00006
Paenibacillus ihbetae	1870820	S	441	59	500	0.00004
Paenibacillus macerans	44252	S	396	33	429	0.00003
Paenibacillus konkukensis	2020716	S	392	40	432	0.00003
Paenibacillus rhizovicinus	2704463	S	390	47	437	0.00003
Paenibacillus cellulositrophicus	562959	S	369	34	403	0.00003
Paenibacillus beijingensis	1126833	S	328	34	362	0.00003
Paenibacillus dendritiformis	130049	S	313	54	367	0.00003
Paenibacillus chitinolyticus	79263	S	282	31	313	0.00002
Paenibacillus thiaminolyticus	49283	S	275	47	322	0.00002
Paenibacillus stellifer	169760	S	257	44	301	0.00002
Paenibacillus durus	44251	S	240	88	328	0.00002
Paenibacillus cellulosilyticus	375489	S	193	22	215	0.00002
Paenibacillus donghaensis	414771	S	181	18	199	0.00001
Paenibacillus albus	2495582	S	179	21	200	0.00001
Paenibacillus naphthalenovorans	162209	S	167	21	188	0.00001
Paenibacillus azoreducens	116718	S	161	17	178	0.00001
Paenibacillus agaridevorans	171404	S	151	181	332	0.00002
Paenibacillus protaetiae	2509456	S	151	20	171	0.00001
Paenibacillus xylanilyticus	248903	S	150	30	180	0.00001
Paenibacillus tritici	1873425	S	144	21	165	0.00001
Paenibacillus sabinae	365617	S	143	35	178	0.00001
Paenibacillus polymyxa	1406	S	139	469	608	0.00004
Paenibacillus riograndensis	483937	S	71	55	126	0.00001
Paenibacillus sonchi	373687	S	30	43	73	0.00001
Paenibacillus physcomitrellae	1619311	S	129	45	174	0.00001
Paenibacillus borealis	160799	S	125	45	170	0.00001
Paenibacillus swuensis	1178515	S	123	15	138	0.00001
Paenibacillus lautus	1401	S	113	149	262	0.00002
Paenibacillus yonginensis	1462996	S	106	47	153	0.00001
Paenibacillus sophorae	1333845	S	97	35	132	0.00001
Paenibacillus tianjinensis	2810347	S	96	16	112	0.00001
Paenibacillus algicola	2565926	S	96	14	110	0.00001
Paenibacillus guangzhouensis	1473112	S	92	8	100	0.00001
Paenibacillus jilunlii	682956	S	84	60	144	0.00001
Paenibacillus bovis	1616788	S	83	10	93	0.00001
Paenibacillus alvei	44250	S	79	9	88	0.00001
Paenibacillus graminis	189425	S	77	42	119	0.00001
Paenibacillus lentus	1338368	S	75	7	82	0.00001
Paenibacillus baekrokdamisoli	1712516	S	72	7	79	0.00001
Paenibacillus barcinonensis	198119	S	70	11	81	0.00001
Paenibacillus pabuli	1472	S	66	24	90	0.00001
Paenibacillus xylanexedens	528191	S	62	46	108	0.00001
Paenibacillus odorifer	189426	S	61	11	72	0.00001
Paenibacillus lutimineralis	2707005	S	59	7	66	0.00000
Paenibacillus psychroresistens	1778678	S	57	2	59	0.00000
Paenibacillus larvae	1464	S	45	4	49	0.00000
Paenibacillus crassostreae	1763538	S	43	6	49	0.00000
Paenibacillus kribbensis	172713	S	43	16	59	0.00000
Paenibacillus peoriae	59893	S	37	230	267	0.00002
Paenibacillus terrae	159743	S	37	18	55	0.00000
Paenibacillus brasilensis	128574	S	36	17	53	0.00000
Paenibacillus uliginis	683737	S	28	32	60	0.00000
Paenibacillus antarcticus	253703	S	24	3	27	0.00000
Paenibacillus glucanolyticus	59843	S	19	121	140	0.00001
Brevibacillus marinus	2496837	S	413	59	472	0.00003
Brevibacillus composti	2796470	S	289	65	354	0.00003
Brevibacillus agri	51101	S	286	62	348	0.00002
Brevibacillus sp. MMS20-4M-10-Y	2895522	S	160	19	179	0.00001
Brevibacillus sp. HD3.3A	2738979	S	27	105	132	0.00001
Brevibacillus sp. DP1.3A	2738867	S	18	14	32	0.00000
Brevibacillus brevis	1393	S	199	90	289	0.00002
Brevibacillus choshinensis	54911	S	150	30	180	0.00001
Brevibacillus laterosporus	1465	S	87	93	180	0.00001
Brevibacillus parabrevis	54914	S	24	97	121	0.00001
Brevibacillus formosus	54913	S	21	16	37	0.00000
Cohnella sp. LGH	1619153	S	333	122	455	0.00003
Cohnella sp. MFER-1	2728023	S	204	32	236	0.00002
Cohnella candidum	2674991	S	502	62	564	0.00004
Cohnella cholangitidis	2598458	S	237	50	287	0.00002
Cohnella abietis	2507935	S	89	11	100	0.00001
Thermobacillus composti	377615	S	971	129	1100	0.00008
Saccharibacillus brassicae	2583377	S	706	74	780	0.00006
Aneurinibacillus soli	1500254	S	71	94	165	0.00001
Planococcus glaciei	459472	S	468	121	589	0.00004
Planococcus sp. 107-1	2908840	S	213	78	291	0.00002
Planococcus sp. MB-3u-03	2058136	S	122	65	187	0.00001
Planococcus sp. PAMC 21323	1526927	S	15	5	20	0.00000
Planococcus plakortidis	1038856	S	179	88	267	0.00002
Planococcus rifietoensis	200991	S	96	54	150	0.00001
Planococcus maritimus	192421	S	88	32	120	0.00001
Planococcus lenghuensis	2213202	S	86	16	102	0.00001
Planococcus halotolerans	2233542	S	76	21	97	0.00001
Planococcus massiliensis	1499687	S	70	12	82	0.00001
Planococcus antarcticus	161360	S	42	11	53	0.00000
Planococcus versutus	1302659	S	24	9	33	0.00000
Planococcus halocryophilus	1215089	S	21	9	30	0.00000
Planococcus donghaensis	414778	S	13	6	19	0.00000
Solibacillus silvestris	76853	S	998	360	1358	0.00010
Solibacillus sp. R5-41	2048654	S	45	18	63	0.00000
Sporosarcina sp. Marseille-Q4063	2810514	S	48	11	59	0.00000
Sporosarcina sp. Te-1	2818390	S	42	10	52	0.00000
Sporosarcina sp. PTS2304	2283194	S	26	21	47	0.00000
Sporosarcina sp. resist	2762563	S	11	62	73	0.00001
Sporosarcina ureae	1571	S	66	17	83	0.00001
Sporosarcina ureilytica	298596	S	16	5	21	0.00000
Sporosarcina pasteurii	1474	S	15	5	20	0.00000
Ureibacillus thermosphaericus	51173	S	87	102	189	0.00001
Ureibacillus thermophilus	367743	S	40	21	61	0.00000
Paenisporosarcina antarctica	417367	S	33	9	42	0.00000
Paenisporosarcina cavernae	2320858	S	13	7	20	0.00000
Kurthia zopfii	1650	S	18	7	25	0.00000
Kurthia sp. 11kri321	1750719	S	18	8	26	0.00000
Rummeliibacillus stabekisii	241244	S	38	16	54	0.00000
Jeotgalibacillus malaysiensis	1508404	S	34	10	44	0.00000
Viridibacillus sp. JNUCC-6	2779527	S	21	6	27	0.00000
Tumebacillus avium	1903704	S	1153	444	1597	0.00011
Tumebacillus algifaecis	1214604	S	254	82	336	0.00002
Alicyclobacillus acidocaldarius	405212	S	957	69	1026	0.00007
Alicyclobacillus acidoterrestris	1450	S	118	15	133	0.00001
Alicyclobacillus mengziensis	2931921	S	98	5	103	0.00001
Alicyclobacillus sp. SO9	2665646	S	59	3	62	0.00000
Alicyclobacillus sp. TC	2606450	S	30	2	32	0.00000
Kyrpidia spormannii	2055160	S	135	63	198	0.00001
Kyrpidia tusciae	33943	S	96	63	159	0.00001
Effusibacillus dendaii	2743772	S	92	10	102	0.00001
Novibacillus thermophilus	1471761	S	556	69	625	0.00004
Kroppenstedtia eburnea	714067	S	197	20	217	0.00002
Kroppenstedtia pulmonis	1380685	S	38	2	40	0.00000
Staphylospora marina	2490858	S	225	33	258	0.00002
Thermoactinomyces vulgaris	2026	S	172	32	204	0.00001
Polycladomyces abyssicola	1125966	S	127	11	138	0.00001
Laceyella sacchari	37482	S	123	26	149	0.00001
Staphylococcus aureus	1280	S	60	3297	3357	0.00024
Staphylococcus sp. 17KM0847	2583989	S	13	5	18	0.00000
Staphylococcus sp. CCM 9025	2892440	S	12	4	16	0.00000
Staphylococcus epidermidis	1282	S	26	157	183	0.00001
Staphylococcus pseudintermedius	283734	S	17	18	35	0.00000
Staphylococcus haemolyticus	1283	S	20	17	37	0.00000
Staphylococcus hominis	1290	S	18	9	27	0.00000
Staphylococcus saccharolyticus	33028	S	15	5	20	0.00000
Staphylococcus auricularis	29379	S	13	4	17	0.00000
Staphylococcus pettenkoferi	170573	S	13	2	15	0.00000
Staphylococcus gallinarum	1293	S	12	0	12	0.00000
Staphylococcus pseudoxylosus	2282419	S	11	4	15	0.00000
Staphylococcus schleiferi	1295	S	11	13	24	0.00000
Staphylococcus lugdunensis	28035	S	10	3	13	0.00000
Staphylococcus simiae	308354	S	10	4	14	0.00000
Staphylococcus lutrae	155085	S	10	3	13	0.00000
Macrococcus canis	1855823	S	16	18	34	0.00000
Macrococcus brunensis	198483	S	15	4	19	0.00000
Macrococcus armenti	2875764	S	11	12	23	0.00000
Jeotgalicoccus sp. WY2	2708346	S	40	7	47	0.00000
Jeotgalicoccus saudimassiliensis	1461582	S	22	2	24	0.00000
Salinicoccus halodurans	407035	S	36	9	45	0.00000
Mammaliicoccus sciuri	1296	S	14	7	21	0.00000
Mammaliicoccus stepanovicii	643214	S	10	3	13	0.00000
Nosocomiicoccus ampullae	489910	S	13	1	14	0.00000
Exiguobacterium alkaliphilum	1428684	S	139	44	183	0.00001
Exiguobacterium sp. N4-1P	2051906	S	34	18	52	0.00000
Exiguobacterium sp. Helios	2735868	S	23	10	33	0.00000
Exiguobacterium sp. AT1b	360911	S	18	18	36	0.00000
Exiguobacterium sp. PFWT01	2829816	S	18	19	37	0.00000
Exiguobacterium mexicanum	340146	S	115	40	155	0.00001
Exiguobacterium acetylicum	41170	S	43	82	125	0.00001
Exiguobacterium antarcticum	132920	S	35	12	47	0.00000
Exiguobacterium sibiricum	332410	S	25	12	37	0.00000
Gemella sp. zg-570	2840371	S	15	5	20	0.00000
Listeria monocytogenes	1639	S	38	1011	1049	0.00007
Listeria grayi	1641	S	25	6	31	0.00000
Listeria weihenstephanensis	1006155	S	19	3	22	0.00000
Listeria innocua	1642	S	17	12	29	0.00000
Listeria sp. PSOL-1	1844999	S	13	3	16	0.00000
Listeria ivanovii	1638	S	11	1	12	0.00000
Listeria marthii	529731	S	10	3	13	0.00000
Brochothrix thermosphacta	2756	S	23	6	29	0.00000
Sporolactobacillus terrae	269673	S	66	8	74	0.00001
Lactobacillus delbrueckii	1584	S	88	189	277	0.00002
Lactobacillus sp. 3B(2020)	2695882	S	10	5	15	0.00000
Lactobacillus johnsonii	33959	S	13	26	39	0.00000
Lactobacillus amylovorus	1604	S	11	23	34	0.00000
Lactobacillus crispatus	47770	S	11	8	19	0.00000
Limosilactobacillus fermentum	1613	S	83	49	132	0.00001
Limosilactobacillus pontis	35787	S	53	24	77	0.00001
Limosilactobacillus mucosae	97478	S	39	15	54	0.00000
Limosilactobacillus reuteri	1598	S	32	25	57	0.00000
Limosilactobacillus panis	47493	S	22	7	29	0.00000
Limosilactobacillus frumenti	104955	S	10	3	13	0.00000
Limosilactobacillus gastricus	227942	S	10	3	13	0.00000
Levilactobacillus zymae	267363	S	91	20	111	0.00001
Levilactobacillus brevis	1580	S	52	12	64	0.00000
Levilactobacillus suantsaii	2292255	S	34	9	43	0.00000
Levilactobacillus koreensis	637971	S	21	2	23	0.00000
Lacticaseibacillus manihotivorans	88233	S	31	6	37	0.00000
Lacticaseibacillus rhamnosus	47715	S	30	4	34	0.00000
Lacticaseibacillus casei	1582	S	28	9	37	0.00000
Lacticaseibacillus chiayiensis	2100821	S	19	2	21	0.00000
Lacticaseibacillus paracasei	1597	S	17	61	78	0.00001
Lacticaseibacillus zeae	57037	S	17	7	24	0.00000
Weissella cibaria	137591	S	23	21	44	0.00000
Weissella confusa	1583	S	15	15	30	0.00000
Weissella soli	155866	S	14	4	18	0.00000
Lactiplantibacillus plantarum	1590	S	42	275	317	0.00002
Lactiplantibacillus pentosus	1589	S	41	7	48	0.00000
Lactiplantibacillus paraplantarum	60520	S	10	1	11	0.00000
Schleiferilactobacillus harbinensis	304207	S	87	7	94	0.00001
Leuconostoc lactis	1246	S	17	32	49	0.00000
Leuconostoc mesenteroides	1245	S	10	6	16	0.00000
Ligilactobacillus ruminis	1623	S	24	7	31	0.00000
Ligilactobacillus salivarius	1624	S	12	7	19	0.00000
Ligilactobacillus agilis	1601	S	11	6	17	0.00000
Ligilactobacillus murinus	1622	S	10	9	19	0.00000
Lentilactobacillus buchneri	1581	S	15	3	18	0.00000
Lentilactobacillus parabuchneri	152331	S	13	2	15	0.00000
Oenococcus kitaharae	336988	S	17	0	17	0.00000
Oenococcus sp. UCMA 16435	2259623	S	13	3	16	0.00000
Loigolactobacillus coryniformis	1610	S	27	10	37	0.00000
Loigolactobacillus bifermentans	1607	S	10	1	11	0.00000
Latilactobacillus sakei	1599	S	16	5	21	0.00000
Latilactobacillus curvatus	28038	S	15	6	21	0.00000
Secundilactobacillus paracollinoides	240427	S	36	8	44	0.00000
Pediococcus acidilactici	1254	S	13	9	22	0.00000
Furfurilactobacillus rossiae	231049	S	26	3	29	0.00000
Acetilactobacillus jinshanensis	1720083	S	23	0	23	0.00000
Liquorilactobacillus nagelii	82688	S	10	4	14	0.00000
Periweissella cryptocerci	2506420	S	19	1	20	0.00000
Streptococcus sp. HKU75	2781599	S	18	8	26	0.00000
Streptococcus suis	1307	S	47	230	277	0.00002
Streptococcus oralis	1303	S	38	43	81	0.00001
Streptococcus sanguinis	1305	S	29	8	37	0.00000
Streptococcus gordonii	1302	S	23	7	30	0.00000
Streptococcus anginosus	1328	S	10	19	29	0.00000
Streptococcus equi	1336	S	11	21	32	0.00000
Streptococcus halichoeri	254785	S	20	23	43	0.00000
Streptococcus chenjunshii	2173853	S	16	1	17	0.00000
Streptococcus sobrinus	1310	S	14	2	16	0.00000
Streptococcus pluranimalium	82348	S	14	6	20	0.00000
Streptococcus pantholopis	1811193	S	13	1	14	0.00000
Streptococcus thermophilus	1308	S	12	523	535	0.00004
Streptococcus respiraculi	2021971	S	11	2	13	0.00000
Streptococcus cristatus	45634	S	11	13	24	0.00000
Streptococcus porcinus	1340	S	10	4	14	0.00000
Streptococcus mitis	28037	S	10	8	18	0.00000
Lactococcus raffinolactis	1366	S	22	9	31	0.00000
Lactococcus lactis	1358	S	12	31	43	0.00000
Lactococcus cremoris	1359	S	11	8	19	0.00000
Floricoccus penangensis	1859475	S	11	2	13	0.00000
Enterococcus avium	33945	S	34	14	48	0.00000
Enterococcus faecalis	1351	S	28	31	59	0.00000
Enterococcus hirae	1354	S	23	14	37	0.00000
Enterococcus faecium	1352	S	21	660	681	0.00005
Enterococcus casseliflavus	37734	S	18	21	39	0.00000
Enterococcus raffinosus	71452	S	16	7	23	0.00000
Enterococcus durans	53345	S	14	10	24	0.00000
Enterococcus mundtii	53346	S	12	4	16	0.00000
Enterococcus gilvus	160453	S	11	3	14	0.00000
Vagococcus lutrae	81947	S	13	21	34	0.00000
Vagococcus hydrophili	2714947	S	11	5	16	0.00000
Vagococcus carniphilus	218144	S	10	6	16	0.00000
Tetragenococcus halophilus	51669	S	12	8	20	0.00000
Jeotgalibaca arthritidis	1868794	S	14	29	43	0.00000
Jeotgalibaca ciconiae	2496265	S	10	3	13	0.00000
Carnobacterium divergens	2748	S	14	3	17	0.00000
Carnobacterium maltaromaticum	2751	S	10	2	12	0.00000
Dolosigranulum pigrum	29394	S	33	8	41	0.00000
Aerococcus urinae	1376	S	16	23	39	0.00000
Aerococcus sanguinicola	119206	S	16	18	34	0.00000
Suicoccus acidiformans	2036206	S	17	9	26	0.00000
Abiotrophia defectiva	46125	S	16	4	20	0.00000
Ignavigranum ruoffiae	89093	S	10	1	11	0.00000
Faecalibacterium prausnitzii	853	S	823	698	1521	0.00011
Flavonifractor plautii	292800	S	511	116	627	0.00004
Dysosmobacter sp. Marseille-Q4140	2830675	S	273	98	371	0.00003
Dysosmobacter welbionis	2093857	S	196	123	319	0.00002
Ethanoligenens harbinense	253239	S	294	14	308	0.00002
Vescimonas coprocola	2714355	S	140	107	247	0.00002
Vescimonas fastidiosa	2714353	S	113	146	259	0.00002
Ruthenibacterium lactatiformans	1550024	S	238	59	297	0.00002
Caproiciproducens sp. NJN-50	2507162	S	197	21	218	0.00002
Anaerotruncus colihominis	169435	S	173	83	256	0.00002
Ruminococcus champanellensis	1161942	S	86	7	93	0.00001
Ruminococcus albus	1264	S	36	1	37	0.00000
Ruminococcus bicirculans	1160721	S	15	3	18	0.00000
Ruminococcus bovis	2564099	S	13	1	14	0.00000
Caproicibacter fermentans	2576756	S	149	7	156	0.00001
Oscillibacter sp. NSJ-62	2763056	S	146	41	187	0.00001
Acutalibacter muris	1796620	S	107	4	111	0.00001
Pusillibacter faecalis	2714358	S	101	58	159	0.00001
Solibaculum mannosilyticum	2780922	S	87	70	157	0.00001
Acetivibrio saccincola	1677857	S	33	17	50	0.00000
Acetivibrio clariflavus	288965	S	27	14	41	0.00000
Acetivibrio thermocellus	1515	S	23	0	23	0.00000
Caproicibacterium amylolyticum	2766537	S	42	3	45	0.00000
Caproicibacterium lactatifermentans	2666138	S	29	3	32	0.00000
Pseudoclostridium thermosuccinogenes	84032	S	26	5	31	0.00000
Ruminiclostridium cellulolyticum	1521	S	14	2	16	0.00000
Ruminiclostridium herbifermentans	2488810	S	10	1	11	0.00000
Thermoclostridium stercorarium	1510	S	23	1	24	0.00000
Mageeibacillus indolicus	884684	S	20	22	42	0.00000
Fastidiosipila sanguinis	236753	S	15	7	22	0.00000
Monoglobus pectinilyticus	1981510	S	12	5	17	0.00000
Thermaerobacter sp. FW80	2546351	S	963	173	1136	0.00008
Thermaerobacter sp. PB12/4term	2293838	S	751	165	916	0.00007
Thermaerobacter marianensis	73919	S	829	182	1011	0.00007
Intestinimonas butyriciproducens	1297617	S	229	72	301	0.00002
Aminipila butyrica	433296	S	36	3	39	0.00000
Aminipila luticellarii	2507160	S	36	3	39	0.00000
Aminipila terrae	2697030	S	16	1	17	0.00000
Emergencia timonensis	1776384	S	62	17	79	0.00001
Flintibacter sp. KGMB00164	2610895	S	151	15	166	0.00001
Massilistercora timonensis	2086584	S	66	57	123	0.00001
Carboxydocella thermautotrophica	178899	S	56	4	60	0.00000
Clostridium sp. SY8519	1042156	S	69	16	85	0.00001
Clostridium sp. M62/1	411486	S	47	51	98	0.00001
Clostridium sp. BJN0001	2930219	S	38	7	45	0.00000
Clostridium sp. DL-VIII	641107	S	36	5	41	0.00000
Clostridium sp. C5S11	704125	S	35	3	38	0.00000
Clostridium sp. BNL1100	755731	S	26	2	28	0.00000
Clostridium sp. JN-1	2483110	S	23	2	25	0.00000
Clostridium sp. JN-9	2507159	S	19	2	21	0.00000
Clostridium sp. 'deep sea'	2779445	S	19	0	19	0.00000
Clostridium sp. C1	1155388	S	13	10	23	0.00000
Clostridium sp. MD294	97138	S	11	0	11	0.00000
Clostridium sp. AWRP	2212991	S	10	7	17	0.00000
Clostridium tetani	1513	S	306	29	335	0.00002
Clostridium perfringens	1502	S	220	52	272	0.00002
Clostridium botulinum	1491	S	196	162	358	0.00003
Clostridium septicum	1504	S	86	18	104	0.00001
Clostridium baratii	1561	S	83	18	101	0.00001
Clostridium bornimense	1216932	S	78	19	97	0.00001
Clostridium isatidis	182773	S	72	24	96	0.00001
Clostridium butyricum	1492	S	72	10	82	0.00001
Clostridium chauvoei	46867	S	66	14	80	0.00001
Clostridium gasigenes	94869	S	49	6	55	0.00000
Clostridium manihotivorum	2320868	S	40	3	43	0.00000
Clostridium beijerinckii	1520	S	40	93	133	0.00001
Clostridium pasteurianum	1501	S	38	4	42	0.00000
Clostridium cadaveris	1529	S	36	7	43	0.00000
Clostridium saccharobutylicum	169679	S	36	5	41	0.00000
Clostridium intestinale	36845	S	34	3	37	0.00000
Clostridium cellulovorans	1493	S	30	3	33	0.00000
Clostridium taeniosporum	394958	S	29	4	33	0.00000
Clostridium tyrobutyricum	1519	S	28	1	29	0.00000
Clostridium estertheticum	238834	S	28	4	32	0.00000
Clostridium kluyveri	1534	S	26	1	27	0.00000
Clostridium aceticum	84022	S	24	2	26	0.00000
Clostridium argentinense	29341	S	23	2	25	0.00000
Clostridium saccharoperbutylacetonicum	36745	S	23	3	26	0.00000
Clostridium sporogenes	1509	S	21	140	161	0.00001
Clostridium fermenticellae	2068654	S	20	1	21	0.00000
Clostridium carboxidivorans	217159	S	18	4	22	0.00000
Clostridium novyi	1542	S	18	132	150	0.00001
Clostridium acetobutylicum	1488	S	15	0	15	0.00000
Clostridium formicaceticum	1497	S	13	1	14	0.00000
Clostridium thermarum	1716543	S	12	5	17	0.00000
Clostridium cochlearium	1494	S	12	3	15	0.00000
Clostridium drakei	332101	S	11	9	20	0.00000
Paraclostridium bifermentans	1490	S	205	52	257	0.00002
Hungatella hathewayi	154046	S	102	3	105	0.00001
Alkaliphilus sp. B6464	2731219	S	37	9	46	0.00000
Alkaliphilus oremlandii	461876	S	27	7	34	0.00000
Alkaliphilus metalliredigens	208226	S	12	2	14	0.00000
Crassaminicella profunda	1286698	S	19	4	23	0.00000
Crassaminicella thermophila	2599308	S	17	6	23	0.00000
Geosporobacter ferrireducens	1424294	S	23	2	25	0.00000
Sarcina sp. JB2	2726954	S	21	6	27	0.00000
Caloramator sp. E03	2576307	S	19	1	20	0.00000
Serpentinicella alkaliphila	1734049	S	13	1	14	0.00000
Romboutsia ilealis	1115758	S	1673	646	2319	0.00017
Romboutsia sp. CE17	2724150	S	316	111	427	0.00003
Romboutsia hominis	1507512	S	278	84	362	0.00003
Paeniclostridium sordellii	1505	S	241	46	287	0.00002
Clostridioides difficile	1496	S	95	1107	1202	0.00009
Clostridioides sp. ES-S-0054-01	2770780	S	22	45	67	0.00000
Terrisporobacter sp. MCA3	2813371	S	93	11	104	0.00001
Acetoanaerobium sticklandii	1511	S	41	3	44	0.00000
Peptacetobacter hiranonis	89152	S	33	7	40	0.00000
Tepidibacter sp. 8C15b	2925782	S	28	4	32	0.00000
Peptoclostridium acidaminophilum	1731	S	26	3	29	0.00000
[Clostridium] scindens	29347	S	92	31	123	0.00001
Lachnoclostridium phocaeense	1871021	S	76	55	131	0.00001
[Clostridium] hylemonae	89153	S	65	15	80	0.00001
Lachnoclostridium sp. YL32	1834196	S	18	28	46	0.00000
Lachnoclostridium phytofermentans	66219	S	14	0	14	0.00000
Blautia producta	33035	S	43	13	56	0.00000
Blautia pseudococcoides	1796616	S	41	10	51	0.00000
Blautia sp. NBRC 113351	2877527	S	28	32	60	0.00000
Blautia liquoris	2779518	S	30	2	32	0.00000
Blautia obeum	40520	S	14	14	28	0.00000
Blautia hansenii	1322	S	10	7	17	0.00000
Lachnospiraceae bacterium NSJ-29	2763667	S	59	14	73	0.00001
Lachnospiraceae bacterium NSJ-38	2763669	S	50	16	66	0.00000
Lachnospiraceae bacterium sunii NSJ-8	2763672	S	41	27	68	0.00000
Lachnospiraceae bacterium NSJ-4	2763670	S	12	10	22	0.00000
Roseburia hominis	301301	S	65	60	125	0.00001
Roseburia intestinalis	166486	S	20	27	47	0.00000
Enterocloster bolteae	208479	S	85	24	109	0.00001
Enterocloster clostridioformis	1531	S	14	39	53	0.00000
Anaerostipes caccae	105841	S	39	6	45	0.00000
Anaerostipes rhamnosivorans	1229621	S	25	8	33	0.00000
Anaerostipes hadrus	649756	S	20	16	36	0.00000
Anaerocolumna chitinilytica	1727145	S	32	0	32	0.00000
Anaerocolumna sedimenticola	2696063	S	23	1	24	0.00000
Anaerocolumna cellulosilytica	433286	S	20	0	20	0.00000
Butyrivibrio fibrisolvens	831	S	37	8	45	0.00000
Butyrivibrio hungatei	185008	S	15	2	17	0.00000
Butyrivibrio proteoclasticus	43305	S	11	2	13	0.00000
Lacrimispora sphenoides	29370	S	38	4	42	0.00000
Lacrimispora saccharolytica	84030	S	22	4	26	0.00000
Coprococcus catus	116085	S	26	13	39	0.00000
Coprococcus comes	410072	S	18	17	35	0.00000
Cellulosilyticum lentocellum	29360	S	19	26	45	0.00000
[Ruminococcus] gnavus	33038	S	29	29	58	0.00000
Sellimonas intestinalis	1653434	S	34	15	49	0.00000
Novisyntrophococcus fermenticellae	2068655	S	33	3	36	0.00000
Anaerobutyricum hallii	39488	S	30	10	40	0.00000
Anaerotignum propionicum	28446	S	29	2	31	0.00000
Dorea longicatena	88431	S	23	21	44	0.00000
Faecalicatena sp. Marseille-Q4148	2823316	S	18	7	25	0.00000
Lachnospira eligens	39485	S	18	2	20	0.00000
Herbinix luporum	1679721	S	15	8	23	0.00000
Pseudobutyrivibrio xylanivorans	185007	S	15	0	15	0.00000
Lachnoanaerobaculum umeaense	617123	S	14	3	17	0.00000
Symbiobacterium thermophilum	2734	S	1144	79	1223	0.00009
Candidatus Desulforudis audaxviator	471827	S	322	13	335	0.00002
Desulforamulus ruminis	1564	S	82	11	93	0.00001
Desulforamulus ferrireducens	1833852	S	45	23	68	0.00000
Desulforamulus reducens	59610	S	30	5	35	0.00000
Acididesulfobacillus acetoxydans	1561005	S	126	4	130	0.00001
Thermanaerosceptrum fracticalcis	1712410	S	72	9	81	0.00001
Candidatus Formimonas warabiya	1761012	S	64	4	68	0.00000
Desulfofarcimen acetoxidans	58138	S	42	4	46	0.00000
Dehalobacterium formicoaceticum	51515	S	25	4	29	0.00000
Christensenella sp. Marseille-P3954	2086585	S	345	141	486	0.00003
Christensenella minuta	626937	S	125	30	155	0.00001
Desulfitobacterium hafniense	49338	S	63	12	75	0.00001
Desulfitobacterium dehalogenans	36854	S	31	5	36	0.00000
Desulfitobacterium dichloroeliminans	233055	S	27	21	48	0.00000
Desulfitobacterium metallireducens	142877	S	23	4	27	0.00000
Desulfosporosinus orientis	1563	S	37	6	43	0.00000
Desulfosporosinus youngiae	339862	S	31	7	38	0.00000
Desulfosporosinus acidiphilus	885581	S	28	4	32	0.00000
Desulfosporosinus meridiei	79209	S	27	8	35	0.00000
Dehalobacter restrictus	55583	S	21	43	64	0.00000
Syntrophobotulus glycolicus	51197	S	31	1	32	0.00000
Heliomicrobium modesticaldum	35701	S	370	119	489	0.00003
Heliorestis convoluta	356322	S	42	2	44	0.00000
Eubacterium limosum	1736	S	52	46	98	0.00001
Eubacterium sp. c-25	2841037	S	15	6	21	0.00000
Eubacterium sp. MSJ-33	2841528	S	14	7	21	0.00000
Eubacterium callanderi	53442	S	25	17	42	0.00000
Eubacterium maltosivorans	2041044	S	18	67	85	0.00001
Acetobacterium sp. KB-1	2184575	S	42	9	51	0.00000
Acetobacterium wieringae	52694	S	38	15	53	0.00000
Acetobacterium woodii	33952	S	23	3	26	0.00000
Alkalibacter sp. ES005	2815577	S	51	2	53	0.00000
Syntrophothermus lipocalidus	86170	S	47	3	50	0.00000
Candidatus Contubernalis alkalaceticum	338645	S	41	1	42	0.00000
Syntrophomonas wolfei	863	S	39	5	44	0.00000
Candidatus Syntrophocurvum alkaliphilum	2293317	S	11	2	13	0.00000
Desulfoscipio gibsoniae	102134	S	96	6	102	0.00001
Thermincola potens	863643	S	53	3	56	0.00000
Vallitalea pronyensis	1348613	S	16	0	16	0.00000
Petrocella atlantisensis	2173034	S	19	2	21	0.00000
Desulfotomaculum nigrificans	1565	S	38	13	51	0.00000
Caloranaerobacter azorensis	116090	S	37	4	41	0.00000
Alkalicella caledoniensis	2731377	S	17	1	18	0.00000
Moorella sp. Hama-1	2138101	S	188	43	231	0.00002
Moorella thermoacetica	1525	S	144	28	172	0.00001
Moorella glycerini	55779	S	133	14	147	0.00001
Ammonifex degensii	42838	S	193	5	198	0.00001
Gelria sp. Kuro-4	2796927	S	451	27	478	0.00003
Thermacetogenium phaeum	85874	S	138	89	227	0.00002
Carboxydothermus hydrogenoformans	129958	S	82	6	88	0.00001
Thermoanaerobacter kivui	2325	S	10	33	43	0.00000
Thermanaeromonas toyohensis	161154	S	43	1	44	0.00000
Caldanaerobacter subterraneus	911092	S	18	24	42	0.00000
Thermoanaerobacterium thermosaccharolyticum	1517	S	22	36	58	0.00000
Thermoanaerobacterium sp. RBIITD	1550240	S	15	10	25	0.00000
Caldicellulosiruptor changbaiensis	1222016	S	10	30	40	0.00000
Zhaonella formicivorans	2528593	S	47	6	53	0.00000
Mahella australiensis	252966	S	46	17	63	0.00000
Thermodesulfobium acidiphilum	1794699	S	19	12	31	0.00000
Iocasia fonsfrigidae	2682810	S	42	3	45	0.00000
Halanaerobium praevalens	2331	S	17	8	25	0.00000
Halanaerobium hydrogeniformans	656519	S	11	4	15	0.00000
Halothermothrix orenii	31909	S	31	4	35	0.00000
Anoxybacter fermentans	1323375	S	44	7	51	0.00000
Acetohalobium arabaticum	28187	S	15	1	16	0.00000
Halobacteroides halobius	42422	S	15	2	17	0.00000
Thermosediminibacter oceani	291990	S	89	5	94	0.00001
Biomaibacter acetigenes	2316383	S	55	2	57	0.00000
Tepidanaerobacter acetatoxydans	499229	S	17	0	17	0.00000
Natranaerofaba carboxydovora	2742683	S	22	0	22	0.00000
Natranaerobius thermophilus	375929	S	21	0	21	0.00000
Koleobacter methoxysyntrophicus	2751313	S	36	2	38	0.00000
Turicibacter sp. H121	1712675	S	2109	1566	3675	0.00026
Turicibacter sp. TJ11	2806443	S	329	212	541	0.00004
Turicibacter sanguinis	154288	S	241	48	289	0.00002
Allobaculum sp. Allo2	2853432	S	44	4	48	0.00000
Allobaculum mucolyticum	2834459	S	40	4	44	0.00000
Faecalibaculum rodentium	1702221	S	79	11	90	0.00001
[Clostridium] innocuum	1522	S	41	26	67	0.00000
Erysipelatoclostridium ramosum	1547	S	15	5	20	0.00000
Bulleidia sp. zg-1006	2806552	S	18	5	23	0.00000
Intestinibaculum porci	2487118	S	16	5	21	0.00000
Faecalibacillus intestinalis	1982626	S	10	7	17	0.00000
Selenomonas sp. oral taxon 126	712528	S	258	65	323	0.00002
Selenomonas sp. oral taxon 920	1884263	S	185	39	224	0.00002
Selenomonas sp. oral taxon 136	713030	S	66	87	153	0.00001
Selenomonas sp. oral taxon 478	712538	S	64	90	154	0.00001
Selenomonas sputigena	69823	S	435	28	463	0.00003
Selenomonas timonae	2754044	S	171	74	245	0.00002
Selenomonas ruminantium	971	S	80	5	85	0.00001
Megamonas funiformis	437897	S	12	2	14	0.00000
Pectinatus frisingensis	865	S	15	0	15	0.00000
Sporomusa termitida	2377	S	92	10	102	0.00001
Methylomusa anaerophila	1930071	S	66	4	70	0.00001
Pelosinus sp. UFO1	484770	S	29	10	39	0.00000
Pelosinus fermentans	365349	S	22	4	26	0.00000
Megasphaera elsdenii	907	S	186	71	257	0.00002
Megasphaera stantonii	2144175	S	182	82	264	0.00002
Megasphaera massiliensis	1232428	S	86	24	110	0.00001
Dialister pneumosintes	39950	S	10	58	68	0.00000
Veillonella rodentium	248315	S	20	7	27	0.00000
Veillonella parvula	29466	S	11	8	19	0.00000
Acidaminococcus fermentans	905	S	106	16	122	0.00001
Acidaminococcus intestini	187327	S	34	2	36	0.00000
Phascolarctobacterium faecium	33025	S	53	3	56	0.00000
Phascolarctobacterium succinatutens	626940	S	23	48	71	0.00001
Phascolarctobacterium sp. Marseille-Q4147	2823317	S	23	18	41	0.00000
Limnochorda pilosa	1555112	S	1124	36	1160	0.00008
Peptoniphilus ivorii	54006	S	77	15	92	0.00001
Murdochiella vaginalis	1852373	S	36	28	64	0.00000
Finegoldia magna	1260	S	15	10	25	0.00000
Helcococcus kunzii	40091	S	11	3	14	0.00000
Parvimonas micra	33033	S	11	15	26	0.00000
Schnuerera ultunensis	45497	S	42	3	45	0.00000
Gudongella oleilytica	1582259	S	19	3	22	0.00000
Tissierella sp. JN-28	2507161	S	16	2	18	0.00000
Keratinibaculum paraultunense	1278232	S	11	3	14	0.00000
Gottschalkia acidurici	1556	S	30	2	32	0.00000
Ezakiella coagulans	46507	S	77	155	232	0.00002
Ezakiella massiliensis	1852374	S	13	5	18	0.00000
Sedimentibacter sp. zth1	2816908	S	21	2	23	0.00000
Ndongobacter massiliensis	1871025	S	49	32	81	0.00001
endosymbiont 'TC1' of Trimyema compressum	243899	S	21	1	22	0.00000
Synechococcus sp. CBW1004	1353136	S	517	133	650	0.00005
Synechococcus sp. RSCCF101	2511069	S	374	73	447	0.00003
Synechococcus sp. CBW1107	2789857	S	329	63	392	0.00003
Synechococcus sp. SynAce01	1916956	S	251	26	277	0.00002
Synechococcus sp. CBW1108	1353147	S	226	31	257	0.00002
Synechococcus sp. CB0101	232348	S	216	47	263	0.00002
Synechococcus sp. JA-3-3Ab	321327	S	211	53	264	0.00002
Synechococcus sp. NB0720_10	2907159	S	177	45	222	0.00002
Synechococcus sp. LTW-R	2751170	S	164	40	204	0.00001
Synechococcus sp. LA31	2741953	S	156	35	191	0.00001
Synechococcus sp. HK01-R	2751171	S	143	24	167	0.00001
Synechococcus sp. PCC 7336	195250	S	142	4	146	0.00001
Synechococcus sp. RS9909	221352	S	140	54	194	0.00001
Synechococcus sp. Minos11	221341	S	137	9	146	0.00001
Synechococcus sp. JA-2-3B'a(2-13)	321332	S	132	31	163	0.00001
Synechococcus sp. A10-1-5-1	2936507	S	129	29	158	0.00001
Synechococcus sp. KORDI-100	1280380	S	104	7	111	0.00001
Synechococcus sp. WH 8101	59932	S	103	37	140	0.00001
Synechococcus sp. NOUM97013	1442555	S	92	14	106	0.00001
Synechococcus sp. BMK-MC-1	1442551	S	83	35	118	0.00001
Synechococcus sp. PROS-U-1	1400866	S	80	14	94	0.00001
Synechococcus sp. KORDI-49	585423	S	74	78	152	0.00001
Synechococcus sp. KORDI-52	585425	S	71	22	93	0.00001
Synechococcus sp. BIOS-E4-1	1400864	S	69	7	76	0.00001
Synechococcus sp. PROS-7-1	1442556	S	69	32	101	0.00001
Synechococcus sp. CC9902	316279	S	59	5	64	0.00000
Synechococcus sp. MEDNS5	1442554	S	59	19	78	0.00001
Synechococcus sp. MIT S9220	166309	S	53	8	61	0.00000
Synechococcus sp. PCC 6312	195253	S	51	2	53	0.00000
Synechococcus sp. A15-127	1050624	S	50	52	102	0.00001
Synechococcus sp. BIOS-U3-1	1400865	S	50	5	55	0.00000
Synechococcus sp. WH 8109	166314	S	48	38	86	0.00001
Synechococcus sp. A15-62	1050657	S	47	34	81	0.00001
Synechococcus sp. ROS8604	1442557	S	46	12	58	0.00000
Synechococcus sp. NIES-970	1827144	S	44	8	52	0.00000
Synechococcus sp. PCC 7003	374981	S	42	13	55	0.00000
Synechococcus sp. A15-44	1050646	S	42	78	120	0.00001
Synechococcus sp. CBW1002	1353134	S	36	322	358	0.00003
Synechococcus sp. TAK9802	1442558	S	32	81	113	0.00001
Synechococcus sp. CBW1006	1353138	S	31	244	275	0.00002
Synechococcus sp. RS9907	221350	S	29	70	99	0.00001
Synechococcus sp. M16.1	1442553	S	27	84	111	0.00001
Synechococcus sp. CC9311	64471	S	27	6	33	0.00000
Synechococcus sp. PCC 7502	1173263	S	26	1	27	0.00000
Synechococcus sp. WH 8020	32052	S	25	5	30	0.00000
Synechococcus sp. RS9902	221345	S	23	49	72	0.00001
Synechococcus sp. PROS-9-1	1968775	S	20	5	25	0.00000
Synechococcus sp. A15-60	1050655	S	16	119	135	0.00001
Synechococcus sp. MVIR-18-1	1386941	S	13	24	37	0.00000
Synechococcus elongatus	32046	S	228	10	238	0.00002
Dactylococcopsis salina	292566	S	42	17	59	0.00000
Cyanobium sp. NIES-981	1851505	S	417	120	537	0.00004
Cyanobium sp. NS01	261284	S	356	115	471	0.00003
Cyanobium gracile	59930	S	618	115	733	0.00005
Prochlorococcus marinus	1219	S	93	23	116	0.00001
Parasynechococcus marenigrum	2881428	S	111	33	144	0.00001
Acaryochloris marina	155978	S	50	15	65	0.00000
Acaryochloris sp. 'Moss Beach'	2740837	S	22	32	54	0.00000
Chamaesiphon minutus	1173032	S	113	6	119	0.00001
Synechocystis sp. PCC 6714	1147	S	33	69	102	0.00001
Nostoc sp. NIES-4103	2005458	S	77	11	88	0.00001
Nostoc sp. MS1	2764711	S	74	13	87	0.00001
Nostoc sp. UHCC 0702	2814655	S	68	9	77	0.00001
Nostoc sp. TCL26-01	2576904	S	54	4	58	0.00000
Nostoc sp. C052	2576902	S	52	13	65	0.00000
Nostoc sp. PCC 7524	28072	S	44	5	49	0.00000
Nostoc sp. CENA543	1869241	S	40	4	44	0.00000
Nostoc sp. 'Peltigera membranacea cyanobiont' N6	1261031	S	39	12	51	0.00000
Nostoc sp. 'Lobaria pulmonaria (5183) cyanobiont'	1618022	S	35	8	43	0.00000
Nostoc sp. UHCC 0870	2914041	S	31	4	35	0.00000
Nostoc sp. PCC 7107	317936	S	31	11	42	0.00000
Nostoc sp. ATCC 53789	76335	S	25	47	72	0.00001
Nostoc sp. TCL240-02	2572090	S	23	14	37	0.00000
Nostoc sp. C057	2576903	S	19	35	54	0.00000
Nostoc sp. NIES-2111	1973475	S	15	41	56	0.00000
Nostoc sphaeroides	446679	S	68	36	104	0.00001
Nostoc linckia	92942	S	67	11	78	0.00001
Nostoc edaphicum	264686	S	58	15	73	0.00001
Nostoc piscinale	224012	S	49	8	57	0.00000
Nostoc flagelliforme	1306274	S	39	13	52	0.00000
Nostoc commune	1178	S	31	9	40	0.00000
Nostoc punctiforme	272131	S	27	18	45	0.00000
Anabaena sp. WA102	1647413	S	39	59	98	0.00001
Anabaena sp. 90	46234	S	26	172	198	0.00001
Anabaena sp. YBS01	2490939	S	12	372	384	0.00003
Anabaena cylindrica	1165	S	60	10	70	0.00001
Cylindrospermum stagnale	142864	S	48	4	52	0.00000
Trichormus azollae	1164	S	46	4	50	0.00000
Richelia sinica	1357545	S	25	2	27	0.00000
Calothrix sp. NIES-2100	1954172	S	82	51	133	0.00001
Calothrix sp. NIES-3974	2005462	S	76	6	82	0.00001
Calothrix sp. PCC 7507	99598	S	70	14	84	0.00001
Calothrix sp. PCC 7716	2853227	S	70	43	113	0.00001
Calothrix sp. PCC 6303	1170562	S	53	14	67	0.00000
Calothrix sp. 336/3	1337936	S	41	11	52	0.00000
Calothrix sp. NIES-2098	1954171	S	37	21	58	0.00000
Calothrix brevissima	938406	S	95	42	137	0.00001
Calothrix parasitica	1973486	S	64	3	67	0.00000
Sphaerospermopsis kisseleviana	289435	S	53	17	70	0.00001
Sphaerospermopsis torques-reginae	984207	S	50	15	65	0.00000
Nodularia sphaerocarpa	137816	S	41	15	56	0.00000
Nodularia spumigena	70799	S	35	6	41	0.00000
Dolichospermum compactum	136073	S	35	37	72	0.00001
Dolichospermum sp. UHCC 0315A	1914871	S	16	93	109	0.00001
Dolichospermum flos-aquae	1166	S	13	89	102	0.00001
Anabaenopsis circularis	109266	S	39	20	59	0.00000
Anabaenopsis elenkinii	156213	S	10	1	11	0.00000
Cylindrospermopsis raciborskii	77022	S	11	7	18	0.00000
Scytonema sp. NIES-4073	2005464	S	104	43	147	0.00001
Scytonema sp. HK-05	1137095	S	68	25	93	0.00001
Brasilonema sennae	1397703	S	54	5	59	0.00000
Fischerella sp. NIES-4106	2005456	S	61	6	67	0.00000
Fischerella sp. NIES-3754	1752063	S	58	10	68	0.00000
Tolypothrix sp. PCC 7910	2099387	S	50	14	64	0.00000
Tolypothrix tenuis	457083	S	39	14	53	0.00000
Rivularia sp. PCC 7116	373994	S	39	2	41	0.00000
Leptolyngbya sp. 7M	2812896	S	2061	123	2184	0.00016
Leptolyngbya sp. BL0902	1115757	S	249	15	264	0.00002
Leptolyngbya sp. NIES-3755	1752064	S	62	5	67	0.00000
Leptolyngbya sp. PCC 7376	111781	S	32	2	34	0.00000
Leptolyngbya boryana	1184	S	75	0	75	0.00001
Kovacikia minuta	2931930	S	227	23	250	0.00002
Leptothermofonsia sichuanensis	2917832	S	138	15	153	0.00001
Leptodesmis sichuanensis	2906798	S	94	12	106	0.00001
Thermosynechococcus sp. TA-1	2813673	S	29	22	51	0.00000
Thermosynechococcus sp. NK55a	1394889	S	22	9	31	0.00000
Thermosynechococcus sp. CL-1	2583530	S	18	14	32	0.00000
Thermosynechococcus vestitus	146786	S	60	20	80	0.00001
Halomicronema hongdechloris	1209493	S	154	6	160	0.00001
Pseudanabaena sp. PCC 7367	82654	S	58	2	60	0.00000
Pseudanabaena sp. ABRG5-3	685565	S	54	3	57	0.00000
Gloeobacter kilaueensis	1416614	S	666	18	684	0.00005
Gloeobacter morelensis	2907343	S	538	197	735	0.00005
Gloeobacter violaceus	33072	S	470	189	659	0.00005
Anthocerotibacter panamensis	2857077	S	162	5	167	0.00001
Moorena producens	1155739	S	251	6	257	0.00002
Oscillatoria acuminata	118323	S	111	7	118	0.00001
Oscillatoria nigro-viridis	482564	S	102	52	154	0.00001
Geitlerinema sp. PCC 7407	1173025	S	354	53	407	0.00003
Allocoleopsis franciscana	2886352	S	112	11	123	0.00001
Oxynema aestuarii	2874213	S	173	14	187	0.00001
Microcoleus vaginatus	119532	S	135	44	179	0.00001
Planktothrix agardhii	1160	S	21	9	30	0.00000
Planktothrix rubescens	59512	S	15	4	19	0.00000
[Phormidium] sp. ETS-05	222819	S	108	6	114	0.00001
Crinalium epipsammum	241425	S	46	5	51	0.00000
Microcystis aeruginosa	1126	S	136	106	242	0.00002
Microcystis sp. MC19	1967666	S	15	7	22	0.00000
Gloeothece verrucosa	2546359	S	39	2	41	0.00000
Gloeothece citriformis	2546356	S	33	2	35	0.00000
Rippkaea orientalis	2546366	S	38	5	43	0.00000
Halothece sp. PCC 7418	65093	S	25	8	33	0.00000
Euhalothece natronophila	577489	S	11	1	12	0.00000
Crocosphaera subtropica	2546360	S	28	3	31	0.00000
Candidatus Atelocyanobacterium thalassa	713887	S	10	2	12	0.00000
Geminocystis herdmanii	669359	S	44	6	50	0.00000
Geminocystis sp. NIES-3708	1615909	S	20	4	24	0.00000
Geminocystis sp. NIES-3709	1617448	S	13	2	15	0.00000
Gloeocapsa sp. PCC 7428	1173026	S	52	5	57	0.00000
Chondrocystis sp. NIES-4102	2005460	S	27	4	31	0.00000
Cyanobacterium aponinum	379064	S	30	8	38	0.00000
Chroococcidiopsis sp. CCMEE 29	155894	S	125	22	147	0.00001
Chroococcidiopsis sp. CCNUC1	2653189	S	23	40	63	0.00000
Chroococcidiopsis thermalis	54299	S	37	71	108	0.00001
Pleurocapsa sp. PCC 7327	118163	S	89	10	99	0.00001
Stanieria cyanosphaera	102116	S	23	9	32	0.00000
Stanieria sp. NIES-3757	1807358	S	15	4	19	0.00000
Gloeomargarita lithophora	1188228	S	58	2	60	0.00000
Thermostichus lividus	33070	S	45	6	51	0.00000
cyanobacterium endosymbiont of Epithemia turgida	718217	S	10	4	14	0.00000
Deinococcus sp. NW-56	2080419	S	735	98	833	0.00006
Deinococcus sp. TS-293	2737050	S	681	64	745	0.00005
Deinococcus sp. KNUC1210	2917691	S	551	21	572	0.00004
Deinococcus sp. AJ005	2652443	S	404	33	437	0.00003
Deinococcus sp. QL22	2939437	S	315	25	340	0.00002
Deinococcus maricopensis	309887	S	1105	82	1187	0.00008
Deinococcus gobiensis	502394	S	940	105	1045	0.00007
Deinococcus metallilatus	1211322	S	903	87	990	0.00007
Deinococcus ficus	317577	S	891	70	961	0.00007
Deinococcus actinosclerus	1768108	S	883	465	1348	0.00010
Deinococcus irradiatisoli	2202254	S	716	54	770	0.00006
Deinococcus peraridilitoris	432329	S	701	29	730	0.00005
Deinococcus wulumuqiensis	980427	S	645	215	860	0.00006
Deinococcus radiopugnans	57497	S	584	61	645	0.00005
Deinococcus radiodurans	1299	S	492	844	1336	0.00010
Deinococcus geothermalis	68909	S	443	59	502	0.00004
Deinococcus soli (ex Cha et al. 2016)	1309411	S	380	313	693	0.00005
Deinococcus psychrotolerans	2489213	S	361	8	369	0.00003
Deinococcus deserti	310783	S	321	19	340	0.00002
Deinococcus proteolyticus	55148	S	316	59	375	0.00003
Deinococcus radiophilus	32062	S	201	35	236	0.00002
Deinococcus puniceus	1182568	S	176	23	199	0.00001
Thermus thermophilus	274	S	403	400	803	0.00006
Thermus oshimai	56957	S	200	35	235	0.00002
Thermus sp. CCB_US3_UF1	1111069	S	154	20	174	0.00001
Thermus sp. NEB1569	2918899	S	45	76	121	0.00001
Thermus aquaticus	271	S	190	25	215	0.00002
Thermus brockianus	56956	S	177	31	208	0.00001
Thermus caldilimi	2483360	S	86	20	106	0.00001
Thermus scotoductus	37636	S	43	62	105	0.00001
Thermus parvatiensis	456163	S	34	156	190	0.00001
Oceanithermus profundus	187137	S	1199	108	1307	0.00009
Meiothermus silvanus	52022	S	410	55	465	0.00003
Meiothermus taiwanensis	172827	S	318	96	414	0.00003
Meiothermus ruber	277	S	290	93	383	0.00003
Marinithermus hydrothermalis	186192	S	687	109	796	0.00006
Truepera radiovictrix	332249	S	1140	52	1192	0.00009
Sphaerobacter thermophilus	2057	S	3045	188	3233	0.00023
Thermomicrobium roseum	500	S	724	16	740	0.00005
Roseiflexus sp. RS-1	357808	S	1186	214	1400	0.00010
Roseiflexus castenholzii	120962	S	1072	200	1272	0.00009
Chloroflexus aurantiacus	1108	S	446	49	495	0.00004
Chloroflexus aggregans	152260	S	359	60	419	0.00003
Tepidiforma bonchosmolovskayae	2601677	S	2624	96	2720	0.00019
Candidatus Promineofilum breve	1806508	S	1855	32	1887	0.00013
Caldilinea aerophila	133453	S	1188	82	1270	0.00009
Anaerolinea thermophila	167964	S	450	60	510	0.00004
Pelolinea submarina	913107	S	379	24	403	0.00003
Brevefilum fermentans	1986204	S	180	9	189	0.00001
Dehalogenimonas formicexedens	1839801	S	186	44	230	0.00002
Dehalogenimonas sp. GP	1536648	S	164	38	202	0.00001
Dehalococcoides mccartyi	61435	S	65	162	227	0.00002
Phototrophicus methaneseepsis	2710758	S	601	6	607	0.00004
Ktedonosporobacter rubrisoli	2509675	S	402	13	415	0.00003
Thermobaculum terrenum	166501	S	333	41	374	0.00003
Fimbriimonas ginsengisoli	1005039	S	1218	5	1223	0.00009
Chthonomonas calidirosea	454171	S	230	1	231	0.00002
Mycoplasma genitalium	2097	S	12	0	12	0.00000
Mycoplasmopsis gallopavonis	76629	S	10	48	58	0.00000
Candidatus Phytoplasma ziziphi	135727	S	19	26	45	0.00000
Alteracholeplasma palmae	38986	S	16	11	27	0.00000
Candidatus Izimaplasma sp. HR1	1541959	S	12	1	13	0.00000
Gemmata obscuriglobus	114	S	22353	2680	25033	0.00179
Gemmata massiliana	1210884	S	9628	3620	13248	0.00095
Gemmata sp. SH-PL17	1630693	S	9450	4004	13454	0.00096
Urbifossiella limnaea	2528023	S	47725	3549	51274	0.00366
Frigoriglobus tundricola	2774151	S	25200	3470	28670	0.00205
Limnoglobus roseus	2598579	S	14963	601	15564	0.00111
Tuwongella immobilis	692036	S	1314	46	1360	0.00010
Telmatocola sphagniphila	1123043	S	1131	9	1140	0.00008
Lacipirellula parvula	2650471	S	24497	2501	26998	0.00193
Lacipirellula limnantheis	2528024	S	15530	1845	17375	0.00124
Botrimarina mediterranea	2528022	S	7128	618	7746	0.00055
Pirellulimonas nuda	2528009	S	6499	660	7159	0.00051
Aeoliella mucimassa	2527972	S	2668	207	2875	0.00021
Adhaeretor mobilis	1930276	S	1516	143	1659	0.00012
Bythopirellula goksoeyrii	1400387	S	1484	101	1585	0.00011
Anatilimnocola aggregata	2528021	S	7580	899	8479	0.00061
Lignipirellula cremea	2528010	S	4936	613	5549	0.00040
Rosistilla oblonga	2527990	S	1308	652	1960	0.00014
Rosistilla carotiformis	2528017	S	890	396	1286	0.00009
Rosistilla ulvae	1930277	S	842	517	1359	0.00010
Pirellula staleyi	125	S	3547	131	3678	0.00026
Pirellula sp. SH-Sr6A	1632865	S	704	18	722	0.00005
Stieleria maiorica	2795974	S	2065	411	2476	0.00018
Stieleria neptunia	2527979	S	1984	233	2217	0.00016
Bremerella volcania	2527984	S	3742	271	4013	0.00029
Roseimaritima ulvae	980254	S	1908	128	2036	0.00015
Roseimaritima multifibrata	1930274	S	534	61	595	0.00004
Rubripirellula lacrimiformis	1930273	S	1099	215	1314	0.00009
Rhodopirellula baltica	265606	S	890	58	948	0.00007
Aureliella helgolandensis	2527968	S	828	67	895	0.00006
Mariniblastus fucicola	980251	S	825	14	839	0.00006
Thermogutta terrifontis	1331910	S	636	19	655	0.00005
Tautonia plasticadhaerens	2527974	S	34270	2496	36766	0.00263
Aquisphaera giovannonii	406548	S	18166	2594	20760	0.00148
Paludisphaera borealis	1387353	S	16586	3065	19651	0.00140
Singulisphaera acidiphila	466153	S	14961	1845	16806	0.00120
Isosphaera pallida	128	S	1705	103	1808	0.00013
Planctomyces sp. SH-PL62	1636152	S	15988	4719	20707	0.00148
Planctomyces sp. SH-PL14	1632864	S	9176	526	9702	0.00069
Caulifigura coniformis	2527983	S	18181	1113	19294	0.00138
Gimesia panareensis	2527978	S	1796	207	2003	0.00014
Gimesia chilikensis	2605989	S	1022	614	1636	0.00012
Gimesia maris	122	S	644	98	742	0.00005
Gimesia alba	2527973	S	474	82	556	0.00004
Gimesia algae	2527971	S	460	114	574	0.00004
Gimesia fumaroli	2527976	S	423	84	507	0.00004
Gimesia aquarii	2527964	S	316	20	336	0.00002
Gimesia benthica	2608982	S	285	399	684	0.00005
Maioricimonas rarisocia	2528026	S	5338	648	5986	0.00043
Alienimonas californiensis	2527989	S	4067	276	4343	0.00031
Symmachiella dynata	2527995	S	2060	117	2177	0.00016
Rubinisphaera brasiliensis	119	S	1340	125	1465	0.00010
Calycomorphotria hydatis	2528027	S	1315	47	1362	0.00010
Planctopirus ephydatiae	2528019	S	514	222	736	0.00005
Planctopirus limnophila	120	S	417	169	586	0.00004
Fuerstiella marisgermanici	1891926	S	1188	20	1208	0.00009
Crateriforma conspicua	2527996	S	1015	173	1188	0.00008
Polystyrenella longa	2528007	S	449	37	486	0.00003
Thalassoglobus polymorphus	2527994	S	394	19	413	0.00003
Humisphaera borealis	2807512	S	8671	185	8856	0.00063
Phycisphaera mikurensis	547188	S	2421	172	2593	0.00019
Mucisphaera calidilacus	2527982	S	1313	69	1382	0.00010
Poriferisphaera corsica	2528020	S	188	1	189	0.00001
Sedimentisphaera salicampi	1941349	S	53	10	63	0.00000
Sedimentisphaera cyanobacteriorum	1940790	S	44	50	94	0.00001
Limihaloglobus sulfuriphilus	1851148	S	98	7	105	0.00001
Anaerohalosphaera lusitana	1936003	S	202	8	210	0.00002
Candidatus Kuenenia stuttgartiensis	174633	S	76	0	76	0.00001
Candidatus Uabimicrobium amorphum	2596890	S	61	0	61	0.00000
Roseimicrobium sp. ORNL1	2711231	S	40208	706	40914	0.00292
Luteolibacter luteus	2728835	S	2818	103	2921	0.00021
Luteolibacter ambystomatis	2824561	S	1998	107	2105	0.00015
Verrucomicrobium spinosum	2736	S	2589	78	2667	0.00019
Verrucomicrobium sp. GAS474	1882831	S	1788	166	1954	0.00014
Sulfuriroseicoccus oceanibius	2707525	S	423	21	444	0.00003
Akkermansia muciniphila	239935	S	712	63	775	0.00006
Akkermansia glycaniphila	1679444	S	288	16	304	0.00002
Opitutus sp. GAS368	1882749	S	5591	789	6380	0.00046
Opitutus terrae	107709	S	5245	232	5477	0.00039
Lacunisphaera limnophila	1838286	S	5342	713	6055	0.00043
Nibricoccus aquaticus	2576891	S	3904	161	4065	0.00029
Oleiharenicola sp. KSB-15	2862869	S	2944	147	3091	0.00022
Ereboglobus luteus	1796921	S	1505	67	1572	0.00011
Ruficoccus sp. ZRK36	2866311	S	616	74	690	0.00005
Coraliomargarita akajimensis	395922	S	177	4	181	0.00001
Methylacidimicrobium sp. AP8	2730359	S	398	56	454	0.00003
Methylacidimicrobium sp. B4	2796139	S	337	59	396	0.00003
Candidatus Xiphinematobacter sp. Idaho Grape	1704307	S	129	7	136	0.00001
Methylacidiphilum kamchatkense	431057	S	23	1	24	0.00000
Methylacidiphilum sp. IT6	2795386	S	10	0	10	0.00000
Methylacidiphilum infernorum	511746	S	12	45	57	0.00000
Kiritimatiella glycovorans	1307763	S	552	622	1174	0.00008
Tichowtungia aerotolerans	2697043	S	255	7	262	0.00002
Candidatus Protochlamydia naegleriophila	389348	S	26	11	37	0.00000
Candidatus Protochlamydia amoebophila	362787	S	24	9	33	0.00000
Parachlamydia acanthamoebae	83552	S	28	7	35	0.00000
Neochlamydia sp. S13	1353976	S	15	2	17	0.00000
Waddlia chondrophila	71667	S	25	5	30	0.00000
Simkania negevensis	83561	S	17	1	18	0.00000
Candidatus Velamenicoccus archaeovorus	1930593	S	161	0	161	0.00001
Chitinophaga sp. XS-30	2604421	S	9955	1618	11573	0.00083
Chitinophaga sp. KRA15-503	2829818	S	1650	511	2161	0.00015
Chitinophaga alhagiae	2203219	S	3940	101	4041	0.00029
Chitinophaga oryzae	2725414	S	2690	445	3135	0.00022
Chitinophaga agri	2703787	S	2276	674	2950	0.00021
Chitinophaga filiformis	104663	S	1524	270	1794	0.00013
Chitinophaga pinensis	79329	S	1309	329	1638	0.00012
Chitinophaga caeni	2029983	S	872	153	1025	0.00007
Niastella koreensis	354356	S	5763	525	6288	0.00045
Flavisolibacter tropicus	1492898	S	1173	165	1338	0.00010
Flavisolibacter ginsenosidimutans	661481	S	1125	63	1188	0.00008
Pseudobacter ginsenosidimutans	661488	S	2127	161	2288	0.00016
Flavihumibacter sp. IMCC34838	2838156	S	875	85	960	0.00007
Flavihumibacter sp. IMCC34837	2838157	S	750	56	806	0.00006
Niabella soli	446683	S	759	89	848	0.00006
Niabella ginsenosidivorans	1176587	S	758	74	832	0.00006
Arachidicoccus sp. BS20	1850526	S	348	137	485	0.00003
Arachidicoccus sp. 5GH13-10	2875539	S	278	73	351	0.00003
Arachidicoccus sp. B3-10	2545455	S	247	22	269	0.00002
Arachidicoccus soli	2341117	S	253	33	286	0.00002
Arachidicoccus ginsenosidivorans	496057	S	246	58	304	0.00002
Paraflavitalea soli	2315862	S	1477	98	1575	0.00011
Pseudocnuella soli	2502779	S	1360	145	1505	0.00011
Ferruginibacter sp. KIS38-8	2875540	S	599	52	651	0.00005
Ferruginibacter lapsinanis	563172	S	490	42	532	0.00004
Panacibacter ginsenosidivorans	1813871	S	891	36	927	0.00007
Lacibacter sp. S13-6-6	2760713	S	814	32	846	0.00006
Filimonas lacunae	477680	S	743	77	820	0.00006
Phnomibacter ginsenosidimutans	2676868	S	639	69	708	0.00005
Hymenobacter sp. 5317J-9	2932250	S	643	155	798	0.00006
Hymenobacter sp. PAMC 26628	1484118	S	621	154	775	0.00006
Hymenobacter sp. PAMC 26554	1484116	S	592	61	653	0.00005
Hymenobacter sp. APR13	1356852	S	590	246	836	0.00006
Hymenobacter sp. BRD128	2675878	S	528	74	602	0.00004
Hymenobacter sp. 5116S-27	2932249	S	518	85	603	0.00004
Hymenobacter sp. BT18	2835648	S	456	62	518	0.00004
Hymenobacter sp. 5116S-3	2932248	S	448	72	520	0.00004
Hymenobacter sp. 5420S-77	2932254	S	423	61	484	0.00003
Hymenobacter sp. 5413J-13	2932251	S	408	62	470	0.00003
Hymenobacter sp. NBH84	2596915	S	405	63	468	0.00003
Hymenobacter sp. DG01	2584940	S	374	105	479	0.00003
Hymenobacter sp. DG25B	1385664	S	344	129	473	0.00003
Hymenobacter sp. S2-20-2	2761579	S	337	55	392	0.00003
Hymenobacter sp. DG25A	1385663	S	294	113	407	0.00003
Hymenobacter sp. BRD67	2675877	S	253	250	503	0.00004
Hymenobacter sp. HDW8	2714932	S	167	551	718	0.00005
Hymenobacter sp. 5516S-25	2933777	S	120	503	623	0.00004
Hymenobacter sp. 5516J-16	2932253	S	90	400	490	0.00004
Hymenobacter monticola	1705399	S	726	137	863	0.00006
Hymenobacter busanensis	2607656	S	632	71	703	0.00005
Hymenobacter sedentarius	1411621	S	578	90	668	0.00005
Hymenobacter jejuensis	2502781	S	541	43	584	0.00004
Hymenobacter oligotrophus	2319843	S	527	59	586	0.00004
Hymenobacter nivis	1850093	S	482	126	608	0.00004
Hymenobacter swuensis	1446467	S	402	91	493	0.00004
Hymenobacter tibetensis	497967	S	364	59	423	0.00003
Hymenobacter qilianensis	1385715	S	288	53	341	0.00002
Hymenobacter baengnokdamensis	2615203	S	261	288	549	0.00004
Hymenobacter radiodurans	2496028	S	140	483	623	0.00004
Pontibacter pudoricolor	2694930	S	1419	185	1604	0.00011
Pontibacter russatus	2694929	S	1303	146	1449	0.00010
Pontibacter actiniarum	323450	S	694	201	895	0.00006
Pontibacter akesuensis	388950	S	629	108	737	0.00005
Pontibacter sp. SGAir0037	2571030	S	412	83	495	0.00004
Pontibacter korlensis	400092	S	397	68	465	0.00003
Rufibacter radiotolerans	1379910	S	502	69	571	0.00004
Rufibacter sp. DG15C	1379909	S	324	182	506	0.00004
Rufibacter tibetensis	512763	S	295	56	351	0.00003
Adhaeribacter radiodurans	2745197	S	446	46	492	0.00004
Adhaeribacter swui	2086471	S	435	52	487	0.00003
Nibribacter ruber	2698458	S	268	146	414	0.00003
Dyadobacter fermentans	94254	S	4169	349	4518	0.00032
Dyadobacter sp. LJ419	2906456	S	460	32	492	0.00004
Dyadobacter sp. NIV53	2861765	S	266	16	282	0.00002
Dyadobacter sandarakinus	2747268	S	494	43	537	0.00004
Fibrella aestuarina	651143	S	679	62	741	0.00005
Fibrella sp. ES10-3-2-2	1834519	S	375	30	405	0.00003
Runella slithyformis	106	S	320	27	347	0.00002
Runella rosea	2259595	S	265	26	291	0.00002
Runella sp. SP2	2268026	S	195	11	206	0.00001
Larkinella sp. IE-0392	2907205	S	334	24	358	0.00003
Leadbetterella byssophila	316068	S	160	88	248	0.00002
Arcticibacterium luteifluviistationis	1784714	S	98	6	104	0.00001
Chryseolinea soli	2321403	S	6141	207	6348	0.00045
Fulvivirga sp. SS9-22	2904245	S	249	18	267	0.00002
Fulvivirga sp. W9P-11	2904246	S	151	30	181	0.00001
Fulvivirga sp. SW1-E11	2904247	S	129	36	165	0.00001
Fulvivirga lutea	2810512	S	156	18	174	0.00001
Spirosoma sp. CJU-R4	2728024	S	543	46	589	0.00004
Spirosoma sp. RHs26	2898794	S	379	31	410	0.00003
Spirosoma sp. KUDC1026	2745947	S	358	35	393	0.00003
Spirosoma sp. KCTC 42546	2520506	S	275	37	312	0.00002
Spirosoma sp. KCTC 72228	2710596	S	224	30	254	0.00002
Spirosoma rigui	564064	S	477	38	515	0.00004
Spirosoma montaniterrae	1178516	S	389	26	415	0.00003
Spirosoma taeanense	2735870	S	363	38	401	0.00003
Spirosoma pollinicola	2057025	S	318	34	352	0.00003
Spirosoma radiotolerans	1379870	S	316	26	342	0.00002
Spirosoma aerolatum	1211326	S	311	17	328	0.00002
Spirosoma endbachense	2666025	S	233	141	374	0.00003
Spirosoma aureum	2692134	S	202	148	350	0.00003
Rhodocytophaga rosea	2704465	S	652	25	677	0.00005
Cytophaga hutchinsonii	985	S	281	27	308	0.00002
Aquirufa nivalisilvae	2516557	S	90	17	107	0.00001
Aquirufa sp. 9H-EGSE	2696560	S	87	21	108	0.00001
Echinicola sp. 20G	2781961	S	108	13	121	0.00001
Echinicola sp. SCS 3-6	2859768	S	106	44	150	0.00001
Echinicola vietnamensis	390884	S	160	83	243	0.00002
Echinicola strongylocentroti	1795355	S	129	21	150	0.00001
Echinicola soli	2591634	S	121	11	132	0.00001
Echinicola rosea	1807691	S	115	50	165	0.00001
Algoriphagus sp. Y33	2772483	S	204	20	224	0.00002
Algoriphagus sp. NBT04N3	2705473	S	147	51	198	0.00001
Algoriphagus sanaruensis	1727163	S	169	24	193	0.00001
Algoriphagus machipongonensis	388413	S	137	14	151	0.00001
Cyclobacterium amurskyense	320787	S	109	14	123	0.00001
Cyclobacterium marinum	104	S	86	25	111	0.00001
Aquiflexum balticum	280473	S	171	26	197	0.00001
Belliella baltica	232259	S	107	53	160	0.00001
Mongoliitalea daihaiensis	2782006	S	106	12	118	0.00001
Flammeovirga pectinis	2494373	S	46	11	57	0.00000
Flammeovirga sp. MY04	1191459	S	44	61	105	0.00001
Flammeovirga kamogawensis	373891	S	39	9	48	0.00000
Flammeovirga yaeyamensis	367791	S	15	20	35	0.00000
Mangrovivirga cuniculi	2715131	S	163	12	175	0.00001
Candidatus Amoebophilus asiaticus	281120	S	67	6	73	0.00001
Cardinium endosymbiont of Oedothorax gibbosus	931101	S	12	16	28	0.00000
Cardinium endosymbiont of Encarsia pergandiella	249402	S	10	4	14	0.00000
Cardinium endosymbiont of Sogatella furcifera	650378	S	10	4	14	0.00000
Candidatus Cardinium hertigii	247481	S	16	3	19	0.00000
Marivirga tractuosa	1006	S	123	51	174	0.00001
Bernardetia litoralis	999	S	70	6	76	0.00001
Flavobacterium sp. M31R6	2739062	S	609	86	695	0.00005
Flavobacterium sp. CJ74	2294119	S	443	34	477	0.00003
Flavobacterium sp. HJ-32-4	1160795	S	301	20	321	0.00002
Flavobacterium sp. MMS21-Er5	2937442	S	251	80	331	0.00002
Flavobacterium sp. MDT1-60	1979344	S	234	41	275	0.00002
Flavobacterium sp. CLA17	2724135	S	207	33	240	0.00002
Flavobacterium sp. F-70	2893884	S	167	31	198	0.00001
Flavobacterium sp. SLB02	2665645	S	167	29	196	0.00001
Flavobacterium sp. WSW3-B6	2856519	S	161	18	179	0.00001
Flavobacterium sp. K5-23	2746225	S	159	35	194	0.00001
Flavobacterium sp. Sr18	935222	S	156	25	181	0.00001
Flavobacterium sp. F-323	2893885	S	153	30	183	0.00001
Flavobacterium sp. B183	907046	S	150	29	179	0.00001
Flavobacterium sp. F-29	2893883	S	147	30	177	0.00001
Flavobacterium sp. KBS0721	1179672	S	145	40	185	0.00001
Flavobacterium sp. IGB 4-14	1871076	S	143	12	155	0.00001
Flavobacterium sp. 140616W15	2478552	S	127	26	153	0.00001
Flavobacterium sp. F-340	2893886	S	114	35	149	0.00001
Flavobacterium sp. KSM-R2A25	2895947	S	108	26	134	0.00001
Flavobacterium sp. LPB0248	2614441	S	105	40	145	0.00001
Flavobacterium sp. KSM-R2A30	2897181	S	93	28	121	0.00001
Flavobacterium sp. I3-2	2748319	S	86	122	208	0.00001
Flavobacterium sp. KK2020170	2830782	S	86	23	109	0.00001
Flavobacterium sp. GENT5	1751095	S	81	17	98	0.00001
Flavobacterium sp. xlx-214	2654325	S	76	15	91	0.00001
Flavobacterium sp. CHNK8	2871165	S	68	65	133	0.00001
Flavobacterium sp. CECT 9288	2845819	S	66	65	131	0.00001
Flavobacterium sp. CS20	2775246	S	59	27	86	0.00001
Flavobacterium sp. SHINM13	1751056	S	38	82	120	0.00001
Flavobacterium sp. GENT11	1751100	S	38	89	127	0.00001
Flavobacterium anhuiense	459526	S	3906	1078	4984	0.00036
Flavobacterium alkalisoli	2602769	S	1122	95	1217	0.00009
Flavobacterium album	2175091	S	524	37	561	0.00004
Flavobacterium gilvum	1492737	S	341	46	387	0.00003
Flavobacterium sangjuense	2518177	S	311	31	342	0.00002
Flavobacterium enshiense	1341165	S	295	33	328	0.00002
Flavobacterium endoglycinae	2816357	S	293	49	342	0.00002
Flavobacterium inviolabile	2748320	S	286	43	329	0.00002
Flavobacterium pallidum	2172098	S	286	25	311	0.00002
Flavobacterium johnsoniae	986	S	262	96	358	0.00003
Flavobacterium magnum	2162713	S	259	25	284	0.00002
Flavobacterium arcticum	1784713	S	236	25	261	0.00002
Flavobacterium nitrogenifigens	1617283	S	229	83	312	0.00002
Flavobacterium kingsejongi	1678728	S	222	32	254	0.00002
Flavobacterium nackdongense	2547394	S	173	14	187	0.00001
Flavobacterium commune	1306519	S	168	24	192	0.00001
Flavobacterium crocinum	2183896	S	143	32	175	0.00001
Flavobacterium sediminis	2201181	S	142	125	267	0.00002
Flavobacterium fluviale	2249356	S	126	35	161	0.00001
Flavobacterium psychrophilum	96345	S	123	22	145	0.00001
Flavobacterium indicum	312277	S	122	19	141	0.00001
Flavobacterium haoranii	683124	S	101	34	135	0.00001
Flavobacterium faecale	1355330	S	98	11	109	0.00001
Flavobacterium branchiophilum	55197	S	85	7	92	0.00001
Flavobacterium sediminilitoris	2024526	S	84	10	94	0.00001
Flavobacterium davisii	2906077	S	83	29	112	0.00001
Flavobacterium oreochromis	2906078	S	71	24	95	0.00001
Flavobacterium crassostreae	1763534	S	68	16	84	0.00001
Flavobacterium columnare	996	S	67	95	162	0.00001
Flavobacterium covae	2906076	S	63	57	120	0.00001
Flavobacterium jumunjinense	998845	S	59	9	68	0.00000
Muricauda aquimarina	254955	S	288	166	454	0.00003
Muricauda sp. SCSIO 64092	2908842	S	99	4	103	0.00001
Muricauda sp. SCSIO 65647	2908843	S	89	4	93	0.00001
Muricauda lutaonensis	516051	S	143	40	183	0.00001
Muricauda ruestringensis	111501	S	98	8	106	0.00001
Muricauda oceani	2698672	S	96	56	152	0.00001
Muricauda aurantiaca	1383885	S	43	3	46	0.00000
Gramella sp. GC03-9	2920386	S	100	34	134	0.00001
Gramella sp. MAR_2010_147	1250205	S	85	12	97	0.00001
Gramella sp. MT6	2705471	S	80	13	93	0.00001
Gramella flava	1486245	S	123	47	170	0.00001
Gramella fulva	2126553	S	121	12	133	0.00001
Gramella forsetii	411153	S	85	25	110	0.00001
Gramella salexigens	1913577	S	78	9	87	0.00001
Gramella echinicola	279359	S	61	9	70	0.00001
Capnocytophaga sp. oral taxon 878	1316596	S	60	23	83	0.00001
Capnocytophaga sp. oral taxon 902	2748316	S	18	29	47	0.00000
Capnocytophaga sp. FDAARGOS_737	2545799	S	17	10	27	0.00000
Capnocytophaga sp. oral taxon 323	1705617	S	15	28	43	0.00000
Capnocytophaga sp. H2931	1945657	S	10	24	34	0.00000
Capnocytophaga sputigena	1019	S	83	29	112	0.00001
Capnocytophaga haemolytica	45243	S	64	5	69	0.00000
Capnocytophaga stomatis	1848904	S	63	16	79	0.00001
Capnocytophaga gingivalis	1017	S	62	7	69	0.00000
Capnocytophaga canimorsus	28188	S	57	19	76	0.00001
Capnocytophaga leadbetteri	327575	S	31	17	48	0.00000
Capnocytophaga cynodegmi	28189	S	29	7	36	0.00000
Capnocytophaga ochracea	1018	S	20	27	47	0.00000
Capnocytophaga endodontalis	2708117	S	18	8	26	0.00000
Polaribacter sp. SM13	2818493	S	45	9	54	0.00000
Polaribacter sp. G4M1	2808900	S	42	8	50	0.00000
Polaribacter sp. MED152	313598	S	38	6	44	0.00000
Polaribacter sp. Hel1_33_78	1336804	S	34	7	41	0.00000
Polaribacter sp. Q13	2806551	S	34	17	51	0.00000
Polaribacter sp. KT25b	1855336	S	32	9	41	0.00000
Polaribacter sp. SA4-10	754397	S	30	6	36	0.00000
Polaribacter sp. ALD11	2058137	S	28	10	38	0.00000
Polaribacter sp. NJDZ03	2855841	S	26	23	49	0.00000
Polaribacter sp. L3A8	2686361	S	26	14	40	0.00000
Polaribacter sp. SA4-12	1312072	S	22	6	28	0.00000
Polaribacter sp. L12M9	2738844	S	19	9	28	0.00000
Polaribacter sp. KT 15	1896175	S	13	51	64	0.00000
Polaribacter vadi	1774273	S	46	7	53	0.00000
Polaribacter litorisediminis	1908341	S	37	5	42	0.00000
Polaribacter reichenbachii	996801	S	25	3	28	0.00000
Polaribacter sejongensis	985043	S	18	13	31	0.00000
Polaribacter haliotis	1888915	S	18	8	26	0.00000
Nonlabens sp. Hel1_33_55	1336802	S	48	9	57	0.00000
Nonlabens sp. MB-3u-79	2058134	S	47	13	60	0.00000
Nonlabens sp. Ci31	2608253	S	42	10	52	0.00000
Nonlabens ponticola	2496866	S	69	10	79	0.00001
Nonlabens spongiae	331648	S	63	35	98	0.00001
Nonlabens dokdonensis	328515	S	52	14	66	0.00000
Nonlabens marinus	930802	S	52	21	73	0.00001
Winogradskyella sp. MH6	2929510	S	47	8	55	0.00000
Winogradskyella sp. J14-2	1936080	S	45	7	52	0.00000
Winogradskyella sp. HaHa_3_26	2749995	S	36	20	56	0.00000
Winogradskyella sp. PG-2	754409	S	33	4	37	0.00000
Winogradskyella sp. PC-19	754417	S	33	11	44	0.00000
Winogradskyella forsetii	2686077	S	77	27	104	0.00001
Winogradskyella helgolandensis	2697010	S	48	14	62	0.00000
Winogradskyella schleiferi	2686078	S	43	23	66	0.00000
Winogradskyella sediminis	1382466	S	32	12	44	0.00000
Myroides odoratus	256	S	146	25	171	0.00001
Myroides fluvii	2572594	S	57	13	70	0.00001
Myroides phaeus	702745	S	56	44	100	0.00001
Myroides odoratimimus	76832	S	23	110	133	0.00001
Myroides profundi	480520	S	15	7	22	0.00000
Maribacter sp. HTCC2170	313603	S	65	4	69	0.00000
Maribacter sp. MJ134	2496865	S	58	6	64	0.00000
Maribacter sp. 1_2014MBL_MicDiv	1644130	S	19	24	43	0.00000
Maribacter cobaltidurans	1178778	S	59	60	119	0.00001
Maribacter hydrothermalis	1836467	S	56	8	64	0.00000
Maribacter dokdonensis	320912	S	16	20	36	0.00000
Antarcticibacterium arcticum	2585771	S	118	20	138	0.00001
Antarcticibacterium sp. 1MA-6-2	2908210	S	98	16	114	0.00001
Antarcticibacterium flavum	2058175	S	78	21	99	0.00001
Aequorivita sublithincola	101385	S	90	82	172	0.00001
Aequorivita sp. H23M31	2494375	S	88	36	124	0.00001
Tenacibaculum sp. SZ-18	754423	S	33	42	75	0.00001
Tenacibaculum jejuense	584609	S	45	4	49	0.00000
Tenacibaculum maritimum	107401	S	36	10	46	0.00000
Tenacibaculum dicentrarchi	669041	S	35	17	52	0.00000
Tenacibaculum singaporense	2358479	S	29	16	45	0.00000
Tenacibaculum todarodis	1850252	S	25	10	35	0.00000
Tenacibaculum mesophilum	104268	S	17	11	28	0.00000
Cellulophaga sp. HaHaR_3_176	1942464	S	51	15	66	0.00000
Cellulophaga sp. L1A9	2686362	S	33	26	59	0.00000
Cellulophaga lytica	979	S	59	23	82	0.00001
Cellulophaga algicola	59600	S	41	9	50	0.00000
Cellulophaga baltica	76594	S	35	23	58	0.00000
Robiginitalea biformata	252307	S	237	14	251	0.00002
Salegentibacter salegens	143223	S	90	17	107	0.00001
Salegentibacter mishustinae	270918	S	72	80	152	0.00001
Salegentibacter sp. T436	1729720	S	49	61	110	0.00001
Sinomicrobium sp. HD2P242	2900738	S	227	9	236	0.00002
Formosa sp. Hel1_31_208	1798225	S	48	6	54	0.00000
Formosa sp. Hel3_A1_48	1336795	S	37	11	48	0.00000
Formosa sp. Hel1_33_131	1336794	S	35	4	39	0.00000
Formosa sp. L2A11	2686363	S	35	13	48	0.00000
Formosa agariphila	320324	S	31	7	38	0.00000
Formosa sediminum	2594004	S	31	8	39	0.00000
Aquimarina sp. TRL1	2736252	S	64	5	69	0.00000
Aquimarina sp. AD1	1714848	S	46	4	50	0.00000
Aquimarina sp. AD10	1714849	S	45	3	48	0.00000
Aquimarina sp. BL5	1714860	S	45	3	48	0.00000
Dokdonia sp. 4H-3-7-5	983548	S	27	16	43	0.00000
Dokdonia sp. Dokd-P16	2173169	S	27	13	40	0.00000
Dokdonia sp. PRO95	1239415	S	24	7	31	0.00000
Dokdonia sp. MED134	313590	S	18	14	32	0.00000
Dokdonia donghaensis	326320	S	13	9	22	0.00000
Kordia antarctica	1218801	S	89	8	97	0.00001
Kordia sp. SMS9	2282170	S	60	4	64	0.00000
Zunongwangia profunda	398743	S	87	84	171	0.00001
Zunongwangia sp. SCSIO 43204	2779359	S	58	47	105	0.00001
Lutibacter profundi	1622118	S	65	7	72	0.00001
Lutibacter sp. A80	2918453	S	32	8	40	0.00000
Lutibacter sp. A64	2918526	S	26	7	33	0.00000
Leeuwenhoekiella sp. ZYFB001	2719912	S	55	41	96	0.00001
Leeuwenhoekiella palythoae	573501	S	33	32	65	0.00000
Lacinutrix sp. WUR7	2653681	S	43	12	55	0.00000
Lacinutrix sp. Bg11-31	2057808	S	32	8	40	0.00000
Lacinutrix sp. 5H-3-7-4	983544	S	25	14	39	0.00000
Lacinutrix venerupis	1486034	S	20	6	26	0.00000
Flagellimonas sp. HMM57	2905121	S	70	6	76	0.00001
Flagellimonas sp. CMM7	2654676	S	55	4	59	0.00000
Algibacter sp. L1A34	2686365	S	38	15	53	0.00000
Algibacter sp. L3A6	2686366	S	38	15	53	0.00000
Algibacter alginicilyticus	1736674	S	48	15	63	0.00000
Seonamhaeicola sp. S2-3	1936081	S	51	13	64	0.00000
Seonamhaeicola sp. ML3	2937786	S	47	5	52	0.00000
Zhouia spongiae	2202721	S	96	26	122	0.00001
Pukyongia salina	2094025	S	95	7	102	0.00001
Euzebyella marina	1761453	S	90	58	148	0.00001
Muriicola soli	2507538	S	90	6	96	0.00001
Sediminicola sp. YIK13	1453352	S	90	10	100	0.00001
Constantimarinum furrinae	2562285	S	82	8	90	0.00001
Zobellia galactanivorans	63186	S	80	5	85	0.00001
Arenibacter algicola	616991	S	80	30	110	0.00001
Aggregatimonas sangjinii	2583587	S	79	4	83	0.00001
Gilvibacter sp. SZ-19	754429	S	77	11	88	0.00001
Tamlana sp. s12	1630406	S	32	16	48	0.00000
Tamlana carrageenivorans	2069432	S	29	13	42	0.00000
Psychroflexus torquis	57029	S	43	3	46	0.00000
Psychroflexus sp. ALD_RP9	2777186	S	31	3	34	0.00000
Costertonia aggregata	343403	S	74	18	92	0.00001
Mesoflavibacter sp. SCSIO 43206	2779362	S	39	47	86	0.00001
Mariniflexile sp. TRM1-10	2027857	S	70	7	77	0.00001
Gillisia sp. Hel1_33_143	1336796	S	66	25	91	0.00001
Olleya aquimaris	639310	S	35	19	54	0.00000
Olleya sp. HaHaR_3_96	2745560	S	11	38	49	0.00000
Galbibacter sp. BG1	1170699	S	61	7	68	0.00000
Marixanthomonas sp. SCSIO 43207	2779360	S	57	20	77	0.00001
Bizionia sp. M204	2675331	S	55	13	68	0.00000
Amniculibacterium sp. G2-70	2767188	S	54	60	114	0.00001
Changchengzhania lutea	2049305	S	52	7	59	0.00000
Aegicerativicinus sediminis	2893202	S	51	3	54	0.00000
Flavivirga eckloniae	1803846	S	50	4	54	0.00000
Urechidicola croceus	1850246	S	49	31	80	0.00001
Flavobacteriaceae bacterium 10Alg115	2584122	S	48	3	51	0.00000
Oceanihabitans sp. IOP_32	2529032	S	42	19	61	0.00000
Siansivirga zeaxanthinifaciens	762954	S	41	11	52	0.00000
Croceibacter atlanticus	313588	S	40	8	48	0.00000
Sabulilitoribacter sp. BrNp1-15	2916754	S	37	9	46	0.00000
Wenyingzhuangia fucanilytica	1790137	S	31	6	37	0.00000
Psychroserpens sp. NJDZ02	2570561	S	24	60	84	0.00001
Chryseobacterium sp. 3008163	2478663	S	327	64	391	0.00003
Chryseobacterium sp. cx-624	2758037	S	109	11	120	0.00001
Chryseobacterium sp. SC2-2	2929800	S	95	63	158	0.00001
Chryseobacterium sp. IHB B 17019	1721091	S	94	14	108	0.00001
Chryseobacterium sp. F4	2852098	S	88	4	92	0.00001
Chryseobacterium sp. Y16C	2920939	S	87	62	149	0.00001
Chryseobacterium sp. ZHDP1	2838877	S	79	78	157	0.00001
Chryseobacterium sp.	1871047	S	79	33	112	0.00001
Chryseobacterium sp. G0201	2487065	S	76	17	93	0.00001
Chryseobacterium sp. 6424	2039166	S	71	19	90	0.00001
Chryseobacterium sp. StRB126	878220	S	66	14	80	0.00001
Chryseobacterium sp. T16E-39	2015076	S	65	7	72	0.00001
Chryseobacterium sp. PCH239	2825845	S	55	33	88	0.00001
Chryseobacterium sp. G0186	2487064	S	53	33	86	0.00001
Chryseobacterium sp. LJ668	2864040	S	53	6	59	0.00000
Chryseobacterium sp. MEBOG07	2879939	S	53	10	63	0.00000
Chryseobacterium sp. MEBOG06	2879938	S	52	10	62	0.00000
Chryseobacterium sp. SNU WT5	2594269	S	48	22	70	0.00001
Chryseobacterium sp. DH-B6	2759528	S	48	16	64	0.00000
Chryseobacterium sp. ADR-1	2929799	S	41	12	53	0.00000
Chryseobacterium sp. G0162	2487063	S	40	34	74	0.00001
Chryseobacterium sp. POL2	2713414	S	39	32	71	0.00001
Chryseobacterium sp. C-17	2898076	S	39	6	45	0.00000
Chryseobacterium sp. JV274	1932669	S	35	141	176	0.00001
Chryseobacterium indologenes	253	S	836	445	1281	0.00009
Chryseobacterium shandongense	1493872	S	230	182	412	0.00003
Chryseobacterium taklimakanense	536441	S	179	131	310	0.00002
Chryseobacterium manosquense	2754694	S	140	145	285	0.00002
Chryseobacterium camelliae	1265445	S	123	95	218	0.00002
Chryseobacterium gleum	250	S	122	184	306	0.00002
Chryseobacterium gallinarum	1324352	S	122	52	174	0.00001
Chryseobacterium indoltheticum	254	S	113	25	138	0.00001
Chryseobacterium arthrosphaerae	651561	S	111	70	181	0.00001
Chryseobacterium carnipullorum	1124835	S	108	47	155	0.00001
Chryseobacterium nepalense	1854498	S	76	11	87	0.00001
Chryseobacterium piperi	558152	S	68	7	75	0.00001
Chryseobacterium aureum	2497456	S	68	14	82	0.00001
Chryseobacterium daecheongense	192389	S	64	10	74	0.00001
Chryseobacterium salivictor	2547600	S	63	9	72	0.00001
Chryseobacterium lactis	1241981	S	56	78	134	0.00001
Chryseobacterium nakagawai	1241982	S	48	80	128	0.00001
Chryseobacterium cucumeris	1813611	S	47	22	69	0.00000
Chryseobacterium balustinum	246	S	45	14	59	0.00000
Chryseobacterium bernardetii	1241978	S	45	378	423	0.00003
Chryseobacterium joostei	112234	S	43	15	58	0.00000
Chryseobacterium glaciei	1685010	S	39	8	47	0.00000
Kaistella sp. 97-N-M2	2908645	S	73	12	85	0.00001
Kaistella sp. GW4-15	2878534	S	52	7	59	0.00000
Kaistella daneshvariae	2487074	S	102	11	113	0.00001
Candidatus Kaistella beijingensis	2820270	S	55	26	81	0.00001
Kaistella jeonii	266749	S	52	4	56	0.00000
Kaistella carnis	1241979	S	52	19	71	0.00001
Kaistella antarctica	266748	S	51	6	57	0.00000
Kaistella flava (ex Peng et al. 2021)	2038776	S	44	8	52	0.00000
Epilithonimonas vandammei	2487072	S	87	160	247	0.00002
Epilithonimonas zeae	1416779	S	67	8	75	0.00001
Elizabethkingia bruuniana	1756149	S	223	759	982	0.00007
Elizabethkingia anophelis	1117645	S	112	107	219	0.00002
Elizabethkingia meningoseptica	238	S	106	10	116	0.00001
Elizabethkingia ursingii	1756150	S	55	9	64	0.00000
Elizabethkingia sp. JS20170427COW	2583851	S	32	5	37	0.00000
Elizabethkingia sp. 2-6	2575699	S	22	59	81	0.00001
Elizabethkingia miricola	172045	S	51	26	77	0.00001
Empedobacter falsenii	343874	S	155	128	283	0.00002
Empedobacter brevis	247	S	72	33	105	0.00001
Empedobacter stercoris	1628248	S	41	19	60	0.00000
Apibacter sp. ESL0404	2704651	S	11	52	63	0.00000
Apibacter raozihei	2500547	S	62	8	70	0.00001
Cruoricaptor ignavus	1118202	S	100	20	120	0.00001
Ornithobacterium rhinotracheale	28251	S	97	91	188	0.00001
Cloacibacterium caeni	2004710	S	44	58	102	0.00001
Cloacibacterium normanense	237258	S	21	19	40	0.00000
Riemerella anatipestifer	34085	S	71	32	103	0.00001
Weeksella virosa	1014	S	39	22	61	0.00000
Bergeyella cardium	1585976	S	39	8	47	0.00000
Faecalibacter bovis	2898187	S	24	4	28	0.00000
Fluviicola taffensis	191579	S	252	16	268	0.00002
Crocinitomix sp. GM2_3_6_6	2862509	S	73	2	75	0.00001
Blattabacterium cuenoti	1653831	S	194	56	250	0.00002
Owenweeksia hongkongensis	253245	S	119	14	133	0.00001
Croceimicrobium hydrocarbonivorans	2761580	S	86	24	110	0.00001
Candidatus Sulcia muelleri	336810	S	30	8	38	0.00000
Candidatus Walczuchella monophlebidarum	1415657	S	19	1	20	0.00000
Ichthyobacterium seriolicida	242600	S	18	0	18	0.00000
Mucilaginibacter gossypii	551996	S	5607	2776	8383	0.00060
Mucilaginibacter sp. SMC90	2929803	S	1060	53	1113	0.00008
Mucilaginibacter sp. 14171R-50	2703789	S	367	18	385	0.00003
Mucilaginibacter sp. 21P	2778902	S	313	16	329	0.00002
Mucilaginibacter sp. F39-2	2728022	S	225	13	238	0.00002
Mucilaginibacter rubeus	2027860	S	1033	1676	2709	0.00019
Mucilaginibacter celer	2305508	S	587	21	608	0.00004
Mucilaginibacter ginsenosidivorax	862126	S	527	19	546	0.00004
Mucilaginibacter mali	2740462	S	514	17	531	0.00004
Mucilaginibacter ginsenosidivorans	398053	S	440	13	453	0.00003
Mucilaginibacter gotjawali	1550579	S	436	11	447	0.00003
Mucilaginibacter mallensis	652787	S	369	11	380	0.00003
Mucilaginibacter paludis	423351	S	368	16	384	0.00003
Mucilaginibacter xinganensis	1234841	S	354	15	369	0.00003
Mucilaginibacter daejeonensis	398049	S	335	18	353	0.00003
Mucilaginibacter ginkgonis	2682091	S	223	9	232	0.00002
Pedobacter sp. HDW13	2714940	S	522	72	594	0.00004
Pedobacter sp. PACM 27299	1727164	S	253	37	290	0.00002
Pedobacter sp. SW-16	2766984	S	216	47	263	0.00002
Pedobacter sp. KBS0701	2578106	S	178	71	249	0.00002
Pedobacter sp. G11	2482728	S	145	21	166	0.00001
Pedobacter sp. D749	2856523	S	130	52	182	0.00001
Pedobacter sp. Q8-18	2895286	S	130	10	140	0.00001
Pedobacter ginsengisoli	363852	S	1413	187	1600	0.00011
Pedobacter heparinus	984	S	901	79	980	0.00007
Pedobacter schmidteae	2201271	S	599	54	653	0.00005
Pedobacter steynii	430522	S	345	34	379	0.00003
Pedobacter suwonensis	332999	S	243	55	298	0.00002
Pedobacter roseus	336820	S	225	72	297	0.00002
Pedobacter cryoconitis	188932	S	213	21	234	0.00002
Pedobacter endophyticus	2789740	S	178	17	195	0.00001
Pedobacter aquae	2605747	S	137	13	150	0.00001
Sphingobacterium sp. DR205	2713573	S	224	23	247	0.00002
Sphingobacterium sp. CZ-2	2557994	S	124	35	159	0.00001
Sphingobacterium sp. UDSM-2020	2795738	S	108	42	150	0.00001
Sphingobacterium sp. ML3W	1538644	S	102	38	140	0.00001
Sphingobacterium sp. SRCM116780	2907623	S	90	14	104	0.00001
Sphingobacterium sp. PCS056	2931400	S	89	18	107	0.00001
Sphingobacterium sp. dk4302	2662364	S	65	7	72	0.00001
Sphingobacterium sp. G1-14	2003121	S	22	102	124	0.00001
Sphingobacterium spiritivorum	258	S	334	268	602	0.00004
Sphingobacterium thalpophilum	259	S	195	252	447	0.00003
Sphingobacterium multivorum	28454	S	162	375	537	0.00004
Sphingobacterium lactis	797291	S	161	156	317	0.00002
Sphingobacterium hotanense	649196	S	136	45	181	0.00001
Sphingobacterium mizutaii	1010	S	109	16	125	0.00001
Sphingobacterium daejeonense	371142	S	107	32	139	0.00001
Sphingobacterium psychroaquaticum	561061	S	96	19	115	0.00001
Sphingobacterium paramultivorum	2886510	S	39	36	75	0.00001
Sphingobacterium siyangense	459529	S	32	129	161	0.00001
Olivibacter sp. SDN3	2764720	S	196	35	231	0.00002
Olivibacter sp. LS-1	2592345	S	194	14	208	0.00001
Solitalea canadensis	995	S	199	18	217	0.00002
Solitalea sp. S2-8	2911172	S	165	20	185	0.00001
Anseongella ginsenosidimutans	496056	S	325	12	337	0.00002
Pseudopedobacter saltans	151895	S	132	120	252	0.00002
Alistipes onderdonkii	328813	S	433	549	982	0.00007
Alistipes dispar	2585119	S	424	58	482	0.00003
Alistipes communis	2585118	S	357	292	649	0.00005
Alistipes finegoldii	214856	S	320	317	637	0.00005
Alistipes shahii	328814	S	285	166	451	0.00003
Alistipes senegalensis	1288121	S	279	58	337	0.00002
Alistipes indistinctus	626932	S	268	62	330	0.00002
Alistipes megaguti	2364787	S	267	34	301	0.00002
Alistipes sp. dk3624	2662363	S	242	58	300	0.00002
Bacteroides fragilis	817	S	134	202	336	0.00002
Bacteroides sp. CBA7301	2715212	S	53	21	74	0.00001
Bacteroides sp. M10	2763022	S	22	51	73	0.00001
Bacteroides cellulosilyticus	246787	S	114	42	156	0.00001
Bacteroides thetaiotaomicron	818	S	84	54	138	0.00001
Bacteroides eggerthii	28111	S	72	84	156	0.00001
Bacteroides salyersiae	291644	S	72	74	146	0.00001
Bacteroides helcogenes	290053	S	69	3	72	0.00001
Bacteroides stercoris	46506	S	68	72	140	0.00001
Bacteroides zoogleoformans	28119	S	65	15	80	0.00001
Bacteroides heparinolyticus	28113	S	63	14	77	0.00001
Bacteroides xylanisolvens	371601	S	58	147	205	0.00001
Bacteroides uniformis	820	S	57	197	254	0.00002
Bacteroides faecis	674529	S	54	45	99	0.00001
Bacteroides zhangwenhongii	2650157	S	54	35	89	0.00001
Bacteroides intestinalis	329854	S	53	8	61	0.00000
Bacteroides caccae	47678	S	42	10	52	0.00000
Bacteroides nordii	291645	S	42	34	76	0.00001
Bacteroides coprosuis	151276	S	36	2	38	0.00000
Bacteroides ovatus	28116	S	31	56	87	0.00001
Bacteroides caecimuris	1796613	S	29	40	69	0.00000
Bacteroides luhongzhouii	2650158	S	20	7	27	0.00000
Phocaeicola salanitronis	376805	S	80	37	117	0.00001
Phocaeicola coprophilus	387090	S	76	44	120	0.00001
Phocaeicola dorei	357276	S	48	77	125	0.00001
Phocaeicola vulgatus	821	S	30	39	69	0.00000
Prevotella sp. Rep29	2691580	S	93	15	108	0.00001
Prevotella sp. E13-17	2913616	S	73	36	109	0.00001
Prevotella sp. oral taxon 475	712471	S	62	6	68	0.00000
Prevotella sp. E9-3	2913621	S	46	29	75	0.00001
Prevotella sp. E15-22	2937774	S	34	34	68	0.00000
Prevotella sp. E2-28	2913620	S	33	26	59	0.00000
Prevotella sp. oral taxon 299	652716	S	13	1	14	0.00000
Prevotella dentalis	52227	S	181	32	213	0.00002
Prevotella denticola	28129	S	97	29	126	0.00001
Prevotella melaninogenica	28132	S	90	30	120	0.00001
Prevotella intermedia	28131	S	78	36	114	0.00001
Prevotella multiformis	282402	S	77	29	106	0.00001
Prevotella copri	165179	S	77	39	116	0.00001
Prevotella ruminicola	839	S	70	2	72	0.00001
Prevotella buccalis	28127	S	53	62	115	0.00001
Prevotella enoeca	76123	S	48	8	56	0.00000
Prevotella jejuni	1177574	S	44	16	60	0.00000
Prevotella bryantii	77095	S	31	2	33	0.00000
Prevotella oris	28135	S	28	3	31	0.00000
Prevotella nigrescens	28133	S	27	14	41	0.00000
Prevotella fusca	589436	S	25	5	30	0.00000
Prevotella herbatica	2801997	S	25	0	25	0.00000
Prevotella histicola	470565	S	16	2	18	0.00000
Prevotella veroralis	28137	S	14	2	16	0.00000
Prevotella scopos	589437	S	10	4	14	0.00000
Pseudoprevotella muciniphila	2133944	S	89	9	98	0.00001
Paraprevotella xylaniphila	454155	S	76	73	149	0.00001
Parabacteroides goldsteinii	328812	S	155	42	197	0.00001
Parabacteroides merdae	46503	S	110	131	241	0.00002
Parabacteroides johnsonii	387661	S	75	65	140	0.00001
Parabacteroides distasonis	823	S	50	209	259	0.00002
Tannerella serpentiformis	712710	S	224	14	238	0.00002
Tannerella forsythia	28112	S	122	7	129	0.00001
Sodaliphilus pleomorphus	2606626	S	219	118	337	0.00002
Duncaniella dubosii	2518971	S	62	14	76	0.00001
Muribaculum intestinale	1796646	S	90	9	99	0.00001
Muribaculum gordoncarteri	2530390	S	87	10	97	0.00001
Porphyromonas sp. oral taxon 275	712435	S	200	21	221	0.00002
Porphyromonas gingivalis	837	S	99	19	118	0.00001
Porphyromonas asaccharolytica	28123	S	63	7	70	0.00001
Porphyromonas cangingivalis	36874	S	44	9	53	0.00000
Porphyromonas somerae	322095	S	34	10	44	0.00000
Porphyromonas endodontalis	28124	S	31	3	34	0.00000
Porphyromonas crevioricanis	393921	S	25	6	31	0.00000
Proteiniphilum saccharofermentans	1642647	S	96	7	103	0.00001
Proteiniphilum sp. JNU-WLY501	2829812	S	61	1	62	0.00000
Petrimonas mucosa	1642646	S	122	7	129	0.00001
Dysgonomonas sp. HDW5A	2714926	S	20	24	44	0.00000
Dysgonomonas sp. HDW5B	2714927	S	15	17	32	0.00000
Barnesiella viscericola	397865	S	153	216	369	0.00003
Coprobacter secundus	1501392	S	33	32	65	0.00000
Butyricimonas virosa	544645	S	48	10	58	0.00000
Butyricimonas faecalis	2093856	S	39	43	82	0.00001
Odoribacter splanchnicus	28118	S	77	12	89	0.00001
Paludibacter propionicigenes	185300	S	82	2	84	0.00001
Tenuifilum thalassicum	2590900	S	55	1	56	0.00000
Salinivirga cyanobacteriivorans	1307839	S	48	1	49	0.00000
Draconibacterium orientale	1168034	S	122	10	132	0.00001
Draconibacterium halophilum	2706887	S	94	7	101	0.00001
Maribellus comscasis	2681766	S	105	2	107	0.00001
Alkalitalea saponilacus	889453	S	82	7	89	0.00001
Labilibaculum antarcticum	1717717	S	61	4	65	0.00000
Rhodocaloribacter litoris	2558931	S	2361	206	2567	0.00018
Rhodothermus marinus	29549	S	2279	110	2389	0.00017
Salinibacter ruber	146919	S	1380	19	1399	0.00010
Haliscomenobacter hydrossis	2350	S	389	6	395	0.00003
Saprospira grandis	1008	S	82	3	85	0.00001
Candidatus Sulfidibacterium hydrothermale	2875962	S	160	6	166	0.00001
Chlorobaculum limnaeum	274537	S	551	90	641	0.00005
Chlorobaculum parvum	274539	S	346	67	413	0.00003
Chlorobaculum tepidum	1097	S	265	73	338	0.00002
Pelodictyon luteolum	1100	S	238	34	272	0.00002
Pelodictyon phaeoclathratiforme	34090	S	64	3	67	0.00000
Chlorobium limicola	1092	S	125	11	136	0.00001
Chlorobium phaeobacteroides	1096	S	78	11	89	0.00001
Chlorobium phaeovibrioides	1094	S	53	9	62	0.00000
Prosthecochloris sp. GSB1	281093	S	236	14	250	0.00002
Prosthecochloris sp. HL-130-GSB	1974213	S	101	16	117	0.00001
Prosthecochloris sp. CIB 2401	1868325	S	90	21	111	0.00001
Prosthecochloris aestuarii	1102	S	70	5	75	0.00001
Chloroherpeton thalassium	100716	S	102	1	103	0.00001
Candidatus Cyclonatronum proteinivorum	1457365	S	197	20	217	0.00002
Melioribacter roseus	1134405	S	90	5	95	0.00001
Ignavibacterium album	591197	S	57	4	61	0.00000
Gemmatirosa kalamazoonesis	861299	S	40740	3282	44022	0.00314
Gemmatimonas groenlandica	2732249	S	5883	663	6546	0.00047
Gemmatimonas aurantiaca	173480	S	4479	451	4930	0.00035
Gemmatimonas phototrophica	1379270	S	3606	497	4103	0.00029
Fibrobacter succinogenes	833	S	123	1	124	0.00001
Candidatus Cloacimonas acidaminovorans	456827	S	26	0	26	0.00000
Luteitalea pratensis	1855912	S	41584	3523	45107	0.00322
Luteitalea sp. TBR-22	2802971	S	36037	4754	40791	0.00291
Granulicella sp. WH15	2602070	S	1554	268	1822	0.00013
Granulicella sp. 5B5	1617967	S	1248	193	1441	0.00010
Granulicella mallensis	940614	S	1131	129	1260	0.00009
Granulicella tundricola	940615	S	958	121	1079	0.00008
Terriglobus roseus	392734	S	1453	287	1740	0.00012
Terriglobus albidus	1592106	S	1182	106	1288	0.00009
Terriglobus saanensis	870903	S	800	101	901	0.00006
Edaphobacter sp. 12200R-103	2703788	S	1846	279	2125	0.00015
Edaphobacter sp. 4G125	2763071	S	652	83	735	0.00005
Acidobacterium capsulatum	33075	S	1286	150	1436	0.00010
Acidobacterium sp. 4Y35	2763107	S	1117	75	1192	0.00009
Candidatus Koribacter versatilis	658062	S	1765	53	1818	0.00013
Acidisarcina polymorpha	2211140	S	875	60	935	0.00007
Paludibaculum fermentans	1473598	S	4668	122	4790	0.00034
Chloracidobacterium aggregatum	2851959	S	575	336	911	0.00007
Chloracidobacterium validum	2821543	S	536	7	543	0.00004
Chloracidobacterium sp. D	2821536	S	55	247	302	0.00002
Chloracidobacterium thermophilum	458033	S	32	132	164	0.00001
Sulfidibacter corallicola	2818388	S	1386	24	1410	0.00010
Thermotomaculum hydrothermale	981385	S	51	2	53	0.00000
Nitrospira moscoviensis	42253	S	1873	138	2011	0.00014
Nitrospira japonica	1325564	S	1133	115	1248	0.00009
Candidatus Nitrospira inopinata	1715989	S	889	65	954	0.00007
Nitrospira sp. KM1	1936990	S	760	61	821	0.00006
Leptospirillum ferrooxidans	180	S	57	1	58	0.00000
Leptospirillum ferriphilum	178606	S	25	48	73	0.00001
Leptospirillum sp. Group II 'CF-1'	1660083	S	24	47	71	0.00001
Dissulfurispira thermophila	2715679	S	50	3	53	0.00000
Thermodesulfovibrio yellowstonii	28262	S	35	0	35	0.00000
Treponema brennaborense	81028	S	116	30	146	0.00001
Treponema socranskii	53419	S	81	29	110	0.00001
Treponema sp. Marseille-Q4132	2766701	S	46	17	63	0.00000
Treponema sp. OMZ 838	1539298	S	16	12	28	0.00000
Treponema primitia	88058	S	61	2	63	0.00000
Treponema azotonutricium	150829	S	52	1	53	0.00000
Treponema caldarium	215591	S	50	3	53	0.00000
Treponema parvum	138851	S	41	1	42	0.00000
Treponema succinifaciens	167	S	35	20	55	0.00000
Treponema medium	58231	S	25	24	49	0.00000
Treponema vincentii	69710	S	23	18	41	0.00000
Treponema peruense	2787628	S	19	1	20	0.00000
Treponema phagedenis	162	S	19	6	25	0.00000
Treponema pedis	409322	S	13	2	15	0.00000
Treponema denticola	158	S	11	3	14	0.00000
Spirochaeta thermophila	154	S	331	6	337	0.00002
Spirochaeta africana	46355	S	125	4	129	0.00001
Salinispira pacifica	1307761	S	64	1	65	0.00000
Sediminispirochaeta smaragdinae	55206	S	50	1	51	0.00000
Oceanispirochaeta crateris	2518645	S	24	0	24	0.00000
Sphaerochaeta coccoides	273376	S	67	2	69	0.00000
Sphaerochaeta associata	1129264	S	60	7	67	0.00000
Sphaerochaeta globosa	1131703	S	44	5	49	0.00000
Sphaerochaeta pleomorpha	1131707	S	20	2	22	0.00000
Breznakiella homolactica	2798577	S	102	5	107	0.00001
Leptospira kmetyi	408139	S	68	0	68	0.00000
Leptospira biflexa	172	S	53	0	53	0.00000
Leptospira santarosai	28183	S	35	0	35	0.00000
Leptospira tipperaryensis	2564040	S	35	0	35	0.00000
Leptospira noguchii	28182	S	27	0	27	0.00000
Leptospira kobayashii	1917830	S	24	0	24	0.00000
Leptospira weilii	28184	S	20	0	20	0.00000
Leptospira borgpetersenii	174	S	17	0	17	0.00000
Leptospira mayottensis	1137606	S	13	0	13	0.00000
Leptospira interrogans	173	S	10	106	116	0.00001
Turneriella parva	29510	S	280	2	282	0.00002
Pyramidobacter piscolens	638849	S	333	13	346	0.00002
Fretibacterium fastidiosum	651822	S	300	3	303	0.00002
Aminomonas paucivorans	81412	S	234	15	249	0.00002
Cloacibacillus porcorum	1197717	S	226	35	261	0.00002
Jonquetella anthropi	428712	S	184	21	205	0.00001
Thermanaerovibrio acidaminovorans	81462	S	108	21	129	0.00001
Thermanaerovibrio velox	108007	S	65	6	71	0.00001
Aminobacterium colombiense	81468	S	40	1	41	0.00000
Acetomicrobium mobile	97477	S	36	0	36	0.00000
Thermovirga lienii	336261	S	28	18	46	0.00000
Candidatus Nanosynbacter featherlites	2572088	S	73	28	101	0.00001
Candidatus Nanosynbacter lyticus	2093824	S	49	116	165	0.00001
Nanosynbacter sp. HMT-352	2899133	S	38	95	133	0.00001
Candidatus Nanosynbacter sp. HMT352	2902423	S	17	54	71	0.00001
Candidatus Saccharimonas aalborgensis	1332188	S	216	2	218	0.00002
Candidatus Bipolaricaulis anaerobius	2026885	S	261	8	269	0.00002
Candidatus Babela massiliensis	673862	S	54	0	54	0.00000
Candidatus Chazhemtobacterium aquaticus	2715735	S	41	0	41	0.00000
Candidatus Absconditicoccus praedator	2735562	S	24	0	24	0.00000
Thermotoga caldifontis	1508419	S	58	81	139	0.00001
Pseudothermotoga hypogea	57487	S	37	12	49	0.00000
Mesotoga prima	1184387	S	29	4	33	0.00000
Mesotoga infera	1236046	S	29	3	32	0.00000
Kosmotoga olearia	651457	S	11	4	15	0.00000
Defluviitoga tunisiensis	1006576	S	10	12	22	0.00000
Athalassotoga saccharophila	1441386	S	34	1	35	0.00000
Thermocrinis minervae	381751	S	25	8	33	0.00000
Thermocrinis albus	136094	S	11	3	14	0.00000
Hydrogenobacter sp. T-8	1632019	S	16	10	26	0.00000
Hydrogenobacter thermophilus	940	S	10	8	18	0.00000
Aquifex aeolicus	63363	S	20	3	23	0.00000
Persephonella marina	309805	S	39	3	42	0.00000
Sulfurihydrogenibium azorense	309806	S	32	5	37	0.00000
Thermosulfidibacter takaii	412593	S	51	2	53	0.00000
Thermovibrio ammonificans	228745	S	33	4	37	0.00000
Desulfurobacterium thermolithotrophum	64160	S	12	1	13	0.00000
Fusobacterium nucleatum	851	S	17	43	60	0.00000
Fusobacterium pseudoperiodonticum	2663009	S	14	26	40	0.00000
Fusobacterium necrophorum	859	S	11	3	14	0.00000
Ilyobacter polytropus	167642	S	10	0	10	0.00000
Leptotrichia trevisanii	109328	S	17	23	40	0.00000
Sebaldella termitidis	826	S	13	1	14	0.00000
Thermosulfurimonas marina	2047767	S	102	11	113	0.00001
Thermodesulfatator indicus	171695	S	44	5	49	0.00000
Thermosulfuriphilus ammonigenes	1936021	S	39	1	40	0.00000
Geovibrio thiophilus	139438	S	57	16	73	0.00001
Flexistipes sinusarabici	2352	S	38	6	44	0.00000
Denitrovibrio acetiphilus	118000	S	25	5	30	0.00000
Calditerrivibrio nitroreducens	477976	S	19	3	22	0.00000
Mucispirillum schaedleri	248039	S	18	2	20	0.00000
Deferribacter desulfuricans	197162	S	12	3	15	0.00000
Desulfurispirillum indicum	936456	S	196	73	269	0.00002
Caldithrix abyssi	187145	S	196	1	197	0.00001
Endomicrobium proavitum	1408281	S	29	9	38	0.00000
Candidatus Endomicrobium trichonymphae	1408204	S	21	6	27	0.00000
Elusimicrobium minutum	423605	S	64	0	64	0.00000
Caldisericum exile	693075	S	68	0	68	0.00000
Coprothermobacter proteolyticus	35786	S	34	5	39	0.00000
Atribacter laminatus	2847778	S	24	0	24	0.00000
Fusarium equiseti	61235	S	10983	1044	12027	0.00086
Fusarium scirpi	2211609	S	3755	307	4062	0.00029
Fusarium acuminatum	5515	S	5503	300	5803	0.00041
Fusarium avenaceum	40199	S	135	5	140	0.00001
Fusarium oxysporum	5507	S	5050	1814	6864	0.00049
Fusarium longipes	694270	S	790	29	819	0.00006
Fusarium poae	36050	S	465	126	591	0.00004
Fusarium sporotrichioides	5514	S	446	36	482	0.00003
Fusarium pseudograminearum	101028	S	249	93	342	0.00002
Fusarium sambucinum	5128	S	175	71	246	0.00002
Fusarium venenatum	56646	S	171	253	424	0.00003
Fusarium culmorum	5516	S	114	102	216	0.00002
Fusarium graminearum	5518	S	96	483	579	0.00004
Fusarium nygamai	42673	S	413	142	555	0.00004
Fusarium fujikuroi	5127	S	176	19	195	0.00001
Fusarium thapsinum	120644	S	120	30	150	0.00001
Fusarium pseudonygamai	47755	S	108	29	137	0.00001
Fusarium verticillioides	117187	S	62	103	165	0.00001
Fusarium nelsonii	77846	S	333	73	406	0.00003
Fusarium chlamydosporum	86545	S	161	35	196	0.00001
Fusarium decemcellulare	57161	S	575	10	585	0.00004
Fusarium dimerum	57145	S	373	9	382	0.00003
Fusarium lateritium	5523	S	300	7	307	0.00002
Fusarium heterosporum	42747	S	118	26	144	0.00001
Fusarium graminum	86546	S	112	26	138	0.00001
Fusarium musae	1042133	S	51	81	132	0.00001
Pochonia chlamydosporia	280754	S	7377	245	7622	0.00054
Metarhizium robertsii	568076	S	1029	537	1566	0.00011
Metarhizium guizhouense	169041	S	709	272	981	0.00007
Metarhizium album	92629	S	607	14	621	0.00004
Metarhizium rileyi	1649241	S	361	61	422	0.00003
Metarhizium humberi	2596975	S	337	152	489	0.00003
Metarhizium anisopliae	5530	S	269	303	572	0.00004
Metarhizium acridum	92637	S	198	99	297	0.00002
Metarhizium majus	1650735	S	171	55	226	0.00002
Metarhizium brunneum	500148	S	170	104	274	0.00002
Ustilaginoidea virens	1159556	S	702	27	729	0.00005
Trichoderma afroharzianum	1567482	S	1549	262	1811	0.00013
Trichoderma reesei	51453	S	331	23	354	0.00003
Trichoderma citrinoviride	58853	S	289	24	313	0.00002
Trichoderma hamatum	49224	S	221	13	234	0.00002
Trichoderma pleuroti	500994	S	220	18	238	0.00002
Trichoderma harzianum	5544	S	192	32	224	0.00002
Trichoderma atroviride	63577	S	178	34	212	0.00002
Trichoderma erinaceum	202914	S	165	19	184	0.00001
Trichoderma gamsii	398673	S	152	16	168	0.00001
Trichoderma asperellum	101201	S	151	8	159	0.00001
Trichoderma koningiopsis	337941	S	128	15	143	0.00001
Trichoderma longibrachiatum	5548	S	49	405	454	0.00003
Trichoderma virens	29875	S	36	302	338	0.00002
Trichoderma viride	5547	S	15	165	180	0.00001
Trichoderma koningii	97093	S	13	103	116	0.00001
Purpureocillium lilacinum	33203	S	2246	111	2357	0.00017
Drechmeria coniospora	98403	S	750	26	776	0.00006
Beauveria felina	37994	S	615	24	639	0.00005
Beauveria brongniartii	118266	S	245	69	314	0.00002
Beauveria pseudobassiana	931006	S	201	33	234	0.00002
Beauveria bassiana	176275	S	122	183	305	0.00002
Beauveria rudraprayagi	1481906	S	113	160	273	0.00002
Cordyceps fumosorosea	114497	S	699	53	752	0.00005
Clonostachys rosea	29856	S	538	29	567	0.00004
Colletotrichum higginsianum	80884	S	945	188	1133	0.00008
Thermothelomyces thermophilus	78579	S	6616	445	7061	0.00050
Thermothielavioides terrestris	2587410	S	6002	553	6555	0.00047
Neurospora crassa	5141	S	2041	131	2172	0.00016
Pyricularia pennisetigena	1578925	S	371	66	437	0.00003
Pyricularia oryzae	318829	S	304	92	396	0.00003
Pyricularia grisea	148305	S	213	36	249	0.00002
Neopestalotiopsis rosae	1562205	S	115	278	393	0.00003
Neopestalotiopsis clavispora	289240	S	100	262	362	0.00003
Botrytis cinerea	40559	S	244	1	245	0.00002
Aspergillus puulaauensis	1220207	S	383	23	406	0.00003
Aspergillus luchuensis	1069201	S	180	20	200	0.00001
Aspergillus chevalieri	182096	S	170	27	197	0.00001
Aspergillus oryzae	5062	S	51	75	126	0.00001
Aspergillus flavus	5059	S	13	21	34	0.00000
Aspergillus fumigatus	746128	S	127	11	138	0.00001
Penicillium chrysogenum	5076	S	414	78	492	0.00004
Penicillium citrinum	5077	S	124	20	144	0.00001
Penicillium aurantiogriseum	36655	S	111	36	147	0.00001
Penicillium expansum	27334	S	96	34	130	0.00001
Penicillium italicum	40296	S	68	22	90	0.00001
Penicillium digitatum	36651	S	57	10	67	0.00000
Paecilomyces niveus	5093	S	177	8	185	0.00001
Paecilomyces variotii	264951	S	100	14	114	0.00001
Talaromyces rugulosus	121627	S	151	14	165	0.00001
Ampelomyces quisqualis	50730	S	497	62	559	0.00004
Paraphaeosphaeria minitans	565426	S	401	164	565	0.00004
Zymoseptoria tritici	1047171	S	202	5	207	0.00001
Cercospora beticola	122368	S	188	2	190	0.00001
Eremothecium gossypii	33169	S	78	90	168	0.00001
Saccharomyces eubayanus	1080349	S	34	3	37	0.00000
Saccharomyces paradoxus	27291	S	14	1	15	0.00000
Saccharomyces cerevisiae	4932	S	13	2	15	0.00000
Naumovozyma dairenensis	27289	S	32	2	34	0.00000
Naumovozyma castellii	27288	S	26	3	29	0.00000
Tetrapisispora blattae	1071379	S	32	3	35	0.00000
Tetrapisispora phaffii	113608	S	21	1	22	0.00000
Kluyveromyces marxianus	4911	S	26	5	31	0.00000
Kluyveromyces lactis	28985	S	15	2	17	0.00000
Kazachstania naganishii	588726	S	35	3	38	0.00000
Lachancea thermotolerans	381046	S	36	3	39	0.00000
Zygotorulaspora mrakii	42260	S	33	7	40	0.00000
Torulaspora globosa	48254	S	19	2	21	0.00000
[Candida] glabrata	5478	S	22	2	24	0.00000
Zygosaccharomyces rouxii	4956	S	17	1	18	0.00000
Brettanomyces nanus	13502	S	45	21	66	0.00000
Brettanomyces bruxellensis	5007	S	24	5	29	0.00000
Pichia kudriavzevii	4909	S	44	5	49	0.00000
Ogataea parapolymorpha	1005962	S	29	2	31	0.00000
Candida dubliniensis	42374	S	37	6	43	0.00000
Candida albicans	5476	S	31	5	36	0.00000
Candida orthopsilosis	273371	S	30	1	31	0.00000
Scheffersomyces stipitis	4924	S	20	1	21	0.00000
Sugiyamaella lignohabitans	796027	S	101	10	111	0.00001
Yarrowia lipolytica	4952	S	88	2	90	0.00001
Saccharomycodes ludwigii	36035	S	16	4	20	0.00000
Schizosaccharomyces pombe	4896	S	36	0	36	0.00000
Pseudozyma flocculosa	84751	S	867	8	875	0.00006
Ustilago maydis	5270	S	281	9	290	0.00002
Sporisorium graminicola	280036	S	260	44	304	0.00002
Malassezia restricta	76775	S	92	19	111	0.00001
Phlebiopsis gigantea	82310	S	264	9	273	0.00002
Rhizoctonia solani	456999	S	97	7	104	0.00001
Marasmius oreades	181124	S	108	10	118	0.00001
Cryptococcus neoformans	5207	S	60	6	66	0.00000
Cryptococcus gattii VGI	37769	S	23	25	48	0.00000
Phytophthora cinnamomi	4785	S	530	101	631	0.00005
Phytophthora fragariae	53985	S	418	68	486	0.00003
Phytophthora cryptogea	4786	S	368	34	402	0.00003
Phytophthora infestans	4787	S	255	440	695	0.00005
Phytophthora cactorum	29920	S	162	27	189	0.00001
Phytophthora boehmeriae	109152	S	140	20	160	0.00001
Phytophthora parasitica	4792	S	124	18	142	0.00001
Pythium aphanidermatum	65070	S	264	8	272	0.00002
