name	taxonomy_id	taxonomy_lvl	kraken_assigned_reads	added_reads	new_est_reads	fraction_total_reads
Bradyrhizobium	374	G	128978	19436	148414	0.03216
Rhodopseudomonas	1073	G	9397	2770	12167	0.00264
Tardiphaga	1395974	G	3176	432	3608	0.00078
Afipia	1033	G	2288	1105	3393	0.00074
Nitrobacter	911	G	2230	310	2540	0.00055
Variibacter	1649510	G	2226	203	2429	0.00053
Rhizobium	379	G	30130	7626	37756	0.00818
Agrobacterium	357	G	6214	2401	8615	0.00187
Neorhizobium	1525371	G	3591	992	4583	0.00099
Pseudorhizobium	1903858	G	1182	277	1459	0.00032
Sinorhizobium	28105	G	11520	8046	19566	0.00424
Ensifer	106591	G	7236	1611	8847	0.00192
Shinella	323620	G	5359	4447	9806	0.00212
Ciceribacter	1648508	G	836	196	1032	0.00022
Georhizobium	2661800	G	829	217	1046	0.00023
Peteryoungia	2853332	G	286	59	345	0.00007
Liberibacter	34019	G	35	8	43	0.00001
Mesorhizobium	68287	G	52535	11589	64124	0.01389
Aquibium	2911176	G	4270	1249	5519	0.00120
Aminobacter	31988	G	2931	2163	5094	0.00110
Nitratireductor	245876	G	2890	526	3416	0.00074
Phyllobacterium	28100	G	1499	184	1683	0.00036
Roseitalea	1915401	G	1145	235	1380	0.00030
Oricola	1594166	G	911	151	1062	0.00023
Hoeflea	274591	G	902	102	1004	0.00022
Salaquimonas	2712688	G	397	21	418	0.00009
Lentilitoribacter	1649463	G	31	0	31	0.00001
Methylobacterium	407	G	29602	6293	35895	0.00778
Microvirga	186650	G	14146	2073	16219	0.00351
Methylorubrum	2282523	G	5925	2875	8800	0.00191
Pseudolabrys	556257	G	8632	1628	10260	0.00222
Starkeya	152053	G	4585	1449	6034	0.00131
Xanthobacter	279	G	4502	1205	5707	0.00124
Ancylobacter	99	G	4091	1645	5736	0.00124
Labrys	204476	G	1491	190	1681	0.00036
Azorhizobium	6	G	1388	360	1748	0.00038
Rhodoplanes	29407	G	10736	1307	12043	0.00261
Hyphomicrobium	81	G	5129	424	5553	0.00120
Methyloceanibacter	1484898	G	2092	164	2256	0.00049
Methyloligella	1485594	G	1282	185	1467	0.00032
Aquabacter	45402	G	1116	233	1349	0.00029
Rhodomicrobium	1068	G	1005	81	1086	0.00024
Caenibius	2827482	G	693	322	1015	0.00022
Filomicrobium	119044	G	514	16	530	0.00012
Devosia	46913	G	11442	1084	12526	0.00271
Youhaiella	1827478	G	1367	341	1708	0.00037
Paradevosia	1573407	G	1284	549	1833	0.00040
Pelagibacterium	1082930	G	582	77	659	0.00014
Maritalea	623276	G	118	4	122	0.00003
Bosea	85413	G	12842	2464	15306	0.00332
Aureimonas	414371	G	6374	1602	7976	0.00173
Martelella	293088	G	3102	645	3747	0.00081
Aurantimonas	182269	G	1865	684	2549	0.00055
Nordella	169055	G	3528	241	3769	0.00082
Pseudorhodoplanes	1734920	G	3356	309	3665	0.00079
Terrihabitans	2874214	G	1783	248	2031	0.00044
Candidatus Hodgkinia	573657	G	17	0	17	0.00000
Methylocystis	133	G	5107	534	5641	0.00122
Methylosinus	425	G	2404	424	2828	0.00061
Stappia	152161	G	2818	647	3465	0.00075
Roseibium	150830	G	1298	191	1489	0.00032
Pannonibacter	227873	G	1146	969	2115	0.00046
Labrenzia	478070	G	1053	104	1157	0.00025
Pseudovibrio	258255	G	240	14	254	0.00006
Phreatobacter	1632780	G	6178	1331	7509	0.00163
Kaustia	2838250	G	2694	323	3017	0.00065
Parvibaculum	256616	G	1185	994	2179	0.00047
Pyruvatibacter	1742974	G	834	124	958	0.00021
Candidatus Phaeomarinobacter	1541445	G	339	20	359	0.00008
Chelatococcus	28209	G	4339	1233	5572	0.00121
Blastochloris	59282	G	3637	1068	4705	0.00102
Methylocella	120652	G	1664	182	1846	0.00040
Methylovirgula	1156568	G	1456	146	1602	0.00035
Beijerinckia	532	G	408	36	444	0.00010
Acuticoccus	1904377	G	2231	295	2526	0.00055
Kaistia	166953	G	2176	670	2846	0.00062
Brucella	234	G	1925	2094	4019	0.00087
Pseudochrobactrum	354349	G	186	41	227	0.00005
Hartmannibacter	1572860	G	1375	307	1682	0.00036
Breoghania	1406135	G	1338	218	1556	0.00034
Lichenihabitans	2723776	G	1186	68	1254	0.00027
Cohaesibacter	655352	G	243	11	254	0.00006
Bartonella	773	G	235	17	252	0.00005
Sphingomonas	13687	G	129413	17638	147051	0.03186
Sphingobium	165695	G	16912	9221	26133	0.00566
Sphingopyxis	165697	G	16248	3842	20090	0.00435
Novosphingobium	165696	G	11430	4567	15997	0.00347
Rhizorhabdus	1649486	G	6234	3433	9667	0.00209
Allosphingosinicella	2823232	G	3098	438	3536	0.00077
Sphingosinithalassobacter	2676233	G	2333	623	2956	0.00064
Parasphingopyxis	1234545	G	1579	89	1668	0.00036
Sphingorhabdus	1434046	G	1366	99	1465	0.00032
Blastomonas	150203	G	1220	245	1465	0.00032
Hankyongella	1763827	G	1073	237	1310	0.00028
Tardibacter	2685927	G	843	757	1600	0.00035
Citromicrobium	72173	G	697	358	1055	0.00023
Novosphingopyxis	2709686	G	650	405	1055	0.00023
Parasphingorhabdus	2709685	G	441	15	456	0.00010
Aquisediminimonas	2676781	G	368	16	384	0.00008
Erythrobacter	1041	G	7599	2165	9764	0.00212
Porphyrobacter	1111	G	2263	715	2978	0.00065
Qipengyuania	1855416	G	4896	1452	6348	0.00138
Tsuneonella	2800686	G	2974	666	3640	0.00079
Altererythrobacter	361177	G	2824	849	3673	0.00080
Croceicoccus	1295327	G	2542	1683	4225	0.00092
Pelagerythrobacter	2800685	G	569	88	657	0.00014
Aurantiacibacter	2800681	G	554	99	653	0.00014
Paraurantiacibacter	2800682	G	517	75	592	0.00013
Croceibacterium	2676755	G	458	212	670	0.00015
Sphingosinicella	335405	G	5468	659	6127	0.00133
Polymorphobacter	1508451	G	1943	85	2028	0.00044
Sandaracinobacter	56358	G	868	69	937	0.00020
Zymomonas	541	G	71	44	115	0.00003
Azospirillum	191	G	23002	3315	26317	0.00570
Skermanella	204447	G	8391	1317	9708	0.00210
Nitrospirillum	1543705	G	1728	238	1966	0.00043
Indioceanicola	2478349	G	1545	253	1798	0.00039
Niveispirillum	1543704	G	743	94	837	0.00018
Roseomonas	125216	G	12446	1942	14388	0.00312
Rhodovastum	504465	G	2291	249	2540	0.00055
Komagataeibacter	1434011	G	1789	874	2663	0.00058
Roseococcus	35812	G	1632	161	1793	0.00039
Acidiphilium	522	G	1592	943	2535	0.00055
Sediminicoccus	1706033	G	1224	66	1290	0.00028
Acidibrevibacterium	2603324	G	1111	111	1222	0.00026
Lichenicola	2804525	G	1020	53	1073	0.00023
Acetobacter	434	G	981	337	1318	0.00029
Gluconacetobacter	89583	G	730	157	887	0.00019
Gluconobacter	441	G	710	184	894	0.00019
Granulibacter	364409	G	439	40	479	0.00010
Asaia	91914	G	331	59	390	0.00008
Neoasaia	320496	G	306	63	369	0.00008
Kozakia	153497	G	199	71	270	0.00006
Novacetimonas	2919364	G	174	82	256	0.00006
Oecophyllibacter	2791118	G	173	6	179	0.00004
Parasaccharibacter	1602345	G	77	4	81	0.00002
Swingsia	1649499	G	52	1	53	0.00001
Neokomagataea	1223423	G	28	4	32	0.00001
Entomobacter	2811380	G	17	1	18	0.00000
Commensalibacter	1079922	G	15	0	15	0.00000
Hypericibacter	2705399	G	11133	756	11889	0.00258
Magnetospirillum	13134	G	4868	101300	106168	0.02300
Rhodospirillum	1081	G	2990	398	3388	0.00073
Ferrovibrio	1231242	G	2288	165	2453	0.00053
Tistrella	171436	G	1935	1027	2962	0.00064
Defluviicoccus	111830	G	983	99	1082	0.00023
Pararhodospirillum	1612157	G	608	51	659	0.00014
Haematospirillum	1804663	G	107	10	117	0.00003
Candidatus Endolissoclinum	1263978	G	44	0	44	0.00001
Stella	93	G	5025	397	5422	0.00117
Elioraea	457933	G	1983	112	2095	0.00045
Thalassospira	168934	G	718	71	789	0.00017
Magnetospira	1182780	G	432	16	448	0.00010
Terasakiella	196080	G	59	1	60	0.00001
Paracoccus	265	G	11136	2123	13259	0.00287
Cereibacter	1653176	G	2890	809	3699	0.00080
Rhodobacter	1060	G	2734	978	3712	0.00080
Rhodovulum	34008	G	1565	412	1977	0.00043
Paroceanicella	2683599	G	1417	431	1848	0.00040
Polymorphum	991903	G	1407	397	1804	0.00039
Pikeienuella	2831955	G	1035	113	1148	0.00025
Pontivivens	1844015	G	876	77	953	0.00021
Thioclava	285107	G	845	125	970	0.00021
Silicimonas	1955420	G	802	56	858	0.00019
Pelagovum	2795377	G	753	109	862	0.00019
Frigidibacter	1775705	G	620	306	926	0.00020
Pukyongiella	2831925	G	529	148	677	0.00015
Brevirhabdus	1855413	G	518	283	801	0.00017
Haematobacter	366614	G	453	209	662	0.00014
Gymnodinialimonas	2937410	G	452	50	502	0.00011
Fuscovulum	2818469	G	411	61	472	0.00010
Falsirhodobacter	1434002	G	403	67	470	0.00010
Pacificitalea	2846749	G	364	93	457	0.00010
Pseudopuniceibacterium	2613960	G	357	32	389	0.00008
Tabrizicola	1443919	G	356	38	394	0.00009
Gemmobacter	204456	G	352	84	436	0.00009
Pseudooceanicola	1679449	G	330	38	368	0.00008
Monaibacterium	2029873	G	324	88	412	0.00009
Roseicitreum	1209946	G	285	17	302	0.00007
Tritonibacter	2083206	G	236	124	360	0.00008
Rhodophyticola	2680018	G	207	7	214	0.00005
Yoonia	2211641	G	193	51	244	0.00005
Qingshengfaniella	2816884	G	180	11	191	0.00004
Rhodobaca	119541	G	179	9	188	0.00004
Pseudohalocynthiibacter	1759417	G	174	40	214	0.00005
Profundibacter	2778525	G	147	6	153	0.00003
Pseudorhodobacter	238783	G	124	9	133	0.00003
Cognatishimia	2211635	G	104	5	109	0.00002
Parasedimentitalea	2738399	G	103	5	108	0.00002
Aestuarium	2820509	G	95	45	140	0.00003
Planktomarina	1284657	G	51	1	52	0.00001
Roseovarius	74030	G	3056	526	3582	0.00078
Sulfitobacter	60136	G	2755	607	3362	0.00073
Salipiger	263377	G	2149	789	2938	0.00064
Roseivivax	93682	G	1852	285	2137	0.00046
Celeribacter	875170	G	1218	533	1751	0.00038
Phaeobacter	302485	G	1052	235	1287	0.00028
Leisingera	191028	G	1018	167	1185	0.00026
Ruegeria	97050	G	902	158	1060	0.00023
Sagittula	58842	G	768	359	1127	0.00024
Pseudosulfitobacter	2854186	G	761	237	998	0.00022
Yangia	2919626	G	755	145	900	0.00020
Ponticoccus	983507	G	534	91	625	0.00014
Dinoroseobacter	309512	G	509	209	718	0.00016
Mameliella	1434019	G	488	102	590	0.00013
Roseobacter	2433	G	485	14	499	0.00011
Ketogulonicigenium	92944	G	417	46	463	0.00010
Octadecabacter	53945	G	405	32	437	0.00009
Roseibacterium	159345	G	391	37	428	0.00009
Actibacterium	1433986	G	376	207	583	0.00013
Oceanicola	252301	G	375	22	397	0.00009
Tateyamaria	299261	G	297	11	308	0.00007
Antarctobacter	74032	G	280	16	296	0.00006
Thalassococcus	436357	G	264	7	271	0.00006
Maribius	387095	G	253	15	268	0.00006
Jannaschia	188905	G	228	7	235	0.00005
Thalassobius	335927	G	166	10	176	0.00004
Falsihalocynthiibacter	2854182	G	59	2	61	0.00001
Caulobacter	75	G	15196	2111	17307	0.00375
Brevundimonas	41275	G	12442	2027	14469	0.00313
Phenylobacterium	20	G	8288	1638	9926	0.00215
Terricaulis	2768684	G	3016	117	3133	0.00068
Asticcacaulis	76890	G	1038	92	1130	0.00024
Candidatus Viadribacter	2892997	G	1695	50	1745	0.00038
Hyphomonas	85	G	1193	61	1254	0.00027
Hirschia	2723	G	16	0	16	0.00000
Marinicauda	1649466	G	1136	212	1348	0.00029
Glycocaulis	1433402	G	393	22	415	0.00009
Maricaulis	74317	G	378	26	404	0.00009
Hyphobacterium	2004661	G	265	12	277	0.00006
Aquisalinus	1795639	G	485	27	512	0.00011
Parvularcula	208215	G	166	22	188	0.00004
Micavibrio	213485	G	313	4	317	0.00007
Candidatus Puniceispirillum	767891	G	43	1	44	0.00001
Rickettsia	780	G	111	11	122	0.00003
Orientia	69474	G	14	1	15	0.00000
Candidatus Phycorickettsia	2115980	G	24	1	25	0.00001
Anaplasma	768	G	67	8	75	0.00002
Wolbachia	953	G	43	2	45	0.00001
Ehrlichia	943	G	22	1	23	0.00001
Neorickettsia	33993	G	14	0	14	0.00000
Luteithermobacter	2813803	G	175	33	208	0.00005
Paremcibacter	2813804	G	163	5	168	0.00004
Candidatus Hydrogenosomobacter	2654634	G	21	12	33	0.00001
Candidatus Cytomitobacter	2601574	G	12	0	12	0.00000
Candidatus Paracaedibacter	1521255	G	29	4	33	0.00001
Candidatus Nucleicultrix	1509243	G	27	2	29	0.00001
Magnetococcus	162171	G	73	2	75	0.00002
Candidatus Pelagibacter	198251	G	31	0	31	0.00001
Candidatus Fonsibacter	2045213	G	17	1	18	0.00000
Kordiimonas	288021	G	38	0	38	0.00001
Burkholderia	32008	G	46450	29075	75525	0.01636
Cupriavidus	106589	G	29111	11625	40736	0.00883
Paraburkholderia	1822464	G	24849	3568	28417	0.00616
Ralstonia	48736	G	7863	10839	18702	0.00405
Pandoraea	93217	G	7842	1577	9419	0.00204
Caballeronia	1827195	G	7050	1148	8198	0.00178
Lautropia	47670	G	803	187	990	0.00021
Polynucleobacter	44013	G	679	22	701	0.00015
Mycetohabitans	2571159	G	517	44	561	0.00012
Chitinimonas	240411	G	511	53	564	0.00012
Mycoavidus	1810868	G	130	7	137	0.00003
Limnobacter	131079	G	84	5	89	0.00002
Candidatus Vallotia	2018044	G	73	10	83	0.00002
Ephemeroptericola	2680021	G	45	3	48	0.00001
Variovorax	34072	G	30095	12781	42876	0.00929
Hydrogenophaga	47420	G	14366	8335	22701	0.00492
Acidovorax	12916	G	10811	6781	17592	0.00381
Ramlibacter	174951	G	9083	4768	13851	0.00300
Comamonas	283	G	6322	3462	9784	0.00212
Schlegelella	215579	G	6022	2606	8628	0.00187
Rhodoferax	28065	G	5684	1678	7362	0.00160
Diaphorobacter	238749	G	3668	4651	8319	0.00180
Delftia	80865	G	3006	3950	6956	0.00151
Polaromonas	52972	G	2631	291	2922	0.00063
Kinneretia	683756	G	2276	1621	3897	0.00084
Ottowia	219181	G	2002	447	2449	0.00053
Alicycliphilus	201096	G	1863	3848	5711	0.00124
Melaminivora	1649468	G	1574	1750	3324	0.00072
Serpentinimonas	2490452	G	1161	342	1503	0.00033
Hylemonella	232523	G	805	149	954	0.00021
Verminephrobacter	364316	G	792	123	915	0.00020
Pulveribacter	2678886	G	690	452	1142	0.00025
Simplicispira	352450	G	512	236	748	0.00016
Limnohabitans	665874	G	355	43	398	0.00009
Candidatus Symbiobacter	1436289	G	272	12	284	0.00006
Curvibacter	281915	G	268	24	292	0.00006
Massilia	149698	G	25383	5460	30843	0.00668
Duganella	75654	G	2135	902	3037	0.00066
Herbaspirillum	963	G	4814	1148	5962	0.00129
Janthinobacterium	29580	G	4286	1095	5381	0.00117
Collimonas	202907	G	1925	279	2204	0.00048
Noviherbaspirillum	1344552	G	1379	304	1683	0.00036
Undibacterium	401469	G	246	19	265	0.00006
Herminiimonas	303379	G	111	21	132	0.00003
Glaciimonas	1229970	G	109	8	117	0.00003
Oxalobacter	846	G	72	8	80	0.00002
Bordetella	517	G	16130	12542	28672	0.00621
Achromobacter	222	G	14285	8001	22286	0.00483
Pigmentiphaga	152267	G	2446	364	2810	0.00061
Orrella	1921582	G	1181	474	1655	0.00036
Castellaniella	359336	G	1153	1004	2157	0.00047
Alcaligenes	507	G	589	190	779	0.00017
Pusillimonas (ex Stolz et al. 2005)	305976	G	574	136	710	0.00015
Kerstersia	257820	G	306	83	389	0.00008
Paralcaligenes	1148163	G	296	15	311	0.00007
Advenella	290425	G	254	9	263	0.00006
Oligella	90243	G	54	18	72	0.00002
Paenalcaligenes	1100891	G	23	1	24	0.00001
Basilea	1472344	G	13	1	14	0.00000
Rhizobacter	212743	G	5085	1523	6608	0.00143
Sphaerotilus	34102	G	3083	2051	5134	0.00111
Methylibium	316612	G	2718	1077	3795	0.00082
Rubrivivax	28067	G	2601	1101	3702	0.00080
Thiomonas	32012	G	2306	851	3157	0.00068
Aquincola	391952	G	1906	895	2801	0.00061
Leptothrix	88	G	1742	755	2497	0.00054
Mitsuaria	65047	G	1695	457	2152	0.00047
Xylophilus	54066	G	1339	542	1881	0.00041
Tepidimonas	114248	G	1162	570	1732	0.00038
Aquabacterium	92793	G	997	363	1360	0.00029
Ideonella	36862	G	957	793	1750	0.00038
Roseateles	93681	G	755	196	951	0.00021
Inhella	644355	G	545	119	664	0.00014
Paucibacter	318147	G	422	100	522	0.00011
Candidatus Ichthyocystis	2929841	G	15	0	15	0.00000
Sutterella	40544	G	812	91	903	0.00020
Turicimonas	1918598	G	60	5	65	0.00001
Thauera	33057	G	7447	5878	13325	0.00289
Azoarcus	12960	G	5768	2413	8181	0.00177
Nitrogeniibacter	2891294	G	1943	409	2352	0.00051
Aromatoleum	551759	G	6059	2267	8326	0.00180
Azospira	146937	G	4360	2611	6971	0.00151
Niveibacterium	1769726	G	1044	194	1238	0.00027
Oryzomicrobium	1911577	G	803	269	1072	0.00023
Rugosibacter	1914449	G	187	43	230	0.00005
Dechloromonas	73029	G	1597	332	1929	0.00042
Ferribacterium	88875	G	1297	262	1559	0.00034
Quatrionicoccus	138117	G	615	216	831	0.00018
Fluviibacter	2808942	G	114	47	161	0.00004
Usitatibacter	2803845	G	11480	1174	12654	0.00274
Denitratisoma	311181	G	1646	1136	2782	0.00060
Sulfuritalea	1054211	G	1369	283	1652	0.00036
Methyloversatilis	378210	G	1090	199	1289	0.00028
Sterolibacterium	157591	G	846	312	1158	0.00025
Thiobacillus	919	G	1616	416	2032	0.00044
Sulfuritortus	1938335	G	1171	681	1852	0.00040
Sideroxydans	314343	G	1175	201	1376	0.00030
Ferrigenium	2249462	G	841	220	1061	0.00023
Ferriphaselus	1443590	G	239	40	279	0.00006
Candidatus Nitrotoga	453161	G	193	12	205	0.00004
Gallionella	96	G	157	17	174	0.00004
Nitrosospira	35798	G	1596	60	1656	0.00036
Nitrosomonas	914	G	889	89	978	0.00021
Sulfurimicrobium	2772198	G	880	147	1027	0.00022
Sulfuriferula	1778653	G	785	172	957	0.00021
Sulfuricella	935200	G	410	47	457	0.00010
Methylovorus	81682	G	237	20	257	0.00006
Methylobacillus	404	G	212	68	280	0.00006
Methylophilus	16	G	100	8	108	0.00002
Methylotenera	359407	G	53	5	58	0.00001
Candidatus Methylopumilus	1679002	G	50	3	53	0.00001
Methyloradius	2872156	G	40	4	44	0.00001
Chromobacterium	535	G	4349	1193	5542	0.00120
Iodobacter	32014	G	89	31	120	0.00003
Jeongeupia	885864	G	1463	359	1822	0.00039
Paludibacterium	400060	G	1146	252	1398	0.00030
Pseudogulbenkiania	568394	G	818	356	1174	0.00025
Vogesella	57739	G	801	253	1054	0.00023
Microvirgula	57479	G	616	153	769	0.00017
Aquitalea	407217	G	556	126	682	0.00015
Laribacter	168470	G	455	516	971	0.00021
Aquaspirillum	187	G	244	47	291	0.00006
Chitinibacter	230666	G	110	62	172	0.00004
Deefgea	400947	G	89	14	103	0.00002
Neisseria	482	G	1691	629	2320	0.00050
Crenobacter	1654931	G	1085	471	1556	0.00034
Chitinolyticbacter	1055692	G	730	120	850	0.00018
Vitreoscilla	59	G	303	73	376	0.00008
Kingella	32257	G	239	92	331	0.00007
Eikenella	538	G	195	69	264	0.00006
Uruburuella	299568	G	178	34	212	0.00005
Paralysiella	2898489	G	70	20	90	0.00002
Alysiella	194195	G	36	7	43	0.00001
Conchiformibius	334107	G	33	39	72	0.00002
Aquella	2593687	G	18	1	19	0.00000
Snodgrassella	1193515	G	17	6	23	0.00001
Simonsiella	71	G	14	3	17	0.00000
Casimicrobium	2706000	G	854	518	1372	0.00030
Candidatus Kinetoplastibacterium	33055	G	14	2	16	0.00000
Lysobacter	68	G	47631	8761	56392	0.01222
Stenotrophomonas	40323	G	12799	6406	19205	0.00416
Xanthomonas	338	G	12461	16708	29169	0.00632
Luteimonas	83614	G	10521	2459	12980	0.00281
Pseudoxanthomonas	83618	G	7263	3699	10962	0.00238
Thermomonas	141948	G	4849	1537	6386	0.00138
Arenimonas	490567	G	1465	343	1808	0.00039
Pseudolysobacter	2709666	G	725	23	748	0.00016
Xylella	2370	G	193	33	226	0.00005
Luteibacter	242605	G	4756	643	5399	0.00117
Rhodanobacter	75309	G	3932	1045	4977	0.00108
Dyella	231454	G	3453	698	4151	0.00090
Frateuria	70411	G	2471	787	3258	0.00071
Dokdonella	323413	G	1948	409	2357	0.00051
Aerosticca	2707020	G	987	1586	2573	0.00056
Ahniella	2233801	G	544	17	561	0.00012
Pseudomonas	286	G	83914	27836	111750	0.02421
Azotobacter	352	G	1759	428	2187	0.00047
Halopseudomonas	2901189	G	1091	264	1355	0.00029
Permianibacter	1649479	G	291	10	301	0.00007
Thiopseudomonas	1654787	G	20	5	25	0.00001
Entomomonas	2758906	G	15	0	15	0.00000
Marinobacter	2742	G	2314	245	2559	0.00055
Klebsiella	570	G	1934	15315	17249	0.00374
Raoultella	160674	G	490	342	832	0.00018
Enterobacter	547	G	2422	5460	7882	0.00171
Citrobacter	544	G	1108	2739	3847	0.00083
Cronobacter	413496	G	682	192	874	0.00019
Kosakonia	1330547	G	615	133	748	0.00016
Leclercia	83654	G	511	307	818	0.00018
Pluralibacter	1330546	G	457	140	597	0.00013
Salmonella	590	G	456	14519	14975	0.00324
Cedecea	158483	G	363	61	424	0.00009
Escherichia	561	G	356	11561	11917	0.00258
Lelliottia	1330545	G	235	65	300	0.00007
Kluyvera	579	G	153	54	207	0.00004
Candidatus Symbiopectobacterium	801	G	53	7	60	0.00001
Candidatus Hamiltonella	568987	G	17	14	31	0.00001
Candidatus Blochmannia	203804	G	20	0	20	0.00000
Candidatus Doolittlea	1906657	G	15	1	16	0.00000
Candidatus Hoaglandella	1906659	G	10	5	15	0.00000
Jejubacter	2815296	G	91	12	103	0.00002
Plesiomonas	702	G	91	35	126	0.00003
Buttiauxella	82976	G	79	14	93	0.00002
Pseudescherichia	2055880	G	75	5	80	0.00002
Scandinavium	2726810	G	74	16	90	0.00002
Atlantibacter	1903434	G	73	18	91	0.00002
Shimwellia	1335483	G	66	15	81	0.00002
Yokenella	158876	G	63	32	95	0.00002
Phytobacter	447792	G	44	109	153	0.00003
Pseudocitrobacter	1504576	G	42	36	78	0.00002
Shigella	620	G	13	464	477	0.00010
Serratia	613	G	3286	1032	4318	0.00094
Yersinia	629	G	361	1142	1503	0.00033
Rahnella	34037	G	334	98	432	0.00009
Nissabacter	1964366	G	230	42	272	0.00006
Gibbsiella	929812	G	133	22	155	0.00003
Rouxiella	1565532	G	80	9	89	0.00002
Ewingella	41201	G	69	12	81	0.00002
Chania	1745211	G	23	3	26	0.00001
Candidatus Fukatsuia	1927833	G	17	1	18	0.00000
Pantoea	53335	G	1980	440	2420	0.00052
Erwinia	551	G	842	174	1016	0.00022
Mixta	2100764	G	451	154	605	0.00013
Buchnera	32199	G	52	12	64	0.00001
Tatumella	82986	G	46	9	55	0.00001
Dickeya	204037	G	936	259	1195	0.00026
Pectobacterium	122277	G	600	140	740	0.00016
Brenneria	71655	G	438	38	476	0.00010
Lonsdalea	1082702	G	198	38	236	0.00005
Musicola	2884243	G	98	0	98	0.00002
Edwardsiella	635	G	556	154	710	0.00015
Hafnia	568	G	77	32	109	0.00002
Obesumbacterium	82982	G	16	12	28	0.00001
Morganella	581	G	193	159	352	0.00008
Providencia	586	G	124	78	202	0.00004
Photorhabdus	29487	G	94	9	103	0.00002
Xenorhabdus	626	G	93	15	108	0.00002
Proteus	583	G	58	77	135	0.00003
Arsenophonus	637	G	24	3	27	0.00001
Sodalis	84565	G	421	33	454	0.00010
Leminorella	82980	G	51	8	59	0.00001
Pragia	82984	G	20	3	23	0.00001
Jinshanibacter	2810357	G	14	1	15	0.00000
Limnobaculum	2172100	G	12	1	13	0.00000
Thioalkalivibrio	106633	G	4288	1027	5315	0.00115
Spiribacter	1335745	G	2651	234	2885	0.00063
Acidihalobacter	1765964	G	1797	183	1980	0.00043
Halorhodospira	85108	G	788	82	870	0.00019
Alkalilimnicola	133193	G	774	123	897	0.00019
Aquisalimonas	406099	G	732	64	796	0.00017
Ectothiorhodospira	1051	G	654	75	729	0.00016
Ectothiorhodosinus	233099	G	93	7	100	0.00002
Allochromatium	85072	G	1431	398	1829	0.00040
Thiodictyon	53392	G	1133	75	1208	0.00026
Thioflavicoccus	156885	G	1100	124	1224	0.00027
Marichromatium	85076	G	1069	257	1326	0.00029
Thiocapsa	1056	G	855	57	912	0.00020
Thiocystis	13724	G	656	69	725	0.00016
Thermochromatium	85073	G	434	129	563	0.00012
Caldichromatium	2828366	G	307	42	349	0.00008
Nitrosococcus	1227	G	301	10	311	0.00007
Rheinheimera	67575	G	77	21	98	0.00002
Candidatus Nitrosacidococcus	2796146	G	22	1	23	0.00001
Candidatus Nitrosoglobus	1980513	G	14	1	15	0.00000
Wenzhouxiangella	1676142	G	1211	75	1286	0.00028
Thiohalobacter	1273155	G	1015	152	1167	0.00025
Guyparkeria	2035712	G	785	231	1016	0.00022
Sulfurivermis	2034504	G	779	377	1156	0.00025
Halothiobacillus	109262	G	450	46	496	0.00011
Woeseia	1738655	G	447	9	456	0.00010
Sulfuriflexus	1860077	G	149	5	154	0.00003
Granulosicoccus	437504	G	121	2	123	0.00003
Halomonas	2745	G	10764	1873	12637	0.00274
Cobetia	204286	G	658	498	1156	0.00025
Halotalea	376488	G	601	146	747	0.00016
Salinicola	404432	G	521	71	592	0.00013
Kushneria	504090	G	494	28	522	0.00011
Chromohalobacter	42054	G	435	56	491	0.00011
Pistricoccus	1897649	G	289	23	312	0.00007
Zymobacter	33073	G	87	14	101	0.00002
Candidatus Portiera	235572	G	15	14	29	0.00001
Alcanivorax	59753	G	1433	820	2253	0.00049
Ketobacter	2025617	G	90	9	99	0.00002
Marinobacterium	48075	G	486	68	554	0.00012
Marinomonas	28253	G	140	17	157	0.00003
Thalassolituus	187492	G	92	12	104	0.00002
Venatorbacter	2893036	G	63	17	80	0.00002
Bacterioplanes	1537406	G	61	3	64	0.00001
Neptunomonas	75687	G	53	5	58	0.00001
Nitrincola	267849	G	37	8	45	0.00001
Amphritea	515417	G	30	2	32	0.00001
Bermanella	599651	G	15	0	15	0.00000
Hahella	158481	G	322	16	338	0.00007
Saccharospirillum	231683	G	171	12	183	0.00004
Reinekea	230494	G	73	4	77	0.00002
Gynuella	1445504	G	65	2	67	0.00001
Litoricola	418700	G	98	5	103	0.00002
Oleiphilus	141450	G	52	5	57	0.00001
Spartinivicinus	2768738	G	41	1	42	0.00001
Endozoicomonas	305899	G	35	2	37	0.00001
Solimonas	413435	G	3409	437	3846	0.00083
Flagellatimonas	2893022	G	853	76	929	0.00020
Sinimarinibacterium	1861863	G	426	299	725	0.00016
Steroidobacter	469322	G	3773	1366	5139	0.00111
Methylococcus	413	G	2694	234	2928	0.00063
Methylomonas	416	G	1451	57	1508	0.00033
Methylocaldum	73778	G	864	63	927	0.00020
Methylomicrobium	39773	G	736	140	876	0.00019
Methylomagnum	1760987	G	693	36	729	0.00016
Methylogaea	1295378	G	631	59	690	0.00015
Candidatus Methylospira	1808977	G	230	11	241	0.00005
Methylotuvimicrobium	2822410	G	147	85	232	0.00005
Methylovulum	762296	G	100	3	103	0.00002
Methylobacter	429	G	27	2	29	0.00001
Aeromonas	642	G	5497	7036	12533	0.00272
Zobellella	347533	G	493	128	621	0.00013
Oceanimonas	129577	G	189	44	233	0.00005
Oceanisphaera	225143	G	63	8	71	0.00002
Dongshaea	2802288	G	56	6	62	0.00001
Tolumonas	43947	G	36	19	55	0.00001
Succinivibrio	83770	G	18	1	19	0.00000
Sulfurifustis	1692042	G	3388	273	3661	0.00079
Sulfuricaulis	1744881	G	1370	134	1504	0.00033
Acidiferrobacter	986106	G	794	18	812	0.00018
Microbulbifer	48073	G	2040	135	2175	0.00047
Cellvibrio	10	G	1267	46	1313	0.00028
Simiduia	447467	G	135	8	143	0.00003
Teredinibacter	2425	G	122	6	128	0.00003
Saccharophagus	316625	G	31	1	32	0.00001
Marinagarivorans	1792291	G	26	2	28	0.00001
Agarilytica	2036021	G	11	0	11	0.00000
Kineobactrum	2678529	G	350	15	365	0.00008
Halioglobus	1217416	G	266	10	276	0.00006
Congregibacter	393661	G	180	80	260	0.00006
Aequoribacter	2847769	G	41	6	47	0.00001
Spongiibacter	630749	G	286	29	315	0.00007
Zhongshania	1434050	G	51	4	55	0.00001
Oceanicoccus	1084558	G	36	0	36	0.00001
Shewanella	22	G	1772	396	2168	0.00047
Alteromonas	226	G	239	50	289	0.00006
Salinimonas	288793	G	119	22	141	0.00003
Hydrocarboniclastica	2650549	G	206	35	241	0.00005
Saliniradius	2661818	G	57	6	63	0.00001
Lacimicrobium	1751872	G	52	4	56	0.00001
Agarivorans	261825	G	45	4	49	0.00001
Paraglaciecola	1621534	G	44	3	47	0.00001
Paraneptunicella	2905123	G	23	1	24	0.00001
Glaciecola	89404	G	21	1	22	0.00000
Catenovulum	1172191	G	18	1	19	0.00000
Saccharobesus	2894574	G	17	1	18	0.00000
Pseudoalteromonas	53246	G	464	85	549	0.00012
Psychrosphaera	907197	G	10	2	12	0.00000
Ferrimonas	44011	G	243	36	279	0.00006
Idiomarina	135575	G	88	11	99	0.00002
Colwellia	28228	G	40	5	45	0.00001
Thalassotalea	1518149	G	30	4	34	0.00001
Moritella	58050	G	42	10	52	0.00001
Psychromonas	67572	G	29	4	33	0.00001
Vibrio	662	G	1529	314	1843	0.00040
Photobacterium	657	G	229	56	285	0.00006
Salinivibrio	51366	G	58	8	66	0.00001
Grimontia	246861	G	42	6	48	0.00001
Thaumasiovibrio	2014233	G	13	2	15	0.00000
Immundisolibacter	1934947	G	1365	309	1674	0.00036
Candidatus Endoriftia	393764	G	362	21	383	0.00008
Candidatus Vesicomyosocius	2732587	G	19	14	33	0.00001
Sedimenticola	349742	G	223	11	234	0.00005
Candidatus Reidiella	2738850	G	183	4	187	0.00004
Thiolapillus	1608298	G	166	5	171	0.00004
Pseudohongiella	1524249	G	67	2	69	0.00002
Gallaecimonas	745410	G	42	4	46	0.00001
Ignatzschineria	112008	G	21	2	23	0.00001
Celerinatantimonas	412033	G	17	1	18	0.00000
Candidatus Thioglobus	655184	G	13	2	15	0.00000
Acinetobacter	469	G	690	381	1071	0.00023
Psychrobacter	497	G	157	8	165	0.00004
Moraxella	475	G	107	12	119	0.00003
Aquirhabdus	2824158	G	27	1	28	0.00001
Legionella	445	G	592	55	647	0.00014
Fluoribacter	461	G	13	1	14	0.00000
Tatlockia	465	G	11	0	11	0.00000
Aquicella	254245	G	187	3	190	0.00004
Coxiella	776	G	85	2	87	0.00002
Rickettsiella	59195	G	22	16	38	0.00001
Thiomicrorhabdus	2039723	G	93	5	98	0.00002
Methylophaga	40222	G	71	24	95	0.00002
Thiomicrospira	933	G	67	18	85	0.00002
Hydrogenovibrio	28884	G	52	24	76	0.00002
Thiosulfatimonas	2781121	G	25	1	26	0.00001
Cycloclasticus	34067	G	18	1	19	0.00000
Piscirickettsia	1237	G	17	1	18	0.00000
Thiosulfativibrio	2781120	G	10	0	10	0.00000
Thiothrix	1030	G	348	11	359	0.00008
Beggiatoa	1021	G	22	0	22	0.00000
Francisella	262	G	49	5	54	0.00001
Allofrancisella	1869285	G	10	1	11	0.00000
Salinisphaera	180541	G	774	813	1587	0.00034
Haemophilus	724	G	75	26	101	0.00002
Aggregatibacter	416916	G	69	15	84	0.00002
Actinobacillus	713	G	63	35	98	0.00002
Mannheimia	75984	G	56	18	74	0.00002
Pasteurella	745	G	40	48	88	0.00002
Glaesserella	2094023	G	23	29	52	0.00001
Avibacterium	292486	G	22	5	27	0.00001
Basfia	697331	G	20	2	22	0.00000
Cardiobacterium	2717	G	369	62	431	0.00009
Suttonella	13275	G	31	2	33	0.00001
Dichelobacter	869	G	28	9	37	0.00001
Kangiella	261963	G	74	6	80	0.00002
Gilliamella	1193503	G	28	10	38	0.00001
Archangium	47	G	17048	1682	18730	0.00406
Cystobacter	42	G	5012	1112	6124	0.00133
Stigmatella	40	G	3718	237	3955	0.00086
Melittangium	44	G	2208	448	2656	0.00058
Myxococcus	32	G	9166	26672	35838	0.00776
Corallococcus	83461	G	8389	579	8968	0.00194
Pyxidicoccus	224458	G	4865	190	5055	0.00110
Anaeromyxobacter	161492	G	22153	1734	23887	0.00518
Vulgatibacter	1524214	G	2514	207	2721	0.00059
Sorangium	39643	G	35406	4577	39983	0.00866
Polyangium	55	G	9844	993	10837	0.00235
Chondromyces	50	G	4385	220	4605	0.00100
Pajaroellobacter	1882917	G	60	2	62	0.00001
Sandaracinus	1055688	G	13735	818	14553	0.00315
Labilithrix	1524217	G	4983	245	5228	0.00113
Haliangium	162027	G	6047	336	6383	0.00138
Geomonas	2651583	G	4361	736	5097	0.00110
Geobacter	28231	G	3832	449	4281	0.00093
Citrifermentans	2883512	G	1315	338	1653	0.00036
Geotalea	2910589	G	555	40	595	0.00013
Geoalkalibacter	392332	G	326	274	600	0.00013
Trichlorobacter	115782	G	175	25	200	0.00004
Desulfuromonas	890	G	3092	425	3517	0.00076
Pelobacter	18	G	422	169	591	0.00013
Syntrophotalea	2812025	G	563	72	635	0.00014
Desulfovibrio	872	G	2463	360	2823	0.00061
Pseudodesulfovibrio	2035811	G	2436	449	2885	0.00063
Solidesulfovibrio	2910984	G	1489	176	1665	0.00036
Oceanidesulfovibrio	2905722	G	740	51	791	0.00017
Desulfocurvibacter	2582840	G	551	45	596	0.00013
Desulfolutivibrio	2773294	G	431	128	559	0.00012
Megalodesulfovibrio	2910978	G	342	18	360	0.00008
Oleidesulfovibrio	2909705	G	132	177	309	0.00007
Maridesulfovibrio	2794998	G	64	6	70	0.00002
Paradesulfovibrio	2910986	G	55	5	60	0.00001
Lawsonia	41707	G	14	0	14	0.00000
Desulfomicrobium	898	G	591	75	666	0.00014
Desulfohalobium	45662	G	147	8	155	0.00003
Desulfosarcina	2299	G	1207	177	1384	0.00030
Desulfococcus	896	G	316	60	376	0.00008
Desulfatibacillum	218207	G	227	7	234	0.00005
Desulfoluna	497721	G	204	11	215	0.00005
Desulfonema	45654	G	161	4	165	0.00004
Desulfobacter	2289	G	93	10	103	0.00002
Desulforapulum	2904687	G	82	10	92	0.00002
Desulfobacula	28222	G	20	1	21	0.00000
Desulfobulbus	893	G	719	133	852	0.00018
Desulfurivibrio	427922	G	299	15	314	0.00007
Desulfomarina	2894767	G	32	2	34	0.00001
Desulfosudis	2904716	G	298	14	312	0.00007
Desulfosediminicola	2886823	G	109	10	119	0.00003
Desulfotalea	109168	G	37	5	42	0.00001
Desulfocapsa	53318	G	25	1	26	0.00001
Persicimonas	2766927	G	1885	64	1949	0.00042
Bradymonas	1779136	G	545	303	848	0.00018
Syntrophobacter	29526	G	469	182	651	0.00014
Desulfoglaeba	361106	G	462	25	487	0.00011
Desulfarculus	453229	G	803	442	1245	0.00027
Desulfomonile	2357	G	164	2	166	0.00004
Desulfobacca	60892	G	156	4	160	0.00003
Syntrophus	43773	G	152	10	162	0.00004
Dissulfurimicrobium	1769732	G	68	4	72	0.00002
Candidatus Desulfofervidus	1902583	G	38	1	39	0.00001
Hippea	84404	G	24	1	25	0.00001
Campylobacter	194	G	379	40	419	0.00009
Sulfurimonas	202746	G	245	18	263	0.00006
Sulfuricurvum	286130	G	19	1	20	0.00000
Helicobacter	209	G	220	24	244	0.00005
Wolinella	843	G	16	6	22	0.00000
Nitratifractor	269260	G	95	8	103	0.00002
Sulfurovum	265570	G	73	9	82	0.00002
Hydrogenimonas	223785	G	96	9	105	0.00002
Sulfurospirillum	57665	G	70	3	73	0.00002
Arcobacter	28196	G	20	11	31	0.00001
Aliarcobacter	2321111	G	11	3	14	0.00000
Malaciobacter	2321114	G	11	2	13	0.00000
Nitratiruptor	269258	G	39	3	42	0.00001
Nitrosophilus	2795692	G	16	2	18	0.00000
Caminibacter	191301	G	21	6	27	0.00001
Nautilia	191291	G	11	2	13	0.00000
Acidithiobacillus	119977	G	798	90	888	0.00019
Bdellovibrio	958	G	299	25	324	0.00007
Pseudobdellovibrio	2862745	G	18	1	19	0.00000
Bacteriovorax	146784	G	18	7	25	0.00001
Hydrogenophilus	70774	G	265	60	325	0.00007
Mariprofundus	377315	G	162	5	167	0.00004
Streptomyces	1883	G	319410	91389	410799	0.08901
Kitasatospora	2063	G	5300	2241	7541	0.00163
Streptacidiphilus	228398	G	3807	1330	5137	0.00111
Yinghuangia	2805681	G	1650	331	1981	0.00043
Microbacterium	33882	G	30097	6257	36354	0.00788
Agromyces	33877	G	8754	2474	11228	0.00243
Curtobacterium	2034	G	5669	1357	7026	0.00152
Rathayibacter	33886	G	5179	1392	6571	0.00142
Leucobacter	55968	G	4219	933	5152	0.00112
Leifsonia	110932	G	4065	3179	7244	0.00157
Clavibacter	1573	G	3919	3320	7239	0.00157
Agrococcus	46352	G	3798	1235	5033	0.00109
Protaetiibacter	2680004	G	1895	654	2549	0.00055
Salinibacterium	235888	G	1575	294	1869	0.00041
Cryobacterium	69578	G	1462	249	1711	0.00037
Frondihabitans	447237	G	1128	209	1337	0.00029
Microterricola	518733	G	1063	307	1370	0.00030
Microcella	337004	G	980	412	1392	0.00030
Plantibacter	190323	G	972	141	1113	0.00024
Herbiconiux	881616	G	734	172	906	0.00020
Gryllotalpicola	1195526	G	718	164	882	0.00019
Mycetocola	76634	G	703	104	807	0.00018
Cnuibacter	1759331	G	691	175	866	0.00019
Frigoribacterium	96492	G	656	226	882	0.00019
Subtercola	120212	G	644	63	707	0.00015
Chryseoglobus	1331730	G	593	129	722	0.00016
Humibacter	427753	G	568	148	716	0.00016
Amnibacterium	1029631	G	554	157	711	0.00015
Marisediminicola	1230698	G	451	65	516	0.00011
Diaminobutyricimonas	1433997	G	435	96	531	0.00012
Gulosibacter	256818	G	430	150	580	0.00013
Glaciihabitans	1649454	G	341	31	372	0.00008
Agreia	110934	G	318	45	363	0.00008
Aquiluna	529881	G	92	5	97	0.00002
Rhodoluna	529883	G	78	4	82	0.00002
Pseudoclavibacter	255204	G	89	21	110	0.00002
Aurantimicrobium	1705353	G	41	2	43	0.00001
Pontimonas	1434032	G	31	1	32	0.00001
Arthrobacter	1663	G	15829	4238	20067	0.00435
Kocuria	57493	G	4789	2041	6830	0.00148
Pseudarthrobacter	1742993	G	2700	1072	3772	0.00082
Micrococcus	1269	G	2024	1959	3983	0.00086
Sinomonas	596707	G	1598	529	2127	0.00046
Glutamicibacter	1742989	G	1279	505	1784	0.00039
Rothia	32207	G	998	535	1533	0.00033
Citricoccus	169133	G	874	299	1173	0.00025
Paenarthrobacter	1742992	G	832	546	1378	0.00030
Nesterenkonia	57494	G	264	21	285	0.00006
Paeniglutamicibacter	1742990	G	99	19	118	0.00003
Psychromicrobium	2078575	G	85	14	99	0.00002
Neomicrococcus	1868332	G	78	41	119	0.00003
Auritidibacter	1160973	G	74	9	83	0.00002
Renibacterium	1645	G	56	4	60	0.00001
Cellulomonas	1707	G	14494	6334	20828	0.00451
Actinotalea	458839	G	985	473	1458	0.00032
Pseudactinotalea	1926259	G	783	149	932	0.00020
Oerskovia	162491	G	697	294	991	0.00021
Paraoerskovia	665568	G	530	181	711	0.00015
Janibacter	53457	G	2736	1074	3810	0.00083
Phycicoccus	367298	G	2431	894	3325	0.00072
Pedococcus	2805645	G	1321	491	1812	0.00039
Intrasporangium	53357	G	1301	448	1749	0.00038
Tetrasphaera	99479	G	1016	333	1349	0.00029
Arsenicicoccus	267408	G	936	462	1398	0.00030
Cellulosimicrobium	157920	G	4251	2184	6435	0.00139
Xylanimonas	186188	G	2340	973	3313	0.00072
Isoptericola	254250	G	1817	1065	2882	0.00062
Ornithinimicrobium	125287	G	4349	1163	5512	0.00119
Serinicoccus	265976	G	2992	1019	4011	0.00087
Brachybacterium	43668	G	4737	997	5734	0.00124
Dermabacter	36739	G	406	287	693	0.00015
Devriesea	472568	G	114	8	122	0.00003
Brevibacterium	1696	G	5103	1304	6407	0.00139
Georgenia	154116	G	4073	1549	5622	0.00122
Ruania	626119	G	3174	489	3663	0.00079
Dermacoccus	57495	G	1134	514	1648	0.00036
Luteipulveratus	745364	G	759	138	897	0.00019
Allobranchiibius	2040262	G	693	198	891	0.00019
Yimella	908935	G	411	107	518	0.00011
Pengzhenrongella	2888818	G	1110	401	1511	0.00033
Luteimicrobium	754249	G	923	369	1292	0.00028
Beutenbergia	84756	G	1133	243	1376	0.00030
Miniimonas	947525	G	872	585	1457	0.00032
Sanguibacter	60919	G	1385	541	1926	0.00042
Gephyromycinifex	2885697	G	342	50	392	0.00009
Austwickia	1184606	G	298	29	327	0.00007
Dermatophilus	1862	G	97	11	108	0.00002
Kytococcus	57499	G	675	316	991	0.00021
Demequina	577469	G	277	28	305	0.00007
Jonesia	43673	G	55	12	67	0.00001
Tropheryma	2038	G	14	0	14	0.00000
Mycolicibacterium	1866885	G	36926	8584	45510	0.00986
Mycobacterium	1763	G	35683	12412	48095	0.01042
Mycolicibacter	1073531	G	2586	1017	3603	0.00078
Mycobacteroides	670516	G	2043	914	2957	0.00064
Mycolicibacillus	2126281	G	536	165	701	0.00015
Hoyosella	697025	G	252	16	268	0.00006
Rhodococcus	1827	G	22298	6887	29185	0.00632
Nocardia	1817	G	21487	4815	26302	0.00570
Corynebacterium	1716	G	14244	4174	18418	0.00399
Gordonia	2053	G	10560	2821	13381	0.00290
Skermania	59613	G	596	82	678	0.00015
Tsukamurella	2060	G	3463	1109	4572	0.00099
Dietzia	37914	G	2057	581	2638	0.00057
Tomitella	741759	G	1237	324	1561	0.00034
Segniliparus	286801	G	325	22	347	0.00008
Lawsonella	1847725	G	71	10	81	0.00002
Micromonospora	1873	G	63558	19901	83459	0.01808
Actinoplanes	1865	G	35003	9882	44885	0.00973
Phytohabitans	907364	G	12335	2053	14388	0.00312
Catellatospora	53365	G	6723	1875	8598	0.00186
Plantactinospora	673534	G	6508	1388	7896	0.00171
Dactylosporangium	35753	G	5112	725	5837	0.00126
Actinocatenispora	390988	G	4695	739	5434	0.00118
Couchioplanes	56433	G	4185	1282	5467	0.00118
Polymorphospora	338583	G	2846	762	3608	0.00078
Natronosporangium	2920401	G	2451	214	2665	0.00058
Verrucosispora	84593	G	1093	917	2010	0.00044
Salinispora	168694	G	968	191	1159	0.00025
Amycolatopsis	1813	G	39906	8565	48471	0.01050
Pseudonocardia	1847	G	34771	8487	43258	0.00937
Saccharomonospora	1851	G	9860	2158	12018	0.00260
Saccharopolyspora	1835	G	9146	2498	11644	0.00252
Saccharothrix	2071	G	8218	2954	11172	0.00242
Kutzneria	43356	G	4935	1319	6254	0.00136
Allokutzneria	1137960	G	4291	1326	5617	0.00122
Actinoalloteichus	65496	G	2685	317	3002	0.00065
Actinosynnema	40566	G	2621	916	3537	0.00077
Kibdelosporangium	2029	G	2597	403	3000	0.00065
Lentzea	165301	G	2301	621	2922	0.00063
Alloactinosynnema	674734	G	1677	478	2155	0.00047
Prauserella	142577	G	968	111	1079	0.00023
Allosaccharopolyspora	2893576	G	854	235	1089	0.00024
Nocardioides	1839	G	75160	21549	96709	0.02095
Aeromicrobium	2040	G	6866	1777	8643	0.00187
Friedmanniella	53387	G	1748	494	2242	0.00049
Marmoricola	86795	G	1399	718	2117	0.00046
Pimelobacter	2044	G	1325	668	1993	0.00043
Mumia	1546255	G	1096	260	1356	0.00029
Micropruina	116071	G	714	145	859	0.00019
Microlunatus	29404	G	5255	804	6059	0.00131
Tessaracoccus	72763	G	4361	1173	5534	0.00120
Brevilactibacter	2717325	G	1865	992	2857	0.00062
Acidipropionibacterium	1912215	G	1569	746	2315	0.00050
Propionibacterium	1743	G	1470	543	2013	0.00044
Auraticoccus	1278221	G	1059	265	1324	0.00029
Cutibacterium	1912216	G	874	266	1140	0.00025
Arachnia	2801844	G	793	76	869	0.00019
Raineyella	1911549	G	686	124	810	0.00018
Vaginimicrobium	2919589	G	40	20	60	0.00001
Kribbella	182639	G	4717	976	5693	0.00123
Actinopolymorpha	117156	G	2211	340	2551	0.00055
Nonomuraea	83681	G	46044	9854	55898	0.01211
Streptosporangium	2000	G	7546	1800	9346	0.00203
Thermobispora	147067	G	2126	636	2762	0.00060
Actinomadura	1988	G	38000	9387	47387	0.01027
Thermomonospora	2019	G	4925	1835	6760	0.00146
Nocardiopsis	2013	G	6005	1385	7390	0.00160
Thermobifida	83677	G	5803	1213	7016	0.00152
Streptomonospora	104204	G	1325	325	1650	0.00036
Spiractinospora	2913367	G	769	65	834	0.00018
Blastococcus	38501	G	6491	2487	8978	0.00195
Modestobacter	88138	G	5429	2193	7622	0.00165
Geodermatophilus	1860	G	3807	1632	5439	0.00118
Frankia	1854	G	9548	1177	10725	0.00232
Actinomyces	1654	G	6596	1111	7707	0.00167
Schaalia	2529408	G	910	206	1116	0.00024
Flaviflexus	1522056	G	489	142	631	0.00014
Trueperella	1069494	G	450	154	604	0.00013
Pauljensenia	2740557	G	251	114	365	0.00008
Nanchangia	2888879	G	226	31	257	0.00006
Actinobaculum	76833	G	91	6	97	0.00002
Actinotignum	1653174	G	77	6	83	0.00002
Arcanobacterium	28263	G	64	17	81	0.00002
Mobiluncus	2050	G	59	21	80	0.00002
Changpingibacter	2912996	G	47	17	64	0.00001
Varibaculum	184869	G	33	12	45	0.00001
Boudabousia	2767318	G	24	2	26	0.00001
Fannyhessea	2767327	G	20	7	27	0.00001
Jiangella	281472	G	5872	1342	7214	0.00156
Bifidobacterium	1678	G	3698	1206	4904	0.00106
Parascardovia	196082	G	73	16	89	0.00002
Gardnerella	2701	G	13	7	20	0.00000
Scardovia	196081	G	13	6	19	0.00000
Nakamurella	53460	G	3482	610	4092	0.00089
Catenulispora	414878	G	2043	390	2433	0.00053
Jatrophihabitans	1434010	G	1665	190	1855	0.00040
Stackebrandtia	283810	G	1297	154	1451	0.00031
Natronoglycomyces	2838311	G	207	9	216	0.00005
Kineococcus	33981	G	1150	416	1566	0.00034
Epidermidibacterium	2078948	G	796	509	1305	0.00028
Actinopolyspora	1849	G	757	101	858	0.00019
Acidothermus	28048	G	529	33	562	0.00012
Candidatus Planktophila	622681	G	90	13	103	0.00002
Candidatus Nanopelagicus	2039639	G	17	5	22	0.00000
Conexibacter	191494	G	18039	3132	21171	0.00459
Miltoncostaea	2843200	G	5398	834	6232	0.00135
Aquihabitans	1648491	G	7303	1427	8730	0.00189
Iamia	467975	G	4331	791	5122	0.00111
Actinomarinicola	2789775	G	4139	928	5067	0.00110
Ilumatobacter	682522	G	1580	107	1687	0.00037
Acidimicrobium	53634	G	566	48	614	0.00013
Rubrobacter	42255	G	10182	522	10704	0.00232
Baekduia	2600304	G	5937	1206	7143	0.00155
Eggerthella	84111	G	831	323	1154	0.00025
Gordonibacter	644652	G	415	211	626	0.00014
Arabiibacter	2005386	G	385	90	475	0.00010
Adlercreutzia	447020	G	357	86	443	0.00010
Raoultibacter	1926677	G	209	19	228	0.00005
Berryella	2815775	G	191	256	447	0.00010
Slackia	84108	G	129	4	133	0.00003
Denitrobacterium	79603	G	104	51	155	0.00003
Phoenicibacter	1981050	G	22	11	33	0.00001
Cryptobacterium	84162	G	19	2	21	0.00000
Olsenella	133925	G	633	127	760	0.00016
Parolsenella	2082587	G	362	136	498	0.00011
Thermophilibacter	2847307	G	227	105	332	0.00007
Parafannyhessea	2847312	G	227	157	384	0.00008
Atopobium	1380	G	48	5	53	0.00001
Lancefieldella	2767353	G	10	1	11	0.00000
Collinsella	102106	G	539	194	733	0.00016
Coriobacterium	33870	G	114	4	118	0.00003
Egicoccus	1755825	G	1577	294	1871	0.00041
Euzebya	908623	G	1495	151	1646	0.00036
Egibacter	1747770	G	1336	96	1432	0.00031
Priestia	2800373	G	6201	5278	11479	0.00249
Bacillus	1386	G	4842	28539	33381	0.00723
Geobacillus	129337	G	950	367	1317	0.00029
Cytobacillus	2675230	G	864	432	1296	0.00028
Alkalihalobacillus	2675234	G	854	222	1076	0.00023
Anoxybacillus	150247	G	618	184	802	0.00017
Neobacillus	2675232	G	613	311	924	0.00020
Hydrogenibacillus	1609627	G	589	89	678	0.00015
Metabacillus	2675233	G	431	197	628	0.00014
Oceanobacillus	182709	G	327	40	367	0.00008
Parageobacillus	1906945	G	315	108	423	0.00009
Peribacillus	2675229	G	290	151	441	0.00010
Lysinibacillus	400634	G	262	99	361	0.00008
Mesobacillus	2675231	G	244	86	330	0.00007
Terribacillus	459532	G	197	37	234	0.00005
Heyndrickxia	2837504	G	191	81	272	0.00006
Virgibacillus	84406	G	185	29	214	0.00005
Sutcliffiella	2837511	G	159	76	235	0.00005
Rossellomorea	2837508	G	134	65	199	0.00004
Halobacillus	45667	G	124	19	143	0.00003
Salicibibacter	2685905	G	116	7	123	0.00003
Niallia	2837506	G	114	36	150	0.00003
Weizmannia	2817139	G	112	64	176	0.00004
Salisediminibacterium	1434042	G	107	18	125	0.00003
Caldibacillus	1276290	G	88	38	126	0.00003
Caldalkalibacillus	379065	G	86	20	106	0.00002
Aeribacillus	1055323	G	80	47	127	0.00003
Lentibacillus	175304	G	69	5	74	0.00002
Fictibacillus	1329200	G	69	12	81	0.00002
Gracilibacillus	74385	G	60	7	67	0.00001
Gottfriedia	2837503	G	54	20	74	0.00002
Pontibacillus	289201	G	45	6	51	0.00001
Alkalihalophilus	2893060	G	42	9	51	0.00001
Salimicrobium	351195	G	40	7	47	0.00001
Halalkalibacterium	2893055	G	33	31	64	0.00001
Psychrobacillus	1221880	G	32	13	45	0.00001
Lederbergia	2804231	G	31	9	40	0.00001
Sediminibacillus	482460	G	31	6	37	0.00001
Radiobacillus	2785518	G	26	5	31	0.00001
Anaerobacillus	704093	G	23	6	29	0.00001
Pradoshia	2651279	G	21	8	29	0.00001
Amphibacillus	29331	G	17	3	20	0.00000
Mangrovibacillus	2920444	G	16	10	26	0.00001
Evansella	2837485	G	14	2	16	0.00000
Paraliobacillus	200903	G	11	2	13	0.00000
Paenibacillus	44249	G	11246	1214	12460	0.00270
Brevibacillus	55080	G	1385	274	1659	0.00036
Cohnella	329857	G	802	127	929	0.00020
Thermobacillus	76632	G	785	120	905	0.00020
Saccharibacillus	456492	G	368	49	417	0.00009
Aneurinibacillus	55079	G	119	22	141	0.00003
Novibacillus	1677050	G	2558	417	2975	0.00064
Thermoactinomyces	2023	G	600	140	740	0.00016
Kroppenstedtia	1274351	G	519	53	572	0.00012
Polycladomyces	1348505	G	292	31	323	0.00007
Staphylospora	2689589	G	242	44	286	0.00006
Laceyella	292635	G	235	63	298	0.00006
Alicyclobacillus	29330	G	882	73	955	0.00021
Tumebacillus	432330	G	606	235	841	0.00018
Kyrpidia	1129704	G	254	16	270	0.00006
Effusibacillus	1502725	G	52	8	60	0.00001
Planococcus	1372	G	425	142	567	0.00012
Sporosarcina	1569	G	129	34	163	0.00004
Ureibacillus	160795	G	45	42	87	0.00002
Solibacillus	648800	G	39	19	58	0.00001
Paenisporosarcina	651660	G	28	15	43	0.00001
Jeotgalibacillus	157226	G	20	8	28	0.00001
Kurthia	1649	G	13	7	20	0.00000
Staphylococcus	1279	G	223	907	1130	0.00025
Mammaliicoccus	2803850	G	39	27	66	0.00001
Macrococcus	69965	G	35	12	47	0.00001
Jeotgalicoccus	227979	G	29	5	34	0.00001
Salinicoccus	45669	G	21	8	29	0.00001
Exiguobacterium	33986	G	322	104	426	0.00009
Gemella	1378	G	13	2	15	0.00000
Listeria	1637	G	84	32	116	0.00003
Brochothrix	2755	G	12	5	17	0.00000
Sporolactobacillus	2077	G	46	8	54	0.00001
Lacticaseibacillus	2759736	G	128	44	172	0.00004
Limosilactobacillus	2742598	G	127	93	220	0.00005
Lactobacillus	1578	G	118	191	309	0.00007
Levilactobacillus	2767886	G	99	34	133	0.00003
Weissella	46255	G	59	14	73	0.00002
Schleiferilactobacillus	2767891	G	53	7	60	0.00001
Ligilactobacillus	2767887	G	52	32	84	0.00002
Lactiplantibacillus	2767842	G	43	19	62	0.00001
Lentilactobacillus	2767893	G	40	14	54	0.00001
Leuconostoc	1243	G	37	8	45	0.00001
Latilactobacillus	2767885	G	33	32	65	0.00001
Pediococcus	1253	G	27	15	42	0.00001
Oenococcus	46254	G	26	1	27	0.00001
Loigolactobacillus	2767889	G	21	16	37	0.00001
Secundilactobacillus	2767892	G	18	8	26	0.00001
Liquorilactobacillus	2767888	G	14	12	26	0.00001
Companilactobacillus	2767879	G	12	1	13	0.00000
Paucilactobacillus	2767890	G	10	5	15	0.00000
Amylolactobacillus	2767876	G	10	11	21	0.00000
Streptococcus	1301	G	301	204	505	0.00011
Lactococcus	1357	G	63	29	92	0.00002
Enterococcus	1350	G	134	205	339	0.00007
Vagococcus	2737	G	30	15	45	0.00001
Tetragenococcus	51668	G	21	6	27	0.00001
Aerococcus	1375	G	73	20	93	0.00002
Abiotrophia	46123	G	13	5	18	0.00000
Jeotgalibaca	1470540	G	33	22	55	0.00001
Carnobacterium	2747	G	21	7	28	0.00001
Dolosigranulum	29393	G	15	5	20	0.00000
Faecalibacterium	216851	G	538	375	913	0.00020
Dysosmobacter	2591381	G	344	158	502	0.00011
Flavonifractor	946234	G	288	74	362	0.00008
Ethanoligenens	253238	G	178	10	188	0.00004
Vescimonas	2892396	G	165	186	351	0.00008
Acetivibrio	35829	G	160	98	258	0.00006
Ruthenibacterium	1905344	G	152	44	196	0.00004
Oscillibacter	459786	G	132	44	176	0.00004
Caproiciproducens	1738645	G	128	17	145	0.00003
Anaerotruncus	244127	G	107	57	164	0.00004
Ruminococcus	1263	G	89	2	91	0.00002
Acutalibacter	1918385	G	85	4	89	0.00002
Pseudoclostridium	2304693	G	82	18	100	0.00002
Caproicibacter	2576755	G	78	4	82	0.00002
Caproicibacterium	2834348	G	59	4	63	0.00001
Solibaculum	2842531	G	54	55	109	0.00002
Pusillibacter	2892397	G	49	34	83	0.00002
Thermoclostridium	2304691	G	43	82	125	0.00003
Ruminiclostridium	1508657	G	22	4	26	0.00001
Mageeibacillus	1637257	G	15	23	38	0.00001
Thermaerobacter	73918	G	2399	207	2606	0.00056
Intestinimonas	1392389	G	160	65	225	0.00005
Flintibacter	1918454	G	107	11	118	0.00003
Aminipila	2060094	G	50	3	53	0.00001
Emergencia	1926556	G	31	12	43	0.00001
Mogibacterium	86331	G	12	2	14	0.00000
Massilistercora	2717089	G	51	55	106	0.00002
Carboxydocella	178898	G	37	4	41	0.00001
Symbiobacterium	2733	G	1099	108	1207	0.00026
Lachnoclostridium	1506553	G	155	81	236	0.00005
Blautia	572511	G	146	73	219	0.00005
Herbinix	1663717	G	134	228	362	0.00008
Roseburia	841	G	60	51	111	0.00002
Anaerocolumna	1843210	G	55	2	57	0.00001
Lacrimispora	2719231	G	49	3	52	0.00001
Enterocloster	2719313	G	44	30	74	0.00002
Coprococcus	33042	G	35	27	62	0.00001
Anaerostipes	207244	G	33	16	49	0.00001
Butyrivibrio	830	G	28	4	32	0.00001
Mediterraneibacter	2316020	G	16	15	31	0.00001
Dorea	189330	G	14	12	26	0.00001
Anaerotignum	2039240	G	13	1	14	0.00000
Sellimonas	1769710	G	12	7	19	0.00000
Anaerobutyricum	2569097	G	11	3	14	0.00000
Clostridium	1485	G	603	157	760	0.00016
Hungatella	1649459	G	55	2	57	0.00001
Alkaliphilus	114627	G	39	7	46	0.00001
Crassaminicella	1848399	G	18	3	21	0.00000
Caloramator	44258	G	15	1	16	0.00000
Serpentinicella	1890059	G	12	2	14	0.00000
Geosporobacter	390805	G	11	1	12	0.00000
Candidatus Desulforudis	471826	G	268	15	283	0.00006
Desulforamulus	2916693	G	133	39	172	0.00004
Acididesulfobacillus	2924872	G	90	3	93	0.00002
Candidatus Formimonas	2840454	G	46	2	48	0.00001
Dehalobacterium	51514	G	35	5	40	0.00001
Thermanaerosceptrum	2651578	G	32	4	36	0.00001
Desulfofarcimen	2282742	G	18	2	20	0.00000
Christensenella	990721	G	329	161	490	0.00011
Heliomicrobium	2831443	G	247	85	332	0.00007
Heliorestis	79598	G	25	2	27	0.00001
Eubacterium	1730	G	150	45	195	0.00004
Acetobacterium	33951	G	63	10	73	0.00002
Alkalibacter	274470	G	22	1	23	0.00001
Desulfosporosinus	79206	G	69	7	76	0.00002
Desulfitobacterium	36853	G	66	21	87	0.00002
Dehalobacter	56112	G	39	9	48	0.00001
Syntrophobotulus	51196	G	22	1	23	0.00001
Syntrophothermus	129001	G	63	6	69	0.00002
Syntrophomonas	862	G	24	5	29	0.00001
Candidatus Contubernalis	338648	G	17	0	17	0.00000
Clostridioides	1870884	G	25	2457	2482	0.00054
Romboutsia	1501226	G	17	5	22	0.00000
Terrisporobacter	1505652	G	15	2	17	0.00000
Acetoanaerobium	186831	G	11	1	12	0.00000
Peptoclostridium	1481960	G	11	1	12	0.00000
Tepidibacter	214904	G	10	2	12	0.00000
Desulfoscipio	2867376	G	54	4	58	0.00001
Thermincola	278993	G	38	3	41	0.00001
Desulfotomaculum	1562	G	29	11	40	0.00001
Vallitalea	1348611	G	10	0	10	0.00000
Caloranaerobacter	171003	G	15	2	17	0.00000
Moorella	44260	G	401	13	414	0.00009
Ammonifex	42837	G	145	5	150	0.00003
Gelria	189326	G	347	27	374	0.00008
Thermacetogenium	140458	G	138	94	232	0.00005
Carboxydothermus	129957	G	48	4	52	0.00001
Thermanaeromonas	202949	G	43	1	44	0.00001
Caldanaerobacter	249529	G	25	20	45	0.00001
Thermoanaerobacter	1754	G	24	3	27	0.00001
Thermoanaerobacterium	28895	G	49	16	65	0.00001
Caldicellulosiruptor	44000	G	49	5	54	0.00001
Mahella	252965	G	43	20	63	0.00001
Zhaonella	2748674	G	36	4	40	0.00001
Thermodesulfobium	227388	G	28	0	28	0.00001
Iocasia	2899804	G	56	5	61	0.00001
Halanaerobium	2330	G	26	2	28	0.00001
Halothermothrix	32636	G	22	3	25	0.00001
Anoxybacter	1769008	G	56	12	68	0.00001
Halobacteroides	42417	G	26	7	33	0.00001
Biomaibacter	2770094	G	36	3	39	0.00001
Tepidanaerobacter	499228	G	14	0	14	0.00000
Thermosediminibacter	291988	G	43	4	47	0.00001
Koleobacter	2786989	G	38	2	40	0.00001
Natranaerofaba	2807497	G	15	0	15	0.00000
Natranaerobius	375928	G	10	1	11	0.00000
Selenomonas	970	G	1010	61	1071	0.00023
Megamonas	158846	G	24	1	25	0.00001
Pectinatus	864	G	10	0	10	0.00000
Methylomusa	2093783	G	50	4	54	0.00001
Sporomusa	2375	G	47	7	54	0.00001
Pelosinus	365348	G	32	4	36	0.00001
Megasphaera	906	G	257	113	370	0.00008
Dialister	39948	G	45	1	46	0.00001
Veillonella	29465	G	22	2	24	0.00001
Acidaminococcus	904	G	93	9	102	0.00002
Phascolarctobacterium	33024	G	75	27	102	0.00002
Limnochorda	1676651	G	1250	59	1309	0.00028
Peptoniphilus	162289	G	60	23	83	0.00002
Murdochiella	1161127	G	22	19	41	0.00001
Anaerococcus	165779	G	13	13	26	0.00001
Schnuerera	2794837	G	26	5	31	0.00001
Tissierella	41273	G	15	3	18	0.00000
Keratinibaculum	1354809	G	11	5	16	0.00000
Gottschalkia	1505664	G	19	2	21	0.00000
Ezakiella	1582879	G	50	98	148	0.00003
Sedimentibacter	190972	G	13	1	14	0.00000
Allobaculum	174708	G	53	11	64	0.00001
Faecalibaculum	1729679	G	33	11	44	0.00001
Erysipelatoclostridium	1505663	G	22	18	40	0.00001
Erysipelothrix	1647	G	21	3	24	0.00001
Bulleidia	118747	G	16	6	22	0.00000
Turicibacter	191303	G	20	12	32	0.00001
Ndongobacter	1930845	G	41	43	84	0.00002
Sphaerobacter	2056	G	6368	290	6658	0.00144
Thermomicrobium	499	G	500	6	506	0.00011
Roseiflexus	120961	G	1535	80	1615	0.00035
Chloroflexus	1107	G	553	21	574	0.00012
Tepidiforma	2682228	G	1787	80	1867	0.00040
Candidatus Promineofilum	1988031	G	1424	31	1455	0.00032
Anaerolinea	233189	G	297	24	321	0.00007
Pelolinea	1649478	G	264	10	274	0.00006
Brevefilum	2019482	G	118	3	121	0.00003
Caldilinea	233191	G	658	30	688	0.00015
Dehalogenimonas	670486	G	307	6	313	0.00007
Dehalococcoides	61434	G	95	1	96	0.00002
Phototrophicus	2922426	G	305	2	307	0.00007
Ktedonosporobacter	2692417	G	286	6	292	0.00006
Thermobaculum	262406	G	233	37	270	0.00006
Synechococcus	1129	G	3851	443	4294	0.00093
Dactylococcopsis	13034	G	20	8	28	0.00001
Cyanobium	167375	G	832	199	1031	0.00022
Parasynechococcus	2881427	G	74	23	97	0.00002
Prochlorococcus	1218	G	43	2	45	0.00001
Chamaesiphon	217161	G	69	4	73	0.00002
Acaryochloris	155977	G	65	2	67	0.00001
Synechocystis	1142	G	57	3	60	0.00001
Nostoc	1177	G	970	141	1111	0.00024
Anabaena	1163	G	101	289	390	0.00008
Cylindrospermum	56106	G	33	3	36	0.00001
Trichormus	264688	G	18	2	20	0.00000
Calothrix	1186	G	405	40	445	0.00010
Sphaerospermopsis	752201	G	87	15	102	0.00002
Nodularia	159191	G	67	8	75	0.00002
Dolichospermum	748770	G	39	114	153	0.00003
Anabaenopsis	110103	G	28	15	43	0.00001
Scytonema	1203	G	154	22	176	0.00004
Brasilonema	383614	G	33	4	37	0.00001
Fischerella	1190	G	62	9	71	0.00002
Tolypothrix	111782	G	50	10	60	0.00001
Rivularia	373984	G	18	1	19	0.00000
Leptolyngbya	47251	G	1092	81	1173	0.00025
Kovacikia	1874526	G	128	13	141	0.00003
Leptodesmis	2664261	G	80	10	90	0.00002
Leptothermofonsia	2917830	G	54	5	59	0.00001
Thermoleptolyngbya	2303528	G	224	21	245	0.00005
Thermosynechococcus	146785	G	106	12	118	0.00003
Halomicronema	170610	G	103	4	107	0.00002
Pseudanabaena	1152	G	57	2	59	0.00001
Gloeobacter	33071	G	1239	36	1275	0.00028
Anthocerotibacter	2857076	G	97	4	101	0.00002
Moorena	1155738	G	264	7	271	0.00006
Oscillatoria	1158	G	88	24	112	0.00002
Geitlerinema	63132	G	222	36	258	0.00006
Allocoleopsis	2886347	G	48	5	53	0.00001
Oxynema	1492710	G	86	8	94	0.00002
Microcoleus	44471	G	50	13	63	0.00001
Planktothrix	54304	G	22	2	24	0.00001
Koinonema	2023214	G	54	3	57	0.00001
Crinalium	241421	G	16	2	18	0.00000
Limnospira	2596745	G	14	0	14	0.00000
Microcystis	1125	G	136	37	173	0.00004
Gloeothece	28070	G	43	3	46	0.00001
Rippkaea	2546365	G	29	3	32	0.00001
Crocosphaera	263510	G	22	2	24	0.00001
Halothece	76023	G	13	4	17	0.00000
Gloeocapsa	102231	G	33	3	36	0.00001
Geminocystis	669357	G	30	3	33	0.00001
Chondrocystis	268175	G	23	3	26	0.00001
Cyanobacterium	102234	G	16	4	20	0.00000
Chroococcidiopsis	54298	G	182	32	214	0.00005
Pleurocapsa	44474	G	41	6	47	0.00001
Stanieria	102115	G	17	2	19	0.00000
Gloeomargarita	1188227	G	34	1	35	0.00001
Thermostichus	2881385	G	22	15	37	0.00001
Deinococcus	1298	G	8336	683	9019	0.00195
Thermus	270	G	1608	143	1751	0.00038
Meiothermus	65551	G	877	58	935	0.00020
Oceanithermus	208447	G	870	104	974	0.00021
Marinithermus	186191	G	513	87	600	0.00013
Truepera	332248	G	654	40	694	0.00015
Fimbriimonas	1005038	G	737	4	741	0.00016
Chthonomonas	1077265	G	198	1	199	0.00004
Mycoplasma	2093	G	46	18	64	0.00001
Mycoplasmopsis	2767358	G	22	16	38	0.00001
Alteracholeplasma	2903105	G	15	3	18	0.00000
Candidatus Phytoplasma	33926	G	12	0	12	0.00000
Spiroplasma	2132	G	33	3	36	0.00001
Gemmata	113	G	20968	2295	23263	0.00504
Urbifossiella	2807415	G	17891	1717	19608	0.00425
Frigoriglobus	2774146	G	11797	1986	13783	0.00299
Limnoglobus	2731450	G	8768	446	9214	0.00200
Tuwongella	2051044	G	763	36	799	0.00017
Telmatocola	1382832	G	666	7	673	0.00015
Lacipirellula	2691417	G	8682	697	9379	0.00203
Pirellulimonas	2795783	G	2803	359	3162	0.00069
Botrimarina	2795782	G	2414	267	2681	0.00058
Aeoliella	2795781	G	932	92	1024	0.00022
Adhaeretor	2862451	G	601	68	669	0.00015
Bythopirellula	1400386	G	515	44	559	0.00012
Lignipirellula	2795775	G	1735	226	1961	0.00043
Stieleria	2795973	G	1709	219	1928	0.00042
Anatilimnocola	2807414	G	1556	193	1749	0.00038
Rosistilla	2795779	G	1539	128	1667	0.00036
Bremerella	2714594	G	1160	99	1259	0.00027
Pirellula	123	G	1126	43	1169	0.00025
Roseimaritima	1579506	G	981	73	1054	0.00023
Rubripirellula	1579505	G	379	83	462	0.00010
Mariniblastus	2005380	G	298	6	304	0.00007
Aureliella	2795605	G	286	26	312	0.00007
Rhodopirellula	265488	G	276	22	298	0.00006
Thermogutta	1676125	G	299	10	309	0.00007
Tautonia	2680020	G	10185	1026	11211	0.00243
Aquisphaera	1511635	G	7324	1437	8761	0.00190
Paludisphaera	1763521	G	4605	1170	5775	0.00125
Singulisphaera	466152	G	3356	569	3925	0.00085
Isosphaera	127	G	767	63	830	0.00018
Planctomyces	118	G	7717	2037	9754	0.00211
Caulifigura	2795778	G	3118	233	3351	0.00073
Gimesia	1649453	G	2550	154	2704	0.00059
Maioricimonas	2795777	G	2290	328	2618	0.00057
Alienimonas	2714737	G	1833	154	1987	0.00043
Symmachiella	2795780	G	851	57	908	0.00020
Rubinisphaera	1649490	G	493	55	548	0.00012
Fuerstiella	1936111	G	478	9	487	0.00011
Planctopirus	1649480	G	421	18	439	0.00010
Calycomorphotria	2795776	G	382	16	398	0.00009
Crateriforma	2714592	G	370	88	458	0.00010
Polystyrenella	2795774	G	185	18	203	0.00004
Thalassoglobus	2795865	G	159	9	168	0.00004
Humisphaera	2807511	G	3060	87	3147	0.00068
Phycisphaera	666508	G	1291	120	1411	0.00031
Mucisphaera	2913022	G	631	40	671	0.00015
Poriferisphaera	2803301	G	80	0	80	0.00002
Anaerohalosphaera	2690159	G	129	4	133	0.00003
Limihaloglobus	2690160	G	58	4	62	0.00001
Sedimentisphaera	2483368	G	39	19	58	0.00001
Candidatus Kuenenia	380738	G	68	0	68	0.00001
Candidatus Uabimicrobium	2897349	G	44	0	44	0.00001
Opitutus	178440	G	5169	466	5635	0.00122
Lacunisphaera	1961799	G	2248	318	2566	0.00056
Nibricoccus	2576890	G	1709	78	1787	0.00039
Oleiharenicola	2100741	G	1052	57	1109	0.00024
Ereboglobus	2028344	G	693	35	728	0.00016
Ruficoccus	2175957	G	325	53	378	0.00008
Coraliomargarita	442430	G	90	2	92	0.00002
Roseimicrobium	1348508	G	1584	56	1640	0.00036
Verrucomicrobium	2735	G	1471	128	1599	0.00035
Luteolibacter	518753	G	1329	52	1381	0.00030
Sulfuriroseicoccus	2911469	G	164	17	181	0.00004
Akkermansia	239934	G	496	41	537	0.00012
Methylacidimicrobium	1541670	G	487	46	533	0.00012
Candidatus Xiphinematobacter	134550	G	53	4	57	0.00001
Methylacidiphilum	511745	G	48	1	49	0.00001
Kiritimatiella	1921784	G	350	454	804	0.00017
Tichowtungia	2907187	G	152	5	157	0.00003
Candidatus Protochlamydia	282132	G	24	10	34	0.00001
Parachlamydia	83551	G	15	7	22	0.00000
Candidatus Rhabdochlamydia	292833	G	26	2	28	0.00001
Waddlia	71666	G	18	4	22	0.00000
Simkania	34093	G	13	2	15	0.00000
Chlamydia	810	G	35	13	48	0.00001
Candidatus Velamenicoccus	2789201	G	136	0	136	0.00003
Hymenobacter	89966	G	7186	361	7547	0.00164
Pontibacter	323449	G	1908	214	2122	0.00046
Rufibacter	1379908	G	360	83	443	0.00010
Adhaeribacter	299566	G	160	12	172	0.00004
Nibribacter	1649474	G	81	43	124	0.00003
Spirosoma	107	G	1495	83	1578	0.00034
Rhodocytophaga	455076	G	112	4	116	0.00003
Cytophaga	978	G	38	3	41	0.00001
Aquirufa	2676247	G	35	5	40	0.00001
Dyadobacter	120831	G	446	32	478	0.00010
Fibrella	861914	G	364	29	393	0.00009
Runella	105	G	196	8	204	0.00004
Larkinella	332157	G	87	6	93	0.00002
Leadbetterella	319458	G	20	11	31	0.00001
Chryseolinea	1433993	G	966	32	998	0.00022
Fulvivirga	396811	G	152	9	161	0.00003
Echinicola	390846	G	186	34	220	0.00005
Algoriphagus	246875	G	81	11	92	0.00002
Aquiflexum	280472	G	31	5	36	0.00001
Cyclobacterium	68288	G	30	4	34	0.00001
Belliella	232244	G	23	13	36	0.00001
Mongoliitalea	1511649	G	17	2	19	0.00000
Candidatus Amoebophilus	281119	G	22	1	23	0.00001
Candidatus Cardinium	273135	G	16	7	23	0.00001
Flammeovirga	59739	G	27	1	28	0.00001
Mangrovivirga	2858886	G	25	2	27	0.00001
Marivirga	869806	G	23	9	32	0.00001
Bernardetia	1937972	G	15	1	16	0.00000
Chitinophaga	79328	G	1509	99	1608	0.00035
Niastella	354354	G	669	81	750	0.00016
Flavisolibacter	398041	G	648	61	709	0.00015
Paraflavitalea	2698688	G	404	35	439	0.00010
Pseudocnuella	2812019	G	385	53	438	0.00010
Flavihumibacter	1004301	G	349	23	372	0.00008
Pseudobacter	1860196	G	324	32	356	0.00008
Niabella	379899	G	298	26	324	0.00007
Arachidicoccus	1769012	G	222	38	260	0.00006
Lacibacter	649461	G	151	7	158	0.00003
Phnomibacter	2836216	G	149	20	169	0.00004
Ferruginibacter	1004303	G	142	10	152	0.00003
Panacibacter	1874621	G	142	7	149	0.00003
Filimonas	649460	G	114	15	129	0.00003
Rhodocaloribacter	2893090	G	1822	197	2019	0.00044
Rhodothermus	29548	G	1642	97	1739	0.00038
Salinibacter	146918	G	875	16	891	0.00019
Alistipes	239759	G	1676	654	2330	0.00051
Prevotella	838	G	579	87	666	0.00014
Paraprevotella	577309	G	32	32	64	0.00001
Pseudoprevotella	2884814	G	30	3	33	0.00001
Bacteroides	816	G	478	245	723	0.00016
Phocaeicola	909656	G	97	51	148	0.00003
Tannerella	195950	G	191	13	204	0.00004
Parabacteroides	375288	G	136	93	229	0.00005
Sodaliphilus	2815786	G	91	52	143	0.00003
Duncaniella	2518495	G	80	4	84	0.00002
Muribaculum	1918540	G	57	8	65	0.00001
Porphyromonas	836	G	230	28	258	0.00006
Proteiniphilum	294702	G	50	2	52	0.00001
Petrimonas	307628	G	43	2	45	0.00001
Dysgonomonas	156973	G	11	0	11	0.00000
Barnesiella	397864	G	54	81	135	0.00003
Butyricimonas	574697	G	34	20	54	0.00001
Odoribacter	283168	G	13	1	14	0.00000
Paludibacter	346096	G	23	0	23	0.00001
Salinivirga	1970191	G	20	0	20	0.00000
Tenuifilum	2760873	G	15	0	15	0.00000
Draconibacterium	1471399	G	39	1	40	0.00001
Maribellus	2678352	G	35	1	36	0.00001
Labilibaculum	2060722	G	14	0	14	0.00000
Alkalitalea	1193324	G	12	0	12	0.00000
Flavobacterium	237	G	838	113	951	0.00021
Capnocytophaga	1016	G	155	22	177	0.00004
Muricauda	111500	G	141	29	170	0.00004
Gramella	292691	G	133	22	155	0.00003
Robiginitalea	252306	G	97	6	103	0.00002
Polaribacter	52959	G	79	10	89	0.00002
Antarcticibacterium	2058174	G	71	12	83	0.00002
Nonlabens	363408	G	66	11	77	0.00002
Winogradskyella	286104	G	56	12	68	0.00001
Sinomicrobium	1434045	G	53	2	55	0.00001
Aequorivita	153265	G	47	2	49	0.00001
Maribacter	252356	G	45	14	59	0.00001
Tenacibaculum	104267	G	42	8	50	0.00001
Formosa	225842	G	41	8	49	0.00001
Salegentibacter	143222	G	32	18	50	0.00001
Myroides	76831	G	31	9	40	0.00001
Kordia	221065	G	30	2	32	0.00001
Aggregatimonas	2913017	G	27	1	28	0.00001
Aquimarina	290174	G	24	1	25	0.00001
Algibacter	261827	G	23	7	30	0.00001
Zunongwangia	417127	G	23	16	39	0.00001
Leeuwenhoekiella	283735	G	22	5	27	0.00001
Cellulophaga	104264	G	22	2	24	0.00001
Dokdonia	326319	G	22	2	24	0.00001
Mariniflexile	527198	G	21	2	23	0.00001
Flagellimonas	444459	G	19	1	20	0.00000
Zhouia	561555	G	17	4	21	0.00000
Tamlana	393005	G	17	3	20	0.00000
Muriicola	762641	G	17	1	18	0.00000
Zobellia	112040	G	16	1	17	0.00000
Euzebyella	1287916	G	15	8	23	0.00001
Gilvibacter	379070	G	15	2	17	0.00000
Sediminicola	389486	G	15	1	16	0.00000
Galbibacter	379068	G	14	1	15	0.00000
Lacinutrix	291183	G	14	4	18	0.00000
Lutibacter	358023	G	12	1	13	0.00000
Arenibacter	178469	G	10	3	13	0.00000
Pukyongia	2831916	G	10	0	10	0.00000
Chryseobacterium	59732	G	630	235	865	0.00019
Kaistella	2782231	G	104	20	124	0.00003
Epilithonimonas	2782229	G	17	21	38	0.00001
Elizabethkingia	308865	G	75	30	105	0.00002
Cruoricaptor	1433995	G	28	5	33	0.00001
Empedobacter	59734	G	23	14	37	0.00001
Apibacter	1778601	G	18	1	19	0.00000
Bergeyella	59735	G	14	4	18	0.00000
Riemerella	34084	G	11	6	17	0.00000
Ornithobacterium	28250	G	10	10	20	0.00000
Blattabacterium	34098	G	74	9	83	0.00002
Fluviicola	332102	G	24	1	25	0.00001
Crocinitomix	246873	G	18	0	18	0.00000
Owenweeksia	267986	G	25	1	26	0.00001
Croceimicrobium	2828338	G	16	3	19	0.00000
Mucilaginibacter	423349	G	961	82	1043	0.00023
Pedobacter	84567	G	397	35	432	0.00009
Sphingobacterium	28453	G	347	228	575	0.00012
Anseongella	1773450	G	114	5	119	0.00003
Solitalea	929509	G	53	4	57	0.00001
Olivibacter	376469	G	49	5	54	0.00001
Pseudopedobacter	1649482	G	24	25	49	0.00001
Haliscomenobacter	2349	G	112	2	114	0.00002
Saprospira	1007	G	30	1	31	0.00001
Candidatus Sulfidibacterium	2923290	G	33	1	34	0.00001
Chlorobaculum	256319	G	745	62	807	0.00017
Pelodictyon	1099	G	188	32	220	0.00005
Chlorobium	1091	G	139	16	155	0.00003
Prosthecochloris	1101	G	277	25	302	0.00007
Chloroherpeton	100715	G	55	1	56	0.00001
Melioribacter	1134403	G	42	4	46	0.00001
Ignavibacterium	795750	G	35	4	39	0.00001
Candidatus Cyclonatronum	2489367	G	82	10	92	0.00002
Gemmatirosa	1706036	G	24353	2581	26934	0.00584
Gemmatimonas	173479	G	8104	249	8353	0.00181
Fibrobacter	832	G	62	1	63	0.00001
Candidatus Cloacimonas	456826	G	27	0	27	0.00001
Luteitalea	2004797	G	34626	2216	36842	0.00798
Granulicella	940557	G	3537	426	3963	0.00086
Terriglobus	392733	G	2498	354	2852	0.00062
Acidobacterium	33973	G	1953	191	2144	0.00046
Candidatus Koribacter	658061	G	1591	63	1654	0.00036
Edaphobacter	388463	G	1063	155	1218	0.00026
Acidisarcina	2608728	G	661	57	718	0.00016
Paludibaculum	1649475	G	2922	95	3017	0.00065
Chloracidobacterium	458032	G	1463	52	1515	0.00033
Sulfidibacter	2915177	G	845	21	866	0.00019
Thermotomaculum	1172428	G	37	2	39	0.00001
Nitrospira	1234	G	5395	89	5484	0.00119
Leptospirillum	179	G	158	3	161	0.00003
Thermodesulfovibrio	28261	G	39	1	40	0.00001
Dissulfurispira	2811506	G	38	2	40	0.00001
Treponema	157	G	369	48	417	0.00009
Spirochaeta	146	G	264	6	270	0.00006
Salinispira	1616789	G	39	0	39	0.00001
Sediminispirochaeta	1911556	G	30	0	30	0.00001
Sphaerochaeta	399320	G	111	5	116	0.00003
Breznakiella	2845254	G	61	3	64	0.00001
Borrelia	138	G	22	7	29	0.00001
Leptospira	171	G	181	24	205	0.00004
Turneriella	338321	G	121	1	122	0.00003
Brachyspira	29521	G	32	0	32	0.00001
Fretibacterium	1434006	G	199	3	202	0.00004
Aminomonas	81411	G	180	21	201	0.00004
Pyramidobacter	638847	G	174	11	185	0.00004
Thermanaerovibrio	81461	G	152	30	182	0.00004
Cloacibacillus	508459	G	143	32	175	0.00004
Jonquetella	428711	G	111	19	130	0.00003
Acetomicrobium	49894	G	26	0	26	0.00001
Aminobacterium	81466	G	21	1	22	0.00000
Thermovirga	336260	G	17	15	32	0.00001
Candidatus Bipolaricaulis	2250122	G	224	10	234	0.00005
Candidatus Saccharimonas	1331051	G	50	0	50	0.00001
Candidatus Nanosynbacter	2093823	G	50	42	92	0.00002
Candidatus Babela	1551504	G	41	1	42	0.00001
Candidatus Chazhemtobacterium	2715734	G	24	0	24	0.00001
Candidatus Absconditicoccus	2900570	G	14	0	14	0.00000
Thermotoga	2335	G	98	11	109	0.00002
Pseudothermotoga	1643951	G	28	1	29	0.00001
Thermosipho	2420	G	29	1	30	0.00001
Fervidobacterium	2422	G	21	7	28	0.00001
Mesotoga	1184396	G	42	2	44	0.00001
Kosmotoga	651456	G	21	1	22	0.00000
Marinitoga	160798	G	14	1	15	0.00000
Defluviitoga	1511648	G	12	20	32	0.00001
Athalassotoga	1769718	G	15	0	15	0.00000
Hydrogenobacter	939	G	30	4	34	0.00001
Thermocrinis	75905	G	30	6	36	0.00001
Aquifex	2713	G	11	1	12	0.00000
Sulfurihydrogenibium	212790	G	41	3	44	0.00001
Persephonella	182899	G	33	1	34	0.00001
Thermosulfidibacter	412592	G	39	1	40	0.00001
Thermovibrio	171868	G	47	7	54	0.00001
Desulfurobacterium	64159	G	18	2	20	0.00000
Thermosulfurimonas	1522431	G	75	5	80	0.00002
Thermosulfuriphilus	2033601	G	34	1	35	0.00001
Thermodesulfatator	241192	G	27	2	29	0.00001
Thermodesulfobacterium	1740	G	21	2	23	0.00000
Caldimicrobium	444090	G	11	0	11	0.00000
Caldithrix	187144	G	126	1	127	0.00003
Geovibrio	46200	G	26	7	33	0.00001
Mucispirillum	248038	G	18	2	20	0.00000
Flexistipes	2351	G	17	3	20	0.00000
Denitrovibrio	117999	G	14	2	16	0.00000
Calditerrivibrio	545865	G	11	2	13	0.00000
Leptotrichia	32067	G	36	11	47	0.00001
Fusobacterium	848	G	47	12	59	0.00001
Desulfurispirillum	393029	G	93	51	144	0.00003
Elusimicrobium	423604	G	41	1	42	0.00001
Endomicrobium	1408194	G	39	1	40	0.00001
Coprothermobacter	68335	G	61	14	75	0.00002
Caldisericum	693074	G	30	0	30	0.00001
Dictyoglomus	13	G	28	0	28	0.00001
Atribacter	2847777	G	23	0	23	0.00001
Fusarium	5506	G	2647	217	2864	0.00062
Metarhizium	5529	G	708	97	805	0.00017
Ustilaginoidea	124426	G	234	13	247	0.00005
Pochonia	243023	G	51	3	54	0.00001
Trichoderma	5543	G	974	52	1026	0.00022
Beauveria	5581	G	511	25	536	0.00012
Cordyceps	45234	G	247	22	269	0.00006
Purpureocillium	1052105	G	283	25	308	0.00007
Drechmeria	98402	G	206	12	218	0.00005
Clonostachys	110564	G	120	10	130	0.00003
Colletotrichum	5455	G	300	74	374	0.00008
Thermothelomyces	1920207	G	2364	153	2517	0.00055
Thermothielavioides	2609811	G	861	76	937	0.00020
Neurospora	5140	G	233	15	248	0.00005
Pyricularia	48558	G	369	3	372	0.00008
Neopestalotiopsis	1562158	G	195	3	198	0.00004
Botrytis	33196	G	80	0	80	0.00002
Aspergillus	5052	G	1881	116	1997	0.00043
Penicillium	5073	G	210	8	218	0.00005
Paecilomyces	33202	G	77	2	79	0.00002
Talaromyces	5094	G	60	3	63	0.00001
Paraphaeosphaeria	125369	G	118	39	157	0.00003
Ampelomyces	50729	G	74	7	81	0.00002
Zymoseptoria	1047167	G	66	0	66	0.00001
Cercospora	29002	G	36	0	36	0.00001
Eremothecium	33170	G	41	30	71	0.00002
Lachancea	300275	G	29	1	30	0.00001
Kazachstania	71245	G	21	0	21	0.00000
Saccharomyces	4930	G	18	0	18	0.00000
Nakaseomyces	374468	G	16	0	16	0.00000
Tetrapisispora	113604	G	15	0	15	0.00000
Naumovozyma	278028	G	14	0	14	0.00000
Kluyveromyces	4910	G	13	1	14	0.00000
Brettanomyces	13366	G	23	1	24	0.00001
Ogataea	461281	G	15	0	15	0.00000
Pichia	4919	G	11	0	11	0.00000
Candida	1535326	G	33	1	34	0.00001
Yarrowia	4951	G	37	0	37	0.00001
Sugiyamaella	410829	G	17	1	18	0.00000
Schizosaccharomyces	4895	G	10	0	10	0.00000
Pseudozyma	63298	G	369	3	372	0.00008
Ustilago	5269	G	158	3	161	0.00004
Sporisorium	63265	G	100	14	114	0.00002
Malassezia	55193	G	49	8	57	0.00001
Phlebiopsis	82309	G	118	1	119	0.00003
Rhizoctonia	1322061	G	27	1	28	0.00001
Marasmius	34448	G	28	1	29	0.00001
Cryptococcus	5206	G	35	5	40	0.00001
Encephalitozoon	6033	G	13	0	13	0.00000
Phytophthora	4783	G	941	185	1126	0.00024
Pythium	4797	G	134	6	140	0.00003
