name	taxonomy_id	taxonomy_lvl	kraken_assigned_reads	added_reads	new_est_reads	fraction_total_reads
Bradyrhizobiaceae	41294	F	243899	21439	265338	0.03928
Phyllobacteriaceae	69277	F	170548	25925	196473	0.02908
Rhizobiaceae	82115	F	137836	44133	181969	0.02694
Methylobacteriaceae	119045	F	73547	9918	83465	0.01236
Xanthobacteraceae	335928	F	61041	9507	70548	0.01044
Devosiaceae	2831106	F	45990	3515	49505	0.00733
Hyphomicrobiaceae	45401	F	39516	3561	43077	0.00638
Boseaceae	2831100	F	20046	2912	22958	0.00340
Aurantimonadaceae	255475	F	18118	16993	35111	0.00520
Methylocystaceae	31993	F	12148	960	13108	0.00194
Stappiaceae	2821832	F	10285	2323	12608	0.00187
Phreatobacteraceae	2843305	F	9463	1536	10999	0.00163
Parvibaculaceae	2813035	F	7067	1547	8614	0.00128
Chelatococcaceae	2036754	F	6031	1303	7334	0.00109
Blastochloridaceae	2831090	F	5721	1277	6998	0.00104
Beijerinckiaceae	45404	F	5689	393	6082	0.00090
Brucellaceae	118882	F	4273	1641	5914	0.00088
Kaistiaceae	2831111	F	3553	832	4385	0.00065
Amorphaceae	2685818	F	3086	313	3399	0.00050
Pleomorphomonadaceae	2843308	F	2168	369	2537	0.00038
Breoghaniaceae	2831104	F	2098	262	2360	0.00035
Lichenihabitantaceae	2723775	F	1801	79	1880	0.00028
Cohaesibacteraceae	655351	F	408	15	423	0.00006
Bartonellaceae	772	F	383	44	427	0.00006
Sphingomonadaceae	41297	F	545642	58313	603955	0.08940
Erythrobacteraceae	335929	F	66398	10968	77366	0.01145
Sphingosinicellaceae	2820280	F	17870	1414	19284	0.00285
Zymomonadaceae	2844881	F	124	62	186	0.00003
Azospirillaceae	2829815	F	48113	4293	52406	0.00776
Acetobacteraceae	433	F	44410	4398	48808	0.00723
Rhodospirillaceae	41295	F	36749	109951	146700	0.02172
Stellaceae	2844601	F	6065	382	6447	0.00095
Elioraeaceae	2690195	F	2645	120	2765	0.00041
Thalassospiraceae	2844866	F	1704	95	1799	0.00027
Terasakiellaceae	2813951	F	92	2	94	0.00001
Caulobacteraceae	76892	F	138211	11776	149987	0.02220
Rhodobacteraceae	31989	F	49248	6415	55663	0.00824
Roseobacteraceae	2854170	F	32744	3929	36673	0.00543
Hyphomonadaceae	69657	F	4683	148	4831	0.00072
Maricaulaceae	2800061	F	3406	1705	5111	0.00076
Parvularculaceae	255474	F	962	58	1020	0.00015
Emcibacteraceae	2066491	F	515	46	561	0.00008
Anaplasmataceae	942	F	222	2	224	0.00003
Rickettsiaceae	775	F	182	8	190	0.00003
Candidatus Midichloriaceae	1328881	F	32	18	50	0.00001
Candidatus Deianiraeaceae	2603433	F	12	0	12	0.00000
Holosporaceae	44746	F	90	1	91	0.00001
Caedimonadaceae	2100208	F	54	2	56	0.00001
Candidatus Paracaedibacteraceae	1777752	F	35	2	37	0.00001
Magnetococcaceae	1191479	F	96	2	98	0.00001
Pelagibacteraceae	1655514	F	63	23	86	0.00001
Kordiimonadaceae	1331809	F	55	0	55	0.00001
Xanthomonadaceae	32033	F	246469	36955	283424	0.04195
Rhodanobacteraceae	1775411	F	53934	7190	61124	0.00905
Pseudomonadaceae	135621	F	286551	103046	389597	0.05767
Marinobacteraceae	2887365	F	2949	183	3132	0.00046
Enterobacteriaceae	543	F	16390	43122	59512	0.00881
Yersiniaceae	1903411	F	6346	8519	14865	0.00220
Erwiniaceae	1903409	F	4885	652	5537	0.00082
Pectobacteriaceae	1903410	F	3128	337	3465	0.00051
Hafniaceae	1903412	F	920	327	1247	0.00018
Morganellaceae	1903414	F	785	314	1099	0.00016
Bruguierivoracaceae	2812006	F	551	30	581	0.00009
Budviciaceae	1903416	F	130	13	143	0.00002
Ectothiorhodospiraceae	72276	F	13255	1110	14365	0.00213
Chromatiaceae	1046	F	9025	544	9569	0.00142
Wenzhouxiangellaceae	1676141	F	1563	1461	3024	0.00045
Thioalkalispiraceae	1096778	F	920	293	1213	0.00018
Thioalkalibacteraceae	2035710	F	908	201	1109	0.00016
Halothiobacillaceae	255526	F	606	45	651	0.00010
Woeseiaceae	1738654	F	502	7	509	0.00008
Granulosicoccaceae	449719	F	334	7	341	0.00005
Halomonadaceae	28256	F	18407	1609	20016	0.00296
Alcanivoracaceae	224372	F	2009	812	2821	0.00042
Oceanospirillaceae	135620	F	1222	115	1337	0.00020
Hahellaceae	224379	F	393	12	405	0.00006
Saccharospirillaceae	255527	F	385	16	401	0.00006
Litoricolaceae	449732	F	129	5	134	0.00002
Endozoicomonadaceae	2066474	F	45	2	47	0.00001
Oleiphilaceae	191033	F	31	2	33	0.00000
Zooshikellaceae	2898533	F	31	0	31	0.00000
Sinobacteraceae	568386	F	8606	781	9387	0.00139
Steroidobacteraceae	2689614	F	2953	634	3587	0.00053
Methylococcaceae	403	F	8934	325	9259	0.00137
Aeromonadaceae	84642	F	8161	5293	13454	0.00199
Succinivibrionaceae	83763	F	21	0	21	0.00000
Acidiferrobacteraceae	1692041	F	6194	249	6443	0.00095
Microbulbiferaceae	1706373	F	2463	114	2577	0.00038
Cellvibrionaceae	1706371	F	1485	42	1527	0.00023
Halieaceae	1706372	F	1075	81	1156	0.00017
Spongiibacteraceae	1706375	F	434	28	462	0.00007
Shewanellaceae	267890	F	2189	334	2523	0.00037
Alteromonadaceae	72275	F	1061	115	1176	0.00017
Pseudoalteromonadaceae	267888	F	640	69	709	0.00010
Ferrimonadaceae	267892	F	265	27	292	0.00004
Colwelliaceae	267889	F	149	11	160	0.00002
Idiomarinaceae	267893	F	127	10	137	0.00002
Moritellaceae	267891	F	40	6	46	0.00001
Psychromonadaceae	267894	F	34	3	37	0.00001
Vibrionaceae	641	F	2615	325	2940	0.00044
Immundisolibacteraceae	1934946	F	1534	1619	3153	0.00047
Celerinatantimonadaceae	412032	F	13	40	53	0.00001
Legionellaceae	444	F	866	41	907	0.00013
Coxiellaceae	118968	F	516	14	530	0.00008
Moraxellaceae	468	F	1386	359	1745	0.00026
Piscirickettsiaceae	135616	F	557	42	599	0.00009
Thiotrichaceae	135617	F	466	11	477	0.00007
Francisellaceae	34064	F	85	4	89	0.00001
Salinisphaeraceae	742031	F	1001	869	1870	0.00028
Pasteurellaceae	712	F	714	337	1051	0.00016
Cardiobacteriaceae	868	F	552	56	608	0.00009
Kangiellaceae	1920240	F	107	6	113	0.00002
Orbaceae	1240483	F	47	9	56	0.00001
Burkholderiaceae	119060	F	241682	78512	320194	0.04740
Comamonadaceae	80864	F	191920	49187	241107	0.03569
Oxalobacteraceae	75682	F	63711	6672	70383	0.01042
Alcaligenaceae	506	F	57138	61134	118272	0.01751
Sutterellaceae	995019	F	1083	75	1158	0.00017
Zoogloeaceae	2008794	F	17893	6057	23950	0.00355
Rhodocyclaceae	75787	F	13851	3851	17702	0.00262
Azonexaceae	2008795	F	4306	418	4724	0.00070
Fluviibacteraceae	2808923	F	137	41	178	0.00003
Usitatibacteraceae	2803844	F	15107	1078	16185	0.00240
Sterolibacteriaceae	2008793	F	5650	1332	6982	0.00103
Nitrosomonadaceae	206379	F	3036	106	3142	0.00047
Thiobacillaceae	2008790	F	2956	752	3708	0.00055
Gallionellaceae	90627	F	2924	328	3252	0.00048
Sulfuricellaceae	2772226	F	2263	266	2529	0.00037
Methylophilaceae	32011	F	1053	94	1147	0.00017
Chromobacteriaceae	1499392	F	14170	2430	16600	0.00246
Neisseriaceae	481	F	5994	1070	7064	0.00105
Casimicrobiaceae	2705999	F	933	369	1302	0.00019
Myxococcaceae	31	F	29350	10932	40282	0.00596
Anaeromyxobacteraceae	1524215	F	29158	2126	31284	0.00463
Archangiaceae	39	F	23819	1495	25314	0.00375
Vulgatibacteraceae	1524213	F	3139	257	3396	0.00050
Polyangiaceae	49	F	56052	4829	60881	0.00901
Sandaracinaceae	1055686	F	21131	1252	22383	0.00331
Labilitrichaceae	1524216	F	10412	554	10966	0.00162
Kofleriaceae	224464	F	8315	474	8789	0.00130
Geobacteraceae	213422	F	12986	1286	14272	0.00211
Desulfuromonadaceae	213421	F	3936	582	4518	0.00067
Syntrophotaleaceae	2812024	F	679	81	760	0.00011
Desulfovibrionaceae	194924	F	10625	1041	11666	0.00173
Desulfomicrobiaceae	213116	F	569	87	656	0.00010
Desulfohalobiaceae	213117	F	136	7	143	0.00002
Desulfobacteraceae	213119	F	2313	246	2559	0.00038
Desulfobulbaceae	213121	F	1108	176	1284	0.00019
Desulfosudaceae	2904715	F	285	18	303	0.00004
Desulfocapsaceae	2886822	F	158	15	173	0.00003
Bradymonadaceae	1779135	F	3172	402	3574	0.00053
Syntrophobacteraceae	213465	F	940	261	1201	0.00018
Desulfarculaceae	453228	F	788	550	1338	0.00020
Syntrophaceae	213468	F	469	96	565	0.00008
Candidatus Desulfofervidaceae	1902584	F	30	0	30	0.00000
Desulfurellaceae	117942	F	29	1	30	0.00000
Campylobacteraceae	72294	F	484	46	530	0.00008
Thiovulaceae	2771471	F	368	30	398	0.00006
Helicobacteraceae	72293	F	248	15	263	0.00004
Sulfurovaceae	2771472	F	193	15	208	0.00003
Hydrogenimonaceae	292630	F	132	12	144	0.00002
Arcobacteraceae	2808963	F	98	10	108	0.00002
Sulfurospirillaceae	2932623	F	73	3	76	0.00001
Nitratiruptoraceae	2795691	F	71	7	78	0.00001
Nautiliaceae	224467	F	54	7	61	0.00001
Acidithiobacillaceae	225058	F	880	61	941	0.00014
Bdellovibrionaceae	213483	F	711	10	721	0.00011
Halobacteriovoraceae	1652132	F	30	9	39	0.00001
Bacteriovoracaceae	263369	F	28	5	33	0.00000
Silvanigrellaceae	2024974	F	36	0	36	0.00001
Hydrogenophilaceae	206349	F	334	55	389	0.00006
Mariprofundaceae	580372	F	250	6	256	0.00004
Streptomycetaceae	2062	F	351238	79631	430869	0.06378
Micromonosporaceae	28056	F	292986	51309	344295	0.05097
Microbacteriaceae	85023	F	119751	17305	137056	0.02029
Micrococcaceae	1268	F	33510	8200	41710	0.00617
Cellulomonadaceae	85016	F	20614	7687	28301	0.00419
Promicromonosporaceae	85017	F	10143	4452	14595	0.00216
Intrasporangiaceae	85021	F	10105	3084	13189	0.00195
Ornithinimicrobiaceae	2805590	F	7666	1820	9486	0.00140
Dermabacteraceae	85020	F	6156	1358	7514	0.00111
Brevibacteriaceae	85019	F	5704	1330	7034	0.00104
Bogoriellaceae	145358	F	4049	1388	5437	0.00080
Dermacoccaceae	145357	F	3517	957	4474	0.00066
Ruaniaceae	1331736	F	3420	470	3890	0.00058
Beutenbergiaceae	125316	F	2526	4055	6581	0.00097
Sanguibacteraceae	145360	F	1644	576	2220	0.00033
Dermatophilaceae	85018	F	737	77	814	0.00012
Kytococcaceae	2805426	F	689	289	978	0.00014
Demequinaceae	1042322	F	384	34	418	0.00006
Jonesiaceae	85022	F	61	12	73	0.00001
Tropherymataceae	2805591	F	17	0	17	0.00000
Mycobacteriaceae	1762	F	87104	12380	99484	0.01473
Nocardiaceae	85025	F	49799	11014	60813	0.00900
Corynebacteriaceae	1653	F	16509	4386	20895	0.00309
Gordoniaceae	85026	F	12900	3143	16043	0.00237
Tsukamurellaceae	85028	F	4048	1168	5216	0.00077
Dietziaceae	85029	F	2512	2411	4923	0.00073
Segniliparaceae	316606	F	391	24	415	0.00006
Lawsonellaceae	2805586	F	58	7	65	0.00001
Pseudonocardiaceae	2070	F	123093	19714	142807	0.02114
Nocardioidaceae	85015	F	82197	18530	100727	0.01491
Propionibacteriaceae	31957	F	18690	11895	30585	0.00453
Kribbellaceae	2726069	F	5070	906	5976	0.00088
Actinopolymorphaceae	2805400	F	1873	246	2119	0.00031
Streptosporangiaceae	2004	F	61397	10819	72216	0.01069
Thermomonosporaceae	2012	F	31028	6721	37749	0.00559
Nocardiopsaceae	83676	F	10218	1721	11939	0.00177
Geodermatophilaceae	85030	F	10806	3113	13919	0.00206
Actinomycetaceae	2049	F	10318	1657	11975	0.00177
Frankiaceae	74712	F	9535	1020	10555	0.00156
Jiangellaceae	1217100	F	5604	1118	6722	0.00100
Bifidobacteriaceae	31953	F	4672	1309	5981	0.00089
Nakamurellaceae	85031	F	3063	436	3499	0.00052
Catenulisporaceae	414877	F	2231	369	2600	0.00038
Glycomycetaceae	85034	F	1651	148	1799	0.00027
Jatrophihabitantaceae	2805416	F	1598	156	1754	0.00026
Kineosporiaceae	83778	F	1088	341	1429	0.00021
Sporichthyaceae	85033	F	831	466	1297	0.00019
Actinopolysporaceae	622451	F	679	78	757	0.00011
Acidothermaceae	85032	F	530	28	558	0.00008
Candidatus Nanopelagicaceae	2162846	F	210	3	213	0.00003
Conexibacteraceae	320583	F	16358	2527	18885	0.00280
Miltoncostaeaceae	2843199	F	6050	826	6876	0.00102
Iamiaceae	633392	F	15938	2184	18122	0.00268
Ilumatobacteraceae	2448023	F	1541	96	1637	0.00024
Acidimicrobiaceae	84994	F	643	49	692	0.00010
Rubrobacteraceae	84997	F	10082	439	10521	0.00156
Baekduiaceae	2600303	F	5199	956	6155	0.00091
Eggerthellaceae	1643826	F	3943	683	4626	0.00068
Atopobiaceae	1643824	F	2109	489	2598	0.00038
Coriobacteriaceae	84107	F	859	191	1050	0.00016
Egicoccaceae	1755824	F	1609	270	1879	0.00028
Egibacteraceae	1747769	F	1523	97	1620	0.00024
Euzebyaceae	908622	F	1483	132	1615	0.00024
Bacillaceae	186817	F	25325	37975	63300	0.00937
Paenibacillaceae	186822	F	18870	1445	20315	0.00301
Alicyclobacillaceae	186823	F	2309	335	2644	0.00039
Planococcaceae	186818	F	958	280	1238	0.00018
Thermoactinomycetaceae	186824	F	911	101	1012	0.00015
Staphylococcaceae	90964	F	498	5039	5537	0.00082
Listeriaceae	186820	F	140	1958	2098	0.00031
Sporolactobacillaceae	186821	F	48	6	54	0.00001
Lactobacillaceae	33958	F	1326	510	1836	0.00027
Streptococcaceae	1300	F	525	6383	6908	0.00102
Enterococcaceae	81852	F	256	213	469	0.00007
Carnobacteriaceae	186828	F	104	29	133	0.00002
Aerococcaceae	186827	F	103	26	129	0.00002
Oscillospiraceae	216572	F	3348	1038	4386	0.00065
Clostridiales Family XVII. Incertae Sedis	539000	F	2616	558	3174	0.00047
Eubacteriales Family XIII. Incertae Sedis	543314	F	109	113	222	0.00003
Clostridiales Family XVI. Incertae Sedis	543347	F	34	11	45	0.00001
Symbiobacteriaceae	543349	F	1133	89	1222	0.00018
Lachnospiraceae	186803	F	1071	320	1391	0.00021
Clostridiaceae	31979	F	783	128	911	0.00013
Peptococcaceae	186807	F	577	45	622	0.00009
Christensenellaceae	990719	F	400	157	557	0.00008
Heliobacteriaceae	31984	F	284	94	378	0.00006
Desulfitobacteriaceae	2937909	F	284	23	307	0.00005
Eubacteriaceae	186806	F	282	43	325	0.00005
Peptostreptococcaceae	186804	F	123	1456	1579	0.00023
Syntrophomonadaceae	68298	F	116	4	120	0.00002
Desulfallaceae	2867375	F	57	4	61	0.00001
Desulfotomaculaceae	2937910	F	33	11	44	0.00001
Thermincolaceae	2937911	F	31	2	33	0.00000
Vallitaleaceae	2603322	F	27	1	28	0.00000
Thermohalobacteraceae	2848916	F	21	2	23	0.00000
Thermoanaerobacteraceae	186814	F	1323	163	1486	0.00022
Thermoanaerobacterales Family III. Incertae Sedis	543371	F	79	12	91	0.00001
Thermoanaerobacterales Family IV. Incertae Sedis	543372	F	25	10	35	0.00001
Zhaonellaceae	2748673	F	23	2	25	0.00000
Thermodesulfobiaceae	227387	F	10	0	10	0.00000
Halanaerobiaceae	972	F	77	59	136	0.00002
Halobacteroidaceae	53434	F	27	9	36	0.00001
Thermosediminibacteraceae	2770093	F	57	3	60	0.00001
Tepidanaerobacteraceae	2770092	F	37	1	38	0.00001
Natranaerofabaceae	2807496	F	20	1	21	0.00000
Koleobacteraceae	2786988	F	23	1	24	0.00000
Selenomonadaceae	1843491	F	1384	66	1450	0.00021
Sporomusaceae	1843490	F	154	11	165	0.00002
Veillonellaceae	31977	F	365	100	465	0.00007
Acidaminococcaceae	909930	F	199	45	244	0.00004
Limnochordaceae	1676650	F	926	34	960	0.00014
Erysipelotrichaceae	128827	F	241	52	293	0.00004
Turicibacteraceae	2810281	F	40	24	64	0.00001
Peptoniphilaceae	1570339	F	155	70	225	0.00003
Tissierellaceae	1737406	F	30	3	33	0.00000
Gottschalkiaceae	2042895	F	27	179	206	0.00003
Deinococcaceae	183710	F	11029	509	11538	0.00171
Thermaceae	188786	F	4837	281	5118	0.00076
Trueperaceae	332247	F	880	47	927	0.00014
Synechococcaceae	1890426	F	4961	464	5425	0.00080
Prochlorococcaceae	2881426	F	1135	228	1363	0.00020
Acaryochloridaceae	1890429	F	90	2	92	0.00001
Chamaesiphonaceae	1890431	F	61	2	63	0.00001
Merismopediaceae	1890428	F	55	2	57	0.00001
Nostocaceae	1162	F	962	278	1240	0.00018
Calotrichaceae	2661849	F	524	40	564	0.00008
Aphanizomenonaceae	1892259	F	256	168	424	0.00006
Scytonemataceae	1182	F	245	24	269	0.00004
Tolypothrichaceae	119859	F	104	16	120	0.00002
Hapalosiphonaceae	1892263	F	101	12	113	0.00002
Rivulariaceae	1185	F	23	1	24	0.00000
Leptolyngbyaceae	1890438	F	1360	306	1666	0.00025
Oculatellaceae	2303507	F	213	9	222	0.00003
Prochlorotrichaceae	2303730	F	123	4	127	0.00002
Thermosynechococcaceae	2881378	F	108	8	116	0.00002
Pseudanabaenaceae	1890436	F	70	2	72	0.00001
Gloeobacteraceae	1890422	F	1586	29	1615	0.00024
Oscillatoriaceae	1892254	F	367	39	406	0.00006
Coleofasciculaceae	1892251	F	304	37	341	0.00005
Microcoleaceae	1892252	F	202	123	325	0.00005
Sirenicapillariaceae	2934961	F	26	3	29	0.00000
Gomontiellaceae	1892255	F	22	2	24	0.00000
Microcystaceae	1890449	F	136	48	184	0.00003
Aphanothecaceae	1890450	F	121	15	136	0.00002
Chroococcaceae	1890464	F	96	15	111	0.00002
Chroococcidiopsidaceae	1890528	F	180	22	202	0.00003
Hyellaceae	1890500	F	39	3	42	0.00001
Dermocarpellaceae	1890498	F	26	1	27	0.00000
Thermostichaceae	2881384	F	32	3	35	0.00001
Gloeomargaritaceae	1955043	F	31	9	40	0.00001
Sphaerobacteraceae	85002	F	2323	142	2465	0.00037
Thermomicrobiaceae	189777	F	553	12	565	0.00008
Roseiflexaceae	1508635	F	1774	100	1874	0.00028
Chloroflexaceae	1106	F	574	22	596	0.00009
Ardenticatenaceae	1382930	F	1526	29	1555	0.00023
Tepidiformaceae	2682227	F	1520	61	1581	0.00023
Anaerolineaceae	292628	F	1091	22	1113	0.00016
Caldilineaceae	475964	F	789	351	1140	0.00017
Dehalococcoidaceae	1202464	F	156	5	161	0.00002
Phototrophicaceae	2922432	F	441	4	445	0.00007
Ktedonosporobacteraceae	2692416	F	317	322	639	0.00009
Fimbriimonadaceae	1663426	F	1712	8	1720	0.00025
Chthonomonadaceae	1077264	F	236	1	237	0.00004
Mycoplasmataceae	2092	F	195	37	232	0.00003
Spiroplasmataceae	2131	F	61	4	65	0.00001
Entomoplasmataceae	33925	F	18	27	45	0.00001
Acholeplasmataceae	2146	F	70	4	74	0.00001
Gemmataceae	1914233	F	58910	1829	60739	0.00899
Planctomycetaceae	126	F	29210	2177	31387	0.00465
Isosphaeraceae	1763524	F	25612	2733	28345	0.00420
Lacipirellulaceae	2691359	F	12515	620	13135	0.00194
Pirellulaceae	2691357	F	10592	476	11068	0.00164
Thermoguttaceae	2691358	F	266	8	274	0.00004
Tepidisphaeraceae	1771355	F	3738	92	3830	0.00057
Phycisphaeraceae	666507	F	2623	153	2776	0.00041
Anaerohalosphaeraceae	2690158	F	168	3	171	0.00003
Sedimentisphaeraceae	2483367	F	113	22	135	0.00002
Candidatus Brocadiaceae	1127830	F	60	0	60	0.00001
Candidatus Uabimicrobiaceae	2897348	F	31	0	31	0.00000
Opitutaceae	134623	F	24905	868	25773	0.00382
Puniceicoccaceae	415002	F	532	54	586	0.00009
Verrucomicrobiaceae	203557	F	6373	202	6575	0.00097
Akkermansiaceae	1647988	F	674	595	1269	0.00019
Methylacidiphilaceae	717964	F	57	57	114	0.00002
Kiritimatiellaceae	1921783	F	409	443	852	0.00013
Tichowtungiaceae	2907186	F	145	8	153	0.00002
Parachlamydiaceae	92713	F	133	10	143	0.00002
Rhabdochlamydiaceae	689704	F	62	3	65	0.00001
Simkaniaceae	92712	F	32	2	34	0.00001
Waddliaceae	92714	F	32	4	36	0.00001
Chlamydiaceae	809	F	73	153	226	0.00003
Gemmatimonadaceae	219687	F	114490	6037	120527	0.01784
Hymenobacteraceae	1853232	F	12277	551	12828	0.00190
Cytophagaceae	89373	F	2062	100	2162	0.00032
Spirosomaceae	2896860	F	1834	112	1946	0.00029
Fulvivirgaceae	2762286	F	978	32	1010	0.00015
Cyclobacteriaceae	563798	F	471	53	524	0.00008
Amoebophilaceae	1501348	F	87	2	89	0.00001
Flammeovirgaceae	200667	F	51	3	54	0.00001
Mangrovivirgaceae	2858885	F	26	1	27	0.00000
Bernardetiaceae	1937968	F	21	1	22	0.00000
Marivirgaceae	2762301	F	21	7	28	0.00000
Flavobacteriaceae	49546	F	8988	588	9576	0.00142
Weeksellaceae	2762318	F	1573	459	2032	0.00030
Blattabacteriaceae	39782	F	104	8	112	0.00002
Crocinitomicaceae	1853230	F	66	3	69	0.00001
Schleiferiaceae	1333713	F	56	33	89	0.00001
Chitinophagaceae	563835	F	10726	163	10889	0.00161
Rhodothermaceae	563843	F	6964	323	7287	0.00108
Rikenellaceae	171550	F	2325	810	3135	0.00046
Prevotellaceae	171552	F	878	124	1002	0.00015
Bacteroidaceae	815	F	803	378	1181	0.00017
Tannerellaceae	2005525	F	423	136	559	0.00008
Muribaculaceae	2005473	F	400	85	485	0.00007
Porphyromonadaceae	171551	F	292	29	321	0.00005
Dysgonomonadaceae	2005520	F	156	5	161	0.00002
Odoribacteraceae	1853231	F	92	25	117	0.00002
Barnesiellaceae	2005519	F	80	103	183	0.00003
Paludibacteraceae	2005523	F	26	0	26	0.00000
Salinivirgaceae	1970190	F	17	0	17	0.00000
Tenuifilaceae	2760872	F	11	0	11	0.00000
Prolixibacteraceae	1471398	F	99	2	101	0.00001
Marinilabiliaceae	558415	F	22	1	23	0.00000
Marinifilaceae	1573805	F	13	0	13	0.00000
Sphingobacteriaceae	84566	F	3148	372	3520	0.00052
Haliscomenobacteraceae	1937961	F	147	1	148	0.00002
Saprospiraceae	89374	F	29	49	78	0.00001
Chlorobiaceae	191412	F	1973	265	2238	0.00033
Melioribacteraceae	1334117	F	47	3	50	0.00001
Ignavibacteriaceae	795749	F	37	3	40	0.00001
Fibrobacteraceae	204431	F	73	64	137	0.00002
Vicinamibacteraceae	2211325	F	40449	2088	42537	0.00630
Acidobacteriaceae	204434	F	16253	362	16615	0.00246
Bryobacteraceae	1962910	F	3397	1717	5114	0.00076
Acanthopleuribacteraceae	533207	F	1067	22	1089	0.00016
Thermotomaculaceae	2562244	F	31	1	32	0.00000
Nitrospiraceae	189779	F	3191	43	3234	0.00048
Dissulfurispiraceae	2811505	F	40	1	41	0.00001
Thermodesulfovibrionaceae	2811504	F	35	0	35	0.00001
Treponemataceae	2845253	F	528	84	612	0.00009
Spirochaetaceae	137	F	456	10	466	0.00007
Sphaerochaetaceae	2791015	F	129	79	208	0.00003
Borreliaceae	1643685	F	47	0	47	0.00001
Leptospiraceae	170	F	442	22	464	0.00007
Brachyspiraceae	143786	F	23	0	23	0.00000
Synergistaceae	649777	F	1252	97	1349	0.00020
Candidatus Nanosynbacteraceae	2093822	F	211	617	828	0.00012
Candidatus Chazhemtobacteraceae	2715733	F	79	0	79	0.00001
Candidatus Babeliaceae	2497645	F	39	0	39	0.00001
Candidatus Absconditicoccaceae	2900569	F	17	0	17	0.00000
Thermotogaceae	188709	F	163	33	196	0.00003
Fervidobacteriaceae	1643950	F	60	11	71	0.00001
Kosmotogaceae	1643948	F	76	1	77	0.00001
Petrotogaceae	1643949	F	43	10	53	0.00001
Mesoaciditogaceae	1769717	F	18	0	18	0.00000
Hydrogenothermaceae	224027	F	112	4	116	0.00002
Aquificaceae	64898	F	103	39	142	0.00002
Desulfurobacteriaceae	558314	F	58	2	60	0.00001
Deferribacteraceae	191394	F	189	4	193	0.00003
Thermodesulfobacteriaceae	188711	F	186	3	189	0.00003
Calditrichaceae	1962854	F	165	1	166	0.00002
Fusobacteriaceae	203492	F	85	19	104	0.00002
Leptotrichiaceae	1129771	F	71	12	83	0.00001
Chrysiogenaceae	189770	F	102	42	144	0.00002
Endomicrobiaceae	1783343	F	43	0	43	0.00001
Elusimicrobiaceae	641876	F	42	0	42	0.00001
Dictyoglomaceae	203488	F	35	0	35	0.00001
Caldisericaceae	693073	F	31	0	31	0.00000
Coprothermobacteraceae	2138247	F	30	5	35	0.00001
Atribacteraceae	2847776	F	25	0	25	0.00000
Nectriaceae	110618	F	3090	216	3306	0.00049
Hypocreaceae	5129	F	1398	82	1480	0.00022
Clavicipitaceae	34397	F	1366	155	1521	0.00023
Cordycipitaceae	474943	F	1183	42	1225	0.00018
Ophiocordycipitaceae	474942	F	725	43	768	0.00011
Bionectriaceae	103887	F	136	11	147	0.00002
Glomerellaceae	681950	F	368	89	457	0.00007
Chaetomiaceae	35718	F	2441	130	2571	0.00038
Sordariaceae	5148	F	330	27	357	0.00005
Pyriculariaceae	2528436	F	484	5	489	0.00007
Sporocadaceae	1812776	F	260	4	264	0.00004
Sclerotiniaceae	28983	F	73	0	73	0.00001
Aspergillaceae	1131492	F	978	52	1030	0.00015
Thermoascaceae	1131624	F	98	4	102	0.00002
Trichocomaceae	28568	F	59	4	63	0.00001
Didymosphaeriaceae	221678	F	154	52	206	0.00003
Leptosphaeriaceae	34374	F	93	10	103	0.00002
Mycosphaerellaceae	93133	F	141	1	142	0.00002
Saccharomycetaceae	4893	F	246	34	280	0.00004
Debaryomycetaceae	766764	F	60	0	60	0.00001
Pichiaceae	1156497	F	53	1	54	0.00001
Dipodascaceae	34353	F	46	0	46	0.00001
Trichomonascaceae	410830	F	17	1	18	0.00000
Phaffomycetaceae	115784	F	10	0	10	0.00000
Ustilaginaceae	5268	F	921	26	947	0.00014
Malasseziaceae	742845	F	52	10	62	0.00001
Phanerochaetaceae	396331	F	157	2	159	0.00002
Ceratobasidiaceae	5250	F	34	2	36	0.00001
Marasmiaceae	654128	F	20	1	21	0.00000
Cryptococcaceae	1884633	F	49	9	58	0.00001
Unikaryonidae	36734	F	10	0	10	0.00000
Peronosporaceae	4777	F	1455	153	1608	0.00024
Pythiaceae	4782	F	141	4	145	0.00002
