name	taxonomy_id	taxonomy_lvl	kraken_assigned_reads	added_reads	new_est_reads	fraction_total_reads
Bradyrhizobiaceae	41294	F	405012	35357	440369	0.02811
Rhizobiaceae	82115	F	216127	73739	289866	0.01850
Phyllobacteriaceae	69277	F	195147	34124	229271	0.01464
Methylobacteriaceae	119045	F	188497	27973	216470	0.01382
Xanthobacteraceae	335928	F	68564	12521	81085	0.00518
Hyphomicrobiaceae	45401	F	54813	5465	60278	0.00385
Boseaceae	2831100	F	40825	6522	47347	0.00302
Devosiaceae	2831106	F	38050	3269	41319	0.00264
Aurantimonadaceae	255475	F	34482	7124	41606	0.00266
Methylocystaceae	31993	F	22264	25597	47861	0.00306
Stappiaceae	2821832	F	19845	4596	24441	0.00156
Phreatobacteraceae	2843305	F	18364	3274	21638	0.00138
Parvibaculaceae	2813035	F	14755	3266	18021	0.00115
Chelatococcaceae	2036754	F	13942	3375	17317	0.00111
Blastochloridaceae	2831090	F	10755	2632	13387	0.00085
Beijerinckiaceae	45404	F	10110	766	10876	0.00069
Amorphaceae	2685818	F	7440	837	8277	0.00053
Kaistiaceae	2831111	F	6090	1557	7647	0.00049
Brucellaceae	118882	F	5990	11513	17503	0.00112
Pleomorphomonadaceae	2843308	F	4125	762	4887	0.00031
Breoghaniaceae	2831104	F	3996	544	4540	0.00029
Lichenihabitantaceae	2723775	F	3669	183	3852	0.00025
Cohaesibacteraceae	655351	F	713	30	743	0.00005
Bartonellaceae	772	F	626	37	663	0.00004
Sphingomonadaceae	41297	F	863276	101951	965227	0.06162
Erythrobacteraceae	335929	F	99092	18722	117814	0.00752
Sphingosinicellaceae	2820280	F	35965	3241	39206	0.00250
Zymomonadaceae	2844881	F	201	173	374	0.00002
Azospirillaceae	2829815	F	125031	13076	138107	0.00882
Acetobacteraceae	433	F	109572	13357	122929	0.00785
Rhodospirillaceae	41295	F	67914	284246	352160	0.02248
Stellaceae	2844601	F	13449	930	14379	0.00092
Elioraeaceae	2690195	F	6503	330	6833	0.00044
Thalassospiraceae	2844866	F	3530	218	3748	0.00024
Terasakiellaceae	2813951	F	158	4	162	0.00001
Rhodobacteraceae	31989	F	120435	16616	137051	0.00875
Roseobacteraceae	2854170	F	79462	9361	88823	0.00567
Caulobacteraceae	76892	F	146041	30110	176151	0.01125
Hyphomonadaceae	69657	F	7884	279	8163	0.00052
Maricaulaceae	2800061	F	6726	682	7408	0.00047
Parvularculaceae	255474	F	2098	138	2236	0.00014
Anaplasmataceae	942	F	512	7	519	0.00003
Rickettsiaceae	775	F	427	27	454	0.00003
Candidatus Midichloriaceae	1328881	F	53	3	56	0.00000
Candidatus Deianiraeaceae	2603433	F	34	35	69	0.00000
Emcibacteraceae	2066491	F	971	97	1068	0.00007
Holosporaceae	44746	F	202	4	206	0.00001
Caedimonadaceae	2100208	F	86	4	90	0.00001
Candidatus Paracaedibacteraceae	1777752	F	74	2	76	0.00000
Magnetococcaceae	1191479	F	284	92	376	0.00002
Pelagibacteraceae	1655514	F	68	2	70	0.00000
Kordiimonadaceae	1331809	F	108	2	110	0.00001
Burkholderiaceae	119060	F	388234	183436	571670	0.03649
Comamonadaceae	80864	F	359852	118410	478262	0.03053
Oxalobacteraceae	75682	F	129499	16269	145768	0.00931
Alcaligenaceae	506	F	107669	161981	269650	0.01721
Sutterellaceae	995019	F	2424	218	2642	0.00017
Zoogloeaceae	2008794	F	42293	16847	59140	0.00378
Rhodocyclaceae	75787	F	33231	10795	44026	0.00281
Azonexaceae	2008795	F	10640	1162	11802	0.00075
Fluviibacteraceae	2808923	F	267	98	365	0.00002
Usitatibacteraceae	2803844	F	28363	2288	30651	0.00196
Sterolibacteriaceae	2008793	F	12697	3470	16167	0.00103
Nitrosomonadaceae	206379	F	8918	359	9277	0.00059
Thiobacillaceae	2008790	F	6998	2077	9075	0.00058
Gallionellaceae	90627	F	6328	765	7093	0.00045
Sulfuricellaceae	2772226	F	5131	656	5787	0.00037
Methylophilaceae	32011	F	1799	179	1978	0.00013
Chromobacteriaceae	1499392	F	32885	6700	39585	0.00253
Neisseriaceae	481	F	14169	2988	17157	0.00110
Casimicrobiaceae	2705999	F	2191	1076	3267	0.00021
Pseudomonadaceae	135621	F	441144	155270	596414	0.03807
Marinobacteraceae	2887365	F	7256	563	7819	0.00050
Xanthomonadaceae	32033	F	342209	66397	408606	0.02608
Rhodanobacteraceae	1775411	F	52815	8771	61586	0.00393
Enterobacteriaceae	543	F	41477	123632	165109	0.01054
Yersiniaceae	1903411	F	15500	15955	31455	0.00201
Erwiniaceae	1903409	F	11379	1972	13351	0.00085
Pectobacteriaceae	1903410	F	7528	1250	8778	0.00056
Morganellaceae	1903414	F	2746	2087	4833	0.00031
Hafniaceae	1903412	F	2271	492	2763	0.00018
Bruguierivoracaceae	2812006	F	1328	89	1417	0.00009
Budviciaceae	1903416	F	297	39	336	0.00002
Ectothiorhodospiraceae	72276	F	32626	3128	35754	0.00228
Chromatiaceae	1046	F	23555	1670	25225	0.00161
Wenzhouxiangellaceae	1676141	F	3825	3472	7297	0.00047
Thioalkalibacteraceae	2035710	F	2214	572	2786	0.00018
Thioalkalispiraceae	1096778	F	1963	750	2713	0.00017
Halothiobacillaceae	255526	F	1237	107	1344	0.00009
Woeseiaceae	1738654	F	1133	20	1153	0.00007
Granulosicoccaceae	449719	F	868	20	888	0.00006
Halomonadaceae	28256	F	47783	5245	53028	0.00339
Alcanivoracaceae	224372	F	5004	2415	7419	0.00047
Oceanospirillaceae	135620	F	3108	343	3451	0.00022
Hahellaceae	224379	F	938	37	975	0.00006
Saccharospirillaceae	255527	F	874	45	919	0.00006
Litoricolaceae	449732	F	345	17	362	0.00002
Zooshikellaceae	2898533	F	228	7	235	0.00002
Endozoicomonadaceae	2066474	F	135	8	143	0.00001
Oleiphilaceae	191033	F	111	9	120	0.00001
Methylococcaceae	403	F	22329	1018	23347	0.00149
Aeromonadaceae	84642	F	21478	14744	36222	0.00231
Succinivibrionaceae	83763	F	37	2	39	0.00000
Sinobacteraceae	568386	F	13076	1567	14643	0.00093
Steroidobacteraceae	2689614	F	7338	1957	9295	0.00059
Acidiferrobacteraceae	1692041	F	14953	740	15693	0.00100
Microbulbiferaceae	1706373	F	6156	353	6509	0.00042
Cellvibrionaceae	1706371	F	2707	90	2797	0.00018
Halieaceae	1706372	F	2697	258	2955	0.00019
Spongiibacteraceae	1706375	F	1118	89	1207	0.00008
Shewanellaceae	267890	F	5590	960	6550	0.00042
Alteromonadaceae	72275	F	2484	484	2968	0.00019
Pseudoalteromonadaceae	267888	F	1612	207	1819	0.00012
Ferrimonadaceae	267892	F	699	78	777	0.00005
Idiomarinaceae	267893	F	371	40	411	0.00003
Colwelliaceae	267889	F	305	23	328	0.00002
Moritellaceae	267891	F	95	11	106	0.00001
Psychromonadaceae	267894	F	81	6	87	0.00001
Vibrionaceae	641	F	6195	3204	9399	0.00060
Moraxellaceae	468	F	3863	1989	5852	0.00037
Immundisolibacteraceae	1934946	F	3657	4062	7719	0.00049
Celerinatantimonadaceae	412032	F	42	137	179	0.00001
Piscirickettsiaceae	135616	F	1278	118	1396	0.00009
Thiotrichaceae	135617	F	1032	31	1063	0.00007
Francisellaceae	34064	F	200	10	210	0.00001
Legionellaceae	444	F	1454	76	1530	0.00010
Coxiellaceae	118968	F	1025	25	1050	0.00007
Salinisphaeraceae	742031	F	2293	2118	4411	0.00028
Pasteurellaceae	712	F	1290	427	1717	0.00011
Cardiobacteriaceae	868	F	1232	162	1394	0.00009
Kangiellaceae	1920240	F	219	14	233	0.00001
Orbaceae	1240483	F	78	18	96	0.00001
Archangiaceae	39	F	108248	6069	114317	0.00730
Myxococcaceae	31	F	88847	39754	128601	0.00821
Anaeromyxobacteraceae	1524215	F	80987	6332	87319	0.00557
Vulgatibacteraceae	1524213	F	7739	651	8390	0.00054
Polyangiaceae	49	F	135374	11291	146665	0.00936
Sandaracinaceae	1055686	F	42274	2473	44747	0.00286
Labilitrichaceae	1524216	F	13120	632	13752	0.00088
Kofleriaceae	224464	F	15742	896	16638	0.00106
Geobacteraceae	213422	F	38129	3966	42095	0.00269
Desulfuromonadaceae	213421	F	11878	1900	13778	0.00088
Syntrophotaleaceae	2812024	F	1964	255	2219	0.00014
Desulfovibrionaceae	194924	F	32573	3086	35659	0.00228
Desulfomicrobiaceae	213116	F	1885	262	2147	0.00014
Desulfohalobiaceae	213117	F	491	25	516	0.00003
Desulfobacteraceae	213119	F	7825	844	8669	0.00055
Desulfobulbaceae	213121	F	3371	524	3895	0.00025
Desulfosudaceae	2904715	F	953	61	1014	0.00006
Desulfocapsaceae	2886822	F	544	57	601	0.00004
Bradymonadaceae	1779135	F	8153	1183	9336	0.00060
Syntrophobacteraceae	213465	F	3058	799	3857	0.00025
Desulfarculaceae	453228	F	2681	1687	4368	0.00028
Syntrophaceae	213468	F	1547	369	1916	0.00012
Candidatus Desulfofervidaceae	1902584	F	184	4	188	0.00001
Desulfurellaceae	117942	F	67	3	70	0.00000
Campylobacteraceae	72294	F	1139	129	1268	0.00008
Thiovulaceae	2771471	F	894	55	949	0.00006
Helicobacteraceae	72293	F	759	251	1010	0.00006
Sulfurovaceae	2771472	F	577	45	622	0.00004
Hydrogenimonaceae	292630	F	326	31	357	0.00002
Sulfurospirillaceae	2932623	F	213	10	223	0.00001
Arcobacteraceae	2808963	F	188	23	211	0.00001
Nitratiruptoraceae	2795691	F	235	25	260	0.00002
Nautiliaceae	224467	F	143	19	162	0.00001
Acidithiobacillaceae	225058	F	2504	231	2735	0.00017
Bdellovibrionaceae	213483	F	1002	14	1016	0.00006
Bacteriovoracaceae	263369	F	56	18	74	0.00000
Halobacteriovoraceae	1652132	F	49	23	72	0.00000
Silvanigrellaceae	2024974	F	51	1	52	0.00000
Hydrogenophilaceae	206349	F	813	167	980	0.00006
Mariprofundaceae	580372	F	545	16	561	0.00004
Streptomycetaceae	2062	F	1265160	318285	1583445	0.10109
Microbacteriaceae	85023	F	367116	66569	433685	0.02769
Micrococcaceae	1268	F	132067	35110	167177	0.01067
Cellulomonadaceae	85016	F	67954	26624	94578	0.00604
Intrasporangiaceae	85021	F	38576	12724	51300	0.00327
Promicromonosporaceae	85017	F	37084	17004	54088	0.00345
Ornithinimicrobiaceae	2805590	F	30694	7644	38338	0.00245
Dermabacteraceae	85020	F	21172	4775	25947	0.00166
Brevibacteriaceae	85019	F	20359	4917	25276	0.00161
Bogoriellaceae	145358	F	16407	5927	22334	0.00143
Ruaniaceae	1331736	F	13086	1926	15012	0.00096
Dermacoccaceae	145357	F	11539	3222	14761	0.00094
Beutenbergiaceae	125316	F	7995	13465	21460	0.00137
Sanguibacteraceae	145360	F	5123	1883	7006	0.00045
Dermatophilaceae	85018	F	2922	334	3256	0.00021
Kytococcaceae	2805426	F	2664	1178	3842	0.00025
Demequinaceae	1042322	F	1050	102	1152	0.00007
Jonesiaceae	85022	F	233	50	283	0.00002
Tropherymataceae	2805591	F	74	0	74	0.00000
Mycobacteriaceae	1762	F	315995	55428	371423	0.02371
Nocardiaceae	85025	F	179472	44531	224003	0.01430
Corynebacteriaceae	1653	F	56986	17707	74693	0.00477
Gordoniaceae	85026	F	42996	10873	53869	0.00344
Tsukamurellaceae	85028	F	12663	3879	16542	0.00106
Dietziaceae	85029	F	8223	7888	16111	0.00103
Segniliparaceae	316606	F	1191	79	1270	0.00008
Lawsonellaceae	2805586	F	222	30	252	0.00002
Pseudonocardiaceae	2070	F	550330	100645	650975	0.04156
Micromonosporaceae	28056	F	524796	91191	615987	0.03932
Nocardioidaceae	85015	F	321965	80738	402703	0.02571
Propionibacteriaceae	31957	F	79044	17775	96819	0.00618
Kribbellaceae	2726069	F	17672	3544	21216	0.00135
Actinopolymorphaceae	2805400	F	7674	1133	8807	0.00056
Thermomonosporaceae	2012	F	100148	24462	124610	0.00795
Streptosporangiaceae	2004	F	99603	20419	120022	0.00766
Nocardiopsaceae	83676	F	46472	9602	56074	0.00358
Geodermatophilaceae	85030	F	68989	21955	90944	0.00581
Actinomycetaceae	2049	F	38470	6659	45129	0.00288
Frankiaceae	74712	F	37805	4453	42258	0.00270
Jiangellaceae	1217100	F	34172	7422	41594	0.00266
Bifidobacteriaceae	31953	F	14623	4738	19361	0.00124
Nakamurellaceae	85031	F	13493	2256	15749	0.00101
Catenulisporaceae	414877	F	7429	1359	8788	0.00056
Jatrophihabitantaceae	2805416	F	5908	646	6554	0.00042
Glycomycetaceae	85034	F	5870	591	6461	0.00041
Kineosporiaceae	83778	F	4638	1608	6246	0.00040
Sporichthyaceae	85033	F	2630	1614	4244	0.00027
Actinopolysporaceae	622451	F	2576	329	2905	0.00019
Acidothermaceae	85032	F	1998	122	2120	0.00014
Candidatus Nanopelagicaceae	2162846	F	512	10	522	0.00003
Rubrobacteraceae	84997	F	124822	6129	130951	0.00836
Baekduiaceae	2600303	F	17179	3448	20627	0.00132
Iamiaceae	633392	F	80866	11943	92809	0.00592
Ilumatobacteraceae	2448023	F	6765	469	7234	0.00046
Acidimicrobiaceae	84994	F	2492	216	2708	0.00017
Conexibacteraceae	320583	F	64825	10830	75655	0.00483
Miltoncostaeaceae	2843199	F	23717	3570	27287	0.00174
Eggerthellaceae	1643826	F	11539	2215	13754	0.00088
Atopobiaceae	1643824	F	6355	1651	8006	0.00051
Coriobacteriaceae	84107	F	2608	685	3293	0.00021
Euzebyaceae	908622	F	7266	747	8013	0.00051
Egicoccaceae	1755824	F	7025	1321	8346	0.00053
Egibacteraceae	1747769	F	6097	444	6541	0.00042
Bacillaceae	186817	F	68172	82750	150922	0.00963
Paenibacillaceae	186822	F	48641	4466	53107	0.00339
Alicyclobacillaceae	186823	F	6268	1086	7354	0.00047
Planococcaceae	186818	F	2598	879	3477	0.00022
Staphylococcaceae	90964	F	2277	4101	6378	0.00041
Thermoactinomycetaceae	186824	F	2181	1995	4176	0.00027
Listeriaceae	186820	F	332	2593	2925	0.00019
Sporolactobacillaceae	186821	F	102	17	119	0.00001
Lactobacillaceae	33958	F	3850	1813	5663	0.00036
Streptococcaceae	1300	F	1278	1124	2402	0.00015
Enterococcaceae	81852	F	812	1370	2182	0.00014
Aerococcaceae	186827	F	318	89	407	0.00003
Carnobacteriaceae	186828	F	230	84	314	0.00002
Clostridiales Family XVII. Incertae Sedis	539000	F	8883	1965	10848	0.00069
Eubacteriales Family XIII. Incertae Sedis	543314	F	315	471	786	0.00005
Clostridiales Family XVI. Incertae Sedis	543347	F	123	68	191	0.00001
Oscillospiraceae	216572	F	9746	3916	13662	0.00087
Symbiobacteriaceae	543349	F	3414	326	3740	0.00024
Lachnospiraceae	186803	F	2949	1137	4086	0.00026
Clostridiaceae	31979	F	2469	436	2905	0.00019
Peptococcaceae	186807	F	1998	207	2205	0.00014
Christensenellaceae	990719	F	1039	509	1548	0.00010
Heliobacteriaceae	31984	F	960	415	1375	0.00009
Eubacteriaceae	186806	F	906	166	1072	0.00007
Desulfitobacteriaceae	2937909	F	762	84	846	0.00005
Syntrophomonadaceae	68298	F	363	18	381	0.00002
Peptostreptococcaceae	186804	F	275	1991	2266	0.00014
Desulfallaceae	2867375	F	177	16	193	0.00001
Thermincolaceae	2937911	F	121	11	132	0.00001
Desulfotomaculaceae	2937910	F	98	41	139	0.00001
Vallitaleaceae	2603322	F	65	5	70	0.00000
Thermohalobacteraceae	2848916	F	49	7	56	0.00000
Proteinivoraceae	1491775	F	33	4	37	0.00000
Thermoanaerobacteraceae	186814	F	4027	563	4590	0.00029
Thermoanaerobacterales Family III. Incertae Sedis	543371	F	208	44	252	0.00002
Thermoanaerobacterales Family IV. Incertae Sedis	543372	F	127	67	194	0.00001
Zhaonellaceae	2748673	F	126	19	145	0.00001
Thermodesulfobiaceae	227387	F	95	1	96	0.00001
Halanaerobiaceae	972	F	183	155	338	0.00002
Halobacteroidaceae	53434	F	103	8	111	0.00001
Tepidanaerobacteraceae	2770092	F	166	8	174	0.00001
Thermosediminibacteraceae	2770093	F	156	12	168	0.00001
Natranaerofabaceae	2807496	F	66	3	69	0.00000
Natranaerobiaceae	485255	F	47	6	53	0.00000
Koleobacteraceae	2786988	F	107	9	116	0.00001
Selenomonadaceae	1843491	F	3755	209	3964	0.00025
Sporomusaceae	1843490	F	448	37	485	0.00003
Veillonellaceae	31977	F	1080	401	1481	0.00009
Acidaminococcaceae	909930	F	587	134	721	0.00005
Limnochordaceae	1676650	F	3515	158	3673	0.00023
Peptoniphilaceae	1570339	F	381	243	624	0.00004
Tissierellaceae	1737406	F	82	13	95	0.00001
Gottschalkiaceae	2042895	F	62	331	393	0.00003
Erysipelotrichaceae	128827	F	601	191	792	0.00005
Turicibacteraceae	2810281	F	29	318	347	0.00002
Deinococcaceae	183710	F	31178	2077	33255	0.00212
Thermaceae	188786	F	15510	998	16508	0.00105
Trueperaceae	332247	F	2575	149	2724	0.00017
Synechococcaceae	1890426	F	15393	1683	17076	0.00109
Prochlorococcaceae	2881426	F	3667	842	4509	0.00029
Acaryochloridaceae	1890429	F	246	7	253	0.00002
Merismopediaceae	1890428	F	232	15	247	0.00002
Chamaesiphonaceae	1890431	F	224	12	236	0.00002
Nostocaceae	1162	F	3692	1223	4915	0.00031
Calotrichaceae	2661849	F	1528	134	1662	0.00011
Scytonemataceae	1182	F	1013	119	1132	0.00007
Aphanizomenonaceae	1892259	F	755	490	1245	0.00008
Tolypothrichaceae	119859	F	275	53	328	0.00002
Hapalosiphonaceae	1892263	F	218	29	247	0.00002
Rivulariaceae	1185	F	66	3	69	0.00000
Leptolyngbyaceae	1890438	F	5039	349	5388	0.00034
Oculatellaceae	2303507	F	674	57	731	0.00005
Prochlorotrichaceae	2303730	F	404	16	420	0.00003
Thermosynechococcaceae	2881378	F	378	37	415	0.00003
Pseudanabaenaceae	1890436	F	184	8	192	0.00001
Gloeobacteraceae	1890422	F	5397	121	5518	0.00035
Oscillatoriaceae	1892254	F	1107	131	1238	0.00008
Coleofasciculaceae	1892251	F	973	132	1105	0.00007
Microcoleaceae	1892252	F	617	343	960	0.00006
Gomontiellaceae	1892255	F	80	9	89	0.00001
Sirenicapillariaceae	2934961	F	53	2	55	0.00000
Microcystaceae	1890449	F	459	132	591	0.00004
Aphanothecaceae	1890450	F	346	37	383	0.00002
Chroococcaceae	1890464	F	224	25	249	0.00002
Geminocystaceae	2815910	F	50	12	62	0.00000
Chroococcidiopsidaceae	1890528	F	729	113	842	0.00005
Hyellaceae	1890500	F	137	15	152	0.00001
Dermocarpellaceae	1890498	F	57	4	61	0.00000
Gloeomargaritaceae	1955043	F	150	5	155	0.00001
Thermostichaceae	2881384	F	97	41	138	0.00001
Sphaerobacteraceae	85002	F	7958	489	8447	0.00054
Thermomicrobiaceae	189777	F	1824	36	1860	0.00012
Roseiflexaceae	1508635	F	3980	250	4230	0.00027
Chloroflexaceae	1106	F	1586	71	1657	0.00011
Tepidiformaceae	2682227	F	5341	248	5589	0.00036
Ardenticatenaceae	1382930	F	5152	114	5266	0.00034
Anaerolineaceae	292628	F	2570	55	2625	0.00017
Caldilineaceae	475964	F	2404	1227	3631	0.00023
Dehalococcoidaceae	1202464	F	411	13	424	0.00003
Ktedonosporobacteraceae	2692416	F	911	28	939	0.00006
Phototrophicaceae	2922432	F	864	941	1805	0.00012
Fimbriimonadaceae	1663426	F	2696	17	2713	0.00017
Chthonomonadaceae	1077264	F	720	6	726	0.00005
Mycoplasmataceae	2092	F	410	66	476	0.00003
Acholeplasmataceae	2146	F	166	13	179	0.00001
Spiroplasmataceae	2131	F	124	10	134	0.00001
Entomoplasmataceae	33925	F	18	18	36	0.00000
Mycoplasmoidaceae	2790998	F	19	0	19	0.00000
Metamycoplasmataceae	2895623	F	17	41	58	0.00000
Gemmataceae	1914233	F	285224	11051	296275	0.01891
Lacipirellulaceae	2691359	F	63344	3470	66814	0.00427
Pirellulaceae	2691357	F	45589	2308	47897	0.00306
Thermoguttaceae	2691358	F	1240	45	1285	0.00008
Isosphaeraceae	1763524	F	105262	12136	117398	0.00749
Planctomycetaceae	126	F	86555	9132	95687	0.00611
Tepidisphaeraceae	1771355	F	16258	439	16697	0.00107
Phycisphaeraceae	666507	F	8031	514	8545	0.00055
Anaerohalosphaeraceae	2690158	F	432	16	448	0.00003
Sedimentisphaeraceae	2483367	F	415	98	513	0.00003
Candidatus Brocadiaceae	1127830	F	248	1	249	0.00002
Candidatus Uabimicrobiaceae	2897348	F	130	2	132	0.00001
Opitutaceae	134623	F	31096	1294	32390	0.00207
Puniceicoccaceae	415002	F	1381	179	1560	0.00010
Verrucomicrobiaceae	203557	F	15975	566	16541	0.00106
Akkermansiaceae	1647988	F	1672	1888	3560	0.00023
Methylacidiphilaceae	717964	F	162	172	334	0.00002
Kiritimatiellaceae	1921783	F	1212	1466	2678	0.00017
Tichowtungiaceae	2907186	F	473	18	491	0.00003
Parachlamydiaceae	92713	F	168	16	184	0.00001
Waddliaceae	92714	F	55	10	65	0.00000
Rhabdochlamydiaceae	689704	F	44	5	49	0.00000
Simkaniaceae	92712	F	42	4	46	0.00000
Chlamydiaceae	809	F	114	377	491	0.00003
Hymenobacteraceae	1853232	F	35800	1588	37388	0.00239
Cytophagaceae	89373	F	5614	265	5879	0.00038
Spirosomaceae	2896860	F	4217	223	4440	0.00028
Fulvivirgaceae	2762286	F	2562	73	2635	0.00017
Cyclobacteriaceae	563798	F	1018	103	1121	0.00007
Flammeovirgaceae	200667	F	96	5	101	0.00001
Marivirgaceae	2762301	F	80	25	105	0.00001
Mangrovivirgaceae	2858885	F	62	4	66	0.00000
Amoebophilaceae	1501348	F	56	11	67	0.00000
Bernardetiaceae	1937968	F	41	2	43	0.00000
Chitinophagaceae	563835	F	17298	249	17547	0.00112
Rhodothermaceae	563843	F	17074	910	17984	0.00115
Rikenellaceae	171550	F	5745	1600	7345	0.00047
Prevotellaceae	171552	F	2152	300	2452	0.00016
Bacteroidaceae	815	F	1951	724	2675	0.00017
Tannerellaceae	2005525	F	1073	262	1335	0.00009
Muribaculaceae	2005473	F	855	147	1002	0.00006
Porphyromonadaceae	171551	F	735	67	802	0.00005
Dysgonomonadaceae	2005520	F	304	9	313	0.00002
Barnesiellaceae	2005519	F	211	203	414	0.00003
Odoribacteraceae	1853231	F	177	38	215	0.00001
Paludibacteraceae	2005523	F	66	1	67	0.00000
Tenuifilaceae	2760872	F	44	1	45	0.00000
Salinivirgaceae	1970190	F	43	0	43	0.00000
Prolixibacteraceae	1471398	F	223	4	227	0.00001
Marinilabiliaceae	558415	F	37	2	39	0.00000
Marinifilaceae	1573805	F	33	2	35	0.00000
Flavobacteriaceae	49546	F	8154	514	8668	0.00055
Weeksellaceae	2762318	F	5004	1836	6840	0.00044
Blattabacteriaceae	39782	F	152	12	164	0.00001
Schleiferiaceae	1333713	F	115	8	123	0.00001
Crocinitomicaceae	1853230	F	90	41	131	0.00001
Ichthyobacteriaceae	1755828	F	19	0	19	0.00000
Sphingobacteriaceae	84566	F	6873	656	7529	0.00048
Haliscomenobacteraceae	1937961	F	393	5	398	0.00003
Saprospiraceae	89374	F	78	118	196	0.00001
Chlorobiaceae	191412	F	4967	579	5546	0.00035
Melioribacteraceae	1334117	F	186	19	205	0.00001
Ignavibacteriaceae	795749	F	86	10	96	0.00001
Gemmatimonadaceae	219687	F	114826	7303	122129	0.00780
Fibrobacteraceae	204431	F	189	104	293	0.00002
Vicinamibacteraceae	2211325	F	119023	7073	126096	0.00805
Acidobacteriaceae	204434	F	37542	936	38478	0.00246
Bryobacteraceae	1962910	F	9956	5481	15437	0.00099
Acanthopleuribacteraceae	533207	F	2922	69	2991	0.00019
Thermotomaculaceae	2562244	F	132	7	139	0.00001
Nitrospiraceae	189779	F	17376	263	17639	0.00113
Dissulfurispiraceae	2811505	F	174	12	186	0.00001
Thermodesulfovibrionaceae	2811504	F	140	4	144	0.00001
Treponemataceae	2845253	F	1331	334	1665	0.00011
Spirochaetaceae	137	F	1291	31	1322	0.00008
Sphaerochaetaceae	2791015	F	346	221	567	0.00004
Borreliaceae	1643685	F	136	1	137	0.00001
Leptospiraceae	170	F	985	33	1018	0.00006
Brachyspiraceae	143786	F	102	2	104	0.00001
Synergistaceae	649777	F	4108	1257	5365	0.00034
Candidatus Nanosynbacteraceae	2093822	F	187	274	461	0.00003
Candidatus Babeliaceae	2497645	F	77	1	78	0.00001
Candidatus Absconditicoccaceae	2900569	F	72	0	72	0.00000
Candidatus Chazhemtobacteraceae	2715733	F	50	0	50	0.00000
Thermotogaceae	188709	F	583	27	610	0.00004
Fervidobacteriaceae	1643950	F	148	48	196	0.00001
Kosmotogaceae	1643948	F	288	9	297	0.00002
Petrotogaceae	1643949	F	95	53	148	0.00001
Mesoaciditogaceae	1769717	F	86	3	89	0.00001
Aquificaceae	64898	F	376	2	378	0.00002
Hydrogenothermaceae	224027	F	204	151	355	0.00002
Desulfurobacteriaceae	558314	F	214	17	231	0.00001
Thermodesulfobacteriaceae	188711	F	670	14	684	0.00004
Calditrichaceae	1962854	F	455	4	459	0.00003
Deferribacteraceae	191394	F	383	12	395	0.00003
Chrysiogenaceae	189770	F	371	187	558	0.00004
Fusobacteriaceae	203492	F	180	31	211	0.00001
Leptotrichiaceae	1129771	F	145	21	166	0.00001
Endomicrobiaceae	1783343	F	122	1	123	0.00001
Elusimicrobiaceae	641876	F	110	1	111	0.00001
Dictyoglomaceae	203488	F	171	0	171	0.00001
Coprothermobacteraceae	2138247	F	141	31	172	0.00001
Caldisericaceae	693073	F	130	0	130	0.00001
Atribacteraceae	2847776	F	77	2	79	0.00001
Nectriaceae	110618	F	9246	796	10042	0.00064
Clavicipitaceae	34397	F	3447	335	3782	0.00024
Hypocreaceae	5129	F	3363	160	3523	0.00022
Cordycipitaceae	474943	F	3019	104	3123	0.00020
Ophiocordycipitaceae	474942	F	1898	106	2004	0.00013
Bionectriaceae	103887	F	363	27	390	0.00002
Glomerellaceae	681950	F	1143	234	1377	0.00009
Chaetomiaceae	35718	F	4140	162	4302	0.00027
Sordariaceae	5148	F	461	27	488	0.00003
Pyriculariaceae	2528436	F	1350	12	1362	0.00009
Sporocadaceae	1812776	F	648	8	656	0.00004
Sclerotiniaceae	28983	F	284	1	285	0.00002
Aspergillaceae	1131492	F	4783	197	4980	0.00032
Thermoascaceae	1131624	F	291	8	299	0.00002
Trichocomaceae	28568	F	226	11	237	0.00002
Didymosphaeriaceae	221678	F	499	167	666	0.00004
Leptosphaeriaceae	34374	F	417	44	461	0.00003
Mycosphaerellaceae	93133	F	395	4	399	0.00003
Saccharomycetaceae	4893	F	687	109	796	0.00005
Pichiaceae	1156497	F	191	5	196	0.00001
Debaryomycetaceae	766764	F	139	1	140	0.00001
Dipodascaceae	34353	F	115	0	115	0.00001
Trichomonascaceae	410830	F	70	5	75	0.00000
Phaffomycetaceae	115784	F	15	0	15	0.00000
Schizosaccharomycetaceae	4894	F	52	1	53	0.00000
Ustilaginaceae	5268	F	2467	48	2515	0.00016
Malasseziaceae	742845	F	147	24	171	0.00001
Phanerochaetaceae	396331	F	470	3	473	0.00003
Ceratobasidiaceae	5250	F	91	4	95	0.00001
Marasmiaceae	654128	F	86	3	89	0.00001
Cryptococcaceae	1884633	F	163	17	180	0.00001
Unikaryonidae	36734	F	20	0	20	0.00000
Peronosporaceae	4777	F	4117	459	4576	0.00029
Pythiaceae	4782	F	384	9	393	0.00003
