name	taxonomy_id	taxonomy_lvl	kraken_assigned_reads	added_reads	new_est_reads	fraction_total_reads
Bradyrhizobium sp. 200	2782665	S	6072	1459	7531	0.00058
Bradyrhizobium sp. 170	2782641	S	5575	1549	7124	0.00055
Bradyrhizobium sp. CCBAU 51753	1325100	S	5557	1337	6894	0.00053
Bradyrhizobium sp. CCBAU 051011	858422	S	5080	1063	6143	0.00047
Bradyrhizobium sp. BTAi1	288000	S	4990	1017	6007	0.00046
Bradyrhizobium sp. A19	2898149	S	4934	961	5895	0.00045
Bradyrhizobium sp. ORS 278	114615	S	4856	1234	6090	0.00047
Bradyrhizobium sp. ORS 285	115808	S	4731	1183	5914	0.00046
Bradyrhizobium sp. SK17	2057741	S	3854	1382	5236	0.00040
Bradyrhizobium sp. 186	2782654	S	3622	1047	4669	0.00036
Bradyrhizobium sp. CCBAU 53421	1325120	S	2912	984	3896	0.00030
Bradyrhizobium sp. CCBAU 53338	1325111	S	2699	1175	3874	0.00030
Bradyrhizobium sp. CCBAU 53340	1325112	S	2609	1078	3687	0.00028
Bradyrhizobium sp. CCBAU 53351	1325114	S	2569	1378	3947	0.00030
Bradyrhizobium sp. 195	2782662	S	2555	979	3534	0.00027
Bradyrhizobium sp. 1(2017)	1404888	S	2547	857	3404	0.00026
Bradyrhizobium sp. CCGE-LA001	1223566	S	2235	892	3127	0.00024
Bradyrhizobium sp. 6(2017)	1197460	S	2201	1146	3347	0.00026
Bradyrhizobium sp. S2-11-2	2840472	S	2053	1650	3703	0.00029
Bradyrhizobium sp. I71	2590772	S	1844	1686	3530	0.00027
Bradyrhizobium sp. 191	2782659	S	1837	1897	3734	0.00029
Bradyrhizobium sp. CCBAU 51765	1325102	S	1803	1717	3520	0.00027
Bradyrhizobium sp. 41S5	1404443	S	1798	1292	3090	0.00024
Bradyrhizobium sp. S2-20-1	2840469	S	1782	1517	3299	0.00025
Bradyrhizobium sp. S2-11-4	2840473	S	1712	1602	3314	0.00026
Bradyrhizobium sp. C-145	574727	S	1122	1164	2286	0.00018
Bradyrhizobium sp.	376	S	878	3001	3879	0.00030
Bradyrhizobium sp. 144S4	2823807	S	666	1706	2372	0.00018
Bradyrhizobium sp. 323S2	1404649	S	635	1661	2296	0.00018
Bradyrhizobium sp. 40	2782674	S	621	1444	2065	0.00016
Bradyrhizobium sp. 4	2782678	S	608	1585	2193	0.00017
Bradyrhizobium sp. 192	2782660	S	575	1447	2022	0.00016
Bradyrhizobium sp. LCT2	2493093	S	387	1128	1515	0.00012
Bradyrhizobium sp. 187	2782655	S	244	1222	1466	0.00011
Bradyrhizobium sp. SG09	2599805	S	238	1759	1997	0.00015
Bradyrhizobium sp. TM102	2599819	S	224	1582	1806	0.00014
Bradyrhizobium sp. CW1	2782686	S	150	2343	2493	0.00019
Bradyrhizobium sp. 38S5	2819348	S	124	1531	1655	0.00013
Bradyrhizobium sp. 172	2782643	S	124	1524	1648	0.00013
Bradyrhizobium sp. 1S5	2816456	S	112	1275	1387	0.00011
Bradyrhizobium sp. 131	2782609	S	100	1648	1748	0.00013
Bradyrhizobium sp. 155	2782629	S	87	1582	1669	0.00013
Bradyrhizobium erythrophlei	1437360	S	15079	1406	16485	0.00127
Bradyrhizobium diazoefficiens	1355477	S	11252	26968	38220	0.00294
Bradyrhizobium icense	1274631	S	5898	949	6847	0.00053
Bradyrhizobium lablabi	722472	S	5038	6179	11217	0.00086
Bradyrhizobium paxllaeri	190148	S	4791	988	5779	0.00045
Bradyrhizobium oligotrophicum	44255	S	4353	861	5214	0.00040
Bradyrhizobium genosp. L	83637	S	4276	969	5245	0.00040
Bradyrhizobium canariense	255045	S	4250	6969	11219	0.00086
Bradyrhizobium japonicum	375	S	4189	6211	10400	0.00080
Bradyrhizobium arachidis	858423	S	3415	1059	4474	0.00034
Bradyrhizobium guangdongense	1325090	S	3132	1244	4376	0.00034
Bradyrhizobium genosp. B	83627	S	2761	650	3411	0.00026
Bradyrhizobium vignae	1549949	S	2724	704	3428	0.00026
Bradyrhizobium quebecense	2748629	S	2615	1579	4194	0.00032
Bradyrhizobium cosmicum	1404864	S	2536	894	3430	0.00026
Bradyrhizobium guangzhouense	1325095	S	2454	998	3452	0.00027
Bradyrhizobium guangxiense	1325115	S	2382	1107	3489	0.00027
Bradyrhizobium septentrionale	1404411	S	2206	1435	3641	0.00028
Bradyrhizobium daqingense	993502	S	1912	1104	3016	0.00023
Bradyrhizobium amphicarpaeae	1404768	S	1739	779	2518	0.00019
Bradyrhizobium betae	244734	S	1617	1001	2618	0.00020
Bradyrhizobium symbiodeficiens	1404367	S	1409	2217	3626	0.00028
Bradyrhizobium zhanjiangense	1325107	S	1141	1195	2336	0.00018
Bradyrhizobium elkanii	29448	S	755	2938	3693	0.00028
Bradyrhizobium ottawaense	931866	S	550	3588	4138	0.00032
Rhodopseudomonas palustris	1076	S	17118	6619	23737	0.00183
Rhodopseudomonas boonkerdii	475937	S	2243	642	2885	0.00022
Rhodopseudomonas sp. SK50-23	340268	S	2226	486	2712	0.00021
Tardiphaga sp. 37S4	1404741	S	1283	954	2237	0.00017
Tardiphaga sp. vice154	2592814	S	116	1416	1532	0.00012
Tardiphaga sp. vice278	2592815	S	68	1300	1368	0.00011
Tardiphaga sp. vice304	2592817	S	44	656	700	0.00005
Tardiphaga sp. vice352	2592816	S	32	762	794	0.00006
Tardiphaga robiniae	943830	S	1293	856	2149	0.00017
Afipia carboxidovorans	40137	S	2969	956	3925	0.00030
Afipia sp. GAS231	1882747	S	2081	1680	3761	0.00029
Nitrobacter hamburgensis	912	S	2552	502	3054	0.00024
Nitrobacter winogradskyi	913	S	2220	433	2653	0.00020
Variibacter gotjawalensis	1333996	S	4919	454	5373	0.00041
Rhizobium sp. BG4	2613770	S	1883	402	2285	0.00018
Rhizobium sp. NXC24	2048897	S	1648	262	1910	0.00015
Rhizobium sp. WYJ-E13	2849093	S	1643	232	1875	0.00014
Rhizobium sp. ACO-34A	1571470	S	1386	326	1712	0.00013
Rhizobium sp. WL3	2603277	S	1310	278	1588	0.00012
Rhizobium sp. SL42	2806346	S	1224	248	1472	0.00011
Rhizobium sp. AB2/73	2795216	S	1178	654	1832	0.00014
Rhizobium sp. 11515TR	2028343	S	1112	265	1377	0.00011
Rhizobium sp. NZLR1	2731096	S	958	344	1302	0.00010
Rhizobium sp. NLR16a	2731112	S	919	413	1332	0.00010
Rhizobium sp. CIAT894	2020312	S	918	416	1334	0.00010
Rhizobium sp. NXC14	1981173	S	843	353	1196	0.00009
Rhizobium sp. C104	2917727	S	780	433	1213	0.00009
Rhizobium sp. K102	2918527	S	737	510	1247	0.00010
Rhizobium sp. L51/94	2819999	S	560	642	1202	0.00009
Rhizobium sp. 007	2785056	S	425	774	1199	0.00009
Rhizobium sp. X9	2815360	S	362	833	1195	0.00009
Rhizobium sp. Kim5	2020311	S	251	548	799	0.00006
Rhizobium sp. IE4771	1301032	S	247	495	742	0.00006
Rhizobium sp. TAL182	2020313	S	211	602	813	0.00006
Rhizobium sp. NIBRBAC000502774	2590777	S	135	630	765	0.00006
Rhizobium sp. ZX09	2291939	S	80	366	446	0.00003
Rhizobium sp. Y9	1914541	S	75	293	368	0.00003
Rhizobium sp. B230/85	2819994	S	73	696	769	0.00006
Rhizobium sp. CCGE531	2364271	S	44	1392	1436	0.00011
Rhizobium sp. T136	555319	S	39	1112	1151	0.00009
Rhizobium sp. N324	1703969	S	32	603	635	0.00005
Rhizobium sp. B21/90	2819993	S	20	621	641	0.00005
Rhizobium sp. CCGE532	2364272	S	15	1003	1018	0.00008
Rhizobium leguminosarum	384	S	8877	12057	20934	0.00161
Rhizobium etli	29449	S	2540	3079	5619	0.00043
Rhizobium jaguaris	1312183	S	1824	257	2081	0.00016
Rhizobium gallicum	56730	S	1717	2330	4047	0.00031
Rhizobium pseudoryzae	379684	S	1706	408	2114	0.00016
Rhizobium phaseoli	396	S	1425	3077	4502	0.00035
Rhizobium bangladeshense	1138189	S	1343	350	1693	0.00013
Rhizobium lentis	1138194	S	1103	370	1473	0.00011
Rhizobium tropici	398	S	1044	299	1343	0.00010
Rhizobium binae	1138190	S	970	385	1355	0.00010
Rhizobium rosettiformans	1368430	S	954	489	1443	0.00011
Rhizobium daejeonense	240521	S	884	312	1196	0.00009
Rhizobium rhizoryzae	451876	S	828	128	956	0.00007
Rhizobium indicum	2583231	S	648	596	1244	0.00010
Rhizobium pusense	648995	S	509	2097	2606	0.00020
Rhizobium acidisoli	1538158	S	505	435	940	0.00007
Rhizobium laguerreae	1076926	S	261	464	725	0.00006
Rhizobium oryzihabitans	2267833	S	255	369	624	0.00005
Rhizobium hidalgonense	1538159	S	250	594	844	0.00007
Rhizobium ruizarguesonis	2081791	S	151	1145	1296	0.00010
Rhizobium favelukesii	348824	S	34	1170	1204	0.00009
Agrobacterium tumefaciens	358	S	4314	4340	8654	0.00067
Agrobacterium fabrum	1176649	S	419	565	984	0.00008
Agrobacterium fabacearum	1183401	S	95	1338	1433	0.00011
Agrobacterium vitis	373	S	2400	335	2735	0.00021
Agrobacterium sp. T29	2580515	S	376	305	681	0.00005
Agrobacterium sp. RAC06	1842536	S	265	563	828	0.00006
Agrobacterium sp. MA01	2664893	S	258	537	795	0.00006
Agrobacterium sp. CGMCC 11546	2579248	S	118	247	365	0.00003
Agrobacterium sp. S7/73	2820002	S	69	382	451	0.00003
Agrobacterium vaccinii	2735528	S	892	137	1029	0.00008
Agrobacterium larrymoorei	160699	S	673	132	805	0.00006
Agrobacterium rubi	28099	S	588	189	777	0.00006
Agrobacterium salinitolerans	1183413	S	553	220	773	0.00006
Agrobacterium rhizogenes	359	S	428	1048	1476	0.00011
Neorhizobium galegae	399	S	5240	1648	6888	0.00053
Neorhizobium sp. SOG26	2060726	S	1502	343	1845	0.00014
Neorhizobium sp. NCHU2750	1825976	S	1459	377	1836	0.00014
Pseudorhizobium flavum	1335061	S	1068	713	1781	0.00014
Pseudorhizobium banfieldiae	1125847	S	1030	620	1650	0.00013
Sinorhizobium meliloti	382	S	10785	11629	22414	0.00173
Sinorhizobium fredii	380	S	8289	11434	19723	0.00152
Sinorhizobium americanum	194963	S	2910	1179	4089	0.00031
Sinorhizobium sp. BG8	2613773	S	2081	395	2476	0.00019
Sinorhizobium sp. CCBAU 05631	794846	S	462	675	1137	0.00009
Sinorhizobium medicae	110321	S	2402	316	2718	0.00021
Ensifer adhaerens	106592	S	6461	3644	10105	0.00078
Ensifer mexicanus	375549	S	3305	571	3876	0.00030
Ensifer alkalisoli	1752398	S	2579	558	3137	0.00024
Ensifer sojae	716925	S	2409	947	3356	0.00026
Ensifer sp. PDNC004	2811423	S	1977	882	2859	0.00022
Ensifer sp. T173	555315	S	353	1463	1816	0.00014
Shinella sp. HZN7	879274	S	3288	3054	6342	0.00049
Shinella sp. PSBB067	2715959	S	2486	2032	4518	0.00035
Shinella sp. XGS7	2877941	S	2097	2181	4278	0.00033
Shinella sp. H4-D48	2925841	S	1037	451	1488	0.00011
Shinella zoogloeoides	352475	S	2592	4052	6644	0.00051
Shinella oryzae	2871820	S	1427	689	2116	0.00016
Ciceribacter thiooxidans	1969821	S	2136	485	2621	0.00020
Georhizobium profundi	2341112	S	2054	529	2583	0.00020
Peteryoungia desertarenae	1813451	S	704	141	845	0.00007
Candidatus Liberibacter africanus	34020	S	41	6	47	0.00000
Liberibacter crescens	1273132	S	28	85	113	0.00001
Candidatus Liberibacter asiaticus	34021	S	24	61	85	0.00001
Candidatus Liberibacter solanacearum	556287	S	15	2	17	0.00000
Mesorhizobium sp. 8	2584466	S	4269	1198	5467	0.00042
Mesorhizobium sp. DCY119	2108445	S	2898	794	3692	0.00028
Mesorhizobium sp. Pch-S	2082387	S	2828	454	3282	0.00025
Mesorhizobium sp. M1A.F.Ca.IN.022.06.1.1	2493680	S	2768	986	3754	0.00029
Mesorhizobium sp. M1B.F.Ca.ET.045.04.1.1	2493673	S	2585	1104	3689	0.00028
Mesorhizobium sp. L-2-11	2744521	S	2520	1092	3612	0.00028
Mesorhizobium sp. M1D.F.Ca.ET.043.01.1.1	2493669	S	2459	1626	4085	0.00031
Mesorhizobium sp. M3A.F.Ca.ET.080.04.2.1	2493676	S	2410	826	3236	0.00025
Mesorhizobium sp. B1-1-8	2589976	S	2367	680	3047	0.00023
Mesorhizobium sp. B2-1-1	2589974	S	2337	609	2946	0.00023
Mesorhizobium sp. M1E.F.Ca.ET.045.02.1.1	2493672	S	2332	1290	3622	0.00028
Mesorhizobium sp. J8	2777475	S	2326	848	3174	0.00024
Mesorhizobium sp. M9A.F.Ca.ET.002.03.1.2	2493668	S	2305	1167	3472	0.00027
Mesorhizobium sp. 131-2-1	2744518	S	2237	1321	3558	0.00027
Mesorhizobium sp. B2-8-5	2589903	S	2130	798	2928	0.00023
Mesorhizobium sp. M6A.T.Cr.TU.016.01.1.1	2493677	S	2091	785	2876	0.00022
Mesorhizobium sp. M4B.F.Ca.ET.058.02.1.1	2493675	S	2037	962	2999	0.00023
Mesorhizobium sp. PAMC28654	2880934	S	2023	437	2460	0.00019
Mesorhizobium sp. INR15	2654248	S	1985	328	2313	0.00018
Mesorhizobium sp. B2-1-8	2589967	S	1623	561	2184	0.00017
Mesorhizobium sp. B4-1-4	2589888	S	1604	442	2046	0.00016
Mesorhizobium sp. L-8-10	2744523	S	1523	5126	6649	0.00051
Mesorhizobium sp. M7D.F.Ca.US.005.01.1.1	2493678	S	1400	538	1938	0.00015
Mesorhizobium sp. L-8-3	2744522	S	1399	4839	6238	0.00048
Mesorhizobium sp. M8A.F.Ca.ET.057.01.1.1	2493679	S	1395	590	1985	0.00015
Mesorhizobium sp. NZP2077	2483404	S	1283	478	1761	0.00014
Mesorhizobium sp. M2A.F.Ca.ET.043.05.1.1	2493671	S	1225	1135	2360	0.00018
Mesorhizobium sp. 113-3-3	2744516	S	1222	748	1970	0.00015
Mesorhizobium sp. M7A.F.Ce.TU.012.03.2.1	2493681	S	1176	483	1659	0.00013
Mesorhizobium sp. NBSH29	2654249	S	1093	91	1184	0.00009
Mesorhizobium sp. AA22	1854057	S	1085	763	1848	0.00014
Mesorhizobium sp. 113-1-2	2744515	S	1067	586	1653	0.00013
Mesorhizobium sp. 113-3-9	2744517	S	939	768	1707	0.00013
Mesorhizobium sp. NZP2298	2483403	S	899	590	1489	0.00011
Mesorhizobium sp. M2A.F.Ca.ET.046.03.2.1	2493674	S	779	2227	3006	0.00023
Mesorhizobium sp. M2A.F.Ca.ET.043.02.1.1	2493670	S	658	1790	2448	0.00019
Mesorhizobium sp. WSM1497	278153	S	278	618	896	0.00007
Mesorhizobium sp. 131-2-5	2744519	S	188	1391	1579	0.00012
Mesorhizobium sp. 131-3-5	2744520	S	167	568	735	0.00006
Mesorhizobium sp. NZP2234	2483402	S	125	491	616	0.00005
Mesorhizobium terrae	2725666	S	2744	1076	3820	0.00029
Mesorhizobium opportunistum	593909	S	2520	1211	3731	0.00029
Mesorhizobium amorphae	71433	S	2091	588	2679	0.00021
Mesorhizobium ciceri	39645	S	1653	4477	6130	0.00047
Mesorhizobium loti	381	S	1506	13442	14948	0.00115
Mesorhizobium australicum	536018	S	1398	498	1896	0.00015
Mesorhizobium huakuii	28104	S	1318	1078	2396	0.00018
Mesorhizobium erdmanii	1777866	S	1216	395	1611	0.00012
Mesorhizobium japonicum	2066070	S	1123	940	2063	0.00016
Aquibium microcysteis	675281	S	5691	1891	7582	0.00058
Aquibium oceanicum	1670800	S	4284	1171	5455	0.00042
Nitratireductor sp. SY7	2599600	S	3761	827	4588	0.00035
Nitratireductor sp. OM-1	1756988	S	1848	363	2211	0.00017
Nitratireductor kimnyeongensis	430679	S	1161	191	1352	0.00010
Aminobacter sp. MSH1	374606	S	2717	1910	4627	0.00036
Aminobacter sp. SR38	2774562	S	574	2646	3220	0.00025
Aminobacter sp. MDW-2	2666139	S	389	1920	2309	0.00018
Aminobacter aminovorans	83263	S	399	1389	1788	0.00014
Phyllobacterium sp. T1018	555316	S	1182	173	1355	0.00010
Phyllobacterium sp. 628	2718938	S	634	99	733	0.00006
Phyllobacterium sp. T1293	555317	S	572	77	649	0.00005
Phyllobacterium zundukense	1867719	S	1257	203	1460	0.00011
Roseitalea porphyridii	1852022	S	3177	640	3817	0.00029
Hoeflea sp. IMCC20628	1620421	S	1224	138	1362	0.00010
Hoeflea phototrophica	244596	S	1109	154	1263	0.00010
Oricola thermophila	2742145	S	2165	353	2518	0.00019
Salaquimonas pukyongi	2712698	S	981	51	1032	0.00008
Lentilitoribacter sp. Alg239-R112	2305987	S	65	1	66	0.00001
Methylobacterium nodulans	114616	S	7482	1161	8643	0.00067
Methylobacterium sp. 17Sr1-1	2202826	S	3171	1732	4903	0.00038
Methylobacterium sp. WL1	2603276	S	3124	742	3866	0.00030
Methylobacterium sp. C1	1479019	S	405	3169	3574	0.00028
Methylobacterium sp. XJLW	739141	S	208	2793	3001	0.00023
Methylobacterium aquaticum	270351	S	6481	3267	9748	0.00075
Methylobacterium durans	2202825	S	4783	831	5614	0.00043
Methylobacterium radiodurans	2202828	S	4348	1279	5627	0.00043
Methylobacterium currus	2051553	S	4245	2040	6285	0.00048
Methylobacterium organophilum	410	S	3453	2169	5622	0.00043
Methylobacterium terrae	2202827	S	3395	1806	5201	0.00040
Methylobacterium brachiatum	269660	S	3158	1299	4457	0.00034
Methylobacterium mesophilicum	39956	S	3127	744	3871	0.00030
Methylobacterium tardum	374432	S	2913	1145	4058	0.00031
Methylobacterium indicum	1775910	S	2896	1642	4538	0.00035
Methylobacterium oryzae	334852	S	2477	3353	5830	0.00045
Methylobacterium radiotolerans	31998	S	1106	6503	7609	0.00059
Methylobacterium phyllosphaerae	418223	S	494	1862	2356	0.00018
Microvirga sp. VF16	2807101	S	13353	2423	15776	0.00122
Microvirga sp. 17 mud 1-3	2082949	S	4669	1148	5817	0.00045
Microvirga ossetica	1882682	S	12176	2503	14679	0.00113
Microvirga thermotolerans	2651334	S	6396	2066	8462	0.00065
Methylorubrum populi	223967	S	5597	2837	8434	0.00065
Methylorubrum extorquens	408	S	4381	7651	12032	0.00093
Methylorubrum sp. B1-46	2897334	S	2079	990	3069	0.00024
Methylorubrum zatmanii	29429	S	136	720	856	0.00007
Pseudolabrys taiwanensis	331696	S	9308	1933	11241	0.00087
Pseudolabrys sp. FHR47	2562284	S	6594	1460	8054	0.00062
Xanthobacter dioxanivorans	2528964	S	5107	2029	7136	0.00055
Xanthobacter sp. YC-JY1	2419844	S	1704	1927	3631	0.00028
Xanthobacter autotrophicus	280	S	1584	1928	3512	0.00027
Starkeya sp. ORNL1	2709380	S	5604	1375	6979	0.00054
Starkeya novella	921	S	5076	2262	7338	0.00057
Ancylobacter sp. TS-1	1850374	S	3481	1729	5210	0.00040
Ancylobacter polymorphus	223390	S	3410	1956	5366	0.00041
Ancylobacter pratisalsi	1745854	S	2958	810	3768	0.00029
Labrys sp. KNU-23	2789216	S	3933	495	4428	0.00034
Azorhizobium caulinodans	7	S	3637	928	4565	0.00035
Rhodoplanes sp. Z2-YC6860	674703	S	21371	2594	23965	0.00185
Hyphomicrobium denitrificans	53399	S	4810	717	5527	0.00043
Hyphomicrobium nitrativorans	1427356	S	3971	422	4393	0.00034
Hyphomicrobium sp. MC1	717785	S	2361	218	2579	0.00020
Methyloceanibacter sp. wino2	2170729	S	2496	666	3162	0.00024
Methyloceanibacter caenitepidi	1384459	S	2447	612	3059	0.00024
Methyloligella sp. GL2	2742204	S	3476	518	3994	0.00031
Aquabacter sp. L1I39	2820278	S	3180	657	3837	0.00030
Rhodomicrobium vannielii	1069	S	2532	211	2743	0.00021
Caenibius sp. WL	2872646	S	1116	241	1357	0.00010
Caenibius tardaugens	169176	S	766	675	1441	0.00011
Candidatus Filomicrobium marinum	1608628	S	1129	40	1169	0.00009
Bosea sp. Tri-49	1867715	S	5755	1557	7312	0.00056
Bosea sp. RAC05	1842539	S	4708	1786	6494	0.00050
Bosea sp. F3-2	2599640	S	4522	1687	6209	0.00048
Bosea sp. AS-1	2015316	S	3970	1462	5432	0.00042
Bosea sp. ANAM02	2020412	S	3669	1585	5254	0.00040
Bosea sp. PAMC 26642	1792307	S	3355	831	4186	0.00032
Bosea vaviloviae	1526658	S	3847	1076	4923	0.00038
Devosia sp. A16	1736675	S	6085	845	6930	0.00053
Devosia sp. JXJ CY 41	2917991	S	1879	373	2252	0.00017
Devosia sp. 1566	2499144	S	1831	219	2050	0.00016
Devosia sp. SL43	2806348	S	1821	364	2185	0.00017
Devosia sp. I507	2083786	S	1396	442	1838	0.00014
Devosia sp. MC521	2759954	S	658	116	774	0.00006
Devosia ginsengisoli	400770	S	2282	451	2733	0.00021
Devosia salina	2860336	S	1925	676	2601	0.00020
Devosia beringensis	2657486	S	1866	301	2167	0.00017
Devosia oryziradicis	2801335	S	1821	362	2183	0.00017
Devosia rhizoryzae	2774137	S	1495	177	1672	0.00013
Youhaiella tibetensis	1447062	S	2791	681	3472	0.00027
Paradevosia shaoguanensis	1335043	S	2674	1096	3770	0.00029
Pelagibacterium halotolerans	531813	S	1371	178	1549	0.00012
Maritalea myrionectae	454601	S	331	12	343	0.00003
Aureimonas sp. SA4125	2826993	S	3450	774	4224	0.00033
Aureimonas sp. AU20	1349819	S	3147	545	3692	0.00028
Aureimonas sp. OT7	2816454	S	1549	1453	3002	0.00023
Aureimonas populi	1701758	S	2793	652	3445	0.00027
Aureimonas mangrovi	2758041	S	2529	641	3170	0.00024
Aureimonas altamirensis	370622	S	1628	644	2272	0.00018
Martelella sp. AD-3	686597	S	906	2694	3600	0.00028
Martelella mediterranea	293089	S	1600	676	2276	0.00018
Martelella endophytica	1486262	S	1501	400	1901	0.00015
Martelella lutilitoris	2583532	S	909	852	1761	0.00014
Aurantimonas sp. HBX-1	2906072	S	4764	1733	6497	0.00050
Nordella sp. HKS 07	2712222	S	10493	705	11198	0.00086
Pseudorhodoplanes sinuspersici	1235591	S	7390	674	8064	0.00062
Terrihabitans soli	708113	S	3242	446	3688	0.00028
Candidatus Hodgkinia cicadicola	573658	S	59	1	60	0.00000
Methylocystis bryophila	655015	S	2518	302	2820	0.00022
Methylocystis parvus	134	S	2352	332	2684	0.00021
Methylocystis heyeri	391905	S	2231	297	2528	0.00019
Methylocystis sp. SC2	187303	S	1423	424	1847	0.00014
Methylocystis sp. SB2	743836	S	527	883	1410	0.00011
Methylocystis rosea	173366	S	1633	1322	2955	0.00023
Methylosinus trichosporium	426	S	3207	740	3947	0.00030
Methylosinus sp. C49	2699395	S	2647	598	3245	0.00025
Stappia indica	538381	S	4748	1363	6111	0.00047
Stappia sp. ES.058	1881061	S	2501	377	2878	0.00022
Roseibium aggregatum	187304	S	2637	427	3064	0.00024
Roseibium alexandrii	388408	S	689	72	761	0.00006
Pannonibacter phragmitetus	121719	S	3134	2615	5749	0.00044
Labrenzia sp. VG12	2021862	S	1435	194	1629	0.00013
Labrenzia sp. PHM005	2590016	S	674	58	732	0.00006
Labrenzia sp. THAF82	2587861	S	563	40	603	0.00005
Pseudovibrio brasiliensis	1898042	S	253	95	348	0.00003
Pseudovibrio sp. FO-BEG1	911045	S	252	96	348	0.00003
Phreatobacter stygius	1940610	S	5987	1071	7058	0.00054
Phreatobacter cathodiphilus	1868589	S	5431	1905	7336	0.00057
Phreatobacter sp. NMCR1094	2570229	S	3830	850	4680	0.00036
Kaustia mangrovi	2593653	S	7486	885	8371	0.00064
Parvibaculum lavamentivorans	256618	S	3080	2388	5468	0.00042
Pyruvatibacter mobilis	1712261	S	2154	317	2471	0.00019
Candidatus Phaeomarinobacter ectocarpi	1458461	S	827	50	877	0.00007
Chelatococcus sp. CO-6	1702325	S	5425	3603	9028	0.00070
Chelatococcus daeguensis	444444	S	2950	1898	4848	0.00037
Blastochloris tepida	2233851	S	4590	1837	6427	0.00050
Blastochloris viridis	1079	S	4064	1295	5359	0.00041
Methylocella silvestris	199596	S	2244	298	2542	0.00020
Methylocella tundrae	227605	S	2020	226	2246	0.00017
Methylovirgula ligni	569860	S	1945	282	2227	0.00017
Methylovirgula sp. HY1	2822761	S	1572	111	1683	0.00013
Beijerinckia indica	533	S	992	86	1078	0.00008
Acuticoccus sp. I52.16.1	2928472	S	6156	804	6960	0.00054
Kaistia sp. 32K	2795690	S	5417	1646	7063	0.00054
Brucella anthropi	529	S	990	698	1688	0.00013
Brucella intermedia	94625	S	966	201	1167	0.00009
Brucella sp. BTU1	2840456	S	145	27	172	0.00001
Brucella sp. 10RB9215	1149953	S	75	76	151	0.00001
Brucella sp. 09RB8910	1844051	S	49	47	96	0.00001
Brucella sp. 6810	2769351	S	44	65	109	0.00001
Brucella sp. BO2	693750	S	40	85	125	0.00001
Brucella sp. BO3	2691913	S	39	59	98	0.00001
Brucella sp. 2280	2592625	S	27	50	77	0.00001
Brucella sp. 09RB8471	1149952	S	26	44	70	0.00001
Brucella sp. 458	2821140	S	17	34	51	0.00000
[Ochrobactrum] quorumnocens	271865	S	375	67	442	0.00003
Brucella pseudogrignonensis	419475	S	218	68	286	0.00002
Brucella pituitosa	571256	S	132	46	178	0.00001
Brucella melitensis	29459	S	47	3938	3985	0.00031
Brucella inopinata	1218315	S	34	32	66	0.00001
Brucella suis	29461	S	23	1334	1357	0.00010
Brucella ovis	236	S	14	35	49	0.00000
Pseudochrobactrum sp. XF203	2879116	S	90	86	176	0.00001
Pseudochrobactrum sp. Wa41.01b-1	2864102	S	89	93	182	0.00001
Pseudochrobactrum algeriensis	2834768	S	93	105	198	0.00002
Breoghania sp. L-A4	2304600	S	3654	585	4239	0.00033
Hartmannibacter diazotrophicus	1482074	S	3350	737	4087	0.00031
Lichenihabitans psoromatis	2528642	S	1057	636	1693	0.00013
Lichenihabitans sp. PAMC28606	2880932	S	881	615	1496	0.00012
Cohaesibacter sp. ES.047	1798205	S	701	33	734	0.00006
Bartonella apis	1686310	S	198	14	212	0.00002
Bartonella sp. HY038	2759660	S	58	10	68	0.00001
Bartonella sp. 46A	2893471	S	22	17	39	0.00000
Bartonella sp. WD16.2	1933904	S	12	24	36	0.00000
Bartonella australis	388640	S	36	5	41	0.00000
Bartonella vinsonii	33047	S	27	20	47	0.00000
Bartonella ancashensis	1318743	S	23	4	27	0.00000
Bartonella quintana	803	S	21	5	26	0.00000
Bartonella krasnovii	2267275	S	17	21	38	0.00000
Bartonella alsatica	52764	S	16	5	21	0.00000
Bartonella henselae	38323	S	14	5	19	0.00000
Bartonella bacilliformis	774	S	11	2	13	0.00000
Bartonella schoenbuchensis	165694	S	10	10	20	0.00000
Sphingomonas sp. S8-45	2938948	S	10952	1488	12440	0.00096
Sphingomonas sp. HDW15A	2714942	S	10258	931	11189	0.00086
Sphingomonas sp. DM2-R-LB4	2899123	S	8313	3105	11418	0.00088
Sphingomonas sp. MM-1	745310	S	5761	8003	13764	0.00106
Sphingomonas sp. CL5.1	2653203	S	5150	1920	7070	0.00054
Sphingomonas sp. Cra20	1327635	S	5131	906	6037	0.00047
Sphingomonas sp. AK-PDB1-5	2872652	S	5018	909	5927	0.00046
Sphingomonas sp. LM7	1938607	S	4562	1115	5677	0.00044
Sphingomonas sp. AP4-R1	2735134	S	4505	642	5147	0.00040
Sphingomonas sp. NBWT7	2596913	S	3796	1396	5192	0.00040
Sphingomonas sp. S2-65	2903960	S	3732	835	4567	0.00035
Sphingomonas sp. FARSPH	2219696	S	3502	3212	6714	0.00052
Sphingomonas sp. AAP5	1523415	S	3471	1002	4473	0.00034
Sphingomonas sp. PAMC26645	2565555	S	2747	1024	3771	0.00029
Sphingomonas sp. KC8	1030157	S	2744	390	3134	0.00024
Sphingomonas sp. HMP9	1517554	S	2647	1313	3960	0.00031
Sphingomonas sp. HMP6	1517551	S	2402	529	2931	0.00023
Sphingomonas sp. LK11	1390395	S	1745	1984	3729	0.00029
Sphingomonas sp. NIC1	1961362	S	1489	5225	6714	0.00052
Sphingomonas sp. IC081	304378	S	529	3513	4042	0.00031
Sphingomonas lutea	1045317	S	22298	3248	25546	0.00197
Sphingomonas sediminicola	386874	S	21299	2306	23605	0.00182
Sphingomonas daechungensis	1176646	S	18950	2067	21017	0.00162
Sphingomonas sabuli	2764186	S	16187	2234	18421	0.00142
Sphingomonas ginsengisoli An et al. 2013	363835	S	14855	2280	17135	0.00132
Sphingomonas xanthus	2594473	S	14618	3594	18212	0.00140
Sphingomonas sinipercae	2714944	S	14555	2201	16756	0.00129
Sphingomonas rhizophila	2071607	S	14122	3978	18100	0.00139
Sphingomonas piscis	2714943	S	10294	1072	11366	0.00088
Sphingomonas profundi	2681549	S	6497	1162	7659	0.00059
Sphingomonas alpina	653931	S	6136	570	6706	0.00052
Sphingomonas sanxanigenens	397260	S	5788	3047	8835	0.00068
Sphingomonas koreensis	93064	S	4726	3903	8629	0.00066
Sphingomonas changnyeongensis	2698679	S	4437	966	5403	0.00042
Sphingomonas hengshuiensis	1609977	S	4002	582	4584	0.00035
Sphingomonas taxi	1549858	S	3864	1351	5215	0.00040
Sphingomonas panacis	1560345	S	3648	602	4250	0.00033
Sphingomonas panacisoli	1813879	S	3582	542	4124	0.00032
Sphingomonas suaedae	2599297	S	3417	493	3910	0.00030
Sphingomonas radiodurans	2890321	S	3103	461	3564	0.00027
Sphingomonas insulae	424800	S	2724	874	3598	0.00028
Sphingomonas paucimobilis	13689	S	2436	1764	4200	0.00032
Sphingomonas aliaeris	2759526	S	2426	341	2767	0.00021
Sphingomonas sanguinis	33051	S	1869	1860	3729	0.00029
Sphingomonas melonis	152682	S	1617	6396	8013	0.00062
Sphingomonas lacunae	2698828	S	1396	216	1612	0.00012
Sphingomonas paeninsulae	2319844	S	1180	58	1238	0.00010
Sphingobium sp. Cam5-1	2789327	S	6400	2400	8800	0.00068
Sphingobium sp. SYK-6	627192	S	3206	937	4143	0.00032
Sphingobium sp. EP60837	1855519	S	2257	682	2939	0.00023
Sphingobium sp. TKS	1315974	S	1975	3067	5042	0.00039
Sphingobium sp. CAP-1	2676077	S	1782	1181	2963	0.00023
Sphingobium sp. YG1	2082188	S	1676	759	2435	0.00019
Sphingobium sp. RAC03	1843368	S	1655	332	1987	0.00015
Sphingobium sp. SCG-1	2072936	S	1640	139	1779	0.00014
Sphingobium sp. MI1205	407020	S	1480	2208	3688	0.00028
Sphingobium sp. KCTC 72723	2733867	S	1281	244	1525	0.00012
Sphingobium sp. PAMC28499	2565554	S	483	984	1467	0.00011
Sphingobium sp. YBL2	484429	S	262	1712	1974	0.00015
Sphingobium sp. RSMS	520734	S	241	1414	1655	0.00013
Sphingobium sp. LF-16	2185111	S	43	712	755	0.00006
Sphingobium yanoikuyae	13690	S	2963	5929	8892	0.00068
Sphingobium indicum	332055	S	2382	1942	4324	0.00033
Sphingobium phenoxybenzoativorans	1592790	S	2193	964	3157	0.00024
Sphingobium amiense	135719	S	2055	2728	4783	0.00037
Sphingobium cloacae	120107	S	1901	2997	4898	0.00038
Sphingobium chlorophenolicum	46429	S	1737	851	2588	0.00020
Sphingobium xenophagum	121428	S	1604	1136	2740	0.00021
Sphingobium herbicidovorans	76947	S	1592	1519	3111	0.00024
Sphingobium baderi	1332080	S	1510	1620	3130	0.00024
Sphingobium fuliginis	336203	S	720	2805	3525	0.00027
Sphingopyxis sp. PAMC25046	2565556	S	3182	1563	4745	0.00037
Sphingopyxis sp. YF1	2482763	S	2982	755	3737	0.00029
Sphingopyxis sp. QXT-31	1357916	S	2975	904	3879	0.00030
Sphingopyxis sp. OPL5	2486273	S	2811	588	3399	0.00026
Sphingopyxis sp. BSN-002	2911495	S	2606	515	3121	0.00024
Sphingopyxis sp. 113P3	292913	S	2580	1083	3663	0.00028
Sphingopyxis sp. FD7	1914525	S	2491	1128	3619	0.00028
Sphingopyxis sp. EG6	1874061	S	2110	1141	3251	0.00025
Sphingopyxis sp. MG	1866325	S	116	1133	1249	0.00010
Sphingopyxis macrogoltabida	33050	S	4679	2502	7181	0.00055
Sphingopyxis terrae	33052	S	2760	1646	4406	0.00034
Sphingopyxis fribergensis	1515612	S	2357	1004	3361	0.00026
Sphingopyxis lindanitolerans	2054227	S	2272	1188	3460	0.00027
Sphingopyxis alaskensis	117207	S	2184	547	2731	0.00021
Sphingopyxis granuli	267128	S	1944	5696	7640	0.00059
Novosphingobium sp. Gsoil 351	2675225	S	3794	363	4157	0.00032
Novosphingobium sp. Sx8-5	2896849	S	3484	532	4016	0.00031
Novosphingobium sp. EMRT-2	2571749	S	2902	1857	4759	0.00037
Novosphingobium sp. P6W	1609758	S	2414	449	2863	0.00022
Novosphingobium sp. ES2-1	2780074	S	1789	995	2784	0.00021
Novosphingobium sp. THN1	1016987	S	1648	637	2285	0.00018
Novosphingobium sp. PP1Y	702113	S	1266	1590	2856	0.00022
Novosphingobium sp. KA1	164608	S	642	3469	4111	0.00032
Novosphingobium resinovorum	158500	S	3072	1634	4706	0.00036
Novosphingobium decolorationis	2698673	S	2481	1465	3946	0.00030
Novosphingobium aromaticivorans	48935	S	2470	1234	3704	0.00029
Novosphingobium ginsenosidimutans	1176536	S	1962	224	2186	0.00017
Novosphingobium pentaromativorans	205844	S	1202	2238	3440	0.00027
Rhizorhabdus wittichii	160791	S	6906	4454	11360	0.00088
Rhizorhabdus dicambivorans	1850238	S	4386	3923	8309	0.00064
Rhizorhabdus phycosphaerae	2711156	S	3285	457	3742	0.00029
Allosphingosinicella indica	941907	S	8899	1217	10116	0.00078
Sphingosinithalassobacter sp. CS137	2762748	S	3774	849	4623	0.00036
Sphingosinithalassobacter tenebrarum	2711215	S	2638	875	3513	0.00027
Parasphingopyxis algicola	2026624	S	3548	258	3806	0.00029
Parasphingopyxis sp. CP4	2724527	S	882	44	926	0.00007
Sphingorhabdus sp. YGSMI21	2077182	S	1032	176	1208	0.00009
Sphingorhabdus sp. SMR4y	2584094	S	955	168	1123	0.00009
Sphingorhabdus sp. M41	1806885	S	765	104	869	0.00007
Sphingorhabdus lacus	392610	S	653	33	686	0.00005
Sphingorhabdus lutea	1913578	S	90	8	98	0.00001
Blastomonas sp. RAC04	1842535	S	739	1117	1856	0.00014
Blastomonas fulva	1550728	S	653	1278	1931	0.00015
Hankyongella ginsenosidimutans	1763828	S	2639	556	3195	0.00025
Tardibacter chloracetimidivorans	1921510	S	2507	2143	4650	0.00036
Citromicrobium sp. JL477	1634516	S	1817	889	2706	0.00021
Novosphingopyxis iocasae	2762729	S	1652	981	2633	0.00020
Parasphingorhabdus halotolerans	2725558	S	353	16	369	0.00003
Parasphingorhabdus sp. JHSY0214	2806553	S	346	27	373	0.00003
Parasphingorhabdus litoris	394733	S	338	27	365	0.00003
Aquisediminimonas profunda	1550733	S	981	43	1024	0.00008
Erythrobacter sp. HL-111	1798193	S	2453	503	2956	0.00023
Erythrobacter sp. SDW2	2907154	S	1754	495	2249	0.00017
Erythrobacter sp. JK5	2829500	S	1709	545	2254	0.00017
Erythrobacter sp. HKB08	2502843	S	1678	392	2070	0.00016
Erythrobacter sp. THAF29	2587851	S	1048	259	1307	0.00010
Erythrobacter sp. 3-20A1M	2653850	S	895	1440	2335	0.00018
Erythrobacter sp. KY5	2011159	S	873	74	947	0.00007
Erythrobacter sp. LQ02-29	2920384	S	784	897	1681	0.00013
Erythrobacter sp. A30-3	2785907	S	778	640	1418	0.00011
Erythrobacter sp. SCSIO 43205	2779361	S	445	90	535	0.00004
Erythrobacter litoralis	39960	S	3100	1405	4505	0.00035
Erythrobacter neustonensis	1112	S	1271	314	1585	0.00012
Erythrobacter mangrovi	2739433	S	1254	479	1733	0.00013
Erythrobacter aureus	2182384	S	1029	203	1232	0.00009
Porphyrobacter sp. CACIAM 03H1	2003315	S	2603	812	3415	0.00026
Porphyrobacter sp. LM 6	1896196	S	1344	505	1849	0.00014
Porphyrobacter sp. GA68	2883480	S	1258	592	1850	0.00014
Porphyrobacter sp. HT-58-2	2023229	S	1255	319	1574	0.00012
Qipengyuania flava	192812	S	3515	2085	5600	0.00043
Qipengyuania sediminis	1532023	S	2083	331	2414	0.00019
Qipengyuania soli	2782568	S	1424	284	1708	0.00013
Qipengyuania aurantiaca	2867233	S	1293	459	1752	0.00013
Qipengyuania gelatinilytica	2867231	S	985	200	1185	0.00009
Qipengyuania seohaensis	266951	S	818	185	1003	0.00008
Qipengyuania xiapuensis	2867236	S	653	672	1325	0.00010
Qipengyuania psychrotolerans	2867238	S	650	93	743	0.00006
Qipengyuania aquimaris	255984	S	626	651	1277	0.00010
Altererythrobacter sp. B11	2060312	S	2646	1331	3977	0.00031
Altererythrobacter sp. TH136	2067415	S	2056	418	2474	0.00019
Altererythrobacter sp. BO-6	2604537	S	1130	191	1321	0.00010
Altererythrobacter sp. ZODW24	2185142	S	506	27	533	0.00004
Altererythrobacter epoxidivorans	361183	S	961	291	1252	0.00010
Altererythrobacter ishigakiensis	476157	S	374	31	405	0.00003
Tsuneonella amylolytica	2338327	S	2497	776	3273	0.00025
Tsuneonella dongtanensis	692370	S	2403	521	2924	0.00023
Tsuneonella mangrovi	1982042	S	1679	279	1958	0.00015
Tsuneonella flava	2055955	S	752	238	990	0.00008
Croceicoccus sp. YJ47	2798724	S	1544	957	2501	0.00019
Croceicoccus sp. Ery5	1703340	S	541	624	1165	0.00009
Croceicoccus sp. Ery15	1703338	S	474	791	1265	0.00010
Croceicoccus marinus	450378	S	2688	1509	4197	0.00032
Croceicoccus naphthovorans	1348774	S	1160	1438	2598	0.00020
Aurantiacibacter gangjinensis	502682	S	1140	122	1262	0.00010
Aurantiacibacter atlanticus	1648404	S	490	170	660	0.00005
Pelagerythrobacter marensis	543877	S	1414	216	1630	0.00013
Paraurantiacibacter namhicola	645517	S	1370	196	1566	0.00012
Croceibacterium atlanticum	1267766	S	1307	592	1899	0.00015
Sphingosinicella sp. BN140058	1892855	S	8453	852	9305	0.00072
Sphingosinicella flava	2771430	S	4016	636	4652	0.00036
Sphingosinicella microcystinivorans	335406	S	2792	386	3178	0.00024
Polymorphobacter sp. PAMC 29334	2862331	S	1581	1097	2678	0.00021
Polymorphobacter sp. PAMC 29362	2835787	S	1556	1046	2602	0.00020
Sandaracinobacter sp. M6	2759707	S	2394	185	2579	0.00020
Zymomonas mobilis	542	S	191	243	434	0.00003
Azospirillum sp. B510	137722	S	3143	1228	4371	0.00034
Azospirillum sp. TSH100	652764	S	2541	1220	3761	0.00029
Azospirillum sp. TSA2s	709810	S	2455	1947	4402	0.00034
Azospirillum sp. TSH58	664962	S	1975	2731	4706	0.00036
Azospirillum brasilense	192	S	10635	9704	20339	0.00157
Azospirillum thermophilum	2202148	S	8009	1969	9978	0.00077
Azospirillum thiophilum	528244	S	3949	1366	5315	0.00041
Azospirillum ramasamyi	682998	S	2483	1503	3986	0.00031
Azospirillum humicireducens	1226968	S	2020	1232	3252	0.00025
Azospirillum lipoferum	193	S	1884	1452	3336	0.00026
Azospirillum oryzae	286727	S	1807	1627	3434	0.00026
Azospirillum baldaniorum	1064539	S	1184	2487	3671	0.00028
Skermanella mucosa	1789672	S	4615	3216	7831	0.00060
Skermanella rosea	1817965	S	4359	3957	8316	0.00064
Skermanella sp. TT6	2775420	S	4354	4540	8894	0.00069
Skermanella pratensis	2233999	S	3796	2124	5920	0.00046
Nitrospirillum amazonense	28077	S	4457	572	5029	0.00039
Indioceanicola profundi	2220096	S	4013	611	4624	0.00036
Niveispirillum cyanobacteriorum	1612173	S	1995	237	2232	0.00017
Roseomonas sp. OT10	2897332	S	7823	2087	9910	0.00076
Roseomonas sp. S08	1750527	S	7472	505	7977	0.00061
Roseomonas sp. FDAARGOS_362	2018065	S	497	2714	3211	0.00025
Roseomonas gilardii	257708	S	5564	2684	8248	0.00064
Roseomonas haemaphysalidis	2768162	S	4831	596	5427	0.00042
Roseomonas marmotae	2768161	S	4340	529	4869	0.00038
Roseomonas mucosa	207340	S	439	2784	3223	0.00025
Rhodovastum atsumiense	504468	S	6299	682	6981	0.00054
Roseococcus microcysteis	2771361	S	4815	474	5289	0.00041
Komagataeibacter xylinus	28448	S	1288	2372	3660	0.00028
Komagataeibacter saccharivorans	265959	S	575	216	791	0.00006
Komagataeibacter nataicola	265960	S	397	192	589	0.00005
Komagataeibacter oboediens	65958	S	386	198	584	0.00005
Komagataeibacter medellinensis	1177712	S	332	283	615	0.00005
Komagataeibacter europaeus	33995	S	328	173	501	0.00004
Komagataeibacter rhaeticus	215221	S	12	216	228	0.00002
Acidiphilium multivorum	62140	S	945	4206	5151	0.00040
Acidiphilium cryptum	524	S	201	1364	1565	0.00012
Sediminicoccus rosea	1225128	S	3247	177	3424	0.00026
Acidibrevibacterium fodinaquatile	1969806	S	2886	274	3160	0.00024
Lichenicola cladoniae	1484109	S	2813	146	2959	0.00023
Acetobacter aceti	435	S	1158	432	1590	0.00012
Acetobacter persici	1076596	S	275	40	315	0.00002
Acetobacter sp. KACC 21233	2592655	S	232	51	283	0.00002
Acetobacter ghanensis	431306	S	155	41	196	0.00002
Acetobacter pasteurianus	438	S	103	242	345	0.00003
Acetobacter orientalis	146474	S	76	11	87	0.00001
Acetobacter tropicalis	104102	S	68	79	147	0.00001
Acetobacter ascendens	481146	S	67	80	147	0.00001
Acetobacter senegalensis	446692	S	49	61	110	0.00001
Acetobacter oryzoeni	2500548	S	29	58	87	0.00001
Acetobacter oryzifermentans	1633874	S	12	125	137	0.00001
Gluconobacter oxydans	442	S	716	730	1446	0.00011
Gluconobacter albidus	318683	S	330	61	391	0.00003
Gluconobacter sphaericus	574987	S	228	54	282	0.00002
Gluconobacter frateurii	38308	S	149	39	188	0.00001
Gluconobacter thailandicus	257438	S	63	45	108	0.00001
Gluconacetobacter diazotrophicus	33996	S	1822	400	2222	0.00017
Granulibacter bethesdensis	364410	S	1243	122	1365	0.00011
Asaia bogorensis	91915	S	804	150	954	0.00007
Neoasaia chiangmaiensis	320497	S	754	161	915	0.00007
Kozakia baliensis	153496	S	494	182	676	0.00005
Novacetimonas hansenii	436	S	489	241	730	0.00006
Oecophyllibacter saccharovorans	2558360	S	430	15	445	0.00003
Parasaccharibacter sp. TMW 2.1888	2268025	S	26	141	167	0.00001
Parasaccharibacter apium	1510841	S	18	94	112	0.00001
Swingsia sp. F3b2	2558361	S	184	5	189	0.00001
Swingsia samuiensis	1293412	S	26	4	30	0.00000
Neokomagataea tanensis	661191	S	107	19	126	0.00001
Entomobacter blattae	2762277	S	62	5	67	0.00001
Bombella sp. KACC 21507	2697033	S	25	3	28	0.00000
Hypericibacter adhaerens	2602016	S	12722	2549	15271	0.00118
Hypericibacter terrae	2602015	S	9999	1596	11595	0.00089
Magnetospirillum sp. XM-1	1663591	S	2508	883	3391	0.00026
Magnetospirillum sp. ME-1	1639348	S	2128	813	2941	0.00023
Magnetospirillum gryphiswaldense	55518	S	2969	264845	267814	0.02063
Magnetospirillum magneticum	84159	S	2440	283	2723	0.00021
Rhodospirillum centenum	34018	S	5283	810	6093	0.00047
Rhodospirillum rubrum	1085	S	2439	201	2640	0.00020
Ferrovibrio terrae	2594003	S	6151	423	6574	0.00051
Tistrella mobilis	171437	S	5036	2447	7483	0.00058
Defluviicoccus vanus	111831	S	2814	274	3088	0.00024
Pararhodospirillum photometricum	1084	S	1626	136	1762	0.00014
Haematospirillum jordaniae	1549855	S	302	29	331	0.00003
Candidatus Endolissoclinum faulkneri	1263979	S	157	2	159	0.00001
Stella humosa	94	S	12359	933	13292	0.00102
Elioraea tepida	2843330	S	5197	288	5485	0.00042
Thalassospira sp. A40-3	2785908	S	281	104	385	0.00003
Thalassospira sp. B30-1	2785911	S	168	234	402	0.00003
Thalassospira marina	2048283	S	405	28	433	0.00003
Thalassospira indica	1891279	S	262	159	421	0.00003
Thalassospira xiamenensis	220697	S	186	241	427	0.00003
Magnetospira sp. QH-2	1288970	S	1170	43	1213	0.00009
Terasakiella sp. SH-1	2560057	S	170	4	174	0.00001
Paracoccus sp. MC1862	2760307	S	1575	172	1747	0.00013
Paracoccus sp. AK26	2589076	S	1374	234	1608	0.00012
Paracoccus sp. MA	2895796	S	1302	699	2001	0.00015
Paracoccus sp. S8-55	2903900	S	853	114	967	0.00007
Paracoccus sp. H4-D09	2812658	S	790	167	957	0.00007
Paracoccus sp. Arc7-R13	2500532	S	526	541	1067	0.00008
Paracoccus sanguinis	1545044	S	2501	677	3178	0.00024
Paracoccus liaowanqingii	2560053	S	1686	194	1880	0.00014
Paracoccus yeei	147645	S	1665	2654	4319	0.00033
Paracoccus denitrificans	266	S	1489	1057	2546	0.00020
Paracoccus aminovorans	34004	S	1449	425	1874	0.00014
Paracoccus zhejiangensis	1077935	S	1430	333	1763	0.00014
Paracoccus pantotrophus	82367	S	1362	792	2154	0.00017
Paracoccus suum	2259340	S	1317	246	1563	0.00012
Paracoccus jeotgali	2065379	S	1265	242	1507	0.00012
Paracoccus contaminans	1945662	S	1227	280	1507	0.00012
Paracoccus aminophilus	34003	S	1132	113	1245	0.00010
Paracoccus kondratievae	135740	S	725	144	869	0.00007
Paracoccus tegillarcae	1529068	S	639	36	675	0.00005
Paracoccus marcusii	59779	S	537	486	1023	0.00008
Paracoccus mutanolyticus	1499308	S	213	714	927	0.00007
Cereibacter sphaeroides	1063	S	5194	2331	7525	0.00058
Cereibacter azotoformans	43057	S	562	1925	2487	0.00019
Rhodobacter sp. CZR27	2033869	S	2101	708	2809	0.00022
Rhodobacter sp. N10	2807096	S	1758	218	1976	0.00015
Rhodobacter sp. LPB0142	1850250	S	1618	1172	2790	0.00021
Rhodobacter capsulatus	1061	S	2012	429	2441	0.00019
Rhodovulum sp. P5	1564506	S	1058	100	1158	0.00009
Rhodovulum sp. MB263	308754	S	1039	415	1454	0.00011
Rhodovulum sulfidophilum	35806	S	1588	1085	2673	0.00021
Paroceanicella profunda	2579971	S	3641	768	4409	0.00034
Polymorphum gilvum	991904	S	3621	969	4590	0.00035
Pikeienuella piscinae	2748098	S	2683	268	2951	0.00023
Pontivivens ytuae	2789856	S	2392	184	2576	0.00020
Thioclava electrotropha	1549850	S	1025	264	1289	0.00010
Thioclava nitratireducens	1915078	S	952	317	1269	0.00010
Silicimonas algicola	1826607	S	2156	126	2282	0.00018
Pelagovum pacificum	2588711	S	2036	244	2280	0.00018
Frigidibacter mobilis	1335048	S	1559	633	2192	0.00017
Pukyongiella litopenaei	2605946	S	1436	255	1691	0.00013
Brevirhabdus pacifica	1267768	S	1414	450	1864	0.00014
Fuscovulum blasticum	1075	S	1198	156	1354	0.00010
Gymnodinialimonas ceratoperidinii	2856823	S	1189	100	1289	0.00010
Haematobacter massiliensis	195105	S	1123	452	1575	0.00012
Falsirhodobacter sp. PG104	2692330	S	1068	157	1225	0.00009
Pseudopuniceibacterium antarcticum	2613965	S	1040	73	1113	0.00009
Gemmobacter aquarius	2169400	S	978	214	1192	0.00009
Tabrizicola piscis	2494374	S	961	92	1053	0.00008
Pacificitalea manganoxidans	1411902	S	904	149	1053	0.00008
Pseudooceanicola algae	1537215	S	862	78	940	0.00007
Monaibacterium sp. h42	2758038	S	813	132	945	0.00007
Roseicitreum antarcticum	564137	S	777	37	814	0.00006
Tritonibacter mobilis	379347	S	637	177	814	0.00006
Pseudohalocynthiibacter aestuariivivens	1591409	S	535	65	600	0.00005
Yoonia vestfoldensis	245188	S	530	71	601	0.00005
Qingshengfaniella alkalisoli	2599296	S	491	23	514	0.00004
Rhodophyticola sp. CCM32	2916397	S	470	12	482	0.00004
Profundibacter amoris	2171755	S	390	12	402	0.00003
Rhodobaca barguzinensis	441209	S	374	16	390	0.00003
Pseudorhodobacter turbinis	2500533	S	362	20	382	0.00003
Aestuarium zhoushanense	2820523	S	282	74	356	0.00003
Parasedimentitalea marina	2483033	S	277	11	288	0.00002
Cognatishimia activa	1715691	S	254	9	263	0.00002
Planktomarina temperata	1284658	S	159	3	162	0.00001
Roseovarius sp. SCSIO 43702	2823043	S	1737	106	1843	0.00014
Roseovarius sp. THAF9	2587847	S	840	130	970	0.00007
Roseovarius sp. THAF8	2587846	S	342	511	853	0.00007
Roseovarius sp. THAF27	2587850	S	338	523	861	0.00007
Roseovarius sp. TM1035	391613	S	142	285	427	0.00003
Roseovarius indicus	540747	S	2224	382	2606	0.00020
Roseovarius faecimaris	2494550	S	815	25	840	0.00006
Roseovarius mucosus	215743	S	131	257	388	0.00003
Sulfitobacter sp. JK7-1	2829501	S	830	34	864	0.00007
Sulfitobacter sp. THAF37	2587855	S	829	208	1037	0.00008
Sulfitobacter sp. D7	1968541	S	423	99	522	0.00004
Sulfitobacter sp. JL08	2070369	S	404	6	410	0.00003
Sulfitobacter sp. SK011	1389004	S	381	7	388	0.00003
Sulfitobacter sp. DSM 110093	2883127	S	279	72	351	0.00003
Sulfitobacter sp. BSw21498	664426	S	239	19	258	0.00002
Sulfitobacter sp. SK012	1389005	S	227	2	229	0.00002
Sulfitobacter sp. SK025	1389011	S	106	176	282	0.00002
Sulfitobacter sp. CB2047	1525218	S	69	168	237	0.00002
Sulfitobacter sp. B30-2	2785912	S	60	120	180	0.00001
Sulfitobacter alexandrii	1917485	S	1300	330	1630	0.00013
Sulfitobacter mediterraneus	83219	S	646	37	683	0.00005
Sulfitobacter indolifex	225422	S	371	51	422	0.00003
Sulfitobacter dubius	218673	S	356	116	472	0.00004
Sulfitobacter pontiacus	60137	S	159	307	466	0.00004
Salipiger profundus	1229727	S	2382	645	3027	0.00023
Salipiger abyssi	1250539	S	1721	456	2177	0.00017
Salipiger sp. CCB-MM3	1792508	S	1626	166	1792	0.00014
Roseivivax sp. THAF30	2587852	S	1268	242	1510	0.00012
Roseivivax sp. THAF197b	2588299	S	26	580	606	0.00005
Roseivivax sp. THAF40	2587858	S	17	494	511	0.00004
Roseivivax marinus	1379903	S	2304	245	2549	0.00020
Celeribacter indicus	1208324	S	1946	566	2512	0.00019
Celeribacter ethanolicus	1758178	S	725	144	869	0.00007
Celeribacter baekdonensis	875171	S	336	50	386	0.00003
Celeribacter marinus	1397108	S	242	6	248	0.00002
Phaeobacter gallaeciensis	60890	S	905	278	1183	0.00009
Phaeobacter inhibens	221822	S	741	243	984	0.00008
Phaeobacter piscinae	1580596	S	336	254	590	0.00005
Phaeobacter porticola	1844006	S	208	59	267	0.00002
Phaeobacter sp. LSS9	681157	S	64	97	161	0.00001
Leisingera aquaemixtae	1396826	S	1001	147	1148	0.00009
Leisingera sp. NJS204	2508307	S	212	276	488	0.00004
Leisingera sp. NJS201	2508306	S	192	236	428	0.00003
Leisingera methylohalidivorans	133924	S	667	132	799	0.00006
Ruegeria sp. TM1040	292414	S	415	44	459	0.00004
Ruegeria sp. THAF33	2587853	S	345	66	411	0.00003
Ruegeria sp. SCSIO 43209	2793010	S	345	46	391	0.00003
Ruegeria sp. AD91A	2293862	S	293	30	323	0.00002
Ruegeria pomeroyi	89184	S	1136	140	1276	0.00010
Sulfitobacter pseudonitzschiae	1402135	S	1366	272	1638	0.00013
Pseudosulfitobacter sp. DSM 107133	2883100	S	488	114	602	0.00005
Yangia pacifica	311180	S	1967	228	2195	0.00017
Sagittula sp. P11	2009329	S	1917	400	2317	0.00018
Mameliella alba	561184	S	1469	147	1616	0.00012
Ponticoccus alexandrii	1943633	S	1428	142	1570	0.00012
Roseobacter ponti	1891787	S	540	11	551	0.00004
Roseobacter denitrificans	2434	S	404	48	452	0.00003
Roseobacter litoralis	42443	S	293	33	326	0.00003
Dinoroseobacter shibae	215813	S	1288	11269	12557	0.00097
Octadecabacter sp. SW4	2602067	S	440	35	475	0.00004
Octadecabacter arcticus	53946	S	239	32	271	0.00002
Octadecabacter antarcticus	1217908	S	238	26	264	0.00002
Octadecabacter temperatus	1458307	S	171	3	174	0.00001
Actibacterium sp. EMB200-NS6	1609966	S	1093	275	1368	0.00011
Roseibacterium elongatum	159346	S	1091	70	1161	0.00009
Oceanicola sp. D3	2587163	S	1070	41	1111	0.00009
Ketogulonicigenium vulgare	92945	S	539	91	630	0.00005
Ketogulonicigenium robustum	92947	S	493	56	549	0.00004
Maribius sp. THAF1	2587842	S	804	33	837	0.00006
Tateyamaria omphalii	299262	S	741	16	757	0.00006
Thalassococcus sp. S3	2017482	S	709	13	722	0.00006
Antarctobacter heliothermus	74033	S	705	23	728	0.00006
Jannaschia sp. CCS1	290400	S	670	13	683	0.00005
Thalassobius gelatinovorus	53501	S	467	18	485	0.00004
Falsihalocynthiibacter arcticus	1579316	S	186	4	190	0.00001
Caulobacter sp. S6	2823693	S	5008	589	5597	0.00043
Caulobacter sp. FWC26	69665	S	1755	804	2559	0.00020
Caulobacter segnis	88688	S	5797	2556	8353	0.00064
Caulobacter mirabilis	69666	S	4623	913	5536	0.00043
Caulobacter vibrioides	155892	S	3709	1587	5296	0.00041
Caulobacter flavus	1679497	S	3664	1073	4737	0.00036
Caulobacter rhizosphaerae	2010972	S	3278	991	4269	0.00033
Caulobacter soli	2708539	S	2810	928	3738	0.00029
Caulobacter henricii	69395	S	1505	268	1773	0.00014
Brevundimonas sp. PAMC22021	2861285	S	1812	404	2216	0.00017
Brevundimonas sp. M20	2591463	S	1730	276	2006	0.00015
Brevundimonas sp. MF30-B	2561924	S	1611	260	1871	0.00014
Brevundimonas sp. LM2	1938605	S	1571	275	1846	0.00014
Brevundimonas sp. AJA228-03	2752515	S	1184	159	1343	0.00010
Brevundimonas sp. CS1	2813778	S	456	451	907	0.00007
Brevundimonas sp. SGAir0440	2579977	S	349	336	685	0.00005
Brevundimonas sp. DS20	1532555	S	345	858	1203	0.00009
Brevundimonas sp. Bb-A	2560058	S	320	660	980	0.00008
Brevundimonas sp. GW460-12-10-14-LB2	1827469	S	317	551	868	0.00007
Brevundimonas sp. 'scallop'	2562582	S	307	539	846	0.00007
Brevundimonas naejangsanensis	588932	S	2952	1023	3975	0.00031
Brevundimonas goettingensis	2774190	S	1887	303	2190	0.00017
Brevundimonas albigilva	1312364	S	1869	1048	2917	0.00022
Brevundimonas subvibrioides	74313	S	1708	311	2019	0.00016
Brevundimonas pondensis	2774189	S	1246	385	1631	0.00013
Brevundimonas vitisensis	2800818	S	1230	155	1385	0.00011
Brevundimonas diminuta	293	S	1193	2231	3424	0.00026
Brevundimonas mediterranea	74329	S	1026	398	1424	0.00011
Brevundimonas nasdae	172043	S	982	685	1667	0.00013
Brevundimonas vancanneytii	1325724	S	330	1257	1587	0.00012
Brevundimonas vesicularis	41276	S	329	726	1055	0.00008
Phenylobacterium zucineum	284016	S	11727	2547	14274	0.00110
Phenylobacterium parvum	2201350	S	2747	322	3069	0.00024
Terricaulis silvestris	2686094	S	11791	441	12232	0.00094
Asticcacaulis excentricus	78587	S	1333	232	1565	0.00012
Asticcacaulis sp. AND118	2840468	S	1190	198	1388	0.00011
Candidatus Viadribacter manganicus	1759059	S	5485	162	5647	0.00044
Hyphomonas sp. CACIAM 19H1	1873716	S	1048	174	1222	0.00009
Hyphomonas sp. Mor2	1906738	S	665	15	680	0.00005
Hyphomonas sp. KY3	2016196	S	562	68	630	0.00005
Hyphomonas neptunium	81032	S	1018	128	1146	0.00009
Hirschia baltica	2724	S	56	1	57	0.00000
Marinicauda algicola	2029849	S	3124	566	3690	0.00028
Maricaulis maris	74318	S	1021	71	1092	0.00008
Glycocaulis alkaliphilus	1434191	S	956	53	1009	0.00008
Hyphobacterium sp. CCMP332	2749086	S	769	35	804	0.00006
Aquisalinus flavus	1526572	S	1410	73	1483	0.00011
Parvularcula bermudensis	208216	S	589	76	665	0.00005
Anaplasma ovis	142058	S	96	21	117	0.00001
Anaplasma platys	949	S	48	7	55	0.00000
Anaplasma marginale	770	S	17	37	54	0.00000
Anaplasma phagocytophilum	948	S	12	2	14	0.00000
Wolbachia pipientis	955	S	12	48	60	0.00000
Neorickettsia helminthoeca	33994	S	22	9	31	0.00000
Neorickettsia findlayensis	2686014	S	10	32	42	0.00000
Ehrlichia ruminantium	779	S	15	4	19	0.00000
Ehrlichia canis	944	S	12	6	18	0.00000
Candidatus Neoehrlichia mikurensis	89586	S	16	4	20	0.00000
Rickettsia tillamookensis	2761623	S	101	51	152	0.00001
Rickettsia endosymbiont of Ixodes scapularis	444612	S	16	17	33	0.00000
Rickettsia endosymbiont of Oedothorax gibbosus	931099	S	16	2	18	0.00000
Rickettsia endosymbiont of Bemisia tabaci	337479	S	11	9	20	0.00000
Rickettsia canadensis	788	S	10	1	11	0.00000
Orientia tsutsugamushi	784	S	19	1	20	0.00000
Candidatus Phycorickettsia trachydisci	2115978	S	28	2	30	0.00000
Candidatus Midichloria mitochondrii	234827	S	27	4	31	0.00000
Candidatus Fokinia solitaria	1802984	S	19	1	20	0.00000
Candidatus Deianiraea vastatrix	2163644	S	32	0	32	0.00000
Rickettsiales endosymbiont of Stachyamoeba lipophora	2486578	S	22	3	25	0.00000
Micavibrio aeruginosavorus	349221	S	779	10	789	0.00006
Candidatus Puniceispirillum marinum	767892	S	126	4	130	0.00001
Luteithermobacter gelatinilyticus	2582913	S	447	88	535	0.00004
Paremcibacter congregatus	2043170	S	373	12	385	0.00003
Candidatus Hydrogenosomobacter endosymbioticus	2558174	S	63	1	64	0.00000
Candidatus Cytomitobacter indipagum	2601575	S	21	6	27	0.00000
Candidatus Cytomitobacter primus	2066024	S	11	3	14	0.00000
endosymbiont of Acanthamoeba sp. UWC8	86106	S	31	0	31	0.00000
Candidatus Gromoviella agglomerans	2806609	S	19	1	20	0.00000
Candidatus Nesciobacter abundans	2601668	S	17	3	20	0.00000
Candidatus Paracaedibacter acanthamoebae	91604	S	81	4	85	0.00001
Candidatus Nucleicultrix amoebiphila	1509244	S	77	4	81	0.00001
Magnetococcus marinus	1124597	S	237	7	244	0.00002
Candidatus Pelagibacter sp. RS40	1977865	S	19	14	33	0.00000
Candidatus Pelagibacter sp. IMCC9063	1002672	S	10	1	11	0.00000
Candidatus Fonsibacter ubiquis	1925548	S	47	5	52	0.00000
Kordiimonas pumila	2161677	S	93	2	95	0.00001
Burkholderia multivorans	87883	S	5241	24289	29530	0.00227
Burkholderia ubonensis	101571	S	5213	2185	7398	0.00057
Burkholderia cenocepacia	95486	S	4008	6474	10482	0.00081
Burkholderia cepacia	292	S	3428	3151	6579	0.00051
Burkholderia pyrrocinia	60550	S	2208	709	2917	0.00022
Burkholderia contaminans	488447	S	1901	809	2710	0.00021
Burkholderia stagnalis	1503054	S	1805	468	2273	0.00018
Burkholderia ambifaria	152480	S	1738	874	2612	0.00020
Burkholderia dolosa	152500	S	1528	25254	26782	0.00206
Burkholderia anthina	179879	S	1523	1019	2542	0.00020
Burkholderia lata	482957	S	1454	854	2308	0.00018
Burkholderia stabilis	95485	S	1442	751	2193	0.00017
Burkholderia territorii	1503055	S	1160	354	1514	0.00012
Burkholderia seminalis	488731	S	999	292	1291	0.00010
Burkholderia vietnamiensis	60552	S	937	86773	87710	0.00676
Burkholderia metallica	488729	S	834	256	1090	0.00008
Burkholderia diffusa	488732	S	552	167	719	0.00006
Burkholderia pseudomultivorans	1207504	S	441	277	718	0.00006
Burkholderia latens	488446	S	282	318	600	0.00005
Burkholderia aenigmatica	2015348	S	257	398	655	0.00005
Burkholderia pseudomallei	28450	S	2458	23067	25525	0.00197
Burkholderia thailandensis	57975	S	1686	1690	3376	0.00026
Burkholderia mayonis	1385591	S	1681	301	1982	0.00015
Burkholderia oklahomensis	342113	S	1210	389	1599	0.00012
Burkholderia savannae	1637837	S	297	246	543	0.00004
Burkholderia sp. MSMB1588	1636423	S	109	119	228	0.00002
Burkholderia sp. MSMB617WGS	1637831	S	92	153	245	0.00002
Burkholderia mallei	13373	S	56	2386	2442	0.00019
Burkholderia sp. DHOD12	2571746	S	2997	268	3265	0.00025
Burkholderia sp. Bp7605	1740163	S	1601	203	1804	0.00014
Burkholderia sp. NRF60-BP8	1637853	S	602	201	803	0.00006
Burkholderia sp. LA-2-3-30-S1-D2	1637862	S	577	242	819	0.00006
Burkholderia sp. JP2-270	2217913	S	567	232	799	0.00006
Burkholderia sp. MSMB0856	1637869	S	543	245	788	0.00006
Burkholderia sp. PAMC 26561	1795043	S	518	663	1181	0.00009
Burkholderia sp. MS455	2811788	S	456	211	667	0.00005
Burkholderia sp. PAMC 28687	1795874	S	300	594	894	0.00007
Burkholderia sp. IDO3	1705310	S	268	235	503	0.00004
Burkholderia sp. KBS0801	1179675	S	125	128	253	0.00002
Burkholderia sp. LAS2	2813843	S	110	293	403	0.00003
Burkholderia sp. KJ006	416344	S	38	133	171	0.00001
Burkholderia sp. MS389	2811789	S	29	121	150	0.00001
Burkholderia sp. MBR-1	2732364	S	28	66	94	0.00001
Burkholderia gladioli	28095	S	6392	1931	8323	0.00064
Burkholderia glumae	337	S	2361	19070	21431	0.00165
Burkholderia plantarii	41899	S	1648	439	2087	0.00016
Burkholderia perseverans	2615214	S	1479	417	1896	0.00015
Cupriavidus taiwanensis	164546	S	10693	8458	19151	0.00148
Cupriavidus pauculus	82633	S	8577	3625	12202	0.00094
Cupriavidus oxalaticus	96344	S	4950	2132	7082	0.00055
Cupriavidus necator	106590	S	4444	3589	8033	0.00062
Cupriavidus basilensis	68895	S	4427	2394	6821	0.00053
Cupriavidus sp. EM10	2839983	S	1933	1068	3001	0.00023
Cupriavidus sp. MP-37	2884455	S	1115	1093	2208	0.00017
Cupriavidus sp. KK10	1478019	S	335	976	1311	0.00010
Cupriavidus sp. ISTL7	2771360	S	315	1970	2285	0.00018
Cupriavidus sp. USMAA2-4	876364	S	255	1733	1988	0.00015
Cupriavidus sp. USMAHM13	1389192	S	216	1478	1694	0.00013
Cupriavidus campinensis	151783	S	3472	1207	4679	0.00036
Cupriavidus metallidurans	119219	S	2631	1718	4349	0.00034
Cupriavidus pinatubonensis	248026	S	2364	391	2755	0.00021
Cupriavidus gilardii	82541	S	1249	6037	7286	0.00056
Cupriavidus neocaledonicus	1040979	S	846	1008	1854	0.00014
Cupriavidus nantongensis	1796606	S	742	1999	2741	0.00021
Cupriavidus malaysiensis	367825	S	214	1384	1598	0.00012
Paraburkholderia sp. SOS3	1926494	S	2281	312	2593	0.00020
Paraburkholderia sp. PGU16	2735433	S	1103	609	1712	0.00013
Paraburkholderia sp. PGU19	2735434	S	894	765	1659	0.00013
Paraburkholderia pallida	2547399	S	3079	530	3609	0.00028
Paraburkholderia aromaticivorans	2026199	S	2722	1166	3888	0.00030
Paraburkholderia acidisoli	2571748	S	2436	407	2843	0.00022
Paraburkholderia caribensis	75105	S	2419	1753	4172	0.00032
Paraburkholderia tropica	92647	S	2324	483	2807	0.00022
Paraburkholderia acidiphila	2571747	S	2300	426	2726	0.00021
Paraburkholderia edwinii	2861782	S	2072	264	2336	0.00018
Paraburkholderia phytofirmans	261302	S	2024	776	2800	0.00022
Paraburkholderia terricola	169427	S	1949	560	2509	0.00019
Paraburkholderia fungorum	134537	S	1885	426	2311	0.00018
Paraburkholderia atlantica	2654982	S	1812	415	2227	0.00017
Paraburkholderia phymatum	148447	S	1807	444	2251	0.00017
Paraburkholderia sprentiae	948107	S	1707	354	2061	0.00016
Paraburkholderia megapolitana	420953	S	1641	145	1786	0.00014
Paraburkholderia phenoliruptrix	252970	S	1636	451	2087	0.00016
Paraburkholderia graminis	60548	S	1633	379	2012	0.00016
Paraburkholderia caledonica	134536	S	1429	247	1676	0.00013
Paraburkholderia terrae	311230	S	1404	1583	2987	0.00023
Paraburkholderia ginsengisoli	311231	S	1387	402	1789	0.00014
Paraburkholderia hospita	169430	S	1384	1561	2945	0.00023
Paraburkholderia caffeinilytica	1761016	S	1215	305	1520	0.00012
Paraburkholderia dokdonella	2211211	S	1168	291	1459	0.00011
Paraburkholderia xenovorans	36873	S	1092	1453	2545	0.00020
Paraburkholderia dioscoreae	2604047	S	848	556	1404	0.00011
Ralstonia solanacearum	305	S	5902	16588	22490	0.00173
Ralstonia insidiosa	190721	S	1588	1216	2804	0.00022
Ralstonia mannitolilytica	105219	S	1189	1259	2448	0.00019
Ralstonia pickettii	329	S	1122	426	1548	0.00012
Ralstonia sp. 56D2	2842456	S	1028	143	1171	0.00009
blood disease bacterium A2-HR MARDI	1944648	S	12	429	441	0.00003
Ralstonia syzygii	28097	S	95	230	325	0.00003
Ralstonia pseudosolanacearum	1310165	S	42	758	800	0.00006
Pandoraea pnomenusa	93220	S	2443	1179	3622	0.00028
Pandoraea thiooxydans	445709	S	1893	153	2046	0.00016
Pandoraea pulmonicola	93221	S	1853	405	2258	0.00017
Pandoraea sp. XY-2	2518599	S	1386	773	2159	0.00017
Pandoraea vervacti	656178	S	1359	398	1757	0.00014
Pandoraea faecigallinarum	656179	S	1317	357	1674	0.00013
Pandoraea norimbergensis	93219	S	1220	195	1415	0.00011
Pandoraea apista	93218	S	1065	621	1686	0.00013
Pandoraea fibrosis	1891094	S	1050	355	1405	0.00011
Pandoraea oxalativorans	573737	S	985	468	1453	0.00011
Pandoraea sputorum	93222	S	863	388	1251	0.00010
Caballeronia sp. Lep1P3	2878150	S	1867	439	2306	0.00018
Caballeronia sp. TF1N1	2878153	S	1520	173	1693	0.00013
Caballeronia sp. SL2Y3	2878151	S	981	553	1534	0.00012
Caballeronia sp. Sq4a	2878152	S	855	621	1476	0.00011
Caballeronia sp. M1242	2814653	S	789	557	1346	0.00010
Caballeronia sp. SBC2	2705547	S	110	932	1042	0.00008
Caballeronia sp. SBC1	2705548	S	74	876	950	0.00007
Caballeronia zhejiangensis	871203	S	2092	491	2583	0.00020
Caballeronia insecticola	758793	S	1946	407	2353	0.00018
Caballeronia grimmiae	1071679	S	1668	907	2575	0.00020
Polynucleobacter sp. MWH-UH24A	2689110	S	79	5	84	0.00001
Polynucleobacter sp. MWH-Spelu-300-X4	2689109	S	45	2	47	0.00000
Polynucleobacter sp. LimPoW16	1743162	S	40	2	42	0.00000
Polynucleobacter sp. TSB-Sco08W16	1758374	S	39	6	45	0.00000
Polynucleobacter sp. AP-Kolm-20A-A1	2081041	S	34	20	54	0.00000
Polynucleobacter sp. MWH-UH21B	1743174	S	33	6	39	0.00000
Polynucleobacter sp. MWH-Aus1W21	1855880	S	33	8	41	0.00000
Polynucleobacter sp. MWH-Svant-W18	1855909	S	30	6	36	0.00000
Polynucleobacter sp. MWH-P3-07-1	1743173	S	29	4	33	0.00000
Polynucleobacter sp. VK25	1758398	S	28	7	35	0.00000
Polynucleobacter sp. AP-Melu-1000-A1	2081042	S	27	11	38	0.00000
Polynucleobacter sp. MWH-UH2A	1855617	S	26	5	31	0.00000
Polynucleobacter sp. MWH-Braz-FAM2G	1855883	S	25	3	28	0.00000
Polynucleobacter sp. MWH-S4W17	1855910	S	25	13	38	0.00000
Polynucleobacter sp. MWH-CaK5	2689107	S	23	1	24	0.00000
Polynucleobacter sp. AP-Nino-20-G2	2576917	S	23	5	28	0.00000
Polynucleobacter sp. AP-Titi-500A-B4	2576923	S	23	5	28	0.00000
Polynucleobacter sp. es-EL-1	1855652	S	20	3	23	0.00000
Polynucleobacter sp. MWH-UH25E	1855616	S	20	4	24	0.00000
Polynucleobacter sp. AP-Sving-400A-A2	2081049	S	19	10	29	0.00000
Polynucleobacter sp. JS-JIR-II-50	2576919	S	19	9	28	0.00000
Polynucleobacter sp. JS-JIR-II-b4	1758390	S	18	10	28	0.00000
Polynucleobacter sp. MWH-UH35A	1855619	S	18	3	21	0.00000
Polynucleobacter sp. AP-Ainpum-60-G11	2576926	S	18	4	22	0.00000
Polynucleobacter sp. JS-Mosq-20-D10	2576922	S	16	6	22	0.00000
Polynucleobacter sp. AP-Elch-400A-B2	2576930	S	13	6	19	0.00000
Polynucleobacter sp. MG-Unter2-18	2081052	S	13	9	22	0.00000
Polynucleobacter sp. AP-Jannik-300A-C4	2576928	S	13	14	27	0.00000
Polynucleobacter sp. es-MAR-2	1819725	S	12	2	14	0.00000
Polynucleobacter sp. MG-6-Vaara-E2	2576932	S	12	2	14	0.00000
Polynucleobacter sp. Adler-ghost	2770234	S	12	5	17	0.00000
Polynucleobacter sp. AM-7D1	2689102	S	10	11	21	0.00000
Polynucleobacter sp. JS-JIR-5-A7	1758395	S	10	28	38	0.00000
Polynucleobacter necessarius	576610	S	188	33	221	0.00002
Polynucleobacter asymbioticus	576611	S	132	20	152	0.00001
Polynucleobacter difficilis	556054	S	112	9	121	0.00001
Polynucleobacter acidiphobus	556053	S	93	7	100	0.00001
Polynucleobacter paneuropaeus	2527775	S	47	5	52	0.00000
Polynucleobacter wuianus	1743168	S	37	11	48	0.00000
Polynucleobacter duraquae	1835254	S	22	14	36	0.00000
Lautropia mirabilis	47671	S	1613	309	1922	0.00015
Mycetohabitans rhizoxinica	412963	S	1111	78	1189	0.00009
Chitinimonas arctica	2594795	S	1102	92	1194	0.00009
Mycoavidus sp. HKI	2840467	S	148	13	161	0.00001
Mycoavidus sp. B2-EB	2651972	S	58	11	69	0.00001
Mycoavidus cysteinexigens	1553431	S	114	16	130	0.00001
Limnobacter sp. SAORIC-580	2732163	S	175	9	184	0.00001
Candidatus Vallotia lariciata	2018052	S	45	19	64	0.00001
Candidatus Vallotia cooleyia	1177211	S	43	5	48	0.00000
Candidatus Vallotia sp. (ex Adelges kitamiensis)	2864217	S	34	14	48	0.00000
Candidatus Vallotia tarda	1177213	S	28	5	33	0.00000
Ephemeroptericola cinctiostellae	2268024	S	89	6	95	0.00001
Variovorax sp. HW608	1034889	S	6763	1193	7956	0.00061
Variovorax sp. PBS-H4	434008	S	3735	2626	6361	0.00049
Variovorax sp. RA8	662548	S	3711	3082	6793	0.00052
Variovorax sp. PBL-H6	434009	S	3591	3496	7087	0.00055
Variovorax sp. WDL1	207745	S	3544	5936	9480	0.00073
Variovorax sp. PAMC 28711	1795631	S	2631	470	3101	0.00024
Variovorax sp. RKNM96	2681552	S	2618	1023	3641	0.00028
Variovorax sp. PAMC26660	2762322	S	2235	575	2810	0.00022
Variovorax sp. PAMC28562	2762323	S	2135	194	2329	0.00018
Variovorax sp. SRS16	282217	S	1872	3974	5846	0.00045
Variovorax sp. 38R	2774875	S	1553	2084	3637	0.00028
Variovorax sp. PBL-E5	434014	S	1527	3758	5285	0.00041
Variovorax sp. PDNC026	2811425	S	87	3004	3091	0.00024
Variovorax sp. PMC12	2126319	S	35	1552	1587	0.00012
Variovorax paradoxus	34073	S	13669	12808	26477	0.00204
Variovorax boronicumulans	436515	S	2113	1602	3715	0.00029
Hydrogenophaga sp. BA0156	2716225	S	3805	2940	6745	0.00052
Hydrogenophaga sp. PBC	795665	S	3434	4526	7960	0.00061
Hydrogenophaga sp. YM1	2806262	S	3349	1814	5163	0.00040
Hydrogenophaga sp. BPS33	2651974	S	2978	2724	5702	0.00044
Hydrogenophaga sp. SL48	2806347	S	2439	623	3062	0.00024
Hydrogenophaga sp. RAC07	1842537	S	1942	692	2634	0.00020
Hydrogenophaga sp. PBL-H3	434010	S	1897	1947	3844	0.00030
Hydrogenophaga sp. NH-16	2184519	S	1167	2545	3712	0.00029
Hydrogenophaga sp. PAMC20947	2565558	S	1028	74	1102	0.00008
Hydrogenophaga taeniospiralis	65656	S	2085	672	2757	0.00021
Hydrogenophaga crassostreae	1763535	S	966	65	1031	0.00008
Hydrogenophaga pseudoflava	47421	S	965	1608	2573	0.00020
Acidovorax sp. YS12	2738413	S	2089	2005	4094	0.00032
Acidovorax sp. RAC01	1842533	S	1310	1228	2538	0.00020
Acidovorax sp. JMULE5	2518343	S	1205	363	1568	0.00012
Acidovorax sp. HDW3	2714923	S	1191	962	2153	0.00017
Acidovorax sp. KKS102	358220	S	1171	941	2112	0.00016
Acidovorax sp. 1608163	2478662	S	977	225	1202	0.00009
Acidovorax sp. T1	1858609	S	724	3039	3763	0.00029
Acidovorax avenae	80867	S	4399	3109	7508	0.00058
Acidovorax monticola	1926868	S	2368	1026	3394	0.00026
Acidovorax antarcticus	2743470	S	2161	1837	3998	0.00031
Acidovorax carolinensis	553814	S	1465	1332	2797	0.00022
Acidovorax citrulli	80869	S	1238	1254	2492	0.00019
Acidovorax cattleyae	80868	S	1066	818	1884	0.00015
Acidovorax radicis	758826	S	958	215	1173	0.00009
Ramlibacter tataouinensis	94132	S	19980	8683	28663	0.00221
Comamonas sp. NLF-7-7	2597701	S	1536	1336	2872	0.00022
Comamonas sp. NLF-1-9	2853163	S	1318	877	2195	0.00017
Comamonas sp. B21-038	2918299	S	823	222	1045	0.00008
Comamonas sp. Y33R10-2	2853257	S	267	54	321	0.00002
Comamonas aquatica	225991	S	2019	2269	4288	0.00033
Comamonas serinivorans	1082851	S	2004	623	2627	0.00020
Comamonas testosteroni	285	S	1233	1981	3214	0.00025
Comamonas odontotermitis	379895	S	775	169	944	0.00007
Comamonas koreensis	160825	S	738	526	1264	0.00010
Comamonas piscis	1562974	S	621	132	753	0.00006
Comamonas thiooxydans	363952	S	589	1389	1978	0.00015
Comamonas kerstersii	225992	S	434	271	705	0.00005
Comamonas fluminis	2796366	S	433	209	642	0.00005
Rhodoferax sp. BAB1	2741720	S	2412	717	3129	0.00024
Rhodoferax sp. AJA081-3	2752316	S	788	60	848	0.00007
Rhodoferax sp. PAMC 29310	2822760	S	595	71	666	0.00005
Rhodoferax sp. MIZ03	2798804	S	447	51	498	0.00004
Rhodoferax koreense	1842727	S	3523	2082	5605	0.00043
Rhodoferax sediminis	2509614	S	2674	441	3115	0.00024
Rhodoferax ferrireducens	192843	S	1202	87	1289	0.00010
Rhodoferax saidenbachensis	1484693	S	803	94	897	0.00007
Rhodoferax antarcticus	81479	S	575	48	623	0.00005
Rhodoferax aquaticus	2527691	S	374	40	414	0.00003
Schlegelella thermodepolymerans	215580	S	7795	4013	11808	0.00091
Schlegelella brevitalea	413882	S	5645	859	6504	0.00050
Diaphorobacter sp. HDW4A	2714924	S	1386	1544	2930	0.00023
Diaphorobacter sp. HDW4B	2714925	S	1262	172	1434	0.00011
Diaphorobacter sp. JS3051	2792224	S	171	3027	3198	0.00025
Diaphorobacter sp. MNS-0	2866628	S	157	1361	1518	0.00012
Diaphorobacter sp. JS3050	2735554	S	123	1408	1531	0.00012
Diaphorobacter ruginosibacter	1715720	S	1805	355	2160	0.00017
Diaphorobacter aerolatus	1288495	S	1311	2286	3597	0.00028
[Acidovorax] ebreus	721785	S	248	1509	1757	0.00014
Diaphorobacter nitroreducens	164759	S	233	643	876	0.00007
Delftia tsuruhatensis	180282	S	1930	5631	7561	0.00058
Delftia acidovorans	80866	S	1319	2591	3910	0.00030
Delftia lacustris	558537	S	609	3683	4292	0.00033
Delftia sp. Cs1-4	742013	S	189	436	625	0.00005
Delftia sp. HK171	1920191	S	106	282	388	0.00003
Polaromonas sp. JS666	296591	S	2827	2190	5017	0.00039
Polaromonas naphthalenivorans	216465	S	1957	316	2273	0.00018
Polaromonas vacuolata	37448	S	250	28	278	0.00002
Kinneretia sp. DAIF2	2714952	S	4603	1763	6366	0.00049
Kinneretia sp. XES5	2877940	S	1370	1948	3318	0.00026
Ottowia sp. 27C	2816950	S	2161	463	2624	0.00020
Ottowia sp. oral taxon 894	1658672	S	852	135	987	0.00008
Ottowia oryzae	2109914	S	1615	392	2007	0.00015
Alicycliphilus denitrificans	179636	S	4259	8296	12555	0.00097
Melaminivora sp. SC2-9	2109913	S	1912	2504	4416	0.00034
Melaminivora jejuensis	1267217	S	1501	1296	2797	0.00022
Serpentinimonas maccroryi	1458426	S	1365	487	1852	0.00014
Serpentinimonas raichei	1458425	S	1156	463	1619	0.00012
Verminephrobacter eiseniae	364317	S	1939	258	2197	0.00017
Hylemonella gracilis	80880	S	1729	265	1994	0.00015
Pulveribacter suum	2116657	S	1575	888	2463	0.00019
Simplicispira suum	2109915	S	1303	554	1857	0.00014
Limnohabitans sp. 63ED37-2	1678128	S	618	71	689	0.00005
Limnohabitans sp. 103DPR2	1678129	S	204	16	220	0.00002
Candidatus Symbiobacter mobilis	1436290	S	688	27	715	0.00006
Curvibacter sp. AEP1-3	1844971	S	597	46	643	0.00005
Massilia sp. WG5	1707785	S	3565	1742	5307	0.00041
Massilia sp. HC52	2852099	S	2826	858	3684	0.00028
Massilia sp. LPB0304	2769491	S	2771	761	3532	0.00027
Massilia sp. DM-R-R2A-13	2899220	S	2500	616	3116	0.00024
Massilia sp. YMA4	1593482	S	2298	1314	3612	0.00028
Massilia sp. NP310	2861282	S	2197	1608	3805	0.00029
Massilia sp. PAMC28688	2861283	S	1655	278	1933	0.00015
Massilia sp. NR 4-1	1678028	S	330	1097	1427	0.00011
Massilia sp. MB5	2919578	S	323	1111	1434	0.00011
Massilia sp. Dwa41.01b	2709302	S	53	1853	1906	0.00015
Massilia sp. Se16.2.3	2709303	S	41	1446	1487	0.00011
Massilia violaceinigra	2045208	S	4234	1325	5559	0.00043
Massilia putida	1141883	S	4221	1485	5706	0.00044
Massilia flava	871742	S	3887	1043	4930	0.00038
Massilia albidiflava	321983	S	2481	1086	3567	0.00027
Massilia lutea	321985	S	2391	803	3194	0.00025
Massilia umbonata	864828	S	2356	1038	3394	0.00026
Massilia armeniaca	2072590	S	2260	1307	3567	0.00027
Massilia plicata	321984	S	2213	635	2848	0.00022
Massilia oculi	945844	S	1873	1321	3194	0.00025
Massilia antarctica	2765360	S	1804	746	2550	0.00020
Duganella sp. GN2-R2	2728020	S	3101	1455	4556	0.00035
Duganella sp. AF9R3	2728021	S	1825	417	2242	0.00017
Herbaspirillum robiniae	2014887	S	2205	859	3064	0.00024
Herbaspirillum seropedicae	964	S	1525	781	2306	0.00018
Herbaspirillum frisingense	92645	S	1509	497	2006	0.00015
Herbaspirillum hiltneri	341045	S	1304	235	1539	0.00012
Herbaspirillum rubrisubalbicans	80842	S	1260	600	1860	0.00014
Herbaspirillum huttiense	863372	S	926	392	1318	0.00010
Herbaspirillum sp. meg3	2025949	S	800	100	900	0.00007
Janthinobacterium sp. 1_2014MBL_MicDiv	1644131	S	1268	503	1771	0.00014
Janthinobacterium sp. 17J80-10	2497863	S	1215	195	1410	0.00011
Janthinobacterium sp. LM6	1938606	S	597	400	997	0.00008
Janthinobacterium sp. PAMC25594	2861284	S	431	289	720	0.00006
Janthinobacterium sp. Marseille	375286	S	347	96	443	0.00003
Janthinobacterium sp. HH102	1537274	S	261	451	712	0.00005
Janthinobacterium sp. B9-8	1236179	S	153	43	196	0.00002
Janthinobacterium agaricidamnosum	55508	S	1675	2915	4590	0.00035
Janthinobacterium tructae	2590869	S	428	245	673	0.00005
Janthinobacterium lividum	29581	S	392	439	831	0.00006
Janthinobacterium svalbardensis	368607	S	391	218	609	0.00005
Collimonas fungivorans	158899	S	1691	489	2180	0.00017
Collimonas arenae	279058	S	1343	187	1530	0.00012
Collimonas pratensis	279113	S	1208	265	1473	0.00011
Noviherbaspirillum sp. UKPF54	2601898	S	3037	554	3591	0.00028
Undibacterium sp. YM2	2058625	S	171	65	236	0.00002
Undibacterium sp. KW1	2058624	S	151	58	209	0.00002
Undibacterium parvum	401471	S	206	29	235	0.00002
Glaciimonas sp. PAMC28666	2807626	S	260	18	278	0.00002
Herminiimonas arsenitoxidans	1809410	S	243	42	285	0.00002
Oxalobacter formigenes	847	S	174	18	192	0.00001
Achromobacter xylosoxidans	85698	S	6324	11627	17951	0.00138
Achromobacter sp. AONIH1	1758194	S	2052	2913	4965	0.00038
Achromobacter sp. MFA1 R4	1881016	S	1836	552	2388	0.00018
Achromobacter sp. 77	2756133	S	331	862	1193	0.00009
Achromobacter sp. B7	2282475	S	269	637	906	0.00007
Achromobacter sp. ES-001	2860286	S	222	739	961	0.00007
Achromobacter spanius	217203	S	3411	1500	4911	0.00038
Achromobacter denitrificans	32002	S	3281	2533	5814	0.00045
Achromobacter deleyi	1353891	S	2280	1692	3972	0.00031
Achromobacter insolitus	217204	S	1667	488	2155	0.00017
Achromobacter pestifer	1353889	S	1224	893	2117	0.00016
Achromobacter mucicolens	1389922	S	510	814	1324	0.00010
Achromobacter ruhlandii	72557	S	23	1100	1123	0.00009
Bordetella sp. H567	1697043	S	2206	267	2473	0.00019
Bordetella sp. N	1746199	S	2075	234	2309	0.00018
Bordetella genomosp. 13	463040	S	2758	2160	4918	0.00038
Bordetella bronchialis	463025	S	2735	364	3099	0.00024
Bordetella genomosp. 8	1416806	S	2441	281	2722	0.00021
Bordetella flabilis	463014	S	2301	197	2498	0.00019
Bordetella genomosp. 9	1416803	S	2278	620	2898	0.00022
Bordetella petrii	94624	S	1833	2715	4548	0.00035
Bordetella hinzii	103855	S	1832	798	2630	0.00020
Bordetella trematum	123899	S	1442	676	2118	0.00016
Bordetella pseudohinzii	1331258	S	1094	474	1568	0.00012
Bordetella bronchiseptica	518	S	1084	2520	3604	0.00028
Bordetella holmesii	35814	S	747	260	1007	0.00008
Bordetella avium	521	S	694	79	773	0.00006
Bordetella genomosp. 6	463024	S	349	427	776	0.00006
Bordetella pertussis	520	S	223	7457	7680	0.00059
Bordetella parapertussis	519	S	121	10578	10699	0.00082
Pigmentiphaga sp. H8	2488560	S	4014	528	4542	0.00035
Pigmentiphaga aceris	1940612	S	1091	78	1169	0.00009
Castellaniella defragrans	75697	S	2571	1943	4514	0.00035
Orrella dioscoreae	1851544	S	2055	769	2824	0.00022
Orrella marina	2163011	S	300	56	356	0.00003
Orrella sp. f23	2782176	S	156	8	164	0.00001
Alcaligenes faecalis	511	S	510	494	1004	0.00008
Alcaligenes sp. SORT26	2813780	S	130	26	156	0.00001
Alcaligenes sp. DN25	1367435	S	18	43	61	0.00000
Alcaligenes aquatilis	323284	S	87	343	430	0.00003
Alcaligenes ammonioxydans	2582914	S	16	191	207	0.00002
Pusillimonas thiosulfatoxidans	2028345	S	599	187	786	0.00006
Pusillimonas sp. T7-7	1007105	S	388	63	451	0.00003
Pusillimonas sp. DMV24BSW_D	2716226	S	185	13	198	0.00002
Paralcaligenes sp. KSB-10	2901142	S	745	31	776	0.00006
Kerstersia gyiorum	206506	S	692	155	847	0.00007
Advenella kashmirensis	310575	S	309	17	326	0.00003
Advenella mimigardefordensis	302406	S	286	16	302	0.00002
Oligella urethralis	90245	S	53	12	65	0.00001
Oligella ureolytica	90244	S	50	48	98	0.00001
Paenalcaligenes hominis	643674	S	59	3	62	0.00000
Basilea psittacipulmonis	1472345	S	20	2	22	0.00000
Rhizobacter sp. AJA081-3	2753607	S	6402	1750	8152	0.00063
Rhizobacter gummiphilus	946333	S	6020	1285	7305	0.00056
Mitsuaria sp. 7	1658665	S	8814	1913	10727	0.00083
Sphaerotilus sp. FB-5	2914710	S	4185	2991	7176	0.00055
Sphaerotilus natans	34103	S	3669	1561	5230	0.00040
Methylibium petroleiphilum	105560	S	2180	2248	4428	0.00034
Methylibium sp. Pch-M	2082386	S	2155	2025	4180	0.00032
Rubrivivax gelatinosus	28068	S	6441	2205	8646	0.00067
Aquincola tertiaricarbonis	391953	S	5367	2033	7400	0.00057
Thiomonas sp. X19	1050370	S	1999	746	2745	0.00021
Thiomonas intermedia	926	S	1271	189	1460	0.00011
Thiomonas arsenitoxydans	426114	S	480	868	1348	0.00010
Leptothrix cholodnii	34029	S	4285	1474	5759	0.00044
Xylophilus rhododendri	2697032	S	3068	937	4005	0.00031
Tepidimonas taiwanensis	307486	S	2557	1017	3574	0.00028
Ideonella dechloratans	36863	S	2502	1600	4102	0.00032
Roseateles depolymerans	76731	S	2467	513	2980	0.00023
Aquabacterium olei	1296669	S	2192	619	2811	0.00022
Inhella inkyongensis	392593	S	1441	248	1689	0.00013
Paucibacter sp. KCTC 42545	1768242	S	1098	199	1297	0.00010
Candidatus Ichthyocystis hellenicum	1561003	S	32	0	32	0.00000
Sutterella megalosphaeroides	2494234	S	839	156	995	0.00008
Sutterella faecalis	2584944	S	633	96	729	0.00006
Sutterella wadsworthensis	40545	S	293	38	331	0.00003
Turicimonas muris	1796652	S	103	9	112	0.00001
Thauera sp. MZ1T	85643	S	3788	4217	8005	0.00062
Thauera sp. K11	2005884	S	3407	2316	5723	0.00044
Thauera humireducens	1134435	S	2342	1565	3907	0.00030
Thauera chlorobenzoica	96773	S	1773	1843	3616	0.00028
Thauera aromatica	59405	S	1641	2570	4211	0.00032
Thauera hydrothermalis	2184083	S	972	301	1273	0.00010
Azoarcus sp. KH32C	748247	S	3813	762	4575	0.00035
Azoarcus sp. DD4	2027405	S	2721	1937	4658	0.00036
Azoarcus olearius	418699	S	3181	1300	4481	0.00035
Azoarcus communis	41977	S	2350	1005	3355	0.00026
Nitrogeniibacter mangrovi	2016596	S	2848	653	3501	0.00027
Nitrogeniibacter aestuarii	2815343	S	1315	157	1472	0.00011
Aromatoleum petrolei	76116	S	3663	988	4651	0.00036
Aromatoleum aromaticum	551760	S	2990	2217	5207	0.00040
Aromatoleum pumilum	2067960	S	2541	1068	3609	0.00028
Aromatoleum bremense	76115	S	2531	1565	4096	0.00032
Azospira restricta	404405	S	6197	3496	9693	0.00075
Azospira inquinata	2785627	S	526	49	575	0.00004
Azospira sp. I09	1765049	S	437	1314	1751	0.00013
Azospira oryzae	146939	S	397	959	1356	0.00010
Niveibacterium microcysteis	2811415	S	2104	335	2439	0.00019
Oryzomicrobium terrae	1735038	S	1582	451	2033	0.00016
Rugosibacter aromaticivorans	1565605	S	441	81	522	0.00004
Dechloromonas denitrificans	281362	S	2324	637	2961	0.00023
Dechloromonas sp. HYN0024	2231055	S	646	139	785	0.00006
Dechloromonas sp. TW-R-39-2	2654218	S	380	196	576	0.00004
Ferribacterium limneticum	76259	S	3021	540	3561	0.00027
Quatrionicoccus australiensis	138118	S	1257	391	1648	0.00013
Fluviibacter phosphoraccumulans	1751046	S	259	105	364	0.00003
Usitatibacter rugosus	2732067	S	10464	1351	11815	0.00091
Usitatibacter palustris	2732487	S	8332	1144	9476	0.00073
Nitrosospira multiformis	1231	S	5371	192	5563	0.00043
Nitrosospira lacus	1288494	S	640	24	664	0.00005
Nitrosospira sp. NRS527	155925	S	278	202	480	0.00004
Nitrosospira briensis	35799	S	222	173	395	0.00003
Nitrosomonas communis	44574	S	4648	121	4769	0.00037
Nitrosomonas ureae	44577	S	395	14	409	0.00003
Nitrosomonas europaea	915	S	228	36	264	0.00002
Nitrosomonas eutropha	916	S	146	95	241	0.00002
Nitrosomonas stercoris	1444684	S	65	41	106	0.00001
Denitratisoma sp. DHT3	1981880	S	2035	1631	3666	0.00028
Denitratisoma oestradiolicum	311182	S	1144	207	1351	0.00010
Sulfuritalea hydrogenivorans	748811	S	2517	418	2935	0.00023
Methyloversatilis sp. RAC08	1842540	S	2114	309	2423	0.00019
Sterolibacterium denitrificans	157592	S	1758	551	2309	0.00018
Thiobacillus denitrificans	36861	S	3327	732	4059	0.00031
Sulfuritortus calidifontis	1914471	S	2535	1171	3706	0.00029
Sideroxydans sp. MIZ01	2764705	S	1303	299	1602	0.00012
Sideroxydans lithotrophicus	63745	S	930	156	1086	0.00008
Ferrigenium kumadai	1682490	S	1614	361	1975	0.00015
Ferriphaselus amnicola	1188319	S	511	75	586	0.00005
Candidatus Nitrotoga arctica	453162	S	227	76	303	0.00002
Candidatus Nitrotoga sp. AM1P	2559597	S	162	58	220	0.00002
Gallionella capsiferriformans	370405	S	397	39	436	0.00003
Sulfurimicrobium lacus	2715678	S	1805	248	2053	0.00016
Sulfuriferula plumbiphila	171865	S	1102	203	1305	0.00010
Sulfuriferula sp. AH1	1985873	S	538	120	658	0.00005
Sulfuriferula nivalis	2675298	S	81	7	88	0.00001
Sulfuricella denitrificans	649841	S	930	92	1022	0.00008
Methylovorus sp. MP688	887061	S	137	130	267	0.00002
Methylovorus glucosotrophus	266009	S	134	115	249	0.00002
Methylobacillus flagellatus	405	S	469	128	597	0.00005
Methylophilus sp. TWE2	1662285	S	120	9	129	0.00001
Methylophilus medardicus	2588534	S	92	8	100	0.00001
Candidatus Methylopumilus turicensis	1581680	S	57	7	64	0.00001
Candidatus Methylopumilus universalis	2588536	S	50	19	69	0.00001
Candidatus Methylopumilus planktonicus	1581557	S	16	7	23	0.00000
Candidatus Methylopumilus rimovensis	2588535	S	12	1	13	0.00000
Methylotenera mobilis	359408	S	68	7	75	0.00001
Methylotenera versatilis	1055487	S	37	4	41	0.00000
Methyloradius palustris	2778876	S	87	7	94	0.00001
Chromobacterium sp. ATCC 53434	2059672	S	1466	559	2025	0.00016
Chromobacterium sp. Rain0013	2292447	S	250	310	560	0.00004
Chromobacterium sp. Beijing	2735795	S	226	639	865	0.00007
Chromobacterium vaccinii	1108595	S	1465	682	2147	0.00017
Chromobacterium violaceum	536	S	1419	926	2345	0.00018
Chromobacterium phragmitis	2202141	S	920	435	1355	0.00010
Chromobacterium paludis	2605945	S	818	349	1167	0.00009
Chromobacterium rhizoryzae	1778675	S	236	1237	1473	0.00011
Chromobacterium haemolyticum	394935	S	170	1107	1277	0.00010
Iodobacter ciconiae	2496266	S	103	27	130	0.00001
Iodobacter fluviatilis	537	S	101	31	132	0.00001
Jeongeupia sp. USM3	1906741	S	2252	627	2879	0.00022
Jeongeupia sp. HS-3	1009682	S	951	197	1148	0.00009
Paludibacterium paludis	1225769	S	1090	241	1331	0.00010
Paludibacterium yongneupense	400061	S	1048	165	1213	0.00009
Paludibacterium sp. B53371	2806263	S	668	155	823	0.00006
Pseudogulbenkiania sp. NH8B	748280	S	2066	767	2833	0.00022
Vogesella sp. LIG4	1192162	S	1183	344	1527	0.00012
Vogesella sp. XCS3	2877939	S	536	164	700	0.00005
Aquitalea aquatilis	1537400	S	411	141	552	0.00004
Aquitalea magnusonii	332411	S	269	169	438	0.00003
Aquitalea denitrificans	519081	S	232	130	362	0.00003
Aquitalea sp. USM4	1590041	S	194	116	310	0.00002
Microvirgula aerodenitrificans	57480	S	1340	277	1617	0.00012
Laribacter hongkongensis	168471	S	1118	1141	2259	0.00017
Aquaspirillum sp. LM1	1938604	S	625	100	725	0.00006
Chitinibacter bivalviorum	2739434	S	148	141	289	0.00002
Chitinibacter fontanus	1737446	S	122	25	147	0.00001
Deefgea sp. D17	2739061	S	97	36	133	0.00001
Deefgea sp. D25	2865840	S	75	11	86	0.00001
Deefgea sp. D13	2864875	S	74	23	97	0.00001
Neisseria sp. KEM232	655307	S	309	48	357	0.00003
Neisseria sp. oral taxon 014	641148	S	130	59	189	0.00001
Neisseria sp. ZJ785	2709396	S	74	10	84	0.00001
Neisseria sp. Dent CA1/247	2912675	S	58	27	85	0.00001
Neisseria bacilliformis	267212	S	341	87	428	0.00003
Neisseria shayeganii	607712	S	258	41	299	0.00002
Neisseria meningitidis	487	S	243	710	953	0.00007
Neisseria elongata	495	S	225	115	340	0.00003
Neisseria chenwenguii	1853278	S	218	30	248	0.00002
Neisseria dentiae	194197	S	213	28	241	0.00002
Neisseria musculi	1815583	S	168	17	185	0.00001
Neisseria animalis	492	S	132	21	153	0.00001
Neisseria gonorrhoeae	485	S	120	504	624	0.00005
Neisseria lactamica	486	S	102	125	227	0.00002
Neisseria weaveri	28091	S	94	43	137	0.00001
Neisseria sicca	490	S	85	172	257	0.00002
Neisseria weixii	1853276	S	84	10	94	0.00001
Neisseria animaloris	326522	S	76	17	93	0.00001
Neisseria zalophi	640030	S	69	8	77	0.00001
Neisseria arctica	1470200	S	67	7	74	0.00001
Neisseria canis	493	S	63	16	79	0.00001
Neisseria dumasiana	1931275	S	61	27	88	0.00001
Neisseria brasiliensis	2666100	S	58	65	123	0.00001
Neisseria mucosa	488	S	54	125	179	0.00001
Neisseria wadsworthii	607711	S	52	11	63	0.00000
Neisseria zoodegmatis	326523	S	38	25	63	0.00000
Neisseria cinerea	483	S	35	22	57	0.00000
Neisseria macacae	496	S	33	74	107	0.00001
Neisseria subflava	28449	S	14	11	25	0.00000
Neisseria flavescens	484	S	11	8	19	0.00000
Crenobacter cavernae	2290923	S	2471	902	3373	0.00026
Chitinolyticbacter meiyuanensis	682798	S	1629	217	1846	0.00014
Vitreoscilla filiformis	63	S	747	143	890	0.00007
Vitreoscilla massiliensis	1689272	S	101	49	150	0.00001
Kingella potus	265175	S	216	31	247	0.00002
Kingella oralis	505	S	168	28	196	0.00002
Kingella denitrificans	502	S	157	111	268	0.00002
Kingella kingae	504	S	56	9	65	0.00001
Eikenella corrodens	539	S	257	162	419	0.00003
Eikenella exigua	2528037	S	86	54	140	0.00001
Uruburuella suis	252130	S	223	38	261	0.00002
Uruburuella testudinis	1282863	S	177	36	213	0.00002
Paralysiella testudinis	2809020	S	203	44	247	0.00002
Alysiella filiformis	194196	S	51	18	69	0.00001
Alysiella crassa	153491	S	50	17	67	0.00001
Conchiformibius steedae	153493	S	82	14	96	0.00001
Neisseriaceae bacterium CCUG 44465	2917790	S	74	13	87	0.00001
Snodgrassella alvi	1196083	S	58	21	79	0.00001
Morococcus cerebrosus	1056807	S	35	181	216	0.00002
Aquella oligotrophica	2067065	S	34	1	35	0.00000
Simonsiella muelleri	72	S	14	2	16	0.00000
Casimicrobium huifangae	2591109	S	1707	892	2599	0.00020
Candidatus Kinetoplastibacterium desouzaii	994692	S	11	5	16	0.00000
Lysobacter sp. KIS68-7	2904252	S	4726	941	5667	0.00044
Lysobacter sp. TY2-98	2290922	S	4066	674	4740	0.00037
Lysobacter sp. CECT 30171	2822368	S	3452	841	4293	0.00033
Lysobacter sp. 5GHs7-4	2904253	S	3403	1037	4440	0.00034
Lysobacter sp. S4-A87	2925843	S	3065	1017	4082	0.00031
Lysobacter sp. CW239	2762611	S	2341	1313	3654	0.00028
Lysobacter sp. K5869	2820808	S	1958	957	2915	0.00022
Lysobacter sp. H21R4	2781021	S	630	1247	1877	0.00014
Lysobacter sp. CJ11	2764185	S	537	47	584	0.00004
Lysobacter sp. HDW10	2714936	S	354	110	464	0.00004
Lysobacter sp. H23M47	2781024	S	317	1589	1906	0.00015
Lysobacter soli	453783	S	9377	1979	11356	0.00087
Lysobacter enzymogenes	69	S	8304	3081	11385	0.00088
Lysobacter solisilvae (ex Woo and Kim 2022)	2865112	S	7786	2323	10109	0.00078
Lysobacter capsici	435897	S	5122	5491	10613	0.00082
Lysobacter solisilvae (ex Kim et al. 2021)	2763317	S	5109	1061	6170	0.00048
Lysobacter maris	1605891	S	3777	924	4701	0.00036
Lysobacter lycopersici	1324796	S	3402	738	4140	0.00032
Lysobacter antibioticus	84531	S	3300	704	4004	0.00031
Lysobacter arenosi	2795387	S	3098	1014	4112	0.00032
Lysobacter alkalisoli	2591633	S	2787	510	3297	0.00025
Lysobacter oculi	2698682	S	2263	614	2877	0.00022
Lysobacter ciconiae	2781022	S	542	1005	1547	0.00012
Lysobacter gummosus	262324	S	441	3726	4167	0.00032
Lysobacter avium	2781023	S	322	1487	1809	0.00014
Stenotrophomonas maltophilia	40324	S	13537	17908	31445	0.00242
Stenotrophomonas sp. ESTM1D_MKCIP4_1	2072414	S	555	213	768	0.00006
Stenotrophomonas sp. SAU14A_NAIMI4_5	2072413	S	549	317	866	0.00007
Stenotrophomonas sp. ZAC14D2_NAIMI4_7	2072405	S	234	228	462	0.00004
Stenotrophomonas sp. YAU14D1_LEIMI4_1	2072407	S	234	363	597	0.00005
Stenotrophomonas sp. ZAC14A_NAIMI4_1	2072412	S	177	300	477	0.00004
Stenotrophomonas sp. ZAC14D2_NAIMI4_6	2072406	S	164	288	452	0.00003
Stenotrophomonas sp. YAU14A_MKIMI4_1	2072408	S	92	468	560	0.00004
Stenotrophomonas sp. SAU14A_NAIMI4_8	2072409	S	77	392	469	0.00004
Stenotrophomonas sp. LM091	1904944	S	1071	394	1465	0.00011
Stenotrophomonas sp. 169	2770322	S	968	159	1127	0.00009
Stenotrophomonas sp. 364	2691571	S	696	249	945	0.00007
Stenotrophomonas sp. NA06056	2742129	S	357	164	521	0.00004
Stenotrophomonas sp. WZN-1	2005046	S	249	269	518	0.00004
Stenotrophomonas sp. DR822	2871174	S	116	175	291	0.00002
Stenotrophomonas sp. Pemsol	2040586	S	105	301	406	0.00003
Stenotrophomonas sp. pho	2211160	S	87	395	482	0.00004
Stenotrophomonas sp. G4	2303750	S	60	250	310	0.00002
Stenotrophomonas sp. MYb57	1827305	S	59	224	283	0.00002
Stenotrophomonas sp. NY11291	2939415	S	52	565	617	0.00005
Stenotrophomonas sp. ASS1	2282124	S	52	212	264	0.00002
Stenotrophomonas sp. CW117	2775920	S	46	975	1021	0.00008
Stenotrophomonas sp. SI-NJAU-1	2886359	S	37	159	196	0.00002
Stenotrophomonas sp. SXG-1	2682487	S	25	262	287	0.00002
Stenotrophomonas rhizophila	216778	S	3236	902	4138	0.00032
Stenotrophomonas acidaminiphila	128780	S	2042	4590	6632	0.00051
Stenotrophomonas indicatrix	2045451	S	107	371	478	0.00004
Xanthomonas translucens	343	S	3210	3916	7126	0.00055
Xanthomonas campestris	339	S	2660	5322	7982	0.00061
Xanthomonas sacchari	56458	S	1857	598	2455	0.00019
Xanthomonas sp. SS	2724122	S	322	470	792	0.00006
Xanthomonas sp. GW	2724121	S	305	382	687	0.00005
Xanthomonas sp. SI	2724123	S	293	433	726	0.00006
Xanthomonas sp. MLO165	2081477	S	86	62	148	0.00001
Xanthomonas arboricola	56448	S	1536	1131	2667	0.00021
Xanthomonas oryzae	347	S	1286	9622	10908	0.00084
Xanthomonas theicola	56464	S	1185	355	1540	0.00012
Xanthomonas citri	346	S	970	33115	34085	0.00263
Xanthomonas hyacinthi	56455	S	858	476	1334	0.00010
Xanthomonas albilineans	29447	S	821	126	947	0.00007
Xanthomonas vesicatoria	56460	S	792	435	1227	0.00009
Xanthomonas fragariae	48664	S	737	132	869	0.00007
Xanthomonas hortorum	56454	S	693	351	1044	0.00008
Xanthomonas cucurbitae	56453	S	618	97	715	0.00006
Xanthomonas vasicola	56459	S	581	149	730	0.00006
Xanthomonas cassavae	56450	S	462	85	547	0.00004
Xanthomonas euroxanthea	2259622	S	405	238	643	0.00005
Xanthomonas axonopodis	53413	S	378	163	541	0.00004
Xanthomonas hydrangeae	2775159	S	354	79	433	0.00003
Xanthomonas phaseoli	1985254	S	286	461	747	0.00006
Xanthomonas euvesicatoria	456327	S	170	1008	1178	0.00009
Xanthomonas perforans	442694	S	29	95	124	0.00001
Luteimonas sp. MC1750	2799326	S	2699	1038	3737	0.00029
Luteimonas sp. JM171	1896164	S	2370	497	2867	0.00022
Luteimonas sp. S4-F44	2925842	S	2285	458	2743	0.00021
Luteimonas sp. MC1572	2799325	S	2104	1059	3163	0.00024
Luteimonas sp. D4P002	2901869	S	2055	562	2617	0.00020
Luteimonas sp. YGD11-2	2508168	S	2050	920	2970	0.00023
Luteimonas sp. MC1825	2761107	S	1960	1015	2975	0.00023
Luteimonas granuli	1176533	S	2708	967	3675	0.00028
Luteimonas yindakuii	2565782	S	1903	787	2690	0.00021
Luteimonas chenhongjianii	2006110	S	1893	429	2322	0.00018
Pseudoxanthomonas suwonensis	314722	S	5141	2575	7716	0.00059
Pseudoxanthomonas mexicana	128785	S	3434	4275	7709	0.00059
Pseudoxanthomonas sp. X-1	2571115	S	2375	2249	4624	0.00036
Pseudoxanthomonas sp. F37	2932492	S	21	1212	1233	0.00010
Pseudoxanthomonas daejeonensis	266062	S	2001	485	2486	0.00019
Pseudoxanthomonas spadix	415229	S	1481	535	2016	0.00016
Thermomonas sp. XSG	2771436	S	1990	892	2882	0.00022
Thermomonas sp. HDW16	2714945	S	1327	374	1701	0.00013
Thermomonas brevis	215691	S	2750	1171	3921	0.00030
Thermomonas aquatica	2202149	S	2284	1267	3551	0.00027
Thermomonas carbonis	1463158	S	1979	421	2400	0.00018
Arenimonas daejeonensis	370777	S	3100	648	3748	0.00029
Pseudolysobacter antarcticus	2511995	S	1554	46	1600	0.00012
Xylella fastidiosa	2371	S	268	80	348	0.00003
Xylella taiwanensis	1444770	S	166	9	175	0.00001
Luteibacter sp. 321	2911537	S	1946	613	2559	0.00020
Luteibacter sp. EIF3	2780091	S	1579	268	1847	0.00014
Luteibacter sp. 335	2911538	S	1280	306	1586	0.00012
Luteibacter sp. 353	2911539	S	1152	377	1529	0.00012
Luteibacter rhizovicinus	242606	S	1626	247	1873	0.00014
Luteibacter pinisoli	2589080	S	1515	428	1943	0.00015
Luteibacter anthropi	564369	S	1152	227	1379	0.00011
Rhodanobacter denitrificans	666685	S	3062	1324	4386	0.00034
Rhodanobacter sp. FDAARGOS 1247	2778082	S	1936	735	2671	0.00021
Rhodanobacter thiooxydans	416169	S	1734	896	2630	0.00020
Rhodanobacter glycinis	582702	S	1454	290	1744	0.00013
Dyella thiooxydans	445710	S	2389	815	3204	0.00025
Dyella japonica	231455	S	1421	480	1901	0.00015
Dyella telluris	2763498	S	1244	371	1615	0.00012
Dyella terrae	522259	S	1003	158	1161	0.00009
Dyella caseinilytica	1849581	S	801	68	869	0.00007
Dyella sp. M7H15-1	2501295	S	541	61	602	0.00005
Frateuria sp. 5GH9-34	2898793	S	2939	1014	3953	0.00030
Frateuria sp. 5GH9-11	1542730	S	2797	1236	4033	0.00031
Frateuria aurantia	81475	S	737	105	842	0.00006
Dokdonella koreensis	323415	S	4567	872	5439	0.00042
Aerosticca soli	2010829	S	2299	3340	5639	0.00043
Ahniella affigens	2021234	S	1314	38	1352	0.00010
Pseudomonas sp. LPB0260	2614442	S	1262	273	1535	0.00012
Pseudomonas sp. ATCC 13867	1294143	S	1164	427	1591	0.00012
Pseudomonas sp. CC6-YY-74	1930532	S	1150	147	1297	0.00010
Pseudomonas sp. SCB32	2653853	S	1126	252	1378	0.00011
Pseudomonas sp. TCU-HL1	1856685	S	1094	164	1258	0.00010
Pseudomonas sp. PDNC002	2811422	S	1068	256	1324	0.00010
Pseudomonas sp. DY-1	1755504	S	996	133	1129	0.00009
Pseudomonas sp. KNUC1026	2893890	S	996	102	1098	0.00008
Pseudomonas sp. MTM4	2705472	S	835	153	988	0.00008
Pseudomonas sp. Ost2	2678260	S	787	122	909	0.00007
Pseudomonas sp. ABC1	2748080	S	759	115	874	0.00007
Pseudomonas sp. MM211	2866808	S	726	70	796	0.00006
Pseudomonas sp. p1(2021b)	2874628	S	705	409	1114	0.00009
Pseudomonas sp. L5B5	2883205	S	640	123	763	0.00006
Pseudomonas sp. StFLB209	1028989	S	627	176	803	0.00006
Pseudomonas sp. Pc102	2678261	S	625	362	987	0.00008
Pseudomonas sp. OIL-1	2706126	S	599	127	726	0.00006
Pseudomonas sp. 7SR1	1881017	S	589	116	705	0.00005
Pseudomonas sp. B11D7D	2735906	S	578	118	696	0.00005
Pseudomonas sp. Marseille-Q3773	2866592	S	506	178	684	0.00005
Pseudomonas sp. MSPm1	2726956	S	501	117	618	0.00005
Pseudomonas sp. HN2-3	2886360	S	483	116	599	0.00005
Pseudomonas sp. CMR5c	658630	S	471	143	614	0.00005
Pseudomonas sp. LAB-08	143813	S	468	93	561	0.00004
Pseudomonas sp. gcc21	2726989	S	444	210	654	0.00005
Pseudomonas sp. 15A4	2804761	S	399	109	508	0.00004
Pseudomonas sp. DG56-2	2320270	S	396	47	443	0.00003
Pseudomonas sp. MPC6	2498848	S	389	90	479	0.00004
Pseudomonas sp. Leaf58	1736226	S	388	80	468	0.00004
Pseudomonas sp. HLS-6	2049589	S	386	127	513	0.00004
Pseudomonas sp. ADAK13	2730847	S	383	96	479	0.00004
Pseudomonas sp. S09G 359	2054919	S	366	95	461	0.00004
Pseudomonas sp. M1	95619	S	342	864	1206	0.00009
Pseudomonas sp. URMO17WK12:I11	1283291	S	339	248	587	0.00005
Pseudomonas sp. ADPe	2774873	S	330	872	1202	0.00009
Pseudomonas sp. Tri1	2823875	S	312	81	393	0.00003
Pseudomonas sp. Seg1	2678259	S	292	72	364	0.00003
Pseudomonas sp. M30-35	1981174	S	286	17	303	0.00002
Pseudomonas sp. S34	1573718	S	281	72	353	0.00003
Pseudomonas sp. 31-12	2201356	S	279	76	355	0.00003
Pseudomonas sp. MM213	2866807	S	266	62	328	0.00003
Pseudomonas sp. R5-89-07	658644	S	264	88	352	0.00003
Pseudomonas sp. 2hn	2866626	S	262	189	451	0.00003
Pseudomonas sp. DTU12.3	2073078	S	261	71	332	0.00003
Pseudomonas sp. NIBR-H-19	2901380	S	258	60	318	0.00002
Pseudomonas sp. S35	1573719	S	256	73	329	0.00003
Pseudomonas sp. DR48	2871095	S	252	196	448	0.00003
Pseudomonas sp. RtIB026	2749999	S	249	156	405	0.00003
Pseudomonas sp. ACM7	2052956	S	247	47	294	0.00002
Pseudomonas sp. PP3	2815936	S	244	105	349	0.00003
Pseudomonas sp. RC3H12	2834406	S	235	154	389	0.00003
Pseudomonas sp. DNDY-54	2870860	S	233	123	356	0.00003
Pseudomonas sp. LS.1a	2920387	S	230	106	336	0.00003
Pseudomonas sp. HS6	2850559	S	229	66	295	0.00002
Pseudomonas sp. LG1E9	2219057	S	224	71	295	0.00002
Pseudomonas sp. OE 28.3	2745519	S	218	57	275	0.00002
Pseudomonas sp. NS1(2017)	2025658	S	215	61	276	0.00002
Pseudomonas sp. HN11	1344094	S	213	53	266	0.00002
Pseudomonas sp. ADAK18	2730848	S	213	40	253	0.00002
Pseudomonas sp. MRSN12121	1611770	S	203	312	515	0.00004
Pseudomonas sp. CCOS 191	1649877	S	200	179	379	0.00003
Pseudomonas sp. SK	2729423	S	189	176	365	0.00003
Pseudomonas sp. SK3(2021)	2841064	S	187	131	318	0.00002
Pseudomonas sp. LPH1	1898684	S	184	182	366	0.00003
Pseudomonas sp. R2A2	2213057	S	183	227	410	0.00003
Pseudomonas sp. St316	2678257	S	181	64	245	0.00002
Pseudomonas sp. HS-18	2879114	S	167	372	539	0.00004
Pseudomonas sp. IzPS59	2774459	S	167	86	253	0.00002
Pseudomonas sp. NIBRBAC000502773	2590776	S	167	93	260	0.00002
Pseudomonas sp. R84	1573712	S	163	81	244	0.00002
Pseudomonas sp. 14181154	2662033	S	160	191	351	0.00003
Pseudomonas sp. CYM-20-01	2870750	S	150	80	230	0.00002
Pseudomonas sp. SDM007	2812000	S	148	102	250	0.00002
Pseudomonas sp. R76	1573711	S	139	74	213	0.00002
Pseudomonas sp. SCA2728.1_7	2825975	S	138	81	219	0.00002
Pseudomonas sp. AO-1	2855434	S	138	144	282	0.00002
Pseudomonas sp. UW4	1207075	S	131	93	224	0.00002
Pseudomonas sp. FGI182	1259844	S	126	152	278	0.00002
Pseudomonas sp. phDV1	253237	S	126	474	600	0.00005
Pseudomonas sp. FIT81	2837969	S	123	79	202	0.00002
Pseudomonas sp. LTJR-52	2479392	S	123	44	167	0.00001
Pseudomonas sp. THAF7b	2587845	S	121	257	378	0.00003
Pseudomonas sp. B10	118613	S	111	88	199	0.00002
Pseudomonas sp. RBPA9	2746321	S	110	255	365	0.00003
Pseudomonas sp. Z003-0.4C(8344-21)	1855380	S	108	83	191	0.00001
Pseudomonas sp. Cab53	2678258	S	105	181	286	0.00002
Pseudomonas sp. 02C 26	2054914	S	104	247	351	0.00003
Pseudomonas sp. DR 5-09	1534110	S	101	151	252	0.00002
Pseudomonas sp. MPFS	2795724	S	100	184	284	0.00002
Pseudomonas sp. 3-2	2867408	S	99	141	240	0.00002
Pseudomonas sp. BIGb0427	2724470	S	96	232	328	0.00003
Pseudomonas sp. S07E 245	2866278	S	93	234	327	0.00003
Pseudomonas sp. SORT22	2813842	S	92	236	328	0.00003
Pseudomonas sp. C27(2019)	2604941	S	88	14	102	0.00001
Pseudomonas sp. Y5-11	2749808	S	85	281	366	0.00003
Pseudomonas sp. ADAK22	2730851	S	85	230	315	0.00002
Pseudomonas sp. HN2	2884805	S	84	80	164	0.00001
Pseudomonas sp. MYb193	1827300	S	79	91	170	0.00001
Pseudomonas sp. AN-B15	2697023	S	76	231	307	0.00002
Pseudomonas sp. BIOMIG1BAC	1758730	S	75	257	332	0.00003
Pseudomonas sp. A2	107445	S	73	426	499	0.00004
Pseudomonas sp. 09C 129	2054915	S	72	96	168	0.00001
Pseudomonas sp. FDAARGOS_380	2018067	S	69	60	129	0.00001
Pseudomonas sp. RU47	2005388	S	67	185	252	0.00002
Pseudomonas sp. ATCC 43928	676210	S	66	177	243	0.00002
Pseudomonas sp. St29	1500687	S	64	280	344	0.00003
Pseudomonas sp. J380	2605424	S	62	85	147	0.00001
Pseudomonas sp. PONIH3	1636610	S	61	371	432	0.00003
Pseudomonas sp. GR 6-02	1659194	S	61	162	223	0.00002
Pseudomonas sp. SC3(2021)	2871493	S	59	69	128	0.00001
Pseudomonas sp. SXM-1	2169583	S	59	189	248	0.00002
Pseudomonas sp. S150	2559074	S	58	98	156	0.00001
Pseudomonas sp. BC42	2933816	S	57	303	360	0.00003
Pseudomonas sp. S49	1573720	S	56	156	212	0.00002
Pseudomonas sp. LBUM920	2126069	S	55	147	202	0.00002
Pseudomonas sp. CFSAN084952	2664899	S	51	164	215	0.00002
Pseudomonas sp. ArH3a	2862945	S	51	137	188	0.00001
Pseudomonas sp. SWI36	2083052	S	47	143	190	0.00001
Pseudomonas sp. NC02	2067572	S	46	157	203	0.00002
Pseudomonas sp. LG1D9	2083054	S	43	171	214	0.00002
Pseudomonas sp. DR208	2870840	S	41	107	148	0.00001
Pseudomonas sp. R3-18-08	1173283	S	41	127	168	0.00001
Pseudomonas sp. IAC-BECa141	2793103	S	38	85	123	0.00001
Pseudomonas sp. HN8-3	2886361	S	38	82	120	0.00001
Pseudomonas sp. R1-43-08	1173270	S	38	238	276	0.00002
Pseudomonas sp. R3-52-08	1173284	S	38	244	282	0.00002
Pseudomonas sp. DTU12.1	2654238	S	36	153	189	0.00001
Pseudomonas sp. TKP	1415630	S	36	133	169	0.00001
Pseudomonas sp. Colony2	2861799	S	35	154	189	0.00001
Pseudomonas sp. Os17	1500686	S	35	186	221	0.00002
Pseudomonas sp. Y39-6	2749807	S	33	115	148	0.00001
Pseudomonas sp. SWI44	2083053	S	33	295	328	0.00003
Pseudomonas sp. R4-35-07	658643	S	33	236	269	0.00002
Pseudomonas sp. MPDS	2762896	S	31	131	162	0.00001
Pseudomonas sp. PS1(2021)	2866282	S	30	965	995	0.00008
Pseudomonas sp. R2-37-08W	1173273	S	30	150	180	0.00001
Pseudomonas sp. XWY-1	2069256	S	30	189	219	0.00002
Pseudomonas sp. LH1G9	2083055	S	29	108	137	0.00001
Pseudomonas sp. A214	1855331	S	29	91	120	0.00001
Pseudomonas sp. R32	1573704	S	28	78	106	0.00001
Pseudomonas sp. 7-41	2898483	S	28	134	162	0.00001
Pseudomonas sp. BJP69	2597770	S	28	184	212	0.00002
Pseudomonas sp. OST1909	2777367	S	27	90	117	0.00001
Pseudomonas sp. TMW 2.1634	1886807	S	26	73	99	0.00001
Pseudomonas sp. R4-34-07	658642	S	25	153	178	0.00001
Pseudomonas sp. IB20	1702250	S	25	156	181	0.00001
Pseudomonas sp. Eqa60	2799184	S	25	154	179	0.00001
Pseudomonas sp. CIP-10	2892442	S	24	241	265	0.00002
Pseudomonas sp. 13159349	2662034	S	23	239	262	0.00002
Pseudomonas sp. CFA	2651048	S	22	113	135	0.00001
Pseudomonas sp. So3.2b	2864101	S	22	77	99	0.00001
Pseudomonas sp. R4-39-08	1173288	S	20	124	144	0.00001
Pseudomonas sp. B14-6	2738843	S	18	53	71	0.00001
Pseudomonas sp. R2-60-08W	1173280	S	18	133	151	0.00001
Pseudomonas sp. St386	2678256	S	18	160	178	0.00001
Pseudomonas sp. St290	1602166	S	18	75	93	0.00001
Pseudomonas sp. SWI7	2587597	S	17	115	132	0.00001
Pseudomonas sp. VLB120	69328	S	16	236	252	0.00002
Pseudomonas sp. SWI6	2083051	S	16	282	298	0.00002
Pseudomonas sp. I3-I5	2926671	S	16	67	83	0.00001
Pseudomonas sp. R11-23-07	658632	S	15	142	157	0.00001
Pseudomonas sp. SK2	2841063	S	13	250	263	0.00002
Pseudomonas sp. SW-3	147212	S	13	52	65	0.00001
Pseudomonas sp. R2-7-07	658641	S	12	119	131	0.00001
Pseudomonas sp. BYT-1	2816906	S	12	113	125	0.00001
Pseudomonas sp. LTGT-11-2Z	2479393	S	11	329	340	0.00003
Pseudomonas aeruginosa	287	S	5979	67949	73928	0.00569
Pseudomonas mendocina	300	S	3255	1240	4495	0.00035
Pseudomonas alcaligenes	43263	S	2407	1710	4117	0.00032
Pseudomonas furukawaii	1149133	S	1662	528	2190	0.00017
Pseudomonas oleovorans	301	S	308	933	1241	0.00010
Pseudomonas resinovorans	53412	S	1528	349	1877	0.00014
Pseudomonas multiresinivorans	95301	S	691	239	930	0.00007
Pseudomonas nitroreducens	46680	S	212	469	681	0.00005
Pseudomonas citronellolis	53408	S	729	1119	1848	0.00014
Pseudomonas fluorescens	294	S	5962	4886	10848	0.00084
Pseudomonas protegens	380021	S	1446	1313	2759	0.00021
Pseudomonas orientalis	76758	S	1006	278	1284	0.00010
Pseudomonas azotoformans	47878	S	792	316	1108	0.00009
Pseudomonas synxantha	47883	S	715	461	1176	0.00009
Pseudomonas poae	200451	S	554	296	850	0.00007
Pseudomonas rhodesiae	76760	S	474	192	666	0.00005
Pseudomonas mediterranea	183795	S	468	120	588	0.00005
Pseudomonas tolaasii	29442	S	449	86	535	0.00004
Pseudomonas trivialis	200450	S	444	159	603	0.00005
Pseudomonas corrugata	47879	S	431	94	525	0.00004
Pseudomonas migulae	78543	S	342	198	540	0.00004
Pseudomonas cedrina	651740	S	310	81	391	0.00003
Pseudomonas congelans	200452	S	299	92	391	0.00003
Pseudomonas mucidolens	46679	S	297	44	341	0.00003
Pseudomonas brenneri	129817	S	233	93	326	0.00003
Pseudomonas libanensis	75588	S	154	170	324	0.00002
Pseudomonas ogarae	1114970	S	144	108	252	0.00002
Pseudomonas veronii	76761	S	143	385	528	0.00004
Pseudomonas mandelii	75612	S	139	378	517	0.00004
Pseudomonas extremorientalis	169669	S	42	101	143	0.00001
Pseudomonas stutzeri	316	S	10737	7192	17929	0.00138
Pseudomonas chloritidismutans	203192	S	117	165	282	0.00002
Pseudomonas balearica	74829	S	1844	2380	4224	0.00033
Pseudomonas xanthomarina	271420	S	552	93	645	0.00005
Pseudomonas luteola	47886	S	149	73	222	0.00002
Pseudomonas putida	303	S	7420	10169	17589	0.00135
Pseudomonas oryzihabitans	47885	S	2323	514	2837	0.00022
Pseudomonas fulva	47880	S	1532	4264	5796	0.00045
Pseudomonas plecoglossicida	70775	S	499	411	910	0.00007
Pseudomonas mosselii	78327	S	277	539	816	0.00006
Pseudomonas monteilii	76759	S	273	439	712	0.00005
Pseudomonas sp. SGAir0191	2217867	S	121	79	200	0.00002
Pseudomonas shirazica	1940636	S	17	234	251	0.00002
Pseudomonas syringae	317	S	1887	2515	4402	0.00034
Pseudomonas viridiflava	33069	S	1336	156	1492	0.00011
Pseudomonas cichorii	36746	S	705	65	770	0.00006
Pseudomonas asturiensis	1190415	S	385	39	424	0.00003
Pseudomonas amygdali	47877	S	176	727	903	0.00007
Pseudomonas savastanoi	29438	S	74	274	348	0.00003
Pseudomonas syringae group genomosp. 7	251699	S	361	44	405	0.00003
Pseudomonas fuscovaginae	50340	S	188	111	299	0.00002
Pseudomonas avellanae	46257	S	108	109	217	0.00002
Pseudomonas syringae group genomosp. 3	251701	S	67	1588	1655	0.00013
Pseudomonas coronafaciens	53409	S	63	125	188	0.00001
Pseudomonas sp. Lz4W	1206777	S	28	50	78	0.00001
Pseudomonas tremae	200454	S	27	41	68	0.00001
Pseudomonas chlororaphis	587753	S	3404	3740	7144	0.00055
Pseudomonas lundensis	86185	S	395	52	447	0.00003
Pseudomonas fragi	296	S	222	184	406	0.00003
Pseudomonas otitidis	319939	S	2657	634	3291	0.00025
Pseudomonas knackmussii	65741	S	2205	1901	4106	0.00032
Pseudomonas oryzae	1392877	S	2175	758	2933	0.00023
Pseudomonas psychrotolerans	237610	S	2110	483	2593	0.00020
Pseudomonas cavernae	2320867	S	1785	305	2090	0.00016
Pseudomonas entomophila	312306	S	1632	735	2367	0.00018
Pseudomonas lalkuanensis	2604832	S	1428	283	1711	0.00013
Pseudomonas guangdongensis	1245526	S	1325	468	1793	0.00014
Pseudomonas campi	2731681	S	1102	162	1264	0.00010
Pseudomonas parafulva	157782	S	889	264	1153	0.00009
Pseudomonas qingdaonensis	2056231	S	877	188	1065	0.00008
Pseudomonas eucalypticola	2599595	S	851	116	967	0.00007
Pseudomonas nanhaiensis	2830842	S	809	98	907	0.00007
Pseudomonas vanderleydeniana	2745495	S	809	119	928	0.00007
Pseudomonas cremoricolorata	157783	S	718	116	834	0.00006
Pseudomonas rhizosphaerae	216142	S	704	92	796	0.00006
Pseudomonas alkylphenolica	237609	S	676	139	815	0.00006
Pseudomonas frederiksbergensis	104087	S	662	200	862	0.00007
Pseudomonas brassicacearum	930166	S	659	1247	1906	0.00015
Pseudomonas pohangensis	364197	S	636	50	686	0.00005
Pseudomonas saudiphocaensis	1499686	S	625	151	776	0.00006
Pseudomonas zhaodongensis	1176257	S	607	283	890	0.00007
Pseudomonas argentinensis	289370	S	602	143	745	0.00006
Pseudomonas tohonis	2725477	S	596	501	1097	0.00008
Pseudomonas yamanorum	515393	S	577	130	707	0.00005
Pseudomonas phragmitis	1931241	S	555	48	603	0.00005
Pseudomonas umsongensis	198618	S	546	90	636	0.00005
Pseudomonas alvandae	2842348	S	533	86	619	0.00005
Pseudomonas muyukensis	2842357	S	533	163	696	0.00005
Pseudomonas palleroniana	191390	S	495	82	577	0.00004
Pseudomonas tructae	2518644	S	484	88	572	0.00004
Pseudomonas marincola	437900	S	461	76	537	0.00004
Pseudomonas vancouverensis	95300	S	447	73	520	0.00004
Pseudomonas xantholysinigenes	2745490	S	436	123	559	0.00004
Pseudomonas xanthosomae	2842356	S	396	129	525	0.00004
Pseudomonas wenzhouensis	2906062	S	393	152	545	0.00004
Pseudomonas sediminis	1691904	S	391	116	507	0.00004
Pseudomonas hamedanensis	2745504	S	386	71	457	0.00004
Pseudomonas koreensis	198620	S	385	151	536	0.00004
Pseudomonas prosekii	1148509	S	372	63	435	0.00003
Pseudomonas silesiensis	1853130	S	368	80	448	0.00003
Pseudomonas fakonensis	2842355	S	366	117	483	0.00004
Pseudomonas antarctica	219572	S	363	92	455	0.00004
Pseudomonas agarici	46677	S	351	17	368	0.00003
Pseudomonas promysalinigenes	485898	S	348	56	404	0.00003
Pseudomonas extremaustralis	359110	S	340	76	416	0.00003
Pseudomonas arsenicoxydans	702115	S	336	72	408	0.00003
Pseudomonas granadensis	1421430	S	332	158	490	0.00004
Pseudomonas thivervalensis	86265	S	328	70	398	0.00003
Pseudomonas asgharzadehiana	2842349	S	300	71	371	0.00003
Pseudomonas lurida	244566	S	292	67	359	0.00003
Pseudomonas graminis	158627	S	290	81	371	0.00003
Pseudomonas maumuensis	2842354	S	288	141	429	0.00003
Pseudomonas lini	163011	S	282	56	338	0.00003
Pseudomonas taetrolens	47884	S	275	36	311	0.00002
Pseudomonas simiae	321846	S	274	68	342	0.00003
Pseudomonas viciae	2505979	S	274	67	341	0.00003
Pseudomonas toyotomiensis	554344	S	245	226	471	0.00004
Pseudomonas versuta	1788301	S	240	39	279	0.00002
Pseudomonas reinekei	395598	S	232	67	299	0.00002
Pseudomonas psychrophila	122355	S	222	31	253	0.00002
Pseudomonas alcaliphila	101564	S	201	224	425	0.00003
Pseudomonas sihuiensis	1274359	S	201	268	469	0.00004
Pseudomonas kribbensis	1628086	S	196	187	383	0.00003
Pseudomonas chengduensis	489632	S	192	398	590	0.00005
Pseudomonas khazarica	2502979	S	192	236	428	0.00003
Pseudomonas allokribbensis	2774460	S	186	73	259	0.00002
Pseudomonas tritici	2745518	S	181	57	238	0.00002
Pseudomonas oryziphila	2894079	S	169	135	304	0.00002
Pseudomonas kunmingensis	1211807	S	164	241	405	0.00003
Pseudomonas asplenii	53407	S	153	94	247	0.00002
Pseudomonas moraviensis	321662	S	150	246	396	0.00003
Pseudomonas gozinkensis	2774461	S	149	69	218	0.00002
Pseudomonas atacamensis	2565368	S	149	145	294	0.00002
Pseudomonas zeae	2745510	S	145	73	218	0.00002
Pseudomonas azerbaijanoriens	2842350	S	133	89	222	0.00002
Pseudomonas anuradhapurensis	485870	S	131	117	248	0.00002
Pseudomonas tensinigenes	2745511	S	119	65	184	0.00001
Pseudomonas germanica	2815720	S	118	64	182	0.00001
Pseudomonas iranensis	2745503	S	101	76	177	0.00001
Pseudomonas zarinae	2745498	S	97	73	170	0.00001
Pseudomonas salmasensis	2745514	S	84	54	138	0.00001
Pseudomonas juntendi	2666183	S	75	707	782	0.00006
Pseudomonas monsensis	2745509	S	74	79	153	0.00001
Pseudomonas lactis	1615674	S	69	50	119	0.00001
Pseudomonas soli	1306993	S	59	231	290	0.00002
Pseudomonas donghuensis	1163398	S	50	139	189	0.00001
Pseudomonas bijieensis	2681983	S	50	187	237	0.00002
Pseudomonas asiatica	2219225	S	50	279	329	0.00003
Pseudomonas sessilinigenes	658629	S	46	117	163	0.00001
Pseudomonas rhizophila	2045200	S	44	114	158	0.00001
Pseudomonas glycinae	1785145	S	41	73	114	0.00001
Pseudomonas cerasi	1583341	S	34	71	105	0.00001
Pseudomonas shahriarae	2745512	S	17	66	83	0.00001
Pseudomonas taiwanensis	470150	S	15	189	204	0.00002
Candidatus Pseudomonas adelgestsugas	1302376	S	14	0	14	0.00000
Azotobacter chroococcum	353	S	1910	1046	2956	0.00023
Azotobacter salinestris	69964	S	1330	577	1907	0.00015
Azotobacter vinelandii	354	S	1244	1550	2794	0.00022
Halopseudomonas xinjiangensis	487184	S	637	69	706	0.00005
Halopseudomonas sabulinigri	472181	S	519	49	568	0.00004
Halopseudomonas aestusnigri	857252	S	509	364	873	0.00007
Halopseudomonas sp. RR6	2918528	S	499	78	577	0.00004
Halopseudomonas litoralis	797277	S	411	109	520	0.00004
Halopseudomonas salegens	1434072	S	292	23	315	0.00002
Permianibacter aggregans	1510150	S	753	26	779	0.00006
Thiopseudomonas alkaliphila	1697053	S	46	10	56	0.00000
Entomomonas moraniae	2213226	S	24	2	26	0.00000
Entomomonas sp. F2A	2785331	S	15	1	16	0.00000
Marinobacter sp. CA1	2817656	S	714	59	773	0.00006
Marinobacter sp. Arc7-DN-1	2304594	S	402	57	459	0.00004
Marinobacter sp. LPB0319	2769486	S	384	26	410	0.00003
Marinobacter sp. NP-4(2019)	2488665	S	372	72	444	0.00003
Marinobacter sp. LV10R510-11A	1415568	S	216	10	226	0.00002
Marinobacter sp. LQ44	1749259	S	173	261	434	0.00003
Marinobacter sp. es.042	1761794	S	156	155	311	0.00002
Marinobacter sp. JH2	2547598	S	137	41	178	0.00001
Marinobacter sp. CP1	1671721	S	129	254	383	0.00003
Marinobacter sp. BSs20148	490759	S	116	74	190	0.00001
Marinobacter fonticola	2603215	S	552	30	582	0.00004
Marinobacter salarius	1420917	S	494	69	563	0.00004
Marinobacter nauticus	2743	S	396	132	528	0.00004
Marinobacter similis	1420916	S	329	30	359	0.00003
Marinobacter salsuginis	418719	S	323	49	372	0.00003
Marinobacter salinus	1874317	S	290	20	310	0.00002
Marinobacter adhaerens	1033846	S	115	206	321	0.00002
Marinobacter psychrophilus	330734	S	77	49	126	0.00001
Klebsiella pneumoniae	573	S	1550	51802	53352	0.00411
Klebsiella quasipneumoniae	1463165	S	565	2248	2813	0.00022
Klebsiella oxytoca	571	S	372	289	661	0.00005
Klebsiella aerogenes	548	S	345	226	571	0.00004
Klebsiella sp. A52	2834819	S	16	308	324	0.00002
Klebsiella variicola	244366	S	217	929	1146	0.00009
Klebsiella michiganensis	1134687	S	201	841	1042	0.00008
Klebsiella quasivariicola	2026240	S	94	114	208	0.00002
Klebsiella africana	2489010	S	88	60	148	0.00001
Klebsiella huaxiensis	2153354	S	85	94	179	0.00001
Klebsiella grimontii	2058152	S	38	296	334	0.00003
Raoultella sp. HC6	2923366	S	221	166	387	0.00003
Raoultella planticola	575	S	144	166	310	0.00002
Raoultella ornithinolytica	54291	S	130	1078	1208	0.00009
Raoultella terrigena	577	S	86	180	266	0.00002
Raoultella electrica	1259973	S	73	202	275	0.00002
Enterobacter cloacae	550	S	956	1802	2758	0.00021
Enterobacter hormaechei	158836	S	339	5795	6134	0.00047
Enterobacter cancerogenus	69218	S	274	111	385	0.00003
Enterobacter asburiae	61645	S	248	1338	1586	0.00012
Enterobacter roggenkampii	1812935	S	163	781	944	0.00007
Enterobacter ludwigii	299767	S	107	295	402	0.00003
Enterobacter chengduensis	2494701	S	105	85	190	0.00001
Enterobacter chuandaensis	2497875	S	104	80	184	0.00001
Enterobacter cloacae complex sp.	2027919	S	32	950	982	0.00008
Enterobacter sp. BIDMC 29	1329841	S	13	51	64	0.00000
Enterobacter kobei	208224	S	54	728	782	0.00006
Enterobacter sichuanensis	2071710	S	46	50	96	0.00001
Enterobacter sp. SA187	1914861	S	242	51	293	0.00002
Enterobacter sp. JUb54	2724468	S	203	49	252	0.00002
Enterobacter sp. E76	2596949	S	124	270	394	0.00003
Enterobacter sp. Colony194	2866201	S	68	90	158	0.00001
Enterobacter sp. RHBSTW-00994	2742676	S	67	20	87	0.00001
Enterobacter sp. RHBSTW-00175	2742639	S	54	59	113	0.00001
Enterobacter sp. JBIWA008	2831892	S	53	40	93	0.00001
Enterobacter sp. SGAir0187	2836161	S	37	48	85	0.00001
Enterobacter sp. JBIWA003	2831890	S	31	45	76	0.00001
Enterobacter sp. JBIWA005	2831891	S	21	45	66	0.00001
Enterobacter sp. SES19	2705458	S	19	20	39	0.00000
Enterobacter sp. N18-03635	2500132	S	15	43	58	0.00000
Enterobacter sp. E20	1560339	S	11	113	124	0.00001
Enterobacter huaxiensis	2494702	S	142	50	192	0.00001
Enterobacter mori	539813	S	116	174	290	0.00002
Enterobacter bugandensis	881260	S	93	196	289	0.00002
Enterobacter oligotrophicus	2478464	S	75	27	102	0.00001
Enterobacter soli	885040	S	63	19	82	0.00001
Citrobacter freundii	546	S	266	1421	1687	0.00013
Citrobacter werkmanii	67827	S	71	208	279	0.00002
Citrobacter braakii	57706	S	45	424	469	0.00004
Citrobacter sedlakii	67826	S	33	116	149	0.00001
Citrobacter portucalensis	1639133	S	29	357	386	0.00003
Citrobacter freundii complex sp. CFNIH2	2066049	S	18	25	43	0.00000
Citrobacter sp. R56	1573676	S	121	44	165	0.00001
Citrobacter sp. RHB25-C09	2742624	S	101	32	133	0.00001
Citrobacter sp. BDA59-3	2781952	S	31	17	48	0.00000
Citrobacter sp. MGH 55	1439319	S	12	57	69	0.00001
Citrobacter rodentium	67825	S	210	0	210	0.00002
Citrobacter amalonaticus	35703	S	137	801	938	0.00007
Citrobacter farmeri	67824	S	112	67	179	0.00001
Citrobacter koseri	545	S	71	117	188	0.00001
Citrobacter tructae	2562449	S	53	30	83	0.00001
Citrobacter pasteurii	1563222	S	41	41	82	0.00001
Citrobacter arsenatis	2546350	S	35	15	50	0.00000
Citrobacter cronae	1748967	S	12	115	127	0.00001
Cronobacter sakazakii	28141	S	359	311	670	0.00005
Cronobacter dublinensis	413497	S	319	129	448	0.00003
Cronobacter condimenti	1163710	S	191	61	252	0.00002
Cronobacter universalis	535744	S	185	144	329	0.00003
Cronobacter malonaticus	413503	S	125	157	282	0.00002
Cronobacter sp. JZ38	1906275	S	45	141	186	0.00001
Cronobacter muytjensii	413501	S	37	150	187	0.00001
Leclercia adecarboxylata	83655	S	467	974	1441	0.00011
Leclercia sp. 29361	2714951	S	148	69	217	0.00002
Leclercia sp. J807	2681307	S	39	67	106	0.00001
Leclercia sp. W6	2282310	S	28	61	89	0.00001
Leclercia sp. G3L	2898725	S	25	151	176	0.00001
Leclercia sp. 119287	2681308	S	21	74	95	0.00001
Leclercia sp. W17	2282309	S	20	64	84	0.00001
Leclercia pneumoniae	2815358	S	135	75	210	0.00002
Kosakonia sp. SMBL-WEM22	2725560	S	147	71	218	0.00002
Kosakonia sp. CCTCC M2018092	2492396	S	74	75	149	0.00001
Kosakonia sp. MUSA4	2067958	S	73	39	112	0.00001
Kosakonia cowanii	208223	S	285	231	516	0.00004
Kosakonia sacchari	1158459	S	215	107	322	0.00002
Kosakonia radicincitans	283686	S	92	80	172	0.00001
Kosakonia arachidis	551989	S	85	26	111	0.00001
Kosakonia oryzae	497725	S	70	53	123	0.00001
Kosakonia pseudosacchari	1646340	S	64	37	101	0.00001
Salmonella enterica	28901	S	931	38961	39892	0.00307
Salmonella bongori	54736	S	118	42	160	0.00001
Pluralibacter gergoviae	61647	S	799	232	1031	0.00008
[Enterobacter] lignolyticus	1334193	S	376	122	498	0.00004
Cedecea neteri	158822	S	622	155	777	0.00006
Cedecea lapagei	158823	S	152	49	201	0.00002
Cedecea sp. FDAARGOS_727	2545798	S	143	35	178	0.00001
Escherichia coli	562	S	597	17810	18407	0.00142
Escherichia albertii	208962	S	132	198	330	0.00003
Escherichia marmotae	1499973	S	64	42	106	0.00001
Escherichia fergusonii	564	S	51	94	145	0.00001
Escherichia sp. E4742	2044467	S	35	27	62	0.00000
Lelliottia amnigena	61646	S	411	131	542	0.00004
Lelliottia sp. WB101	2153385	S	73	80	153	0.00001
Lelliottia sp. AC1	2067959	S	48	39	87	0.00001
Kluyvera ascorbata	51288	S	143	125	268	0.00002
Kluyvera intermedia	61648	S	101	88	189	0.00001
Kluyvera sp. CRP	2873269	S	23	66	89	0.00001
Kluyvera genomosp. 3	2774055	S	16	42	58	0.00000
Candidatus Symbiopectobacterium sp. SyEd1	2871826	S	170	24	194	0.00001
Blochmannia endosymbiont of Colobopsis nipponica	2681987	S	15	3	18	0.00000
Blochmannia endosymbiont of Polyrhachis (Hedomyrma) turneri	1505596	S	11	2	13	0.00000
Blochmannia endosymbiont of Camponotus nipponensis	2681986	S	10	14	24	0.00000
Candidatus Hamiltonella defensa	138072	S	30	2	32	0.00000
secondary endosymbiont of Ctenarytaina eucalypti	1199245	S	25	1	26	0.00000
secondary endosymbiont of Heteropsylla cubana	134287	S	15	1	16	0.00000
Candidatus Doolittlea endobia	1778262	S	33	2	35	0.00000
Candidatus Hoaglandella endobia	1778263	S	17	1	18	0.00000
Pseudescherichia vulneris	566	S	265	18	283	0.00002
Jejubacter calystegiae	2579935	S	257	32	289	0.00002
Shimwellia blattae	563	S	216	50	266	0.00002
Buttiauxella agrestis	82977	S	75	16	91	0.00001
Buttiauxella ferragutiae	82989	S	25	78	103	0.00001
Buttiauxella sp. 3AFRM03	2479367	S	13	37	50	0.00000
Yokenella regensburgei	158877	S	198	100	298	0.00002
Plesiomonas shigelloides	703	S	198	72	270	0.00002
Atlantibacter hermannii	565	S	195	48	243	0.00002
Scandinavium goeteborgense	1851514	S	162	35	197	0.00002
Pseudocitrobacter sp. G163CM	2891570	S	150	43	193	0.00001
Phytobacter ursingii	1972431	S	111	167	278	0.00002
Phytobacter diazotrophicus	395631	S	10	80	90	0.00001
Enterobacteriaceae endosymbiont of Donacia cincticornis	2675773	S	35	26	61	0.00000
Shigella flexneri	623	S	28	1661	1689	0.00013
Shigella boydii	621	S	10	208	218	0.00002
Candidatus Moranella endobia	1048758	S	38	0	38	0.00000
Candidatus Ishikawaella capsulata	168169	S	15	1	16	0.00000
Serratia marcescens	615	S	1413	1600	3013	0.00023
Serratia plymuthica	82996	S	519	14455	14974	0.00115
Serratia sp. ATCC 39006	104623	S	113	13	126	0.00001
Serratia sp. FDAARGOS_506	2420306	S	99	44	143	0.00001
Serratia sp. FGI94	671990	S	82	34	116	0.00001
Serratia sp. MYb239	2033438	S	35	90	125	0.00001
Serratia sp. 1D1416	2447890	S	30	29	59	0.00000
Serratia sp. 3ACOL1	2448483	S	26	10	36	0.00000
Serratia sp. FS14	1327989	S	20	29	49	0.00000
Serratia sp. P2ACOL2	2482769	S	19	15	34	0.00000
Serratia sp. Tan611	2773264	S	13	25	38	0.00000
Serratia sp. JSRIV006	2831896	S	10	17	27	0.00000
Serratia entomophila	42906	S	357	68	425	0.00003
Serratia rubidaea	61652	S	319	135	454	0.00004
Serratia odorifera	618	S	294	47	341	0.00003
Serratia proteamaculans	28151	S	241	26	267	0.00002
Serratia fonticola	47917	S	205	60	265	0.00002
Serratia surfactantfaciens	2741499	S	198	43	241	0.00002
Serratia quinivorans	137545	S	127	25	152	0.00001
Serratia liquefaciens	614	S	110	57	167	0.00001
Serratia grimesii	82995	S	100	7	107	0.00001
Serratia symbiotica	138074	S	99	17	116	0.00001
Serratia inhibens	2338073	S	89	21	110	0.00001
Serratia rhizosphaerae	2597702	S	88	31	119	0.00001
Serratia ureilytica	300181	S	78	278	356	0.00003
Serratia ficaria	61651	S	22	29	51	0.00000
Yersinia enterocolitica	630	S	92	136	228	0.00002
Yersinia pseudotuberculosis	633	S	21	65	86	0.00001
Yersinia similis	367190	S	12	4	16	0.00000
Yersinia ruckeri	29486	S	67	14	81	0.00001
Yersinia rohdei	29485	S	56	13	69	0.00001
Yersinia mollaretii	33060	S	55	15	70	0.00001
Yersinia aleksiciae	263819	S	48	15	63	0.00000
Yersinia entomophaga	935293	S	47	10	57	0.00000
Yersinia aldovae	29483	S	42	11	53	0.00000
Yersinia frederiksenii	29484	S	41	53	94	0.00001
Yersinia canariae	2607663	S	36	14	50	0.00000
Yersinia kristensenii	28152	S	34	140	174	0.00001
Yersinia intermedia	631	S	12	57	69	0.00001
Yersinia hibernica	2339259	S	11	26	37	0.00000
Rahnella aquatilis	34038	S	236	324	560	0.00004
Rahnella inusitata	58169	S	172	48	220	0.00002
Rahnella sp. ERMR1:05	1805933	S	164	24	188	0.00001
Rahnella victoriana	1510570	S	147	22	169	0.00001
Rahnella aceris	2703885	S	25	49	74	0.00001
Nissabacter sp. SGAir0207	2126321	S	545	89	634	0.00005
Gibbsiella quercinecans	929813	S	390	53	443	0.00003
Ewingella americana	41202	S	211	30	241	0.00002
Rouxiella badensis	1646377	S	210	20	230	0.00002
Chania multitudinisentens	1639108	S	116	13	129	0.00001
Candidatus Fukatsuia symbiotica	1878942	S	34	2	36	0.00000
Pantoea sp. Z09	2886821	S	488	178	666	0.00005
Pantoea sp. SO10	2575375	S	230	50	280	0.00002
Pantoea sp. MSR2	2052056	S	192	23	215	0.00002
Pantoea sp. At-9b	592316	S	172	37	209	0.00002
Pantoea sp. CCBC3-3-1	2490851	S	155	34	189	0.00001
Pantoea sp. SM3640	2787629	S	14	120	134	0.00001
Pantoea agglomerans	549	S	1065	388	1453	0.00011
Pantoea dispersa	59814	S	832	249	1081	0.00008
Pantoea vagans	470934	S	283	531	814	0.00006
Pantoea deleyi	470932	S	282	77	359	0.00003
Pantoea ananatis	553	S	275	104	379	0.00003
Pantoea cypripedii	55209	S	201	14	215	0.00002
Pantoea alhagi	1891675	S	179	63	242	0.00002
Pantoea stewartii	66269	S	152	45	197	0.00002
Pantoea rwandensis	1076550	S	115	29	144	0.00001
Candidatus Pantoea carbekii	1235990	S	14	1	15	0.00000
Erwinia sp. E602	2675378	S	432	86	518	0.00004
Erwinia sp. J780	2681984	S	106	22	128	0.00001
Erwinia sp. QL-Z3	2547962	S	42	108	150	0.00001
Erwinia sp. Ejp617	215689	S	23	35	58	0.00000
Erwinia gerundensis	1619313	S	278	59	337	0.00003
Erwinia persicina	55211	S	196	44	240	0.00002
Erwinia rhapontici	55212	S	179	37	216	0.00002
Erwinia tasmaniensis	338565	S	135	30	165	0.00001
Erwinia amylovora	552	S	124	60	184	0.00001
Erwinia billingiae	182337	S	116	210	326	0.00003
Erwinia tracheiphila	65700	S	96	14	110	0.00001
[Pantoea] beijingensis	1324864	S	91	19	110	0.00001
Candidatus Erwinia haradaeae	1922217	S	78	1	79	0.00001
Erwinia pyrifoliae	79967	S	36	53	89	0.00001
Mixta gaviniae	665914	S	361	151	512	0.00004
Mixta calida	665913	S	276	168	444	0.00003
Mixta theicola	1458355	S	239	83	322	0.00002
Mixta sp. X22927	2872648	S	155	94	249	0.00002
Mixta intestinalis	1615494	S	151	46	197	0.00002
Buchnera aphidicola	9	S	208	31	239	0.00002
Tatumella ptyseos	82987	S	83	17	100	0.00001
Tatumella citrea	53336	S	54	9	63	0.00000
Wigglesworthia glossinidia	51229	S	17	1	18	0.00000
Dickeya dadantii	204038	S	356	168	524	0.00004
Dickeya chrysanthemi	556	S	269	162	431	0.00003
Dickeya zeae	204042	S	260	213	473	0.00004
Dickeya dianthicola	204039	S	249	338	587	0.00005
Dickeya fangzhongdai	1778540	S	138	412	550	0.00004
Dickeya poaceiphila	568768	S	95	14	109	0.00001
Dickeya sp. NCPPB 3274	568766	S	83	38	121	0.00001
Dickeya solani	1089444	S	83	708	791	0.00006
Dickeya oryzae	1240404	S	20	28	48	0.00000
Pectobacterium carotovorum	554	S	157	367	524	0.00004
Pectobacterium brasiliense	180957	S	148	184	332	0.00003
Pectobacterium sp. LJ1	2878098	S	55	16	71	0.00001
Pectobacterium sp. PL64	2738983	S	38	27	65	0.00001
Pectobacterium atrosepticum	29471	S	91	29	120	0.00001
Pectobacterium polaris	2042057	S	86	65	151	0.00001
Pectobacterium parmentieri	1905730	S	75	31	106	0.00001
Pectobacterium wasabiae	55208	S	69	22	91	0.00001
Pectobacterium odoriferum	78398	S	53	41	94	0.00001
Pectobacterium punjabense	2108399	S	53	14	67	0.00001
Pectobacterium versatile	2488639	S	35	83	118	0.00001
Pectobacterium quasiaquaticum	2774015	S	22	22	44	0.00000
Pectobacterium parvum	2778550	S	22	35	57	0.00000
Pectobacterium aroidearum	1201031	S	21	34	55	0.00000
Pectobacterium aquaticum	2204145	S	13	17	30	0.00000
Brenneria izadpanahii	2722756	S	253	301	554	0.00004
Brenneria goodwinii	1109412	S	206	238	444	0.00003
Brenneria rubrifaciens	55213	S	178	76	254	0.00002
Lonsdalea populi	1172565	S	297	85	382	0.00003
Lonsdalea britannica	1082704	S	205	55	260	0.00002
Musicola paradisiaca	69223	S	313	0	313	0.00002
Edwardsiella tarda	636	S	378	276	654	0.00005
Edwardsiella hoshinae	93378	S	244	63	307	0.00002
Edwardsiella ictaluri	67780	S	182	473	655	0.00005
Edwardsiella piscicida	1263550	S	47	701	748	0.00006
Hafnia alvei	569	S	89	131	220	0.00002
Hafnia paralvei	546367	S	49	23	72	0.00001
Obesumbacterium proteus	82983	S	23	20	43	0.00000
Morganella morganii	582	S	464	462	926	0.00007
Providencia rettgeri	587	S	122	181	303	0.00002
Providencia alcalifaciens	126385	S	50	23	73	0.00001
Providencia heimbachae	333962	S	22	9	31	0.00000
Providencia rustigianii	158850	S	20	7	27	0.00000
Providencia sp. R33	2828763	S	18	4	22	0.00000
Providencia sneebia	516075	S	17	1	18	0.00000
Providencia stuartii	588	S	11	77	88	0.00001
Xenorhabdus bovienii	40576	S	87	25	112	0.00001
Xenorhabdus doucetiae	351671	S	66	12	78	0.00001
Xenorhabdus poinarii	40577	S	47	11	58	0.00000
Xenorhabdus nematophila	628	S	46	9	55	0.00000
Xenorhabdus hominickii	351679	S	30	6	36	0.00000
Xenorhabdus budapestensis	290110	S	29	4	33	0.00000
Proteus mirabilis	584	S	160	289	449	0.00003
Proteus vulgaris	585	S	18	27	45	0.00000
Proteus hauseri	183417	S	13	2	15	0.00000
Proteus terrae	1574161	S	10	118	128	0.00001
Photorhabdus thracensis	230089	S	84	18	102	0.00001
Photorhabdus asymbiotica	291112	S	33	4	37	0.00000
Photorhabdus akhurstii	171438	S	28	6	34	0.00000
Photorhabdus laumondii	2218628	S	24	6	30	0.00000
Arsenophonus endosymbiont of Aphis craccivora	1231049	S	17	8	25	0.00000
Arsenophonus nasoniae	638	S	16	15	31	0.00000
Moellerella wisconsensis	158849	S	31	26	57	0.00000
Sodalis sp. dw_23	2697027	S	462	34	496	0.00004
Sodalis endosymbiont of Henestaris halophilus	1929246	S	16	0	16	0.00000
Sodalis praecaptivus	1239307	S	222	159	381	0.00003
Sodalis glossinidius	63612	S	207	32	239	0.00002
Candidatus Sodalis pierantonius	1486991	S	80	61	141	0.00001
Leminorella richardii	158841	S	147	22	169	0.00001
Pragia fontium	82985	S	59	10	69	0.00001
Jinshanibacter zhutongyuii	2498113	S	33	7	40	0.00000
Limnobaculum parvum	2172103	S	31	8	39	0.00000
Thioalkalivibrio sulfidiphilus	1033854	S	2085	1340	3425	0.00026
Thioalkalivibrio paradoxus	108010	S	2006	640	2646	0.00020
Thioalkalivibrio nitratireducens	186931	S	1935	559	2494	0.00019
Thioalkalivibrio sp. K90mix	396595	S	1501	213	1714	0.00013
Thioalkalivibrio versutus	106634	S	1357	201	1558	0.00012
Spiribacter sp. E85	2182432	S	4011	446	4457	0.00034
Spiribacter sp. 2438	2666185	S	809	98	907	0.00007
Spiribacter curvatus	1335757	S	964	65	1029	0.00008
Spiribacter salinus	1335746	S	612	59	671	0.00005
Acidihalobacter aeolianus	2792603	S	1673	253	1926	0.00015
Acidihalobacter ferrooxydans	1765967	S	1307	149	1456	0.00011
Acidihalobacter yilgarnensis	2819280	S	994	73	1067	0.00008
Halorhodospira halophila	1053	S	1830	238	2068	0.00016
Halorhodospira halochloris	1052	S	323	16	339	0.00003
Alkalilimnicola ehrlichii	351052	S	1875	284	2159	0.00017
Aquisalimonas sp. 2447	2740807	S	1775	146	1921	0.00015
Ectothiorhodospira sp. BSL-9	1442136	S	694	250	944	0.00007
Ectothiorhodospira haloalkaliphila	421628	S	678	257	935	0.00007
Ectothiorhodosinus mongolicus	233100	S	273	21	294	0.00002
Allochromatium tepidum	553982	S	1421	811	2232	0.00017
Allochromatium vinosum	1049	S	1373	628	2001	0.00015
Candidatus Thiodictyon syntrophicum	1166950	S	3201	201	3402	0.00026
Thioflavicoccus mobilis	80679	S	3032	326	3358	0.00026
Marichromatium purpuratum	37487	S	2696	617	3313	0.00026
Thiocapsa bogorovii	521689	S	2268	144	2412	0.00019
Thiocystis violascens	73141	S	1721	174	1895	0.00015
Thermochromatium tepidum	1050	S	1102	321	1423	0.00011
Nitrosococcus wardiae	1814290	S	267	34	301	0.00002
Nitrosococcus halophilus	133539	S	259	35	294	0.00002
Nitrosococcus watsonii	473531	S	188	48	236	0.00002
Nitrosococcus oceani	1229	S	153	36	189	0.00001
Caldichromatium japonicum	2699430	S	788	108	896	0.00007
Rheinheimera sp. F8	1763998	S	116	6	122	0.00001
Rheinheimera sp. D18	2545632	S	28	27	55	0.00000
Rheinheimera mangrovi	2498451	S	72	7	79	0.00001
Candidatus Nitrosacidococcus tergens	553981	S	50	2	52	0.00000
Candidatus Nitrosoglobus terrae	1630141	S	29	2	31	0.00000
Wenzhouxiangella marina	1579979	S	2027	150	2177	0.00017
Wenzhouxiangella sp. AB-CW3	2771012	S	1298	67	1365	0.00011
Thiohalobacter sp. COW1	2795687	S	485	1069	1554	0.00012
Thiohalobacter thiocyanaticus	585455	S	376	1026	1402	0.00011
Sulfurivermis fontis	1972068	S	1983	840	2823	0.00022
Guyparkeria halophila	47960	S	1845	524	2369	0.00018
Halothiobacillus sp. LS2	1860122	S	814	81	895	0.00007
Halothiobacillus neapolitanus	927	S	341	40	381	0.00003
Woeseia oceani	1548547	S	1161	22	1183	0.00009
Sulfuriflexus mobilis	1811807	S	432	15	447	0.00003
Granulosicoccus antarcticus	437505	S	363	7	370	0.00003
Halomonas sp. JS92-SW72	2306583	S	1521	1552	3073	0.00024
Halomonas sp. THAF5a	2587844	S	1515	623	2138	0.00016
Halomonas sp. 1513	1883416	S	1110	269	1379	0.00011
Halomonas sp. THAF12	2587849	S	1055	634	1689	0.00013
Halomonas sp. YLGW01	2773308	S	1045	191	1236	0.00010
Halomonas sp. MCCC 1A13316	2733487	S	981	141	1122	0.00009
Halomonas sp. HG01	1609967	S	942	396	1338	0.00010
Halomonas sp. PGE1	2730360	S	705	911	1616	0.00012
Halomonas sp. Y2R2	2562282	S	354	21	375	0.00003
Halomonas sp. A40-4	2785909	S	320	92	412	0.00003
Halomonas sp. SH5A2	2749040	S	274	49	323	0.00002
Halomonas sp. KO116	1504981	S	195	87	282	0.00002
Halomonas sp. 18071143	2855441	S	182	431	613	0.00005
Halomonas sp. R57-5	1610576	S	177	78	255	0.00002
Halomonas sp. FeN2	2832500	S	150	70	220	0.00002
Halomonas sp. GFAJ-1	1118153	S	146	29	175	0.00001
Halomonas sp. SS10-MC5	2854257	S	121	1201	1322	0.00010
Halomonas sp. SF2003	2136172	S	112	551	663	0.00005
Halomonas sp. TD01	999141	S	79	43	122	0.00001
Halomonas sp. NyZ770	2883106	S	75	345	420	0.00003
Halomonas sp. hl-4	1761789	S	70	385	455	0.00004
Halomonas sp. HL-93	1666906	S	50	283	333	0.00003
Halomonas sp. GT	1971364	S	34	25	59	0.00000
Halomonas sp. N3-2A	2014541	S	30	41	71	0.00001
Halomonas sp. A3H3	1346287	S	11	327	338	0.00003
Halomonas beimenensis	475662	S	1644	358	2002	0.00015
Halomonas aestuarii	1897729	S	1240	288	1528	0.00012
Halomonas socia	1081866	S	1141	242	1383	0.00011
Halomonas sulfidivorans	2733488	S	1007	228	1235	0.00010
Halomonas tianxiuensis	2497861	S	956	234	1190	0.00009
Halomonas elongata	2746	S	853	96	949	0.00007
Halomonas chromatireducens	507626	S	791	69	860	0.00007
Halomonas subglaciescola	29571	S	504	60	564	0.00004
Halomonas meridiana	29570	S	471	415	886	0.00007
Halomonas huangheensis	1178482	S	433	27	460	0.00004
Halomonas piezotolerans	2609667	S	393	237	630	0.00005
Halomonas profundi	2852117	S	143	22	165	0.00001
Halomonas titanicae	664683	S	126	709	835	0.00006
Halomonas sulfidoxydans	2733484	S	124	1211	1335	0.00010
Halomonas hydrothermalis	115561	S	88	284	372	0.00003
Halomonas venusta	44935	S	83	117	200	0.00002
Halomonas campaniensis	213554	S	28	147	175	0.00001
Cobetia sp. L2A1	2686360	S	320	43	363	0.00003
Cobetia sp. cqz5-12	2609415	S	196	291	487	0.00004
Cobetia sp. 4B	2758724	S	84	392	476	0.00004
Cobetia sp. AM6	2661553	S	63	385	448	0.00003
Cobetia pacifica	1055101	S	120	376	496	0.00004
Cobetia amphilecti	1055104	S	66	436	502	0.00004
Cobetia marina	28258	S	16	218	234	0.00002
Halotalea alkalilenta	376489	S	1447	310	1757	0.00014
Salinicola tamaricis	1771309	S	1447	183	1630	0.00013
Kushneria phosphatilytica	657387	S	420	18	438	0.00003
Kushneria konosiri	698828	S	356	92	448	0.00003
Kushneria marisflavi	157779	S	306	77	383	0.00003
Chromohalobacter salexigens	158080	S	1100	133	1233	0.00009
Pistricoccus aurantiacus	1883414	S	825	61	886	0.00007
Zymobacter palmae	33074	S	220	32	252	0.00002
Candidatus Portiera aleyrodidarum	91844	S	62	8	70	0.00001
Alcanivorax sp. N3-2A	2014542	S	1247	1521	2768	0.00021
Alcanivorax sp. NBRC 101098	1113728	S	13	150	163	0.00001
Alcanivorax pacificus	1306787	S	949	365	1314	0.00010
Alcanivorax xenomutans	1094342	S	577	285	862	0.00007
Alcanivorax dieselolei	285091	S	565	154	719	0.00006
Alcanivorax borkumensis	59754	S	11	121	132	0.00001
Ketobacter alkanivorans	1917421	S	201	16	217	0.00002
Marinobacterium aestuarii	1821621	S	672	56	728	0.00006
Marinobacterium sediminicola	518898	S	302	50	352	0.00003
Marinobacterium georgiense	48076	S	294	106	400	0.00003
Marinobacterium sp. LSUCC0821	2668067	S	27	2	29	0.00000
Marinomonas sp. CT5	2066133	S	35	3	38	0.00000
Marinomonas sp. FW-1	2071621	S	31	9	40	0.00000
Marinomonas sp. A3A	2065312	S	21	3	24	0.00000
Marinomonas primoryensis	178399	S	63	10	73	0.00001
Marinomonas arctica	383750	S	40	11	51	0.00000
Marinomonas profundi	2726122	S	40	15	55	0.00000
Marinomonas mediterranea	119864	S	38	4	42	0.00000
Marinomonas algicola	2773454	S	31	6	37	0.00000
Marinomonas posidonica	936476	S	29	5	34	0.00000
Marinomonas foliarum	491950	S	27	13	40	0.00000
Venatorbacter cucullus	2661630	S	227	62	289	0.00002
Thalassolituus sp. C2-1	2597518	S	161	12	173	0.00001
Thalassolituus oleivorans	187493	S	64	18	82	0.00001
Bacterioplanes sanyensis	1249553	S	157	10	167	0.00001
Neptunomonas concharum	1031538	S	59	5	64	0.00000
Neptunomonas phycophila	1572645	S	43	3	46	0.00000
Neptunomonas japonica	417574	S	37	2	39	0.00000
Nitrincola iocasae	2614693	S	99	17	116	0.00001
Amphritea japonica	452627	S	66	6	72	0.00001
Bermanella marisrubri	207949	S	39	1	40	0.00000
Hahella chejuensis	158327	S	455	53	508	0.00004
Hahella sp. KA22	1628392	S	368	50	418	0.00003
Saccharospirillum mangrovi	2161747	S	467	30	497	0.00004
Reinekea forsetii	1336806	S	168	9	177	0.00001
Gynuella sunshinyii	1445505	S	164	5	169	0.00001
Litoricola lipolytica	418701	S	270	14	284	0.00002
Oleiphilus messinensis	141451	S	118	9	127	0.00001
Spartinivicinus ruber	2683272	S	116	4	120	0.00001
Endozoicomonas montiporae	1027273	S	88	5	93	0.00001
Methylococcus sp. EFPC2	2812648	S	1646	126	1772	0.00014
Methylococcus sp. Mc7	2860258	S	1447	488	1935	0.00015
Methylococcus capsulatus	414	S	1494	389	1883	0.00015
Methylococcus geothermalis	2681310	S	1248	368	1616	0.00012
Methylomonas sp. LL1	2785785	S	507	26	533	0.00004
Methylomonas sp. LW13	107637	S	201	110	311	0.00002
Methylomonas sp. DH-1	1727196	S	184	371	555	0.00004
Methylomonas sp. EFPC1	2812647	S	176	102	278	0.00002
Methylomonas koyamae	702114	S	498	542	1040	0.00008
Methylomonas rhizoryzae	2608981	S	481	21	502	0.00004
Methylomonas denitrificans	1538553	S	389	29	418	0.00003
Methylomonas methanica	421	S	383	21	404	0.00003
Methylomonas paludis	1173101	S	119	6	125	0.00001
Methylocaldum marinum	1432792	S	1969	125	2094	0.00016
Methylomagnum ishizawai	1760988	S	1837	90	1927	0.00015
Methylomicrobium album	39775	S	1393	61	1454	0.00011
Methylomicrobium sp. wino1	2049332	S	297	276	573	0.00004
Methylogaea oryzae	1295382	S	1690	144	1834	0.00014
Candidatus Methylospira mobilis	1808979	S	571	27	598	0.00005
Methylotuvimicrobium buryatense	95641	S	153	202	355	0.00003
Methylotuvimicrobium alcaliphilum	271065	S	141	217	358	0.00003
Methylovulum psychrotolerans	1704499	S	252	6	258	0.00002
Methylobacter sp. S3L5C	2839024	S	112	7	119	0.00001
Aeromonas sp. FDAARGOS 1415	2778064	S	287	174	461	0.00004
Aeromonas sp. CA23	2033032	S	225	104	329	0.00003
Aeromonas sp. FDAARGOS 1409	2778058	S	133	211	344	0.00003
Aeromonas sp. CU5	2033033	S	127	58	185	0.00001
Aeromonas sp. FDAARGOS 1407	2778056	S	53	179	232	0.00002
Aeromonas sp. 1805	2560028	S	50	152	202	0.00002
Aeromonas sp. ASNIH4	1636609	S	39	204	243	0.00002
Aeromonas sp. FDAARGOS 1410	2778059	S	37	97	134	0.00001
Aeromonas sp. FDAARGOS 1403	2778052	S	34	113	147	0.00001
Aeromonas sp. FDAARGOS 1405	2778054	S	30	54	84	0.00001
Aeromonas sp. 2692-1	2560029	S	27	143	170	0.00001
Aeromonas sp. FDAARGOS 1408	2778057	S	24	152	176	0.00001
Aeromonas sp. FDAARGOS 1404	2778053	S	24	94	118	0.00001
Aeromonas sp. FDAARGOS 1402	2778051	S	23	269	292	0.00002
Aeromonas sp. FDAARGOS 1419	2778068	S	19	61	80	0.00001
Aeromonas sp. ASNIH1	1636606	S	19	402	421	0.00003
Aeromonas sp. FDAARGOS 1406	2778055	S	19	200	219	0.00002
Aeromonas sp. FDAARGOS 1416	2778065	S	18	57	75	0.00001
Aeromonas sp. FDAARGOS 1411	2778060	S	17	59	76	0.00001
Aeromonas sp. ASNIH5	1758179	S	16	296	312	0.00002
Aeromonas sp. FDAARGOS 1414	2778063	S	15	52	67	0.00001
Aeromonas sp. FDAARGOS 1417	2778066	S	15	47	62	0.00000
Aeromonas sp. ASNIH3	1636608	S	12	618	630	0.00005
Aeromonas sp. WP2-W18-CRE-05	2675707	S	11	473	484	0.00004
Aeromonas sp. ASNIH7	1920107	S	11	449	460	0.00004
Aeromonas sp. ASNIH2	1636607	S	10	142	152	0.00001
Aeromonas hydrophila	644	S	1401	3568	4969	0.00038
Aeromonas veronii	654	S	987	2374	3361	0.00026
Aeromonas schubertii	652	S	674	211	885	0.00007
Aeromonas media	651	S	645	1349	1994	0.00015
Aeromonas encheleia	73010	S	570	215	785	0.00006
Aeromonas salmonicida	645	S	547	576	1123	0.00009
Aeromonas simiae	218936	S	524	592	1116	0.00009
Aeromonas caviae	648	S	432	3814	4246	0.00033
Aeromonas rivuli	648794	S	345	105	450	0.00003
Aeromonas enteropelogenes	29489	S	316	281	597	0.00005
Aeromonas dhakensis	196024	S	312	678	990	0.00008
Aeromonas jandaei	650	S	240	264	504	0.00004
Aeromonas sanarellii	633415	S	90	465	555	0.00004
Aeromonas allosaccharophila	656	S	78	132	210	0.00002
Aeromonas rivipollensis	948519	S	55	94	149	0.00001
Zobellella denitrificans	347534	S	1196	310	1506	0.00012
Oceanimonas sp. GK1	511062	S	548	130	678	0.00005
Dongshaea marina	2047966	S	165	17	182	0.00001
Oceanisphaera profunda	1416627	S	81	11	92	0.00001
Oceanisphaera avium	1903694	S	32	5	37	0.00000
Tolumonas auensis	43948	S	95	43	138	0.00001
Succinivibrio dextrinosolvens	83771	S	31	1	32	0.00000
Solimonas sp. K1W22B-7	2303331	S	7897	944	8841	0.00068
Flagellatimonas centrodinii	2806210	S	2124	178	2302	0.00018
Sinimarinibacterium sp. NLF-5-8	2698684	S	1002	598	1600	0.00012
Steroidobacter denitrificans	465721	S	6775	1971	8746	0.00067
Sulfurifustis variabilis	1675686	S	7964	601	8565	0.00066
Sulfuricaulis limicola	1620215	S	3071	278	3349	0.00026
Acidiferrobacter sp. SPIII_3	1281578	S	878	251	1129	0.00009
Acidiferrobacter thiooxydans	163359	S	733	212	945	0.00007
Microbulbifer sp. YPW16	2904242	S	724	72	796	0.00006
Microbulbifer sp. SH-1	2681547	S	617	101	718	0.00006
Microbulbifer sp. YPW1	2745199	S	458	87	545	0.00004
Microbulbifer sp. ALW1	1516059	S	374	67	441	0.00003
Microbulbifer sp. THAF38	2587856	S	135	50	185	0.00001
Microbulbifer sp. GL-2	2591606	S	121	21	142	0.00001
Microbulbifer sp. A4B17	359370	S	109	26	135	0.00001
Microbulbifer aggregans	1769779	S	432	58	490	0.00004
Microbulbifer hydrolyticus	48074	S	431	89	520	0.00004
Microbulbifer celer	435905	S	408	57	465	0.00004
Microbulbifer thermotolerans	252514	S	393	27	420	0.00003
Microbulbifer elongatus	86173	S	328	60	388	0.00003
Microbulbifer agarilyticus	260552	S	222	28	250	0.00002
Microbulbifer variabilis	266805	S	93	39	132	0.00001
Kineobactrum salinum	2708301	S	1011	41	1052	0.00008
Halioglobus japonicus	930805	S	424	20	444	0.00003
Halioglobus maricola	2601894	S	302	12	314	0.00002
Congregibacter litoralis	393662	S	424	180	604	0.00005
Aequoribacter fuscus	2518989	S	129	15	144	0.00001
Cellvibrio sp. PSBB006	1987723	S	536	18	554	0.00004
Cellvibrio sp. KY-GH-1	2303332	S	184	15	199	0.00002
Cellvibrio sp. KY-YJ-3	454662	S	176	28	204	0.00002
Cellvibrio sp. PSBB023	1945512	S	163	17	180	0.00001
Cellvibrio japonicus	155077	S	252	17	269	0.00002
Teredinibacter turnerae	2426	S	203	9	212	0.00002
Teredinibacter haidensis	2731755	S	102	7	109	0.00001
Teredinibacter purpureus	2731756	S	65	2	67	0.00001
Simiduia agarivorans	447471	S	361	20	381	0.00003
Marinagarivorans sp. GE09	2721545	S	75	6	81	0.00001
Saccharophagus degradans	86304	S	66	2	68	0.00001
Agarilytica rhodophyticola	1737490	S	46	1	47	0.00000
Spongiibacter taiwanensis	1748242	S	298	14	312	0.00002
Spongiibacter nanhainus	2794344	S	289	33	322	0.00002
Spongiibacter sp. IMCC21906	1620392	S	110	30	140	0.00001
Zhongshania aliphaticivorans	1470434	S	151	10	161	0.00001
Oceanicoccus sagamiensis	716816	S	79	1	80	0.00001
Shewanella sp. FJAT-53555	2864204	S	75	68	143	0.00001
Shewanella sp. FJAT-54031	2864209	S	58	91	149	0.00001
Shewanella sp. FJAT-51860	2864212	S	56	9	65	0.00001
Shewanella sp. FJAT-53532	2864203	S	49	87	136	0.00001
Shewanella sp. FJAT-53764	2864207	S	48	78	126	0.00001
Shewanella sp. FJAT-52076	2864202	S	47	70	117	0.00001
Shewanella sp. FJAT-53681	2864205	S	46	77	123	0.00001
Shewanella sp. SNU WT4	2590015	S	45	12	57	0.00000
Shewanella sp. Scap07	2589987	S	38	5	43	0.00000
Shewanella sp. FJAT-52072	2864213	S	38	53	91	0.00001
Shewanella sp. KX20019	2803864	S	34	4	38	0.00000
Shewanella sp. FJAT-53870	2864208	S	34	6	40	0.00000
Shewanella sp. WE21	2029986	S	30	16	46	0.00000
Shewanella sp. Pdp11	2059264	S	26	75	101	0.00001
Shewanella sp. FJAT-51754	2864211	S	22	33	55	0.00000
Shewanella sp. MR-4	60480	S	22	23	45	0.00000
Shewanella sp. FJAT-53749	2864206	S	21	4	25	0.00000
Shewanella sp. ANA-3	94122	S	14	37	51	0.00000
Shewanella sp. FJAT-51649	2864210	S	11	17	28	0.00000
Shewanella sp. Arc9-LZ	2698686	S	10	4	14	0.00000
Shewanella algae	38313	S	207	182	389	0.00003
Shewanella cyperi	2814292	S	187	104	291	0.00002
Shewanella khirikhana	1965282	S	182	29	211	0.00002
Shewanella baltica	62322	S	131	182	313	0.00002
Shewanella litorisediminis	1173586	S	125	31	156	0.00001
Shewanella putrefaciens	24	S	116	392	508	0.00004
Shewanella marisflavi	260364	S	106	21	127	0.00001
Shewanella sedimentimangrovi	2814293	S	93	71	164	0.00001
Shewanella amazonensis	60478	S	93	24	117	0.00001
Shewanella dokdonensis	712036	S	86	9	95	0.00001
Shewanella sediminis	271097	S	75	10	85	0.00001
Shewanella avicenniae	2814294	S	63	10	73	0.00001
Shewanella loihica	359303	S	53	91	144	0.00001
Shewanella carassii	1987584	S	51	57	108	0.00001
Shewanella yunxiaonensis	2829809	S	49	8	57	0.00000
Shewanella denitrificans	192073	S	49	7	56	0.00000
Shewanella violacea	60217	S	47	9	56	0.00000
Shewanella pealeana	70864	S	47	8	55	0.00000
Shewanella woodyi	60961	S	46	5	51	0.00000
Shewanella oneidensis	70863	S	42	12	54	0.00000
Shewanella decolorationis	256839	S	40	46	86	0.00001
Shewanella psychropiezotolerans	2593655	S	39	7	46	0.00000
Shewanella halifaxensis	271098	S	38	5	43	0.00000
Shewanella xiamenensis	332186	S	37	198	235	0.00002
Shewanella benthica	43661	S	37	8	45	0.00000
Shewanella psychrophila	225848	S	36	5	41	0.00000
Shewanella glacialimarina	2590884	S	35	4	39	0.00000
Shewanella psychromarinicola	2487742	S	34	5	39	0.00000
Shewanella maritima	2520507	S	33	3	36	0.00000
Shewanella indica	768528	S	31	44	75	0.00001
Shewanella vesiculosa	518738	S	28	7	35	0.00000
Shewanella piezotolerans	404011	S	27	3	30	0.00000
Shewanella aestuarii	1028752	S	26	10	36	0.00000
Shewanella chilikensis	558541	S	23	69	92	0.00001
Shewanella inventionis	1738770	S	18	8	26	0.00000
Shewanella donghaensis	238836	S	16	2	18	0.00000
Shewanella livingstonensis	150120	S	16	3	19	0.00000
Shewanella frigidimarina	56812	S	13	7	20	0.00000
Shewanella polaris	2588449	S	10	19	29	0.00000
Parashewanella spongiae	342950	S	24	1	25	0.00000
Parashewanella tropica	2547970	S	22	2	24	0.00000
Alteromonas sp. RKMC-009	2267264	S	99	25	124	0.00001
Alteromonas sp. BL110	1714845	S	28	35	63	0.00000
Alteromonas sp. 76-1	2358187	S	18	15	33	0.00000
Alteromonas macleodii	28108	S	127	52	179	0.00001
Alteromonas mediterranea	314275	S	90	22	112	0.00001
Alteromonas pelagimontana	1858656	S	58	7	65	0.00001
Alteromonas australica	589873	S	35	53	88	0.00001
Alteromonas naphthalenivorans	715451	S	14	7	21	0.00000
Alteromonas stellipolaris	233316	S	13	32	45	0.00000
Salinimonas marina	2785918	S	108	13	121	0.00001
Salinimonas iocasae	2572577	S	63	14	77	0.00001
Salinimonas lutimaris	914153	S	60	12	72	0.00001
Salinimonas sediminis	2303538	S	58	15	73	0.00001
Hydrocarboniclastica marina	2259620	S	474	71	545	0.00004
Lacimicrobium alkaliphilum	1526571	S	165	13	178	0.00001
Agarivorans sp. TSD2052	2937286	S	38	5	43	0.00000
Agarivorans sp. B2Z047	2652721	S	16	13	29	0.00000
Agarivorans gilvus	680279	S	38	3	41	0.00000
Agarivorans aestuarii	1563703	S	19	7	26	0.00000
Agarivorans albus	182262	S	10	9	19	0.00000
Saliniradius amylolyticus	2183582	S	144	15	159	0.00001
Paraglaciecola mesophila	197222	S	53	5	58	0.00000
Paraglaciecola sp. L1A13	2686359	S	29	2	31	0.00000
Paraglaciecola sp. L3A3	2686358	S	23	1	24	0.00000
Paraglaciecola psychrophila	326544	S	21	1	22	0.00000
Glaciecola nitratireducens	300231	S	78	6	84	0.00001
Paraneptunicella aestuarii	2831148	S	62	3	65	0.00001
Saccharobesus litoralis	2172099	S	32	2	34	0.00000
Catenovulum sediminis	1740262	S	29	2	31	0.00000
Pseudoalteromonas sp. R3	1709477	S	72	10	82	0.00001
Pseudoalteromonas sp. A25	116092	S	41	5	46	0.00000
Pseudoalteromonas sp. THAF3	2587843	S	24	15	39	0.00000
Pseudoalteromonas sp. GCY	2003316	S	18	22	40	0.00000
Pseudoalteromonas sp. A22	327511	S	10	22	32	0.00000
Pseudoalteromonas rubra	43658	S	180	19	199	0.00002
Pseudoalteromonas viridis	339617	S	97	25	122	0.00001
Pseudoalteromonas luteoviolacea	43657	S	63	8	71	0.00001
Pseudoalteromonas piscicida	43662	S	56	32	88	0.00001
Pseudoalteromonas donghaensis	621376	S	50	242	292	0.00002
Pseudoalteromonas shioyasakiensis	1190813	S	43	16	59	0.00000
Pseudoalteromonas spongiae	298657	S	36	7	43	0.00000
Pseudoalteromonas xiamenensis	882626	S	34	4	38	0.00000
Pseudoalteromonas agarivorans	176102	S	34	50	84	0.00001
Pseudoalteromonas ruthenica	151081	S	25	15	40	0.00000
Pseudoalteromonas tunicata	314281	S	24	3	27	0.00000
Pseudoalteromonas prydzensis	182141	S	24	3	27	0.00000
Pseudoalteromonas mariniglutinosa	206042	S	23	23	46	0.00000
Pseudoalteromonas aliena	247523	S	22	6	28	0.00000
Pseudoalteromonas piratica	1348114	S	19	2	21	0.00000
Pseudoalteromonas phenolica	161398	S	18	2	20	0.00000
Pseudoalteromonas ulvae	107327	S	18	1	19	0.00000
Pseudoalteromonas translucida	166935	S	16	33	49	0.00000
Pseudoalteromonas arctica	394751	S	12	5	17	0.00000
Pseudoalteromonas espejiana	28107	S	12	2	14	0.00000
Pseudoalteromonas carrageenovora	227	S	11	2	13	0.00000
Psychrosphaera aestuarii	1266052	S	25	3	28	0.00000
Psychrosphaera ytuae	2820710	S	24	4	28	0.00000
Flocculibacter collagenilyticus	2744479	S	31	3	34	0.00000
Ferrimonas balearica	44012	S	521	68	589	0.00005
Ferrimonas lipolytica	2724191	S	76	11	87	0.00001
Idiomarina sp. OT37-5b	2100422	S	94	22	116	0.00001
Idiomarina sp. X4	2055892	S	47	14	61	0.00000
Idiomarina abyssalis	86102	S	66	7	73	0.00001
Idiomarina loihiensis	135577	S	60	0	60	0.00000
Idiomarina piscisalsi	1096243	S	25	7	32	0.00000
Thalassotalea sp. PS06	2594005	S	35	4	39	0.00000
Thalassotalea sp. HSM 43	2552945	S	30	5	35	0.00000
Thalassotalea sp. LPB0316	2769490	S	26	7	33	0.00000
Thalassotalea crassostreae	1763536	S	12	2	14	0.00000
Colwellia sp. PAMC 20917	1816218	S	20	1	21	0.00000
Colwellia sp. Arc7-635	2497879	S	18	2	20	0.00000
Colwellia sp. MT41	58049	S	16	2	18	0.00000
Colwellia sp. Arc7-D	2161872	S	13	1	14	0.00000
Colwellia sp. 20A7	2689569	S	12	1	13	0.00000
Colwellia psychrerythraea	28229	S	10	1	11	0.00000
Cognaticolwellia beringensis	1967665	S	31	4	35	0.00000
Litorilituus sediminis	718192	S	11	1	12	0.00000
Moritella sp. 5	2746231	S	10	17	27	0.00000
Moritella yayanosii	69539	S	30	12	42	0.00000
Moritella marina	90736	S	15	5	20	0.00000
Psychromonas ingrahamii	357794	S	58	9	67	0.00001
Psychromonas sp. CNPT3	314282	S	12	3	15	0.00000
Vibrio parahaemolyticus	670	S	145	44	189	0.00001
Vibrio harveyi	669	S	63	20	83	0.00001
Vibrio campbellii	680	S	56	35	91	0.00001
Vibrio diabolicus	50719	S	29	36	65	0.00001
Vibrio alginolyticus	663	S	40	41	81	0.00001
Vibrio rotiferianus	190895	S	40	15	55	0.00000
Vibrio owensii	696485	S	37	18	55	0.00000
Vibrio natriegens	691	S	23	13	36	0.00000
Vibrio azureus	512649	S	21	2	23	0.00000
Vibrio sp. OG9-811	2841925	S	142	22	164	0.00001
Vibrio sp. B1FLJ16	2751178	S	44	9	53	0.00000
Vibrio sp. THAF190c	2587865	S	30	4	34	0.00000
Vibrio sp. HDW18	2714948	S	26	4	30	0.00000
Vibrio sp. VB16	2785746	S	24	2	26	0.00000
Vibrio sp. SCSIO 43132	2779363	S	23	5	28	0.00000
Vibrio sp. SS-MA-C1-2	2908646	S	14	2	16	0.00000
Vibrio sp. Scap24	2589990	S	12	7	19	0.00000
Vibrio sp. ED004	2785124	S	12	7	19	0.00000
Vibrio fluvialis	676	S	269	42	311	0.00002
Vibrio furnissii	29494	S	241	72	313	0.00002
Vibrio vulnificus	672	S	207	43	250	0.00002
Vibrio sinaloensis	379097	S	86	12	98	0.00001
Vibrio tubiashii	29498	S	35	13	48	0.00000
Vibrio europaeus	300876	S	23	6	29	0.00000
Vibrio navarrensis	29495	S	119	26	145	0.00001
Vibrio cholerae	666	S	103	4141	4244	0.00033
Vibrio mimicus	674	S	80	15	95	0.00001
Vibrio coralliilyticus	190893	S	78	18	96	0.00001
Vibrio anguillarum	55601	S	70	9	79	0.00001
Vibrio spartinae	1918945	S	62	6	68	0.00001
Vibrio cyclitrophicus	47951	S	56	11	67	0.00001
Vibrio maritimus	990268	S	51	5	56	0.00000
Vibrio gazogenes	687	S	49	5	54	0.00000
Vibrio nigripulchritudo	28173	S	49	6	55	0.00000
Vibrio scophthalmi	45658	S	48	8	56	0.00000
Vibrio breoganii	553239	S	47	5	52	0.00000
Vibrio mediterranei	689	S	46	4	50	0.00000
Vibrio metoecus	1481663	S	45	11	56	0.00000
Vibrio alfacsensis	1074311	S	43	18	61	0.00000
Vibrio splendidus	29497	S	42	9	51	0.00000
Vibrio tapetis	52443	S	41	3	44	0.00000
Vibrio taketomensis	2572923	S	41	5	46	0.00000
Vibrio zhugei	2479546	S	40	9	49	0.00000
Vibrio astriarenae	1481923	S	38	5	43	0.00000
Vibrio cidicii	1763883	S	35	9	44	0.00000
Vibrio panuliri	1381081	S	35	4	39	0.00000
Vibrio chagasii	170679	S	35	5	40	0.00000
Vibrio crassostreae	246167	S	33	9	42	0.00000
Vibrio metschnikovii	28172	S	33	6	39	0.00000
Vibrio rumoiensis	76258	S	32	19	51	0.00000
Vibrio neptunius	170651	S	32	4	36	0.00000
Vibrio ponticus	265668	S	31	2	33	0.00000
Vibrio bathopelagicus	2777577	S	29	5	34	0.00000
Vibrio aquimaris	2587862	S	28	3	31	0.00000
Vibrio cincinnatiensis	675	S	28	5	33	0.00000
Vibrio tritonius	1435069	S	28	3	31	0.00000
Vibrio penaeicida	104609	S	28	3	31	0.00000
Vibrio algicola	2662262	S	27	4	31	0.00000
Vibrio atlanticus	693153	S	25	3	28	0.00000
Vibrio ziniensis	2711221	S	25	3	28	0.00000
Vibrio casei	673372	S	23	6	29	0.00000
Vibrio kanaloae	170673	S	19	3	22	0.00000
Vibrio aphrogenes	1891186	S	18	2	20	0.00000
Vibrio gigantis	296199	S	16	3	19	0.00000
Vibrio hyugaensis	1534743	S	14	3	17	0.00000
Vibrio qinghaiensis	2025808	S	11	3	14	0.00000
Photobacterium damselae	38293	S	691	272	963	0.00007
Photobacterium sp. TLY01	2907534	S	126	23	149	0.00001
Photobacterium sp. GJ3	2829502	S	95	14	109	0.00001
Photobacterium gaetbulicola	1295392	S	168	16	184	0.00001
Photobacterium ganghwense	320778	S	130	28	158	0.00001
Photobacterium profundum	74109	S	24	2	26	0.00000
Salinivibrio kushneri	1908198	S	88	14	102	0.00001
Salinivibrio sp. YCSC6	2003370	S	18	39	57	0.00000
Salinivibrio costicola	51367	S	13	28	41	0.00000
Grimontia hollisae	673	S	104	13	117	0.00001
Aliivibrio fischeri	668	S	31	6	37	0.00000
Aliivibrio salmonicida	40269	S	10	4	14	0.00000
Thaumasiovibrio subtropicus	1891207	S	43	5	48	0.00000
Candidatus Enterovibrio luxaltus	1927128	S	16	0	16	0.00000
Paraphotobacterium marinum	1755811	S	10	2	12	0.00000
Immundisolibacter cernigliae	1810504	S	3460	704	4164	0.00032
Acinetobacter baumannii	470	S	493	2876	3369	0.00026
Acinetobacter pittii	48296	S	48	54	102	0.00001
Acinetobacter calcoaceticus	471	S	26	2	28	0.00000
Acinetobacter seifertii	1530123	S	18	7	25	0.00000
Acinetobacter nosocomialis	106654	S	16	5	21	0.00000
Acinetobacter sp. WCHAc010034	1879049	S	189	82	271	0.00002
Acinetobacter sp. 10FS3-1	2563897	S	25	19	44	0.00000
Acinetobacter sp. ASP199	2773709	S	19	7	26	0.00000
Acinetobacter sp. LoGeW2-3	1808001	S	17	2	19	0.00000
Acinetobacter sp. Marseille-Q1620	2714110	S	16	1	17	0.00000
Acinetobacter sp. CS-2	2798861	S	16	9	25	0.00000
Acinetobacter sp. WCHAc010052	2004647	S	14	7	21	0.00000
Acinetobacter sp. TGL-Y2	1407071	S	13	1	14	0.00000
Acinetobacter sp. TTH0-4	1646498	S	12	2	14	0.00000
Acinetobacter sp. YH12138	2601122	S	12	36	48	0.00000
Acinetobacter sp. SH20PTE14	2905879	S	10	27	37	0.00000
Acinetobacter johnsonii	40214	S	104	72	176	0.00001
Acinetobacter indicus	756892	S	98	93	191	0.00001
Acinetobacter lwoffii	28090	S	61	72	133	0.00001
Acinetobacter schindleri	108981	S	48	48	96	0.00001
Acinetobacter radioresistens	40216	S	46	6	52	0.00000
Acinetobacter soli	487316	S	41	4	45	0.00000
Acinetobacter larvae	1789224	S	39	3	42	0.00000
Acinetobacter haemolyticus	29430	S	32	17	49	0.00000
Acinetobacter junii	40215	S	29	12	41	0.00000
Acinetobacter baylyi	202950	S	24	2	26	0.00000
Acinetobacter bouvetii	202951	S	23	3	26	0.00000
Acinetobacter tandoii	202954	S	22	2	24	0.00000
Acinetobacter variabilis	70346	S	20	27	47	0.00000
Acinetobacter cumulans	2136182	S	19	8	27	0.00000
Acinetobacter shaoyimingii	2715164	S	19	1	20	0.00000
Acinetobacter venetianus	52133	S	18	4	22	0.00000
Acinetobacter lanii	2715163	S	17	2	19	0.00000
Acinetobacter dispersus	70348	S	17	1	18	0.00000
Acinetobacter gyllenbergii	134534	S	15	1	16	0.00000
Acinetobacter piscicola	2006115	S	13	8	21	0.00000
Acinetobacter wuhouensis	1879050	S	12	6	18	0.00000
Acinetobacter chinensis	2004650	S	11	7	18	0.00000
Acinetobacter defluvii	1871111	S	10	8	18	0.00000
Psychrobacter sp. DAB_AL43B	1028416	S	25	3	28	0.00000
Psychrobacter sp. P11F6	1699621	S	23	16	39	0.00000
Psychrobacter sp. P11G3	1699623	S	18	7	25	0.00000
Psychrobacter sp. G	571800	S	13	47	60	0.00000
Psychrobacter sp. P11G5	1699624	S	12	22	34	0.00000
Psychrobacter sp. KH172YL61	2517899	S	11	52	63	0.00000
Psychrobacter sp. 28M-43	2772254	S	11	4	15	0.00000
Psychrobacter sp. WY6	2708350	S	10	6	16	0.00000
Psychrobacter arenosus	256326	S	25	1	26	0.00000
Psychrobacter sanguinis	861445	S	19	6	25	0.00000
Psychrobacter arcticus	334543	S	16	4	20	0.00000
Psychrobacter urativorans	45610	S	14	2	16	0.00000
Psychrobacter cryohalolentis	330922	S	11	41	52	0.00000
Moraxella osloensis	34062	S	108	16	124	0.00001
Moraxella bovoculi	386891	S	29	56	85	0.00001
Moraxella sp. ZY201115	2904121	S	28	3	31	0.00000
Moraxella cuniculi	34061	S	25	3	28	0.00000
Moraxella catarrhalis	480	S	24	5	29	0.00000
Moraxella bovis	476	S	23	7	30	0.00000
Moraxella nonliquefaciens	478	S	13	3	16	0.00000
Aquirhabdus parva	2283318	S	70	3	73	0.00001
Candidatus Endoriftia persephone	393765	S	925	48	973	0.00007
Candidatus Vesicomyosocius sp. SY067_SCS001	2732590	S	26	29	55	0.00000
Bathymodiolus thermophilus thioautotrophic gill symbiont	2360	S	24	1	25	0.00000
Bathymodiolus septemdierum thioautotrophic gill symbiont	113267	S	20	2	22	0.00000
Sedimenticola thiotaurini	1543721	S	652	29	681	0.00005
Candidatus Reidiella endopervernicosa	2738883	S	441	10	451	0.00003
Thiolapillus brandeum	1076588	S	385	10	395	0.00003
Pseudohongiella spirulinae	1249552	S	214	6	220	0.00002
Gallaecimonas mangrovi	2291597	S	129	10	139	0.00001
Celerinatantimonas diazotrophica	412034	S	47	3	50	0.00000
Candidatus Thioglobus autotrophicus	1705394	S	20	1	21	0.00000
Candidatus Thioglobus sp. NP1	2508687	S	11	2	13	0.00000
Ignatzschineria sp. HR5S32	2923279	S	30	3	33	0.00000
Candidatus Steffania adelgidicola	1076626	S	15	0	15	0.00000
Candidatus Azoamicus ciliaticola	2652803	S	10	1	11	0.00000
Candidatus Pseudothioglobus singularis	1427364	S	10	3	13	0.00000
Legionella sp. PC1000	2746060	S	125	17	142	0.00001
Legionella sp. MW5194	2662448	S	112	18	130	0.00001
Legionella sp. PC997	2755562	S	40	5	45	0.00000
Legionella anisa	28082	S	178	36	214	0.00002
Legionella pneumophila	446	S	140	70	210	0.00002
Legionella geestiana	45065	S	132	11	143	0.00001
Legionella spiritensis	452	S	109	10	119	0.00001
Legionella lansingensis	45067	S	86	6	92	0.00001
Legionella sainthelensi	28087	S	66	9	75	0.00001
Legionella jordanis	456	S	59	7	66	0.00001
Legionella israelensis	454	S	57	3	60	0.00000
Legionella oakridgensis	29423	S	49	4	53	0.00000
Legionella longbeachae	450	S	43	6	49	0.00000
Legionella clemsonensis	1867846	S	38	5	43	0.00000
Legionella waltersii	66969	S	38	6	44	0.00000
Legionella hackeliae	449	S	36	5	41	0.00000
Legionella cherrii	28084	S	34	2	36	0.00000
Legionella antarctica	2708020	S	31	1	32	0.00000
Legionella fallonii	96230	S	30	2	32	0.00000
Legionella adelaidensis	45056	S	23	2	25	0.00000
Fluoribacter dumoffii	463	S	56	12	68	0.00001
Tatlockia micdadei	451	S	40	2	42	0.00000
Aquicella siphonis	254247	S	241	70	311	0.00002
Aquicella lusitana	254246	S	212	66	278	0.00002
Coxiella burnetii	777	S	140	46	186	0.00001
Coxiella endosymbiont of Amblyomma nuttalli	2749996	S	32	6	38	0.00000
Coxiella endosymbiont of Amblyomma sculptum	2487929	S	27	17	44	0.00000
Candidatus Coxiella mudrowiae	2054173	S	39	6	45	0.00000
Candidatus Rickettsiella viridis	676208	S	33	12	45	0.00000
Rickettsiella endosymbiont of Dermanyssus gallinae	2856608	S	30	10	40	0.00000
Pasteurella multocida	747	S	1259	3382	4641	0.00036
Aggregatibacter actinomycetemcomitans	714	S	91	99	190	0.00001
Aggregatibacter aphrophilus	732	S	48	25	73	0.00001
Haemophilus parainfluenzae	729	S	45	18	63	0.00000
Haemophilus influenzae	727	S	42	44	86	0.00001
Haemophilus haemolyticus	726	S	21	12	33	0.00000
Haemophilus parahaemolyticus	735	S	18	3	21	0.00000
Haemophilus pittmaniae	249188	S	16	3	19	0.00000
[Haemophilus] ducreyi	730	S	14	8	22	0.00000
Actinobacillus sp. GY-402	2774188	S	71	38	109	0.00001
Actinobacillus pleuropneumoniae	715	S	30	38	68	0.00001
Actinobacillus equuli	718	S	13	6	19	0.00000
Actinobacillus porcitonsillarum	189834	S	10	4	14	0.00000
Mannheimia varigena	85404	S	42	32	74	0.00001
Mannheimia granulomatis	85402	S	38	7	45	0.00000
Mannheimia haemolytica	75985	S	32	11	43	0.00000
Mannheimia bovis	2770636	S	14	7	21	0.00000
Avibacterium sp. 21-595	2911527	S	13	12	25	0.00000
Avibacterium paragallinarum	728	S	22	7	29	0.00000
Avibacterium volantium	762	S	21	8	29	0.00000
Glaesserella parasuis	738	S	34	15	49	0.00000
Glaesserella sp. 15-184	2030797	S	18	5	23	0.00000
Rodentibacter haemolyticus	2778911	S	24	3	27	0.00000
Rodentibacter heylii	1906744	S	13	1	14	0.00000
Frederiksenia canicola	123824	S	23	5	28	0.00000
Histophilus somni	731	S	22	7	29	0.00000
Gallibacterium anatis	750	S	21	6	27	0.00000
Bibersteinia trehalosi	47735	S	16	2	18	0.00000
Bisgaardia hudsonensis	109472	S	11	1	12	0.00000
Thiomicrorhabdus xiamenensis	2739063	S	109	7	116	0.00001
Thiomicrorhabdus aquaedulcis	2211106	S	46	2	48	0.00000
Thiomicrorhabdus sediminis	2580412	S	46	2	48	0.00000
Thiomicrorhabdus indica	2267253	S	22	1	23	0.00000
Thiomicrorhabdus sp. Am19	2791037	S	16	0	16	0.00000
Methylophaga sp. TMB456	2881052	S	81	28	109	0.00001
Methylophaga frappieri	754477	S	75	39	114	0.00001
Methylophaga nitratireducenticrescens	754476	S	68	10	78	0.00001
Thiomicrospira sp. S5	1803865	S	69	58	127	0.00001
Thiomicrospira aerophila	92245	S	39	3	42	0.00000
Thiomicrospira cyclica	147268	S	29	1	30	0.00000
Thiomicrospira microaerophila	406020	S	28	3	31	0.00000
Hydrogenovibrio thermophilus	265883	S	71	59	130	0.00001
Hydrogenovibrio crunogenus	39765	S	36	2	38	0.00000
Hydrogenovibrio marinus	28885	S	28	1	29	0.00000
Thiosulfatimonas sediminis	2675054	S	76	5	81	0.00001
Piscirickettsia salmonis	1238	S	58	5	63	0.00000
Thiosulfativibrio zosterae	2675053	S	49	2	51	0.00000
Thiothrix litoralis	2891210	S	267	22	289	0.00002
Thiothrix sp. CT3	96472	S	155	57	212	0.00002
Thiothrix subterranea	2735563	S	129	39	168	0.00001
Thiothrix unzii	111769	S	102	59	161	0.00001
Candidatus Thiothrix anitrata	2823902	S	84	55	139	0.00001
Beggiatoa leptomitoformis	288004	S	77	2	79	0.00001
Francisella frigiditurris	1542390	S	24	3	27	0.00000
Francisella tularensis	263	S	22	16	38	0.00000
Francisella philomiragia	28110	S	14	27	41	0.00000
Allofrancisella guangzhouensis	594679	S	18	5	23	0.00000
Salinisphaera sp. LB1	2183911	S	1916	89	2005	0.00015
endosymbiont of unidentified scaly snail isolate Monju	1248727	S	1626	150	1776	0.00014
Isorropodon fossajaponicum symbiont	883811	S	18	4	22	0.00000
Abyssogena phaseoliformis symbiont	596095	S	10	3	13	0.00000
Cardiobacterium hominis	2718	S	566	131	697	0.00005
Cardiobacterium sp. Marseille-Q4385	2866573	S	371	77	448	0.00003
Suttonella sp. R2A3	2908648	S	66	4	70	0.00001
Dichelobacter nodosus	870	S	43	13	56	0.00000
Kangiella koreensis	261964	S	55	9	64	0.00000
Kangiella profundi	1561924	S	53	14	67	0.00001
Kangiella sediminilitoris	1144748	S	49	4	53	0.00000
Kangiella geojedonensis	914150	S	39	3	42	0.00000
Gilliamella sp. ESL0405	2704653	S	16	2	18	0.00000
Gilliamella sp. ESL0443	2704655	S	14	3	17	0.00000
Gilliamella sp. ESL0441	2704654	S	12	11	23	0.00000
Gilliamella apicola	1196095	S	15	3	18	0.00000
Frischella perrara	1267021	S	11	3	14	0.00000
Zophobihabitans entericus	1635327	S	11	1	12	0.00000
Archangium violaceum	83451	S	29177	4455	33632	0.00259
Archangium gephyra	48	S	13555	2425	15980	0.00123
Cystobacter fuscus	43	S	21853	4256	26109	0.00201
Stigmatella aurantiaca	41	S	7117	488	7605	0.00059
Melittangium boletus	83453	S	5969	1080	7049	0.00054
Myxococcus xanthus	34	S	8173	55407	63580	0.00490
Myxococcus hansupus	1297742	S	4802	358	5160	0.00040
Myxococcus stipitatus	83455	S	4307	387	4694	0.00036
Myxococcus sp. SCHIC003	2813577	S	3609	330	3939	0.00030
Corallococcus coralloides	184914	S	7853	3088	10941	0.00084
Corallococcus macrosporus	35	S	5516	848	6364	0.00049
Corallococcus sp. EGB	1521117	S	4795	1789	6584	0.00051
Pyxidicoccus sp. SCPEA002	2813578	S	13443	598	14041	0.00108
Anaeromyxobacter sp. Red232	2918170	S	15021	1807	16828	0.00130
Anaeromyxobacter sp. Fw109-5	404589	S	12512	1833	14345	0.00111
Anaeromyxobacter sp. Red630	2918171	S	11211	1672	12883	0.00099
Anaeromyxobacter sp. K	447217	S	2728	6041	8769	0.00068
Anaeromyxobacter dehalogenans	161493	S	8914	6967	15881	0.00122
Vulgatibacter incomptus	1391653	S	6802	593	7395	0.00057
Sorangium cellulosum	56	S	102001	13268	115269	0.00888
Polyangium aurulentum	2567896	S	23096	2175	25271	0.00195
Chondromyces crocatus	52	S	11079	516	11595	0.00089
Pajaroellobacter abortibovis	1882918	S	183	6	189	0.00001
Sandaracinus amylolyticus	927083	S	34912	2070	36982	0.00285
Labilithrix luteola	1391654	S	12039	563	12602	0.00097
Haliangium ochraceum	80816	S	15750	927	16677	0.00128
Geomonas sp. RF6	2897342	S	2855	396	3251	0.00025
Geomonas paludis	2740185	S	2114	1151	3265	0.00025
Geomonas nitrogeniifigens	2847991	S	1969	1099	3068	0.00024
Geomonas subterranea	2847989	S	1689	850	2539	0.00020
Geomonas oryzisoli	2847992	S	1589	942	2531	0.00020
Geobacter sp. FeAm09	2597769	S	1987	270	2257	0.00017
Geobacter sp. SVR	2495594	S	1386	213	1599	0.00012
Geobacter sp. DSM 9736	1277350	S	804	63	867	0.00007
Geobacter sulfurreducens	35554	S	2255	546	2801	0.00022
Geobacter pickeringii	345632	S	2069	563	2632	0.00020
Geobacter metallireducens	28232	S	1343	332	1675	0.00013
Geobacter benzoatilyticus	2815309	S	855	201	1056	0.00008
Citrifermentans bremense	60035	S	1639	706	2345	0.00018
Citrifermentans bemidjiense	225194	S	1616	640	2256	0.00017
Geotalea uraniireducens	351604	S	1133	92	1225	0.00009
Geotalea daltonii	1203471	S	549	47	596	0.00005
Geoalkalibacter subterraneus	483547	S	985	947	1932	0.00015
Trichlorobacter lovleyi	313985	S	545	79	624	0.00005
Desulfuromonas versatilis	2802975	S	3553	699	4252	0.00033
Desulfuromonas sp. DDH964	1823759	S	2332	474	2806	0.00022
Desulfuromonas sp. AOP6	1566351	S	705	87	792	0.00006
Desulfuromonas soudanensis	1603606	S	2213	277	2490	0.00019
Pelobacter propionicus	29543	S	1360	516	1876	0.00014
Syntrophotalea acetylenica	29542	S	746	153	899	0.00007
Syntrophotalea carbinolica	19	S	516	44	560	0.00004
Syntrophotalea acetylenivorans	1842532	S	450	69	519	0.00004
Pseudodesulfovibrio mercurii	641491	S	1516	391	1907	0.00015
Pseudodesulfovibrio indicus	1716143	S	1481	339	1820	0.00014
Pseudodesulfovibrio aespoeensis	182210	S	1029	796	1825	0.00014
Pseudodesulfovibrio cashew	2678688	S	878	188	1066	0.00008
Pseudodesulfovibrio sp. SF6	2810563	S	396	44	440	0.00003
Pseudodesulfovibrio sp. zrk46	2725288	S	344	66	410	0.00003
Pseudodesulfovibrio tunisiensis	463192	S	707	80	787	0.00006
Pseudodesulfovibrio profundus	57320	S	266	289	555	0.00004
Pseudodesulfovibrio piezophilus	879567	S	113	17	130	0.00001
Desulfovibrio sp. IOR2	2583823	S	1056	225	1281	0.00010
Desulfovibrio sp. 86	2666132	S	334	104	438	0.00003
Desulfovibrio sp. G11	631220	S	258	227	485	0.00004
Desulfovibrio vulgaris	881	S	1253	41	1294	0.00010
Desulfovibrio sulfodismutans	63561	S	1081	302	1383	0.00011
Desulfovibrio desulfuricans	876	S	907	242	1149	0.00009
Desulfovibrio piger	901	S	850	191	1041	0.00008
Desulfovibrio fairfieldensis	44742	S	699	70	769	0.00006
Desulfovibrio ferrophilus	241368	S	419	38	457	0.00004
Candidatus Desulfovibrio trichonymphae	1725232	S	151	14	165	0.00001
Solidesulfovibrio carbinoliphilus	345370	S	1938	270	2208	0.00017
Solidesulfovibrio magneticus	184917	S	837	536	1373	0.00011
Solidesulfovibrio carbinolicus	296842	S	751	645	1396	0.00011
Oceanidesulfovibrio marinus	370038	S	2268	158	2426	0.00019
Desulfocurvibacter africanus	873	S	1603	135	1738	0.00013
Desulfolutivibrio sulfoxidireducens	2773299	S	1428	432	1860	0.00014
Megalodesulfovibrio gigas	879	S	1095	60	1155	0.00009
Oleidesulfovibrio alaskensis	58180	S	403	608	1011	0.00008
Maridesulfovibrio salexigens	880	S	125	14	139	0.00001
Maridesulfovibrio hydrothermalis	191026	S	87	10	97	0.00001
Paradesulfovibrio bizertensis	376490	S	180	20	200	0.00002
Lawsonia intracellularis	29546	S	54	0	54	0.00000
Desulfomicrobium baculatum	899	S	1042	82	1124	0.00009
Desulfomicrobium orale	132132	S	588	161	749	0.00006
Desulfohalobium retbaense	45663	S	474	26	500	0.00004
Desulfosarcina ovata	83564	S	1229	72	1301	0.00010
Desulfosarcina alkanivorans	571177	S	1188	556	1744	0.00013
Desulfosarcina widdelii	947919	S	1052	132	1184	0.00009
Desulfococcus multivorans	897	S	954	190	1144	0.00009
Desulfatibacillum aliphaticivorans	218208	S	722	26	748	0.00006
Desulfoluna sp. ASN36	2810562	S	612	34	646	0.00005
Desulfonema magnum	45655	S	314	7	321	0.00002
Desulfonema limicola	45656	S	73	5	78	0.00001
Desulfobacter postgatei	2293	S	164	33	197	0.00002
Desulfobacter hydrogenophilus	2291	S	118	25	143	0.00001
Desulforapulum autotrophicum	2296	S	214	26	240	0.00002
Desulfobacula toluolica	28223	S	90	8	98	0.00001
Desulfobulbus propionicus	894	S	999	66	1065	0.00008
Desulfobulbus oralis	1986146	S	751	180	931	0.00007
Desulfobulbus oligotrophicus	1909699	S	231	216	447	0.00003
Desulfurivibrio alkaliphilus	427923	S	868	51	919	0.00007
Desulfomarina profundi	2772557	S	85	9	94	0.00001
Desulfosudis oleivorans	181663	S	809	56	865	0.00007
Desulfosediminicola ganghwensis	2569540	S	225	27	252	0.00002
Desulfosediminicola flagellatus	2569541	S	100	10	110	0.00001
Desulfotalea psychrophila	84980	S	81	16	97	0.00001
Desulfocapsa sulfexigens	65555	S	78	5	83	0.00001
Persicimonas caeni	2292766	S	5374	215	5589	0.00043
Bradymonas sediminis	1548548	S	1767	163	1930	0.00015
Bradymonadales bacterium V1718	2600177	S	666	37	703	0.00005
Syntrophobacter fumaroxidans	119484	S	1473	666	2139	0.00016
Desulfoglaeba alkanexedens	361111	S	1239	71	1310	0.00010
Desulfarculus baarsii	453230	S	2276	1449	3725	0.00029
Desulfobacca acetoxidans	60893	S	501	14	515	0.00004
Desulfomonile tiedjei	2358	S	483	5	488	0.00004
Syntrophus aciditrophicus	316277	S	386	28	414	0.00003
Dissulfurimicrobium hydrothermale	1750598	S	235	16	251	0.00002
Candidatus Desulfofervidus auxilii	1621989	S	139	3	142	0.00001
Hippea maritima	84405	S	56	3	59	0.00000
Campylobacter showae	204	S	145	13	158	0.00001
Campylobacter gracilis	824	S	127	9	136	0.00001
Campylobacter concisus	199	S	120	17	137	0.00001
Campylobacter curvus	200	S	112	12	124	0.00001
Campylobacter sp. 19-13652	2840180	S	19	2	21	0.00000
Campylobacter sp. RM6914	1032243	S	14	1	15	0.00000
Campylobacter sp. CCUG 57310	2517362	S	11	5	16	0.00000
Campylobacter sp. RM16192	1660080	S	10	5	15	0.00000
Campylobacter rectus	203	S	62	9	71	0.00001
Campylobacter geochelonis	1780362	S	39	3	42	0.00000
Campylobacter jejuni	197	S	21	182	203	0.00002
Campylobacter coli	195	S	20	18	38	0.00000
Campylobacter fetus	196	S	17	4	21	0.00000
Candidatus Campylobacter infans	2561898	S	17	2	19	0.00000
Campylobacter hominis	76517	S	13	5	18	0.00000
Campylobacter mucosalis	202	S	12	0	12	0.00000
Campylobacter blaseri	2042961	S	12	1	13	0.00000
Campylobacter lanienae	75658	S	11	3	14	0.00000
Sulfurimonas sp. HSL-3221	2894755	S	520	49	569	0.00004
Sulfurimonas sp. SWIR-19	2878390	S	21	37	58	0.00000
Sulfurimonas sp. B2	2590551	S	20	2	22	0.00000
Sulfurimonas hydrogeniphila	2509341	S	21	11	32	0.00000
Sulfurimonas paralvinellae	317658	S	16	2	18	0.00000
Sulfurimonas lithotrophica	2590022	S	15	2	17	0.00000
Sulfurimonas gotlandica	1176482	S	10	1	11	0.00000
Sulfuricurvum kujiense	148813	S	72	7	79	0.00001
Helicobacter pylori	210	S	190	86	276	0.00002
Helicobacter sp. NHP19-0012	2849642	S	33	17	50	0.00000
Helicobacter sp. NHP19-0003	2849641	S	26	7	33	0.00000
Helicobacter heilmannii	35817	S	35	21	56	0.00000
Helicobacter bizzozeronii	56877	S	29	4	33	0.00000
Helicobacter cinaedi	213	S	24	10	34	0.00000
Helicobacter felis	214	S	23	4	27	0.00000
Helicobacter mustelae	217	S	21	5	26	0.00000
Helicobacter himalayensis	1591088	S	17	2	19	0.00000
Helicobacter suis	104628	S	16	8	24	0.00000
Helicobacter canis	29419	S	13	5	18	0.00000
Helicobacter enhydrae	222136	S	11	2	13	0.00000
Helicobacter cetorum	138563	S	11	1	12	0.00000
Helicobacter typhlonius	76936	S	10	12	22	0.00000
Wolinella succinogenes	844	S	61	21	82	0.00001
Nitratifractor salsuginis	269261	S	313	27	340	0.00003
Sulfurovum sp. HSL1-3	2893889	S	38	13	51	0.00000
Sulfurovum sp. NBC37-1	387093	S	29	22	51	0.00000
Sulfurovum sp. XGS-02	2925411	S	19	2	21	0.00000
Sulfurovum lithotrophicum	206403	S	37	32	69	0.00001
Sulfurovum indicum	2779528	S	34	4	38	0.00000
Hydrogenimonas urashimensis	2740515	S	333	40	373	0.00003
Sulfurospirillum cavolei	366522	S	69	5	74	0.00001
Sulfurospirillum sp. UCH001	1581011	S	14	15	29	0.00000
Sulfurospirillum halorespirans	194424	S	25	3	28	0.00000
Sulfurospirillum multivorans	66821	S	13	66	79	0.00001
Aliarcobacter cryaerophilus	28198	S	12	12	24	0.00000
Aliarcobacter butzleri	28197	S	10	23	33	0.00000
Halarcobacter bivalviorum	663364	S	12	4	16	0.00000
Nitratiruptor sp. YY09-18	2724901	S	36	42	78	0.00001
Nitratiruptor sp. SB155-2	387092	S	17	31	48	0.00000
Nitrosophilus alvini	2714855	S	40	14	54	0.00000
Nitrosophilus labii	2706014	S	30	13	43	0.00000
Caminibacter mediatlanticus	291048	S	30	23	53	0.00000
Caminibacter pacificus	1424653	S	25	16	41	0.00000
Nautilia sp. PV-1	2579250	S	30	11	41	0.00000
Nautilia profundicola	244787	S	25	10	35	0.00000
Acidithiobacillus caldus	33059	S	658	114	772	0.00006
Acidithiobacillus ferrivorans	160808	S	407	85	492	0.00004
Acidithiobacillus ferrooxidans	920	S	286	280	566	0.00004
Acidithiobacillus ferriphilus	1689834	S	155	35	190	0.00001
Acidithiobacillus thiooxidans	930	S	149	9	158	0.00001
Acidithiobacillus ferridurans	1232575	S	20	189	209	0.00002
Acidithiobacillus sp. 'AMD consortium'	2614801	S	13	193	206	0.00002
Bdellovibrio bacteriovorus	959	S	455	65	520	0.00004
Bdellovibrio sp. NC01	2220073	S	83	9	92	0.00001
Bdellovibrio sp. LBG001	2835041	S	63	7	70	0.00001
Bdellovibrio sp. ZAP7	2231053	S	54	24	78	0.00001
Bdellovibrio sp. KM01	2748865	S	27	12	39	0.00000
Pseudobdellovibrio exovorus	453816	S	60	3	63	0.00000
Bacteriovorax stolpii	960	S	61	19	80	0.00001
Halobacteriovorax sp. BALOs_7	2109558	S	23	8	31	0.00000
Halobacteriovorax marinus	97084	S	21	13	34	0.00000
Fluviispira sanaruensis	2493639	S	29	5	34	0.00000
Silvanigrella aquatica	1915309	S	28	4	32	0.00000
Hydrogenophilus thermoluteolus	297	S	701	160	861	0.00007
Mariprofundus ferrinatatus	1921087	S	263	21	284	0.00002
Mariprofundus aestuarium	1921086	S	190	18	208	0.00002
Streptomyces sp. AMCC400023	2056258	S	10446	4219	14665	0.00113
Streptomyces sp. P3	2135430	S	9645	2677	12322	0.00095
Streptomyces sp. SN-593	659352	S	9195	2618	11813	0.00091
Streptomyces sp. So13.3	2136173	S	8912	1984	10896	0.00084
Streptomyces sp. SCSIO 64649	2878388	S	8782	1917	10699	0.00082
Streptomyces sp. MG28	2865673	S	8564	3118	11682	0.00090
Streptomyces sp. NHF165	2175864	S	8294	1707	10001	0.00077
Streptomyces sp. HM190	2695266	S	8163	2875	11038	0.00085
Streptomyces sp. Z423-1	2730915	S	7867	2506	10373	0.00080
Streptomyces sp. ZYC-3	2797636	S	7670	1676	9346	0.00072
Streptomyces sp. CdTB01	1725411	S	7605	2410	10015	0.00077
Streptomyces sp. WAC 01438	2203204	S	7094	2665	9759	0.00075
Streptomyces sp. MA3_2.13	2867410	S	6394	992	7386	0.00057
Streptomyces sp. CB01881	2078691	S	6379	1412	7791	0.00060
Streptomyces sp. SCUT-3	2684469	S	6324	2978	9302	0.00072
Streptomyces sp. ST1015	1848900	S	6180	1462	7642	0.00059
Streptomyces sp. GQFP	2907545	S	6166	1182	7348	0.00057
Streptomyces sp. 3214.6	1882757	S	5965	1912	7877	0.00061
Streptomyces sp. BH-MK-02	2880933	S	5679	1403	7082	0.00055
Streptomyces sp. NA02950	2742137	S	5609	1286	6895	0.00053
Streptomyces sp. 891-h	2720714	S	5166	1108	6274	0.00048
Streptomyces sp. LRE541	2931983	S	5162	1301	6463	0.00050
Streptomyces sp. 3025	2923272	S	5114	1069	6183	0.00048
Streptomyces sp. CMB-StM0423	2059884	S	5037	2155	7192	0.00055
Streptomyces sp. A2-16	2781734	S	4976	1658	6634	0.00051
Streptomyces sp. Go-475	2072505	S	4915	2375	7290	0.00056
Streptomyces sp. SAT1	1849967	S	4721	1974	6695	0.00052
Streptomyces sp. MST-110588	2833628	S	4648	1322	5970	0.00046
Streptomyces sp. MG62	2838015	S	4561	1815	6376	0.00049
Streptomyces sp. C8S0	2585716	S	4500	1492	5992	0.00046
Streptomyces sp. BJ20	2930049	S	4480	2003	6483	0.00050
Streptomyces sp. JB150	2714844	S	4435	1592	6027	0.00046
Streptomyces sp. DSM 40868	2721173	S	4380	1734	6114	0.00047
Streptomyces sp. YIM 121038	2136401	S	4355	1384	5739	0.00044
Streptomyces sp. GMY02	1333528	S	4238	876	5114	0.00039
Streptomyces sp. HP-A2021	2927875	S	4236	2370	6606	0.00051
Streptomyces sp. RPA4-2	2721244	S	4202	1309	5511	0.00042
Streptomyces sp. GS7	2692234	S	4138	1243	5381	0.00041
Streptomyces sp. MBT27	1488356	S	4112	1384	5496	0.00042
Streptomyces sp. NEAU-sy36	2751189	S	4073	1665	5738	0.00044
Streptomyces sp. NA04227	2742136	S	4017	1087	5104	0.00039
Streptomyces sp. LBUM 1480	2609808	S	3972	34780	38752	0.00299
Streptomyces sp. W1SF4	2305220	S	3863	1525	5388	0.00042
Streptomyces sp. Rer75	2750011	S	3856	1612	5468	0.00042
Streptomyces sp. RTd22	1841249	S	3828	1464	5292	0.00041
Streptomyces sp. QHH-9511	2684468	S	3807	1180	4987	0.00038
Streptomyces sp. BHT-5-2	2866715	S	3704	1262	4966	0.00038
Streptomyces sp. Go 40/10	2825844	S	3645	1690	5335	0.00041
Streptomyces sp. HSG2	2797167	S	3526	917	4443	0.00034
Streptomyces sp. SirexAA-E	862751	S	3507	1137	4644	0.00036
Streptomyces sp. 135	2838850	S	3211	1099	4310	0.00033
Streptomyces sp. SM18	1736046	S	3206	970	4176	0.00032
Streptomyces sp. S1D4-11	2721246	S	3160	2008	5168	0.00040
Streptomyces sp. SYP-A7193	2662065	S	3149	1798	4947	0.00038
Streptomyces sp. Tu 2975	2676871	S	3061	1060	4121	0.00032
Streptomyces sp. fd1-xmd	1812480	S	2949	1305	4254	0.00033
Streptomyces sp. WAC 01529	2203205	S	2948	1100	4048	0.00031
Streptomyces sp. WAC 06738	2203210	S	2827	2238	5065	0.00039
Streptomyces sp. CNQ-509	444103	S	2626	2048	4674	0.00036
Streptomyces sp. S4.7	2705439	S	2606	912	3518	0.00027
Streptomyces sp. jing01	2726118	S	2594	1481	4075	0.00031
Streptomyces sp. TN58	234612	S	2489	1142	3631	0.00028
Streptomyces sp. INR7	2607753	S	2459	1215	3674	0.00028
Streptomyces sp. CB09001	2083284	S	2342	1490	3832	0.00030
Streptomyces sp. XC 2026	2782004	S	2210	1783	3993	0.00031
Streptomyces sp. SUK 48	2582831	S	1988	1204	3192	0.00025
Streptomyces sp. CCM_MD2014	1561022	S	1974	1575	3549	0.00027
Streptomyces sp. HF10	2692233	S	1962	1322	3284	0.00025
Streptomyces sp. WY228	2855836	S	1903	979	2882	0.00022
Streptomyces sp. ADI95-16	1522758	S	1838	1373	3211	0.00025
Streptomyces sp. YPW6	2840373	S	1835	926	2761	0.00021
Streptomyces sp. 769	1262452	S	1798	1255	3053	0.00024
Streptomyces sp. Mg1	465541	S	1762	1403	3165	0.00024
Streptomyces sp. AgN23	1188315	S	1710	1374	3084	0.00024
Streptomyces sp. RPA4-5	2721245	S	1600	970	2570	0.00020
Streptomyces sp. RLB1-33	2721243	S	1497	3759	5256	0.00040
Streptomyces sp. 2323.1	1938841	S	1472	858	2330	0.00018
Streptomyces sp. EAS-AB2608	2779671	S	1468	1970	3438	0.00026
Streptomyces sp. SGAir0924	2109593	S	1376	5619	6995	0.00054
Streptomyces sp. S8	1837283	S	1234	985	2219	0.00017
Streptomyces sp. NEAU-S7GS2	2202000	S	1230	908	2138	0.00016
Streptomyces sp. S063	2005885	S	1211	786	1997	0.00015
Streptomyces sp. ID38640	1265399	S	1170	718	1888	0.00015
Streptomyces sp. PBH53	1577075	S	1151	1392	2543	0.00020
Streptomyces sp. A144	2871487	S	1107	4156	5263	0.00041
Streptomyces sp. NA02536	2742133	S	1103	2650	3753	0.00029
Streptomyces sp. 3211	1964449	S	1103	1174	2277	0.00018
Streptomyces sp. WA6-1-16	2879427	S	1038	951	1989	0.00015
Streptomyces sp. HNA39	2850561	S	1021	1057	2078	0.00016
Streptomyces sp. Sge12	1972846	S	1020	1336	2356	0.00018
Streptomyces sp. SS52	2563602	S	993	3918	4911	0.00038
Streptomyces sp. 11-1-2	1851167	S	878	1439	2317	0.00018
Streptomyces sp. MOE7	1961713	S	843	934	1777	0.00014
Streptomyces sp. HU2014	2939414	S	818	2521	3339	0.00026
Streptomyces sp. CB00271	2750025	S	786	956	1742	0.00013
Streptomyces sp. Tue 6075	1661694	S	780	804	1584	0.00012
Streptomyces sp. endophyte_N2	2153485	S	727	1902	2629	0.00020
Streptomyces sp. CFMR 7	1649184	S	700	1073	1773	0.00014
Streptomyces sp. CB09030	2913412	S	692	2078	2770	0.00021
Streptomyces sp. Tu6071	355249	S	680	1709	2389	0.00018
Streptomyces sp. M2	646637	S	676	2947	3623	0.00028
Streptomyces sp. M56	1495638	S	658	1526	2184	0.00017
Streptomyces sp. WAC00303	2933779	S	606	782	1388	0.00011
Streptomyces sp. CRSS-Y-16	2906474	S	571	2635	3206	0.00025
Streptomyces sp. CB04723	2748873	S	533	865	1398	0.00011
Streptomyces sp. CLI2509	1984801	S	526	1480	2006	0.00015
Streptomyces sp. LBUM 1482	2609809	S	498	11096	11594	0.00089
Streptomyces sp. V17-9	2831149	S	490	1913	2403	0.00019
Streptomyces sp. GF20	2692235	S	451	2293	2744	0.00021
Streptomyces sp. VN1	1821625	S	445	1684	2129	0.00016
Streptomyces sp. PAMC 26508	1265601	S	436	1258	1694	0.00013
Streptomyces sp. BSE6.1	2605730	S	428	1541	1969	0.00015
Streptomyces sp. LBUM 1475	2609807	S	424	11079	11503	0.00089
Streptomyces sp. S1D4-20	2594462	S	417	9112	9529	0.00073
Streptomyces sp. NA03103	2742134	S	408	2153	2561	0.00020
Streptomyces sp. WAC00288	2094021	S	378	1417	1795	0.00014
Streptomyces sp. S1A1-7	2594459	S	332	2521	2853	0.00022
Streptomyces sp. S501	2420135	S	325	1010	1335	0.00010
Streptomyces sp. WA1-19	2884220	S	311	1511	1822	0.00014
Streptomyces sp. RLB3-6	2594457	S	292	7354	7646	0.00059
Streptomyces sp. A1-5	2738410	S	291	1201	1492	0.00011
Streptomyces sp. KPB2	2305221	S	290	1934	2224	0.00017
Streptomyces sp. 2114.2	1881022	S	283	1569	1852	0.00014
Streptomyces sp. RLB3-17	2594455	S	279	3516	3795	0.00029
Streptomyces sp. 604F	1476754	S	272	2077	2349	0.00018
Streptomyces sp. R527F	1664033	S	246	1242	1488	0.00011
Streptomyces sp. NBU3104	2911367	S	229	1359	1588	0.00012
Streptomyces sp. CA-256286	2801033	S	200	1097	1297	0.00010
Streptomyces sp. S1D4-14	2594461	S	186	9762	9948	0.00077
Streptomyces sp. CC0208	2306165	S	163	3857	4020	0.00031
Streptomyces sp. S1D4-23	2594463	S	147	6321	6468	0.00050
Streptomyces sp. FR-008	206662	S	138	1015	1153	0.00009
Streptomyces sp. GBA 94-10	1218177	S	134	1438	1572	0.00012
Streptomyces sp. PVA_94-07	1225337	S	130	1613	1743	0.00013
Streptomyces sp. OUCMDZ-3434	1535304	S	125	1111	1236	0.00010
Streptomyces sp. PLM4	2929798	S	115	856	971	0.00007
Streptomyces sp. A10(2020)	2782013	S	112	1179	1291	0.00010
Streptomyces sp. RLB1-9	2594454	S	104	4601	4705	0.00036
Streptomyces sp. SM17	565560	S	25	927	952	0.00007
Streptomyces sp. ICC4	2099584	S	19	1003	1022	0.00008
Streptomyces sp. ICC1	2099583	S	15	685	700	0.00005
Streptomyces capitiformicae	2014920	S	116039	17703	133742	0.01030
Streptomyces venezuelae	54571	S	21063	8331	29394	0.00226
Streptomyces cadmiisoli	2184053	S	5299	1385	6684	0.00051
Streptomyces aurantiacus	47760	S	4326	1077	5403	0.00042
Streptomyces qaidamensis	1783515	S	4051	1663	5714	0.00044
Streptomyces alboniger	132473	S	2425	896	3321	0.00026
Streptomyces koyangensis	188770	S	1739	1657	3396	0.00026
Streptomyces hygroscopicus	1912	S	7396	11020	18416	0.00142
Streptomyces rapamycinicus	1226757	S	4248	942	5190	0.00040
Streptomyces violaceusniger	68280	S	2053	1234	3287	0.00025
Streptomyces yatensis	155177	S	1566	1038	2604	0.00020
Streptomyces malaysiensis	92644	S	476	1218	1694	0.00013
Streptomyces chartreusis	1969	S	11508	4929	16437	0.00127
Streptomyces nodosus	40318	S	10797	2924	13721	0.00106
Streptomyces phaeolivaceus	2653200	S	9833	2696	12529	0.00097
Streptomyces cyaneochromogenes	2496836	S	9431	2790	12221	0.00094
Streptomyces ferrugineus	1413221	S	9269	3001	12270	0.00095
Streptomyces albus	1888	S	8659	4231	12890	0.00099
Streptomyces griseus	1911	S	3305	2792	6097	0.00047
Streptomyces sp. M54	2759525	S	327	735	1062	0.00008
Streptomyces anulatus	1892	S	2433	2273	4706	0.00036
Streptomyces microflavus	1919	S	1260	4793	6053	0.00047
Streptomyces globisporus	1908	S	949	5982	6931	0.00053
Streptomyces bingchenggensis	379067	S	8444	1716	10160	0.00078
Streptomyces bathyalis	2710756	S	7586	1395	8981	0.00069
Streptomyces formicae	1616117	S	7575	2432	10007	0.00077
Streptomyces lydicus	47763	S	7380	4653	12033	0.00093
Streptomyces armeniacus	83291	S	7149	1106	8255	0.00064
Streptomyces avermitilis	33903	S	6983	2064	9047	0.00070
Streptomyces tsukubensis	83656	S	6904	1600	8504	0.00066
Streptomyces griseorubiginosus	67304	S	6900	2294	9194	0.00071
Streptomyces cattleya	29303	S	6795	2147	8942	0.00069
Streptomyces deccanensis	424188	S	6642	2634	9276	0.00071
Streptomyces buecherae	2763006	S	6585	1812	8397	0.00065
Streptomyces lincolnensis	1915	S	6380	1878	8258	0.00064
Streptomyces dengpaensis	2049881	S	6096	1757	7853	0.00060
Streptomyces aquilus	2548456	S	5955	1791	7746	0.00060
Streptomyces niveus	193462	S	5753	2642	8395	0.00065
Streptomyces davaonensis	348043	S	5617	1610	7227	0.00056
Streptomyces spectabilis	68270	S	5557	1826	7383	0.00057
Streptomyces seoulensis	73044	S	5548	2220	7768	0.00060
Streptomyces roseirectus	2768066	S	5345	1358	6703	0.00052
Streptomyces lunaelactis	1535768	S	5164	1133	6297	0.00049
Streptomyces xinghaiensis	1038928	S	4999	1640	6639	0.00051
Streptomyces griseochromogenes	68214	S	4986	1409	6395	0.00049
Streptomyces asoensis	249586	S	4977	1508	6485	0.00050
Streptomyces rimosus	1927	S	4945	10181	15126	0.00117
Streptomyces calvus	67282	S	4878	1894	6772	0.00052
Streptomyces viridosporus	67581	S	4843	1981	6824	0.00053
Streptomyces xanthii	2768069	S	4758	1520	6278	0.00048
Streptomyces antibioticus	1890	S	4700	1725	6425	0.00049
Streptomyces fodineus	1904616	S	4611	1631	6242	0.00048
Streptomyces globosus	68209	S	4610	1788	6398	0.00049
Streptomyces actuosus	1885	S	4547	1983	6530	0.00050
Streptomyces griseoviridis	45398	S	4538	1535	6073	0.00047
Streptomyces durmitorensis	319947	S	4471	1010	5481	0.00042
Streptomyces nigra	1827580	S	4374	1768	6142	0.00047
Streptomyces genisteinicus	2768068	S	4194	1401	5595	0.00043
Streptomyces albulus	68570	S	4178	1306	5484	0.00042
Streptomyces galilaeus	33899	S	4163	1447	5610	0.00043
Streptomyces olivoreticuli	68246	S	4156	1249	5405	0.00042
Streptomyces roseochromogenus	285450	S	4104	1301	5405	0.00042
Streptomyces vietnamensis	362257	S	4101	1404	5505	0.00042
Streptomyces rectiverticillatus	173860	S	4087	1398	5485	0.00042
Streptomyces liangshanensis	2717324	S	4070	1101	5171	0.00040
Streptomyces ambofaciens	1889	S	4064	2514	6578	0.00051
Streptomyces chromofuscus	42881	S	4052	1595	5647	0.00044
Streptomyces clavuligerus	1901	S	4033	1054	5087	0.00039
Streptomyces paludis	2282738	S	4032	940	4972	0.00038
Streptomyces griseocarneus	51201	S	4020	1501	5521	0.00043
Streptomyces atratus	1893	S	4012	854	4866	0.00037
Streptomyces luteoverticillatus	66425	S	4005	1420	5425	0.00042
Streptomyces broussonetiae	2686304	S	4001	1229	5230	0.00040
Streptomyces aureoverticillatus	66871	S	3991	1107	5098	0.00039
Streptomyces prasinus	67345	S	3973	1341	5314	0.00041
Streptomyces harbinensis	1176198	S	3954	1158	5112	0.00039
Streptomyces alboflavus	67267	S	3921	1122	5043	0.00039
Streptomyces exfoliatus	1905	S	3873	1372	5245	0.00040
Streptomyces collinus	42684	S	3795	2586	6381	0.00049
Streptomyces incarnatus	665007	S	3706	1033	4739	0.00037
Streptomyces ficellus	1977088	S	3690	1395	5085	0.00039
Streptomyces glaucescens	1907	S	3664	1624	5288	0.00041
Streptomyces peucetius	1950	S	3582	1028	4610	0.00036
Streptomyces pactum	68249	S	3562	1447	5009	0.00039
Streptomyces hawaiiensis	67305	S	3508	1484	4992	0.00038
Streptomyces parvulus	146923	S	3482	1561	5043	0.00039
Streptomyces tendae	1932	S	3479	1465	4944	0.00038
Streptomyces pluripotens	1355015	S	3457	839	4296	0.00033
Streptomyces pristinaespiralis	38300	S	3428	1352	4780	0.00037
Streptomyces dangxiongensis	1442032	S	3342	1175	4517	0.00035
Streptomyces lavendulae	1914	S	3337	1196	4533	0.00035
Streptomyces spongiicola	1690221	S	3318	1451	4769	0.00037
Streptomyces subrutilus	36818	S	3257	1257	4514	0.00035
Streptomyces coeruleorubidus	116188	S	3241	1485	4726	0.00036
Streptomyces hundungensis	1077946	S	3184	1051	4235	0.00033
Streptomyces katrae	68223	S	3138	1221	4359	0.00034
Streptomyces vinaceus	1960	S	3093	1143	4236	0.00033
Streptomyces gobiensis	2875706	S	3087	641	3728	0.00029
Streptomyces fagopyri	2662397	S	3085	1048	4133	0.00032
Streptomyces gilvosporeus	553510	S	3059	1020	4079	0.00031
Streptomyces tirandamycinicus	2174846	S	3043	1041	4084	0.00031
Streptomyces inhibens	2293571	S	2980	910	3890	0.00030
Streptomyces finlayi	67296	S	2949	706	3655	0.00028
Streptomyces cyanogenus	80860	S	2918	1280	4198	0.00032
Streptomyces nitrosporeus	28894	S	2913	859	3772	0.00029
Streptomyces tuirus	68278	S	2866	1433	4299	0.00033
Streptomyces kanamyceticus	1967	S	2841	937	3778	0.00029
Streptomyces mobaraensis	35621	S	2805	94464	97269	0.00749
Streptomyces huasconensis	1854574	S	2715	1056	3771	0.00029
Streptomyces qinzhouensis	2599401	S	2712	676	3388	0.00026
Streptomyces angustmyceticus	285578	S	2696	1101	3797	0.00029
Streptomyces pratensis	1169025	S	2617	654	3271	0.00025
Streptomyces gardneri	66892	S	2603	1024	3627	0.00028
Streptomyces rutgersensis	53451	S	2520	1258	3778	0.00029
Streptomyces nojiriensis	66374	S	2378	997	3375	0.00026
Streptomyces leeuwenhoekii	1437453	S	2014	1324	3338	0.00026
Streptomyces cyaneogriseus	68192	S	1809	1328	3137	0.00024
Streptomyces decoyicus	249567	S	1359	706	2065	0.00016
Streptomyces antimycoticus	68175	S	1252	1127	2379	0.00018
Streptomyces auratus	114687	S	1246	766	2012	0.00016
Streptomyces lydicamycinicus	1546107	S	1236	686	1922	0.00015
Streptomyces platensis	58346	S	1086	739	1825	0.00014
Streptomyces xiamenensis	408015	S	1047	810	1857	0.00014
Streptomyces coelicolor	1902	S	356	3169	3525	0.00027
Streptomyces albidoflavus	1886	S	349	4694	5043	0.00039
Streptomyces sampsonii	42239	S	189	1352	1541	0.00012
Streptomyces mirabilis	68239	S	847	4338	5185	0.00040
Streptomyces olivaceus	47716	S	818	2645	3463	0.00027
Streptomyces filamentosus	67294	S	815	918	1733	0.00013
Streptomyces alfalfae	1642299	S	800	3928	4728	0.00036
Streptomyces fungicidicus	68203	S	773	2015	2788	0.00021
Streptomyces cavourensis	67258	S	654	1066	1720	0.00013
Streptomyces californicus	67351	S	626	1795	2421	0.00019
Streptomyces murinus	33900	S	588	1481	2069	0.00016
Streptomyces fradiae	1906	S	587	8155	8742	0.00067
Streptomyces griseofuscus	146922	S	492	1925	2417	0.00019
Streptomyces scabiei	1930	S	431	3248	3679	0.00028
Streptomyces noursei	1971	S	400	1364	1764	0.00014
Streptomyces autolyticus	75293	S	366	1056	1422	0.00011
Streptomyces albireticuli	1940	S	329	1221	1550	0.00012
Streptomyces lividans	1916	S	256	3692	3948	0.00030
Streptomyces cinereoruber	67260	S	248	1142	1390	0.00011
Streptomyces violaceoruber	1935	S	225	866	1091	0.00008
Streptomyces rubrolavendulae	285473	S	218	1411	1629	0.00013
Streptomyces rochei	1928	S	158	1037	1195	0.00009
Streptomyces violascens	67381	S	12	1039	1051	0.00008
Kitasatospora sp. MMS16-BH015	2018025	S	4182	1543	5725	0.00044
Kitasatospora sp. NA04385	2742135	S	3465	2051	5516	0.00042
Kitasatospora setae	2066	S	3720	2123	5843	0.00045
Kitasatospora aureofaciens	1894	S	3159	1437	4596	0.00035
Kitasatospora albolonga	68173	S	1192	904	2096	0.00016
Streptacidiphilus sp. P02-A3a	2704468	S	4297	1471	5768	0.00044
Streptacidiphilus sp. PB12-B1b	2705012	S	3584	1569	5153	0.00040
Streptacidiphilus bronchialis	2126346	S	3547	1284	4831	0.00037
Yinghuangia sp. ASG 101	2896848	S	5398	1020	6418	0.00049
Microbacterium sp. No. 7	1714373	S	2787	1331	4118	0.00032
Microbacterium sp. 4R-513	2567934	S	2242	446	2688	0.00021
Microbacterium sp. JZ31	1906274	S	2072	629	2701	0.00021
Microbacterium sp. 10M-3C3	2483401	S	2028	637	2665	0.00021
Microbacterium sp. SSW1-51	2851650	S	1648	433	2081	0.00016
Microbacterium sp. YJN-G	2763257	S	1610	557	2167	0.00017
Microbacterium sp. ABRD_28	2268461	S	1567	230	1797	0.00014
Microbacterium sp. XT11	367477	S	1436	327	1763	0.00014
Microbacterium sp. SSW1-36	2851648	S	1404	323	1727	0.00013
Microbacterium sp. BH-3-3-3	1906742	S	1370	355	1725	0.00013
Microbacterium sp. H1-D42	2925844	S	1336	240	1576	0.00012
Microbacterium sp. LKL04	912630	S	1297	332	1629	0.00013
Microbacterium sp. NIBRBAC000506063	2734618	S	1291	564	1855	0.00014
Microbacterium sp. A18JL241	2782166	S	1225	305	1530	0.00012
Microbacterium sp. cx-55	2875948	S	1216	194	1410	0.00011
Microbacterium sp. PM5	2014534	S	1206	240	1446	0.00011
Microbacterium sp. Y-01	2048898	S	1176	480	1656	0.00013
Microbacterium sp. CBA3102	2603598	S	1033	259	1292	0.00010
Microbacterium sp. 1S1	2606451	S	1010	432	1442	0.00011
Microbacterium sp. TPU 3598	1938334	S	956	255	1211	0.00009
Microbacterium sp. Nx66	2766784	S	871	563	1434	0.00011
Microbacterium sp. RG1	2489212	S	509	388	897	0.00007
Microbacterium sp. CGR1	1696072	S	245	812	1057	0.00008
Microbacterium sp. 1.5R	1916917	S	229	731	960	0.00007
Microbacterium sp. PAMC22086	2861281	S	218	448	666	0.00005
Microbacterium sp. SGAir0570	2070348	S	212	733	945	0.00007
Microbacterium sp. str. 'China'	2103230	S	118	584	702	0.00005
Microbacterium sp. PAMC 28756	1795053	S	43	655	698	0.00005
Microbacterium sp. PAMC21962	2861280	S	24	959	983	0.00008
Microbacterium sp. KUDC0406	2909588	S	21	1539	1560	0.00012
Microbacterium sp. Se5.02b	2864103	S	16	1181	1197	0.00009
Microbacterium sp. KUDC0405	2909587	S	10	730	740	0.00006
Microbacterium cremeum	2782169	S	4279	988	5267	0.00041
Microbacterium foliorum	104336	S	3030	673	3703	0.00029
Microbacterium oleivorans	273677	S	2768	587	3355	0.00026
Microbacterium hominis	162426	S	2735	7491	10226	0.00079
Microbacterium atlanticum	2782168	S	2613	632	3245	0.00025
Microbacterium lemovicicum	1072463	S	1923	478	2401	0.00019
Microbacterium resistens	156977	S	1900	385	2285	0.00018
Microbacterium sediminis	904291	S	1865	913	2778	0.00021
Microbacterium oryzae	743009	S	1775	584	2359	0.00018
Microbacterium pygmaeum	370764	S	1643	224	1867	0.00014
Microbacterium testaceum	2033	S	1598	316	1914	0.00015
Microbacterium wangchenii	2541726	S	1534	374	1908	0.00015
Microbacterium aurum	36805	S	1528	517	2045	0.00016
Microbacterium caowuchunii	2614638	S	1490	312	1802	0.00014
Microbacterium lushaniae	2614639	S	1442	359	1801	0.00014
Microbacterium oxydans	82380	S	1402	1084	2486	0.00019
Microbacterium chocolatum	84292	S	1373	337	1710	0.00013
Microbacterium esteraromaticum	57043	S	1346	325	1671	0.00013
Microbacterium protaetiae	2509458	S	1340	331	1671	0.00013
Microbacterium luteum	2782167	S	1337	597	1934	0.00015
Microbacterium hydrocarbonoxydans	273678	S	1087	210	1297	0.00010
Microbacterium schleiferi	69362	S	891	325	1216	0.00009
Microbacterium fandaimingii	2708079	S	749	70	819	0.00006
Microbacterium chengjingii	2769067	S	586	34	620	0.00005
Microbacterium binotii	462710	S	570	428	998	0.00008
Microbacterium amylolyticum	936337	S	496	117	613	0.00005
Microbacterium endophyticum	1526412	S	442	34	476	0.00004
Microbacterium paraoxydans	199592	S	220	1459	1679	0.00013
Microbacterium paludicola	300019	S	202	730	932	0.00007
Agromyces sp. H17E-10	2932244	S	3195	1219	4414	0.00034
Agromyces sp. LHK192	2498704	S	2783	940	3723	0.00029
Agromyces sp. CFWR-12	2929802	S	2093	1405	3498	0.00027
Agromyces flavus	589382	S	4252	1560	5812	0.00045
Agromyces soli	659012	S	2793	1178	3971	0.00031
Agromyces aureus	453304	S	2745	904	3649	0.00028
Agromyces marinus	1389020	S	2536	1077	3613	0.00028
Agromyces protaetiae	2509455	S	2244	747	2991	0.00023
Agromyces badenianii	2080742	S	2101	800	2901	0.00022
Agromyces archimandritae	2781962	S	1965	658	2623	0.00020
Agromyces laixinhei	2585717	S	1911	511	2422	0.00019
Agromyces intestinalis	2592652	S	1893	1202	3095	0.00024
Curtobacterium sp. BH-2-1-1	1905847	S	1457	548	2005	0.00015
Curtobacterium sp. L6-1	2841594	S	1450	540	1990	0.00015
Curtobacterium sp. YC1	2795488	S	1165	602	1767	0.00014
Curtobacterium sp. MR_MD2014	1561023	S	1025	538	1563	0.00012
Curtobacterium sp. TC1	2862880	S	975	561	1536	0.00012
Curtobacterium sp. 24E2	2804758	S	885	541	1426	0.00011
Curtobacterium sp. SGAir0471	2070337	S	807	724	1531	0.00012
Curtobacterium sp. TXMA1	2876939	S	645	599	1244	0.00010
Curtobacterium sp. C1	2898151	S	287	969	1256	0.00010
Curtobacterium sp. Csp2	2495430	S	237	903	1140	0.00009
Curtobacterium sp. Csp1	2495429	S	36	895	931	0.00007
Curtobacterium flaccumfaciens	2035	S	2190	1150	3340	0.00026
Curtobacterium luteum	33881	S	1397	570	1967	0.00015
Rathayibacter sp. VKM Ac-2759	2609252	S	1920	772	2692	0.00021
Rathayibacter sp. VKM Ac-2760	2609253	S	1781	1025	2806	0.00022
Rathayibacter sp. VKM Ac-2804	2609257	S	1248	1001	2249	0.00017
Rathayibacter sp. VKM Ac-2801	2609255	S	720	728	1448	0.00011
Rathayibacter sp. VKM Ac-2762	2609254	S	305	877	1182	0.00009
Rathayibacter sp. VKM Ac-2805	2609258	S	268	794	1062	0.00008
Rathayibacter festucae	110937	S	1863	2184	4047	0.00031
Rathayibacter tanaceti	1671680	S	1165	343	1508	0.00012
Rathayibacter iranicus	59737	S	815	126	941	0.00007
Rathayibacter tritici	33888	S	730	251	981	0.00008
Rathayibacter rathayi	33887	S	639	195	834	0.00006
Rathayibacter toxicus	145458	S	320	33	353	0.00003
Leucobacter sp. H25R-14	2932245	S	1475	285	1760	0.00014
Leucobacter sp. Psy1	2875729	S	1313	191	1504	0.00012
Leucobacter sp. NB 10	2873270	S	1306	421	1727	0.00013
Leucobacter sp. CX169	2813744	S	1001	307	1308	0.00010
Leucobacter sp. H21R-36	2932246	S	437	1221	1658	0.00013
Leucobacter sp. H21R-40	2932247	S	379	1060	1439	0.00011
Leucobacter muris	1935379	S	1474	613	2087	0.00016
Leucobacter triazinivorans	1784719	S	1438	986	2424	0.00019
Leucobacter luti	340320	S	572	64	636	0.00005
Leucobacter insecticola	2714934	S	399	40	439	0.00003
Leucobacter viscericola	2714935	S	377	43	420	0.00003
Leucobacter coleopterorum	2714933	S	270	32	302	0.00002
Leucobacter denitrificans	683042	S	267	47	314	0.00002
Agrococcus sp. SCSIO52902	2933290	S	2807	1609	4416	0.00034
Agrococcus sp. Marseille-Q4369	2810513	S	2239	913	3152	0.00024
Agrococcus sp. SGAir0287	2070347	S	2172	763	2935	0.00023
Agrococcus carbonis	684552	S	2374	1282	3656	0.00028
Agrococcus jejuensis	399736	S	2305	849	3154	0.00024
Leifsonia sp. ZF2019	2781978	S	2073	680	2753	0.00021
Leifsonia sp. PS1209	2724914	S	1760	573	2333	0.00018
Leifsonia sp. 21MFCrub1.1	1798223	S	1690	2421	4111	0.00032
Leifsonia shinshuensis	150026	S	2541	850	3391	0.00026
Leifsonia xyli	1575	S	1617	261	1878	0.00014
Clavibacter michiganensis	28447	S	8575	9125	17700	0.00136
Clavibacter zhangzhiyongii	2768071	S	997	573	1570	0.00012
Clavibacter sp. A6099	2860285	S	585	449	1034	0.00008
Protaetiibacter intestinalis	2419774	S	1897	807	2704	0.00021
Protaetiibacter sp. SSC-01	2759943	S	1888	827	2715	0.00021
Protaetiibacter larvae	2592654	S	1426	539	1965	0.00015
Salinibacterium sp. ZJ450	2708338	S	1599	297	1896	0.00015
Salinibacterium sp. ZJ70	2708084	S	1237	376	1613	0.00012
Salinibacterium sp. dk2585	2603292	S	1098	219	1317	0.00010
Salinibacterium sp. UTAS2018	2508880	S	372	39	411	0.00003
Salinibacterium sp. M195	2583374	S	307	39	346	0.00003
Salinibacterium hongtaonis	2079791	S	545	69	614	0.00005
Cryobacterium sp. LW097	1978566	S	1219	312	1531	0.00012
Cryobacterium sp. PAMC25264	2861288	S	605	412	1017	0.00008
Cryobacterium soli	2220095	S	912	533	1445	0.00011
Cryobacterium arcticum	670052	S	671	566	1237	0.00010
Frondihabitans sp. PAMC 28766	1795630	S	1904	307	2211	0.00017
Frondihabitans sp. 762G35	1446794	S	1650	423	2073	0.00016
Microterricola viridarii	412690	S	3283	981	4264	0.00033
Microcella flavibacter	1804990	S	1812	1045	2857	0.00022
Microcella alkaliphila	279828	S	1227	258	1485	0.00011
Plantibacter sp. PA-3-X8	2480625	S	580	594	1174	0.00009
Plantibacter sp. M259	2583822	S	554	548	1102	0.00008
Plantibacter flavus	150123	S	638	562	1200	0.00009
Mycetocola sp. JXN-3	2116510	S	779	137	916	0.00007
Mycetocola zhujimingii	2079792	S	755	109	864	0.00007
Mycetocola spongiae	2859226	S	690	108	798	0.00006
Cnuibacter physcomitrellae	1619308	S	2207	580	2787	0.00021
Herbiconiux sp. SALV-R1	2735133	S	2104	511	2615	0.00020
Subtercola sp. AK-R2A1-2	2895559	S	1225	144	1369	0.00011
Subtercola sp. PAMC28395	2846775	S	772	98	870	0.00007
Frigoribacterium sp. NBH87	2596916	S	2004	713	2717	0.00021
Gryllotalpicola protaetiae	2419771	S	1929	452	2381	0.00018
Chryseoglobus sp. 28M-23	2772253	S	359	765	1124	0.00009
Chryseoglobus indicus	2750620	S	317	714	1031	0.00008
Humibacter sp. WJ7-1	2599293	S	1682	448	2130	0.00016
Amnibacterium sp. L3-i23	2905871	S	1646	478	2124	0.00016
Marisediminicola antarctica	674079	S	1396	210	1606	0.00012
Gulosibacter sediminis	1729695	S	1352	468	1820	0.00014
Diaminobutyricimonas sp. LJ205	2683590	S	1253	284	1537	0.00012
Glaciihabitans sp. INWT7	2596912	S	1035	99	1134	0.00009
Agreia sp. COWG	2773266	S	990	145	1135	0.00009
Aquiluna borgnonia	2499157	S	160	31	191	0.00001
Candidatus Aquiluna sp. UB-MaderosW2red	1855377	S	89	11	100	0.00001
Rhodoluna limnophila	232537	S	121	12	133	0.00001
Candidatus Rhodoluna planktonica	535712	S	75	7	82	0.00001
Rhodoluna lacicola	529884	S	48	4	52	0.00000
Pseudoclavibacter sp. Marseille-Q3772	2866588	S	265	60	325	0.00003
Aurantimicrobium photophilum	1987356	S	80	7	87	0.00001
Aurantimicrobium minutum	708131	S	69	19	88	0.00001
Aurantimicrobium sp. MWH-Uga1	2079575	S	37	10	47	0.00000
Pontimonas salivibrio	1159327	S	120	6	126	0.00001
Arthrobacter sp. QXT-31	1357915	S	6961	2395	9356	0.00072
Arthrobacter sp. FW305-BF8	2879617	S	2003	679	2682	0.00021
Arthrobacter sp. QL17	2895818	S	1625	451	2076	0.00016
Arthrobacter sp. PM3	2017685	S	1504	289	1793	0.00014
Arthrobacter sp. NicSoilB8	2830998	S	1442	463	1905	0.00015
Arthrobacter sp. PGP41	2079227	S	1360	588	1948	0.00015
Arthrobacter sp. 24S4-2	2575374	S	1267	354	1621	0.00012
Arthrobacter sp. NicSoilC5	2831000	S	1243	793	2036	0.00016
Arthrobacter sp. PAMC25564	2565366	S	1229	413	1642	0.00013
Arthrobacter sp. U41	1849032	S	1204	424	1628	0.00013
Arthrobacter sp. KBS0702	2578107	S	1152	565	1717	0.00013
Arthrobacter sp. UKPF54-2	2600159	S	1113	579	1692	0.00013
Arthrobacter sp. FB24	290399	S	1083	430	1513	0.00012
Arthrobacter sp. ERGS1:01	1704044	S	1054	247	1301	0.00010
Arthrobacter sp. NicSoilB4	2830997	S	1031	400	1431	0.00011
Arthrobacter sp. FW306-2-2C-D06B	2879618	S	901	217	1118	0.00009
Arthrobacter sp. Helios	2828862	S	896	179	1075	0.00008
Arthrobacter sp. PAMC25284	2861279	S	846	273	1119	0.00009
Arthrobacter sp. zg-Y462	2886936	S	694	173	867	0.00007
Arthrobacter sp. PAMC 25486	1494608	S	631	126	757	0.00006
Arthrobacter sp. StoSoilB5	2830992	S	571	203	774	0.00006
Arthrobacter sp. zg-Y809	2886940	S	538	217	755	0.00006
Arthrobacter sp. StoSoilB20	2830995	S	512	178	690	0.00005
Arthrobacter sp. NtRootA1	2830983	S	483	182	665	0.00005
Arthrobacter sp. YN	2020486	S	369	188	557	0.00004
Arthrobacter sp. D5-1	1477518	S	340	280	620	0.00005
Arthrobacter sp. C1-1	2813727	S	285	48	333	0.00003
Arthrobacter sp. FW306-06-A	2879621	S	225	942	1167	0.00009
Arthrobacter sp. NicSoilB11	2830999	S	203	965	1168	0.00009
Arthrobacter sp. FW306-05-C	2879620	S	177	1108	1285	0.00010
Arthrobacter sp. FW306-07-I	2879622	S	167	1116	1283	0.00010
Arthrobacter sp. StoSoilB19	2830994	S	157	857	1014	0.00008
Arthrobacter sp. StoSoilA2	2830990	S	136	292	428	0.00003
Arthrobacter sp. StoSoilB13	2830993	S	133	295	428	0.00003
Arthrobacter sp. AQ5-05	2184581	S	23	406	429	0.00003
Arthrobacter agilis	37921	S	2627	454	3081	0.00024
Arthrobacter crystallopoietes	37928	S	2372	520	2892	0.00022
Arthrobacter sulfonylureivorans	2486855	S	1330	255	1585	0.00012
Arthrobacter woluwensis	156980	S	1186	324	1510	0.00012
Arthrobacter dokdonellae	2211210	S	1032	211	1243	0.00010
Arthrobacter jiangjiafuii	2817475	S	802	258	1060	0.00008
Arthrobacter alpinus	656366	S	706	1088	1794	0.00014
Arthrobacter sunyaminii	2816859	S	562	210	772	0.00006
Kocuria rosea	1275	S	3328	1192	4520	0.00035
Kocuria flava	446860	S	3065	1735	4800	0.00037
Kocuria turfanensis	388357	S	2943	1140	4083	0.00031
Kocuria palustris	71999	S	1355	615	1970	0.00015
Kocuria rhizophila	72000	S	1068	1633	2701	0.00021
Kocuria varians	1272	S	843	652	1495	0.00012
Kocuria sp. TGY1127_2	2711328	S	380	73	453	0.00003
Kocuria sp. KD4	2719588	S	223	366	589	0.00005
Kocuria sp. BT304	1702043	S	93	461	554	0.00004
Kocuria indica	1049583	S	177	347	524	0.00004
Pseudarthrobacter sp. L1SW	2851598	S	1268	601	1869	0.00014
Pseudarthrobacter sp. BIM B-2242	2772401	S	1029	309	1338	0.00010
Pseudarthrobacter sp. SSS035	2931399	S	710	624	1334	0.00010
Pseudarthrobacter sp. NIBRBAC000502772	2590775	S	543	410	953	0.00007
Pseudarthrobacter sp. NBSH8	2596911	S	511	216	727	0.00006
Pseudarthrobacter sp. NIBRBAC000502771	2590774	S	283	1019	1302	0.00010
Pseudarthrobacter sp. NIBRBAC000502770	2590785	S	240	755	995	0.00008
Pseudarthrobacter phenanthrenivorans	361575	S	1516	857	2373	0.00018
Pseudarthrobacter chlorophenolicus	85085	S	1038	436	1474	0.00011
Pseudarthrobacter equi	728066	S	950	418	1368	0.00011
Pseudarthrobacter psychrotolerans	2697569	S	702	312	1014	0.00008
Pseudarthrobacter sulfonivorans	121292	S	589	622	1211	0.00009
Micrococcus luteus	1270	S	2744	5222	7966	0.00061
Micrococcus sp. KD337-16	2856555	S	1182	831	2013	0.00016
Micrococcus sp. KBS0714	1179670	S	33	309	342	0.00003
Micrococcus yunnanensis	566027	S	32	281	313	0.00002
Sinomonas atrocyanea	37927	S	2480	958	3438	0.00026
Sinomonas sp. R1AF57	2020377	S	2154	591	2745	0.00021
Glutamicibacter protophormiae	37930	S	875	644	1519	0.00012
Glutamicibacter creatinolyticus	162496	S	846	242	1088	0.00008
Glutamicibacter halophytocola	1933880	S	463	98	561	0.00004
Glutamicibacter mishrai	1775880	S	349	86	435	0.00003
Glutamicibacter arilaitensis	256701	S	296	124	420	0.00003
Glutamicibacter nicotianae	37929	S	277	807	1084	0.00008
Glutamicibacter sp. ZJUTW	1155384	S	86	337	423	0.00003
Rothia kristinae	37923	S	1538	1030	2568	0.00020
Rothia mucilaginosa	43675	S	479	113	592	0.00005
Rothia nasimurium	85336	S	255	153	408	0.00003
Rothia aeria	172042	S	204	103	307	0.00002
Rothia dentocariosa	2047	S	152	75	227	0.00002
Rothia terrae	396015	S	108	52	160	0.00001
Rothia amarae	169480	S	85	44	129	0.00001
Rothia sp. ZJ932	2810516	S	76	14	90	0.00001
Paenarthrobacter ureafaciens	37931	S	666	1254	1920	0.00015
Paenarthrobacter aurescens	43663	S	514	403	917	0.00007
Paenarthrobacter sp. YJN-5	2735316	S	240	591	831	0.00006
Paenarthrobacter sp. YJN-D	2735317	S	121	270	391	0.00003
Paenarthrobacter nicotinovorans	29320	S	110	211	321	0.00002
Citricoccus sp. SGAir0253	2567881	S	2254	731	2985	0.00023
Nesterenkonia sp. NBAIMH1	2600320	S	792	62	854	0.00007
Paeniglutamicibacter sp. Y32M11	2853258	S	437	83	520	0.00004
Psychromicrobium lacuslunae	1618207	S	356	61	417	0.00003
Auritidibacter sp. NML130574	2170745	S	303	38	341	0.00003
Neomicrococcus aestuarii	556325	S	287	155	442	0.00003
Renibacterium salmoninarum	1646	S	195	14	209	0.00002
Cellulomonas sp. Y8	2591145	S	3672	1993	5665	0.00044
Cellulomonas sp. H30R-01	2704467	S	3260	1594	4854	0.00037
Cellulomonas sp. C5510	2871170	S	3026	1531	4557	0.00035
Cellulomonas sp. JZ18	2654191	S	2985	1604	4589	0.00035
Cellulomonas sp. zg-ZUI188	2819978	S	2755	974	3729	0.00029
Cellulomonas sp. zg-ZUI222	2816956	S	2459	1163	3622	0.00028
Cellulomonas sp. zg-ZUI157	2819979	S	2379	1034	3413	0.00026
Cellulomonas sp. PSBB021	2003551	S	2119	2082	4201	0.00032
Cellulomonas sp. EW123	2608402	S	1997	1451	3448	0.00027
Cellulomonas fimi	1708	S	3195	3300	6495	0.00050
Cellulomonas iranensis	76862	S	2655	1545	4200	0.00032
Cellulomonas shaoxiangyii	2566013	S	2639	1367	4006	0.00031
Cellulomonas flavigena	1711	S	2485	1172	3657	0.00028
Cellulomonas gilvus	11	S	2380	1303	3683	0.00028
Cellulomonas taurus	2729175	S	1852	750	2602	0.00020
Actinotalea sp. JY-7876	2758442	S	3022	1387	4409	0.00034
Oerskovia sp. KBS0722	1179673	S	2168	880	3048	0.00023
Pseudactinotalea sp. HY158	2654547	S	2138	393	2531	0.00019
Paraoerskovia marina	545619	S	1474	486	1960	0.00015
Janibacter melonis	262209	S	2940	1221	4161	0.00032
Janibacter limosus	53458	S	2010	653	2663	0.00021
Janibacter indicus	857417	S	1137	1858	2995	0.00023
Janibacter sp. YB324	2761047	S	631	1376	2007	0.00015
Phycicoccus sp. HDW14	2714941	S	3878	1546	5424	0.00042
Phycicoccus endophyticus	1690220	S	3110	1099	4209	0.00032
Intrasporangium calvum	53358	S	4917	1690	6607	0.00051
Pedococcus dokdonensis	443156	S	3611	1274	4885	0.00038
Tetrasphaera sp. HKS02	1813880	S	3042	950	3992	0.00031
Arsenicicoccus sp. oral taxon 190	1658671	S	2867	1353	4220	0.00033
Cellulosimicrobium cellulans	1710	S	5042	6253	11295	0.00087
Cellulosimicrobium sp. BI34T	2587808	S	2172	1223	3395	0.00026
Cellulosimicrobium sp. JZ28	1906273	S	503	1356	1859	0.00014
Cellulosimicrobium sp. 72-3	2731680	S	247	1263	1510	0.00012
Cellulosimicrobium sp. TH-20	1980001	S	178	938	1116	0.00009
Xylanimonas protaetiae	2509457	S	2592	1402	3994	0.00031
Xylanimonas cellulosilytica	186189	S	2175	964	3139	0.00024
Xylanimonas allomyrinae	2509459	S	2107	827	2934	0.00023
Isoptericola variabilis	139208	S	3398	2234	5632	0.00043
Isoptericola dokdonensis	372663	S	2662	1296	3958	0.00030
Ornithinimicrobium avium	2283195	S	3239	1053	4292	0.00033
Ornithinimicrobium sp. HY006	2508882	S	2379	971	3350	0.00026
Ornithinimicrobium sp. INDO-MA30-4	2908651	S	407	89	496	0.00004
Ornithinimicrobium flavum	1288636	S	2644	1028	3672	0.00028
Ornithinimicrobium ciconiae	2594265	S	1975	379	2354	0.00018
Ornithinimicrobium pratense	2593973	S	1680	586	2266	0.00017
Serinicoccus chungangensis	767452	S	2447	1008	3455	0.00027
Serinicoccus hydrothermalis	1758689	S	2000	1089	3089	0.00024
Serinicoccus profundi	1078471	S	1882	819	2701	0.00021
Serinicoccus marinus	247333	S	1826	1047	2873	0.00022
Brachybacterium sp. SGAir0954	2571029	S	2058	672	2730	0.00021
Brachybacterium sp. CBA3105	2887346	S	2018	554	2572	0.00020
Brachybacterium sp. P6-10-X1	1903186	S	1921	393	2314	0.00018
Brachybacterium saurashtrense	556288	S	1715	564	2279	0.00018
Brachybacterium ginsengisoli	1331682	S	1712	569	2281	0.00018
Brachybacterium faecium	43669	S	1675	583	2258	0.00017
Brachybacterium vulturis	2017484	S	1365	551	1916	0.00015
Brachybacterium avium	2017485	S	1121	451	1572	0.00012
Dermabacter vaginalis	1630135	S	565	445	1010	0.00008
Dermabacter jinjuensis	1667168	S	525	530	1055	0.00008
Devriesea agamarum	472569	S	271	19	290	0.00002
Brevibacterium sp. CS2	2575923	S	1902	936	2838	0.00022
Brevibacterium sp. SMBL_HHYL_HB1	2777556	S	890	235	1125	0.00009
Brevibacterium sp. HY170	2898795	S	394	130	524	0.00004
Brevibacterium sp. 'Marine'	2725563	S	337	244	581	0.00004
Brevibacterium sp. W7.2	2823518	S	272	1450	1722	0.00013
Brevibacterium casei	33889	S	1990	1554	3544	0.00027
Brevibacterium linens	1703	S	1485	986	2471	0.00019
Brevibacterium luteolum	199591	S	1103	538	1641	0.00013
Brevibacterium oceani	358099	S	669	169	838	0.00006
Brevibacterium sandarakinum	629680	S	667	139	806	0.00006
Brevibacterium aurantiacum	273384	S	657	499	1156	0.00009
Brevibacterium atlanticum	2697563	S	644	154	798	0.00006
Brevibacterium limosum	2697565	S	523	216	739	0.00006
Brevibacterium pigmentatum	1496080	S	452	367	819	0.00006
Brevibacterium siliguriense	1136497	S	421	137	558	0.00004
Georgenia sp. TF02-10	2917725	S	3389	1554	4943	0.00038
Georgenia yuyongxinii	2589797	S	3106	957	4063	0.00031
Georgenia wutianyii	2585135	S	2778	1207	3985	0.00031
Georgenia faecalis	2483799	S	2641	914	3555	0.00027
Haloactinobacterium kanbiaonis	2675754	S	3342	606	3948	0.00030
Ruania sp. LR1S40	2897774	S	1801	463	2264	0.00017
Ruania sp. M4N3S171	2897773	S	1090	184	1274	0.00010
Ruania zhangjianzhongii	2603206	S	2075	260	2335	0.00018
Ruania alkalisoli	2779775	S	1230	252	1482	0.00011
Dermacoccus nishinomiyaensis	1274	S	1928	1005	2933	0.00023
Dermacoccus sp. PAMC28757	2762331	S	1282	559	1841	0.00014
Luteipulveratus mongoliensis	571913	S	2551	440	2991	0.00023
Allobranchiibius sp. GilTou73	2904523	S	1898	515	2413	0.00019
Yimella sp. cx-51	2770551	S	1308	324	1632	0.00013
Beutenbergia cavernae	84757	S	3841	801	4642	0.00036
Miniimonas sp. S16	2171623	S	2705	1764	4469	0.00034
Pengzhenrongella sicca	2819238	S	3481	1213	4694	0.00036
Luteimicrobium xylanilyticum	1133546	S	2811	1084	3895	0.00030
Sanguibacter keddieii	60920	S	2204	821	3025	0.00023
Sanguibacter sp. HDW7	2714931	S	2015	789	2804	0.00022
Gephyromycinifex aptenodytis	2716227	S	1069	151	1220	0.00009
Austwickia chelonae	100225	S	939	88	1027	0.00008
Dermatophilus congolensis	1863	S	309	35	344	0.00003
Kytococcus sedentarius	1276	S	2112	948	3060	0.00024
Demequina sp. TMPB413	2881056	S	816	79	895	0.00007
Jonesia denitrificans	43674	S	143	31	174	0.00001
Tropheryma whipplei	2039	S	53	0	53	0.00000
Mycolicibacterium litorale	758802	S	3831	1105	4936	0.00038
Mycolicibacterium smegmatis	1772	S	3228	2201	5429	0.00042
Mycolicibacterium sp. YH-1	2908837	S	1997	1112	3109	0.00024
Mycolicibacterium fortuitum	1766	S	2779	1108	3887	0.00030
Mycolicibacterium madagascariense	212765	S	2573	421	2994	0.00023
Mycolicibacterium pulveris	36813	S	2571	458	3029	0.00023
Mycolicibacterium phlei	1771	S	2533	910	3443	0.00027
Mycolicibacterium hassiacum	46351	S	2516	719	3235	0.00025
Mycolicibacterium neoaurum	1795	S	2511	735	3246	0.00025
Mycolicibacterium rutilum	370526	S	2450	762	3212	0.00025
Mycolicibacterium sediminis	1286180	S	2348	454	2802	0.00022
Mycolicibacterium chubuense	1800	S	2330	554	2884	0.00022
Mycolicibacterium mageritense	53462	S	2287	409	2696	0.00021
Mycolicibacterium arabiense	1286181	S	2248	372	2620	0.00020
Mycolicibacterium moriokaense	39691	S	2178	286	2464	0.00019
Mycolicibacterium thermoresistibile	1797	S	2166	515	2681	0.00021
Mycolicibacterium psychrotolerans	216929	S	2165	517	2682	0.00021
Mycolicibacterium chitae	1792	S	2119	539	2658	0.00020
Mycolicibacterium vaccae	1810	S	2093	440	2533	0.00020
Mycolicibacterium parafortuitum	39692	S	2034	432	2466	0.00019
Mycolicibacterium rhodesiae	36814	S	2016	345	2361	0.00018
Mycolicibacterium monacense	85693	S	2015	901	2916	0.00022
Mycolicibacterium duvalii	39688	S	1977	412	2389	0.00018
Mycolicibacterium gadium	1794	S	1976	280	2256	0.00017
Mycolicibacterium poriferae	39694	S	1940	430	2370	0.00018
Mycolicibacterium celeriflavum	1249101	S	1894	390	2284	0.00018
Mycolicibacterium phocaicum	319706	S	1890	987	2877	0.00022
Mycolicibacterium tokaiense	39695	S	1872	318	2190	0.00017
Mycolicibacterium fluoranthenivorans	258505	S	1867	261	2128	0.00016
Mycolicibacterium fallax	1793	S	1857	786	2643	0.00020
Mycolicibacterium gilvum	1804	S	1768	671	2439	0.00019
Mycolicibacterium baixiangningiae	2761578	S	1726	295	2021	0.00016
Mycolicibacterium insubricum	444597	S	1724	516	2240	0.00017
Mycolicibacterium aurum	1791	S	1716	241	1957	0.00015
Mycolicibacterium confluentis	28047	S	1685	276	1961	0.00015
Mycolicibacterium boenickei	146017	S	1561	1966	3527	0.00027
Mycolicibacterium anyangense	1431246	S	1523	267	1790	0.00014
Mycolicibacterium aichiense	1799	S	1492	273	1765	0.00014
Mycolicibacterium mengxianglii	2736649	S	1435	167	1602	0.00012
Mycolicibacterium austroafricanum	39687	S	1284	4639	5923	0.00046
Mycobacterium doricum	126673	S	1241	296	1537	0.00012
Mycolicibacterium helvum	1534349	S	1240	157	1397	0.00011
Mycolicibacterium alvei	67081	S	1180	332	1512	0.00012
Mycolicibacterium mucogenicum	56689	S	1106	450	1556	0.00012
Mycolicibacterium sarraceniae	1534348	S	923	126	1049	0.00008
Mycolicibacterium septicum	98668	S	783	513	1296	0.00010
Mycolicibacterium farcinogenes	1802	S	530	1829	2359	0.00018
Mycolicibacterium vanbaalenii	110539	S	358	5248	5606	0.00043
Mycolicibacterium nivoides	2487344	S	185	805	990	0.00008
Mycobacterium sp. JS623	212767	S	2293	207	2500	0.00019
Mycobacterium sp. IDR2000157661	2867005	S	1882	366	2248	0.00017
Mycobacterium sp. YC-RL4	1682113	S	1487	564	2051	0.00016
Mycobacterium sp. DL592	2675524	S	1456	255	1711	0.00013
Mycobacterium sp. MS1601	1936029	S	1426	217	1643	0.00013
Mycobacterium sp. EPa45	1545728	S	1385	247	1632	0.00013
Mycobacterium sp. DL440	2675523	S	1064	248	1312	0.00010
Mycobacterium sp. TY59	2775496	S	989	169	1158	0.00009
Mycobacterium sp. WY10	1920667	S	178	485	663	0.00005
Mycobacterium sp. 20KCMC460	2903536	S	95	1903	1998	0.00015
Mycobacterium sp. PYR15	2051552	S	76	597	673	0.00005
Mycobacterium sp. MOTT36Y	1168287	S	41	470	511	0.00004
Mycobacterium saskatchewanense	220927	S	2016	417	2433	0.00019
Mycobacterium parmense	185642	S	1798	344	2142	0.00017
Mycobacterium kubicae	120959	S	1651	272	1923	0.00015
Mycobacterium shigaense	722731	S	1365	209	1574	0.00012
Mycobacterium simiae	1784	S	1320	123	1443	0.00011
Mycobacterium stomatepiae	470076	S	1222	257	1479	0.00011
Mycobacterium florentinum	292462	S	1185	277	1462	0.00011
Mycobacterium heidelbergense	53376	S	1174	286	1460	0.00011
Mycobacterium lentiflavum	141349	S	1148	282	1430	0.00011
Mycobacterium avium	1764	S	2856	3032	5888	0.00045
Mycobacterium intracellulare	1767	S	1333	11762	13095	0.00101
Mycobacterium mantenii	560555	S	1289	165	1454	0.00011
Mycobacterium colombiense	339268	S	1228	218	1446	0.00011
Mycobacterium marseillense	701042	S	1066	251	1317	0.00010
Mycobacterium paraintracellulare	1138383	S	323	1907	2230	0.00017
Mycobacterium grossiae	1552759	S	2615	830	3445	0.00027
Mycobacterium goodii	134601	S	2549	957	3506	0.00027
Mycobacterium rufum	318424	S	2170	676	2846	0.00022
Mycobacterium holsaticum	152142	S	1966	331	2297	0.00018
Mycobacterium canettii	78331	S	723	485	1208	0.00009
Mycobacterium tuberculosis	1773	S	384	19878	20262	0.00156
Mycobacterium dioxanotrophicus	482462	S	1961	505	2466	0.00019
Mycobacterium branderi	43348	S	1818	234	2052	0.00016
Mycobacterium paragordonae	1389713	S	1747	216	1963	0.00015
Mycobacterium conspicuum	44010	S	1694	215	1909	0.00015
Mycobacterium diernhoferi	1801	S	1653	352	2005	0.00015
Mycobacterium frederiksbergense	117567	S	1614	519	2133	0.00016
Mycobacterium koreense	1069220	S	1482	462	1944	0.00015
Mycobacterium gordonae	1778	S	1450	127	1577	0.00012
Mycobacterium cookii	1775	S	1428	154	1582	0.00012
Mycobacterium paraterrae	577492	S	1328	156	1484	0.00011
Mycobacterium heckeshornense	110505	S	1284	104	1388	0.00011
Mycobacterium vicinigordonae	1719132	S	1260	72	1332	0.00010
Mycobacterium riyadhense	486698	S	1219	55	1274	0.00010
Mycobacterium shinjukuense	398694	S	1210	124	1334	0.00010
Mycobacterium lacus	169765	S	1169	91	1260	0.00010
Mycobacterium ostraviense	2738409	S	1166	114	1280	0.00010
Mycobacterium noviomagense	459858	S	1148	99	1247	0.00010
Mycobacterium kansasii	1768	S	1136	111	1247	0.00010
Mycobacterium malmoense	1780	S	1109	178	1287	0.00010
Mycobacterium xenopi	1789	S	1102	131	1233	0.00010
Mycobacterium paraseoulense	590652	S	1045	208	1253	0.00010
Mycobacterium virginiense	1795032	S	982	275	1257	0.00010
Mycobacterium seoulense	386911	S	955	222	1177	0.00009
Mycobacterium spongiae	886343	S	917	27	944	0.00007
Mycobacterium basiliense	2094119	S	886	34	920	0.00007
Mycobacterium crocinum	388459	S	634	340	974	0.00008
Mycobacterium haemophilum	29311	S	584	31	615	0.00005
Mycobacterium marinum	1781	S	326	1210	1536	0.00012
Mycobacterium senegalense	1796	S	215	1209	1424	0.00011
Mycobacterium leprae	1769	S	161	4	165	0.00001
Mycobacterium lepromatosis	480418	S	153	4	157	0.00001
Mycobacterium novum	2492438	S	153	2153	2306	0.00018
Mycobacterium ulcerans	1809	S	137	686	823	0.00006
Mycobacterium pallens	370524	S	61	529	590	0.00005
Mycobacterium shottsii	133549	S	58	91	149	0.00001
Mycobacterium pseudoshottsii	265949	S	29	157	186	0.00001
Mycolicibacter sp. MYC340	2855503	S	987	261	1248	0.00010
Mycolicibacter sp. MYC098	2872309	S	822	218	1040	0.00008
Mycolicibacter sp. MYC017	2875777	S	591	472	1063	0.00008
Mycolicibacter sp. MYC101	2872311	S	190	751	941	0.00007
Mycolicibacter sp. MYC123	2855502	S	185	755	940	0.00007
Mycolicibacter hiberniae	29314	S	1147	267	1414	0.00011
Mycolicibacter terrae	1788	S	1112	376	1488	0.00011
Mycolicibacter minnesotensis	1118379	S	812	155	967	0.00007
Mycolicibacter sinensis	875328	S	179	2056	2235	0.00017
Mycobacteroides abscessus	36809	S	1945	1793	3738	0.00029
Mycobacteroides chelonae	1774	S	1208	452	1660	0.00013
Mycobacteroides immunogenum	83262	S	740	180	920	0.00007
Mycobacteroides saopaulense	1578165	S	719	120	839	0.00006
Mycobacteroides salmoniphilum	404941	S	657	84	741	0.00006
[Mycobacterium] stephanolepidis	1520670	S	363	145	508	0.00004
Mycolicibacillus parakoreensis	1069221	S	1548	481	2029	0.00016
Hoyosella subflava	639313	S	793	52	845	0.00007
Nocardia asteroides	1824	S	11869	4634	16503	0.00127
Nocardia brasiliensis	37326	S	7016	2204	9220	0.00071
Nocardia terpenica	455432	S	4807	991	5798	0.00045
Nocardia cyriacigeorgica	135487	S	4747	2339	7086	0.00055
Nocardia farcinica	37329	S	3657	2614	6271	0.00048
Nocardia arthritidis	228602	S	3359	487	3846	0.00030
Nocardia huaxiensis	2755382	S	3032	685	3717	0.00029
Nocardia wallacei	480035	S	2742	890	3632	0.00028
Nocardia sp. CS682	1047172	S	2522	690	3212	0.00025
Nocardia gipuzkoensis	2749991	S	2478	1028	3506	0.00027
Nocardia otitidiscaviarum	1823	S	2453	559	3012	0.00023
Nocardia yamanashiensis	209247	S	2365	542	2907	0.00022
Nocardia iowensis	204891	S	2356	583	2939	0.00023
Nocardia yunnanensis	2382165	S	2354	656	3010	0.00023
Nocardia tengchongensis	2055889	S	2304	659	2963	0.00023
Nocardia seriolae	37332	S	2245	691	2936	0.00023
Nocardia nova	37330	S	2169	353	2522	0.00019
Nocardia mangyaensis	2213200	S	2156	656	2812	0.00022
Rhodococcus sp. X156	2499145	S	2989	1202	4191	0.00032
Rhodococcus sp. MTM3W5.2	1805827	S	2520	705	3225	0.00025
Rhodococcus sp. SGAir0479	2567884	S	2127	725	2852	0.00022
Rhodococcus sp. W8901	2742603	S	1949	599	2548	0.00020
Rhodococcus sp. PBTS 1	1653478	S	1759	533	2292	0.00018
Rhodococcus sp. ABRD24	2507582	S	1305	269	1574	0.00012
Rhodococcus sp. R79	2811421	S	1298	860	2158	0.00017
Rhodococcus sp. USK10	2789739	S	1068	742	1810	0.00014
Rhodococcus sp. B7740	1564114	S	927	149	1076	0.00008
Rhodococcus sp. P1Y	1302308	S	878	95	973	0.00007
Rhodococcus sp. WMMA185	679318	S	865	131	996	0.00008
Rhodococcus sp. WAY2	2663121	S	737	667	1404	0.00011
Rhodococcus sp. USK13	2806442	S	646	473	1119	0.00009
Rhodococcus sp. RDE2	2885078	S	579	593	1172	0.00009
Rhodococcus sp. WB9	2594007	S	400	554	954	0.00007
Rhodococcus sp. ZPP	2749906	S	347	989	1336	0.00010
Rhodococcus sp. DMU1	2722825	S	289	1114	1403	0.00011
Rhodococcus sp. M8	1925550	S	270	863	1133	0.00009
Rhodococcus sp. S2-17	1990687	S	266	789	1055	0.00008
Rhodococcus sp. P-2	2795031	S	116	143	259	0.00002
Rhodococcus sp. 21391	2683591	S	115	540	655	0.00005
Rhodococcus sp. WB1	1033922	S	113	995	1108	0.00009
Rhodococcus sp. 2G	1570939	S	95	401	496	0.00004
Rhodococcus sp. YL-1	1045808	S	83	370	453	0.00003
Rhodococcus sp. p52	935199	S	81	450	531	0.00004
Rhodococcus sp. DMF-1	2907624	S	66	538	604	0.00005
Rhodococcus sp. LW-XY12	2856851	S	64	596	660	0.00005
Rhodococcus sp. PSBB049	2812863	S	58	857	915	0.00007
Rhodococcus sp. AQ5-07	2054902	S	51	182	233	0.00002
Rhodococcus sp. 008	1723645	S	44	277	321	0.00002
Rhodococcus sp. BH4	1807790	S	44	293	337	0.00003
Rhodococcus sp. H-CA8f	1727214	S	34	152	186	0.00001
Rhodococcus sp. NJ-530	2490853	S	30	175	205	0.00002
Rhodococcus opacus	37919	S	6197	6528	12725	0.00098
Rhodococcus equi	43767	S	3186	1336	4522	0.00035
Rhodococcus fascians	1828	S	2507	638	3145	0.00024
Rhodococcus rhodochrous	1829	S	2066	1288	3354	0.00026
Rhodococcus triatomae	300028	S	1657	557	2214	0.00017
Rhodococcus koreensis	99653	S	1524	484	2008	0.00015
Rhodococcus coprophilus	38310	S	1381	284	1665	0.00013
Rhodococcus jostii	132919	S	1207	528	1735	0.00013
Rhodococcus pyridinivorans	103816	S	1068	4188	5256	0.00040
Rhodococcus ruber	1830	S	1037	3472	4509	0.00035
Rhodococcus qingshengii	334542	S	391	2219	2610	0.00020
Rhodococcus erythropolis	1833	S	377	1742	2119	0.00016
Rhodococcus globerulus	33008	S	829	110	939	0.00007
Rhodococcus aetherivorans	191292	S	314	2978	3292	0.00025
Corynebacterium cyclohexanicum	322009	S	1866	808	2674	0.00021
Corynebacterium sphenisci	191493	S	1675	553	2228	0.00017
Corynebacterium frankenforstense	1230998	S	1481	483	1964	0.00015
Corynebacterium bovis	36808	S	1377	342	1719	0.00013
Corynebacterium xerosis	1725	S	1316	791	2107	0.00016
Corynebacterium halotolerans	225326	S	1165	289	1454	0.00011
Corynebacterium freneyi	134034	S	1084	451	1535	0.00012
Corynebacterium nuruki	1032851	S	1040	268	1308	0.00010
Corynebacterium sp. CNCTC7651	2815361	S	430	90	520	0.00004
Corynebacterium sp. NML98-0116	702967	S	293	116	409	0.00003
Corynebacterium sp. 1864	2820399	S	90	187	277	0.00002
Corynebacterium sp. FDAARGOS 1242	2778078	S	71	186	257	0.00002
Corynebacterium sp. 4H37-19	2684405	S	51	6	57	0.00000
Corynebacterium sp. sy039	2599641	S	20	2	22	0.00000
Corynebacterium vitaeruminis	38305	S	952	308	1260	0.00010
Corynebacterium maris	575200	S	862	150	1012	0.00008
Corynebacterium humireducens	1223514	S	846	264	1110	0.00009
Corynebacterium doosanense	1121358	S	818	408	1226	0.00009
Corynebacterium variabile	1727	S	799	493	1292	0.00010
Corynebacterium marinum	349751	S	767	307	1074	0.00008
Corynebacterium timonense	441500	S	725	188	913	0.00007
Corynebacterium yudongzhengii	2080740	S	688	138	826	0.00006
Corynebacterium mycetoides	38302	S	681	342	1023	0.00008
Corynebacterium uterequi	1072256	S	650	121	771	0.00006
Corynebacterium liangguodongii	2079535	S	628	152	780	0.00006
Corynebacterium provencense	1737425	S	624	159	783	0.00006
Corynebacterium comes	2675218	S	600	160	760	0.00006
Corynebacterium jeikeium	38289	S	561	1513	2074	0.00016
Corynebacterium atypicum	191610	S	560	175	735	0.00006
Corynebacterium glyciniphilum	1404244	S	553	76	629	0.00005
Corynebacterium imitans	156978	S	542	374	916	0.00007
Corynebacterium terpenotabidum	89154	S	537	167	704	0.00005
Corynebacterium urealyticum	43771	S	529	568	1097	0.00008
Corynebacterium sanguinis	2594913	S	526	371	897	0.00007
Corynebacterium falsenii	108486	S	475	214	689	0.00005
Corynebacterium ureicelerivorans	401472	S	464	164	628	0.00005
Corynebacterium lujinxingii	2763010	S	447	162	609	0.00005
Corynebacterium uberis	2883169	S	439	59	498	0.00004
Corynebacterium glaucum	187491	S	428	100	528	0.00004
Corynebacterium efficiens	152794	S	423	84	507	0.00004
Corynebacterium qintianiae	2709392	S	417	124	541	0.00004
Corynebacterium kroppenstedtii	161879	S	401	44	445	0.00003
Corynebacterium testudinoris	136857	S	394	88	482	0.00004
Corynebacterium glucuronolyticum	39791	S	375	97	472	0.00004
Corynebacterium genitalium	38288	S	368	87	455	0.00004
Corynebacterium coyleae	53374	S	363	98	461	0.00004
Corynebacterium aurimucosum	169292	S	357	182	539	0.00004
Corynebacterium incognita	2754725	S	350	87	437	0.00003
Corynebacterium striatum	43770	S	339	306	645	0.00005
Corynebacterium lactis	1231000	S	326	56	382	0.00003
Corynebacterium matruchotii	43768	S	321	26	347	0.00003
Corynebacterium tuberculostearicum	38304	S	321	207	528	0.00004
Corynebacterium occultum	2675219	S	313	61	374	0.00003
Corynebacterium zhongnanshanii	2768834	S	305	47	352	0.00003
Corynebacterium riegelii	156976	S	282	77	359	0.00003
Corynebacterium renale	1724	S	267	35	302	0.00002
Corynebacterium aquilae	203263	S	253	43	296	0.00002
Corynebacterium urogenitale	2487892	S	224	45	269	0.00002
Corynebacterium cystitidis	35757	S	209	15	224	0.00002
Corynebacterium singulare	161899	S	208	197	405	0.00003
Corynebacterium endometrii	2488819	S	208	45	253	0.00002
Corynebacterium epidermidicanis	1050174	S	201	37	238	0.00002
Corynebacterium casei	160386	S	201	254	455	0.00004
Corynebacterium simulans	146827	S	199	158	357	0.00003
Corynebacterium kalinowskii	2675216	S	192	108	300	0.00002
Corynebacterium lizhenjunii	2709394	S	191	37	228	0.00002
Corynebacterium flavescens	28028	S	190	61	251	0.00002
Corynebacterium minutissimum	38301	S	179	188	367	0.00003
Corynebacterium camporealensis	161896	S	177	49	226	0.00002
Corynebacterium phocae	161895	S	171	26	197	0.00002
Corynebacterium propinquum	43769	S	159	74	233	0.00002
Corynebacterium argentoratense	42817	S	145	35	180	0.00001
Corynebacterium diphtheriae	1717	S	140	183	323	0.00002
Corynebacterium kefirresidentii	1979527	S	140	99	239	0.00002
Corynebacterium macginleyi	38290	S	129	34	163	0.00001
Corynebacterium gerontici	2079234	S	124	27	151	0.00001
Corynebacterium glutamicum	1718	S	121	1722	1843	0.00014
Corynebacterium resistens	258224	S	115	69	184	0.00001
Corynebacterium pelargi	1471400	S	115	41	156	0.00001
Corynebacterium choanae	1862358	S	114	13	127	0.00001
Corynebacterium pseudopelargi	2080757	S	112	42	154	0.00001
Corynebacterium stationis	1705	S	111	30	141	0.00001
Corynebacterium ulcerans	65058	S	105	66	171	0.00001
Corynebacterium deserti	1408191	S	104	40	144	0.00001
Corynebacterium pseudodiphtheriticum	37637	S	104	36	140	0.00001
Corynebacterium pseudotuberculosis	1719	S	90	23	113	0.00001
Corynebacterium ammoniagenes	1697	S	90	21	111	0.00001
Corynebacterium mustelae	571915	S	85	7	92	0.00001
Corynebacterium segmentosum	43990	S	77	189	266	0.00002
Corynebacterium hindlerae	699041	S	64	126	190	0.00001
Corynebacterium silvaticum	2320431	S	62	28	90	0.00001
Corynebacterium accolens	38284	S	61	150	211	0.00002
Corynebacterium anserum	2684406	S	57	7	64	0.00000
Corynebacterium callunae	1721	S	55	20	75	0.00001
Corynebacterium amycolatum	43765	S	55	423	478	0.00004
Corynebacterium rouxii	2719119	S	40	24	64	0.00001
Corynebacterium crudilactis	1652495	S	38	49	87	0.00001
Corynebacterium suranareeae	2506452	S	36	11	47	0.00000
Corynebacterium kutscheri	35755	S	24	4	28	0.00000
Gordonia sp. PP30	2935861	S	1954	622	2576	0.00020
Gordonia sp. YC-JH1	2059875	S	1380	1103	2483	0.00019
Gordonia sp. KTR9	337191	S	1288	294	1582	0.00012
Gordonia sp. PDNC005	2811424	S	1067	183	1250	0.00010
Gordonia sp. WA4-43	2878678	S	271	969	1240	0.00010
Gordonia sp. JH63	2698900	S	199	660	859	0.00007
Gordonia sp. 135	2676309	S	101	701	802	0.00006
Gordonia sp. 1D	1737359	S	39	605	644	0.00005
Gordonia polyisoprenivorans	84595	S	2980	697	3677	0.00028
Gordonia terrae	2055	S	2268	1392	3660	0.00028
Gordonia insulae	2420509	S	1671	267	1938	0.00015
Gordonia phthalatica	1136941	S	1564	710	2274	0.00018
Gordonia amarae	36821	S	1546	355	1901	0.00015
Gordonia bronchialis	2054	S	1488	396	1884	0.00015
Gordonia iterans	1004901	S	1486	580	2066	0.00016
Gordonia jinghuaiqii	2758710	S	1479	332	1811	0.00014
Gordonia pseudoamarae	2831662	S	1262	274	1536	0.00012
Gordonia rubripertincta	36822	S	1216	783	1999	0.00015
Gordonia otitidis	249058	S	1076	201	1277	0.00010
Gordonia zhaorongruii	2597659	S	945	196	1141	0.00009
Gordonia alkanivorans	84096	S	326	1256	1582	0.00012
Gordonia amicalis	89053	S	266	1994	2260	0.00017
Gordonia hongkongensis	1701090	S	189	614	803	0.00006
Skermania piniformis	39122	S	1711	248	1959	0.00015
Tsukamurella paurometabola	2061	S	3259	1752	5011	0.00039
Tsukamurella tyrosinosolvens	57704	S	2455	1187	3642	0.00028
Tsukamurella sp. PLM1	2929795	S	1860	673	2533	0.00020
Tsukamurella pulmonis	47312	S	1711	681	2392	0.00018
Dietzia sp. oral taxon 368	712270	S	1022	2053	3075	0.00024
Dietzia lutea	546160	S	1291	840	2131	0.00016
Dietzia psychralcaliphila	139021	S	1206	397	1603	0.00012
Dietzia timorensis	499555	S	876	562	1438	0.00011
Tomitella gaofuii	2760083	S	1808	629	2437	0.00019
Tomitella fengzijianii	2597660	S	1723	647	2370	0.00018
Segniliparus rotundus	286802	S	958	64	1022	0.00008
Lawsonella clevelandensis	1528099	S	169	23	192	0.00001
Micromonospora sp. WMMC415	2675222	S	13161	5436	18597	0.00143
Micromonospora sp. HM134	2583243	S	5257	2553	7810	0.00060
Micromonospora sp. WMMA2032	2039870	S	5227	3723	8950	0.00069
Micromonospora sp. B006	2201999	S	4257	3560	7817	0.00060
Micromonospora sp. L5	648999	S	456	5087	5543	0.00043
Micromonospora echinaurantiaca	47857	S	10565	5583	16148	0.00124
Micromonospora inositola	47865	S	10487	5653	16140	0.00124
Micromonospora echinofusca	47858	S	9048	4528	13576	0.00105
Micromonospora krabiensis	307121	S	8601	3264	11865	0.00091
Micromonospora carbonacea	47853	S	8135	3996	12131	0.00093
Micromonospora terminaliae	1914461	S	7893	4359	12252	0.00094
Micromonospora purpureochromogenes	47872	S	7845	4549	12394	0.00095
Micromonospora viridifaciens	1881	S	7499	3582	11081	0.00085
Micromonospora coxensis	356852	S	6976	4230	11206	0.00086
Micromonospora coriariae	285665	S	6962	2724	9686	0.00075
Micromonospora siamensis	299152	S	6711	3522	10233	0.00079
Micromonospora echinospora	1877	S	6211	2379	8590	0.00066
Micromonospora auratinigra	261654	S	6053	3478	9531	0.00073
Micromonospora narathiwatensis	299146	S	5893	3017	8910	0.00069
Micromonospora sagamiensis	47875	S	5798	2433	8231	0.00063
Micromonospora maris	1003110	S	5781	1941	7722	0.00059
Micromonospora ferruginea	2749844	S	5670	3568	9238	0.00071
Micromonospora chokoriensis	356851	S	5531	1966	7497	0.00058
Micromonospora endophytica (Xie et al. 2001) Li et al. 2019	515350	S	5510	1841	7351	0.00057
Micromonospora zamorensis	709883	S	4958	1746	6704	0.00052
Micromonospora rifamycinica	291594	S	4602	2258	6860	0.00053
Micromonospora craniellae	2294034	S	4117	2744	6861	0.00053
Micromonospora tulbaghiae	479978	S	2992	3435	6427	0.00050
Micromonospora aurantiaca	47850	S	2446	16867	19313	0.00149
Actinoplanes sp. L3-i22	2836373	S	10888	8149	19037	0.00147
Actinoplanes sp. OR16	946334	S	9934	5061	14995	0.00116
Actinoplanes sp. N902-109	649831	S	9236	3086	12322	0.00095
Actinoplanes friuliensis	196914	S	9883	1843	11726	0.00090
Actinoplanes missouriensis	1866	S	9164	3330	12494	0.00096
Actinoplanes ianthinogenes	122358	S	8860	3936	12796	0.00099
Actinoplanes teichomyceticus	1867	S	8146	3819	11965	0.00092
Actinoplanes derwentensis	113562	S	7323	1276	8599	0.00066
Phytohabitans suffuscus	624315	S	20931	5784	26715	0.00206
Phytohabitans flavus	1076124	S	16918	3558	20476	0.00158
Plantactinospora sp. KBS50	2024580	S	8691	2496	11187	0.00086
Plantactinospora sp. BC1	2108470	S	1863	5645	7508	0.00058
Plantactinospora sp. BB1	2071627	S	1797	5387	7184	0.00055
Dactylosporangium vinaceum	53362	S	15229	2045	17274	0.00133
Catellatospora sp. IY07-71	2728827	S	14183	3756	17939	0.00138
Actinocatenispora thailandica	227318	S	5909	1952	7861	0.00061
Actinocatenispora sera	390989	S	5752	2003	7755	0.00060
Couchioplanes caeruleus	56438	S	10128	2980	13108	0.00101
Polymorphospora rubra	338584	S	9980	2567	12547	0.00097
Natronosporangium hydrolyticum	2811111	S	6262	521	6783	0.00052
Verrucosispora sp. NA02020	2742132	S	3560	2958	6518	0.00050
Salinispora tropica	168695	S	3228	621	3849	0.00030
Amycolatopsis sp. DSM 110486	2865832	S	6864	1574	8438	0.00065
Amycolatopsis sp. WQ 127309	2932773	S	6358	2009	8367	0.00064
Amycolatopsis sp. FDAARGOS 1241	2778070	S	6224	1561	7785	0.00060
Amycolatopsis sp. Hca4	2742131	S	5610	2284	7894	0.00061
Amycolatopsis sp. CA-230715	2745196	S	5562	998	6560	0.00051
Amycolatopsis sp. YIM 10	2653857	S	5540	1837	7377	0.00057
Amycolatopsis sp. FU40	2914159	S	3318	1598	4916	0.00038
Amycolatopsis sp. AA4	1896961	S	3070	1722	4792	0.00037
Amycolatopsis sp. BJA-103	1911175	S	2710	1186	3896	0.00030
Amycolatopsis sp. TNS106	2861750	S	2232	1416	3648	0.00028
Amycolatopsis sp. EV170708-02-1	2919322	S	2137	2233	4370	0.00034
Amycolatopsis acidiphila	715473	S	6854	1721	8575	0.00066
Amycolatopsis pretoriensis	218821	S	5490	1979	7469	0.00058
Amycolatopsis mediterranei	33910	S	5469	6816	12285	0.00095
Amycolatopsis albispora	1804986	S	5119	3360	8479	0.00065
Amycolatopsis thermalba	944492	S	4949	2348	7297	0.00056
Amycolatopsis methanolica	1814	S	4806	2151	6957	0.00054
Amycolatopsis keratiniphila	129921	S	2884	2528	5412	0.00042
Amycolatopsis japonica	208439	S	1391	1378	2769	0.00021
Amycolatopsis aidingensis	2842453	S	4616	644	5260	0.00041
Amycolatopsis orientalis	31958	S	3187	1188	4375	0.00034
Pseudonocardia sp. DSM 110487	2865833	S	24149	4067	28216	0.00217
Pseudonocardia sp. CGMCC 4.1532	2761535	S	6329	4009	10338	0.00080
Pseudonocardia sp. HH130630-07	1690815	S	5091	1762	6853	0.00053
Pseudonocardia sp. AL041005-10	445576	S	4186	1778	5964	0.00046
Pseudonocardia sp. HH130629-09	1641402	S	3428	1677	5105	0.00039
Pseudonocardia sp. EC080625-04	1096868	S	133	3630	3763	0.00029
Pseudonocardia sp. EC080619-01	1096856	S	15	3767	3782	0.00029
Pseudonocardia sp. EC080610-09	1688404	S	13	1110	1123	0.00009
Pseudonocardia dioxanivorans	240495	S	9248	2947	12195	0.00094
Pseudonocardia broussonetiae	2736640	S	9055	3457	12512	0.00096
Pseudonocardia autotrophica	2074	S	5711	1817	7528	0.00058
Pseudonocardia abyssalis	2792008	S	5077	2888	7965	0.00061
Allokutzneria albata	211114	S	29283	8355	37638	0.00290
Saccharopolyspora erythraea	1836	S	11399	3758	15157	0.00117
Saccharopolyspora gregorii	33914	S	5069	1221	6290	0.00048
Saccharopolyspora spinosa	60894	S	2369	1609	3978	0.00031
Saccharopolyspora pogona	333966	S	2218	2679	4897	0.00038
Saccharopolyspora sp. ASAGF58	2719023	S	1403	1879	3282	0.00025
Saccharothrix sp. 6-C	2781735	S	9560	3738	13298	0.00102
Saccharothrix syringae	103733	S	8925	3578	12503	0.00096
Saccharothrix espanaensis	103731	S	6631	2262	8893	0.00069
Saccharomonospora marina	632569	S	3625	976	4601	0.00035
Saccharomonospora viridis	1852	S	3217	579	3796	0.00029
Saccharomonospora cyanea	40989	S	3083	1241	4324	0.00033
Saccharomonospora azurea	40988	S	2743	922	3665	0.00028
Saccharomonospora xinjiangensis	75294	S	2008	391	2399	0.00018
Saccharomonospora glauca	40990	S	1780	715	2495	0.00019
Kutzneria sp. CA-103260	2802641	S	7549	1953	9502	0.00073
Kutzneria albida	43357	S	5706	1576	7282	0.00056
Lentzea guizhouensis	1586287	S	12886	3210	16096	0.00124
Kibdelosporangium phytohabitans	860235	S	8206	1172	9378	0.00072
Actinoalloteichus hoggarensis	1470176	S	2685	424	3109	0.00024
Actinoalloteichus hymeniacidonis	340345	S	2105	240	2345	0.00018
Actinoalloteichus sp. GBA129-24	1612551	S	151	1663	1814	0.00014
Actinoalloteichus fjordicus	1612552	S	119	1584	1703	0.00013
Actinosynnema pretiosum	42197	S	2396	5200	7596	0.00059
Actinosynnema mirum	40567	S	270	2657	2927	0.00023
Alloactinosynnema sp. L-07	1653480	S	4923	1293	6216	0.00048
Prauserella marina	530584	S	3039	324	3363	0.00026
Allosaccharopolyspora coralli	2665642	S	2630	668	3298	0.00025
Nocardioides sp. G188	2849501	S	7600	2900	10500	0.00081
Nocardioides sp. JS614	196162	S	6215	2204	8419	0.00065
Nocardioides sp. LMS-CY	2840457	S	5804	2290	8094	0.00062
Nocardioides sp. TF02-7	2917724	S	5302	2107	7409	0.00057
Nocardioides sp. HDW12B	2714939	S	4965	2027	6992	0.00054
Nocardioides sp. W7	2931390	S	4479	1816	6295	0.00048
Nocardioides sp. SCSIO 67246	2872154	S	4196	1357	5553	0.00043
Nocardioides sp. zg-579	2663857	S	4187	2525	6712	0.00052
Nocardioides sp. zg-1228	2763008	S	4164	2186	6350	0.00049
Nocardioides sp. S-1144	2582905	S	4104	1913	6017	0.00046
Nocardioides sp. cx-173	2898796	S	3967	1635	5602	0.00043
Nocardioides sp. S5	2017486	S	3792	2240	6032	0.00046
Nocardioides sp. 603	2483798	S	3533	1952	5485	0.00042
Nocardioides sp. InS609-2	2760705	S	3478	977	4455	0.00034
Nocardioides sp. MC1495	2736757	S	3465	1498	4963	0.00038
Nocardioides sp. CF8	110319	S	3239	1582	4821	0.00037
Nocardioides sp. JQ2195	2592334	S	3034	780	3814	0.00029
Nocardioides sp. zg-536	2803858	S	2940	1545	4485	0.00035
Nocardioides sp. WS12	2486272	S	2624	568	3192	0.00025
Nocardioides sp. ZJ1313	2685869	S	2582	2894	5476	0.00042
Nocardioides sp. dk884	2662361	S	2562	2855	5417	0.00042
Nocardioides sp. Kera G14	2884264	S	2381	622	3003	0.00023
Nocardioides mesophilus	433659	S	7349	2792	10141	0.00078
Nocardioides anomalus	2712223	S	5148	1930	7078	0.00055
Nocardioides humi	449461	S	4869	1988	6857	0.00053
Nocardioides ungokensis	1643322	S	4862	2095	6957	0.00054
Nocardioides euryhalodurans	2518370	S	4349	1648	5997	0.00046
Nocardioides aromaticivorans	200618	S	4222	1974	6196	0.00048
Nocardioides okcheonensis	2894081	S	4122	2312	6434	0.00050
Nocardioides cynanchi	2558918	S	3970	1178	5148	0.00040
Nocardioides rotundus	1774216	S	3841	1847	5688	0.00044
Nocardioides dongkuii	2760089	S	3779	2283	6062	0.00047
Nocardioides aquaticus	160826	S	3687	1399	5086	0.00039
Nocardioides marinisabuli	419476	S	3451	2331	5782	0.00045
Nocardioides dokdonensis	450734	S	3232	1811	5043	0.00039
Nocardioides sambongensis	2589074	S	3163	1134	4297	0.00033
Nocardioides panacisoli	627624	S	3103	962	4065	0.00031
Nocardioides houyundeii	2045452	S	2856	1083	3939	0.00030
Nocardioides seonyuensis	2518371	S	2819	930	3749	0.00029
Nocardioides piscis	2714938	S	2682	1213	3895	0.00030
Nocardioides daphniae	402297	S	2186	1227	3413	0.00026
Nocardioides jishulii	2575440	S	2008	896	2904	0.00022
Nocardioides baekrokdamisoli	1804624	S	1398	223	1621	0.00012
Nocardioides yefusunii	2500546	S	1362	503	1865	0.00014
Aeromicrobium sp. Leaf245	1736306	S	2557	983	3540	0.00027
Aeromicrobium sp. zg-629	2663859	S	2251	920	3171	0.00024
Aeromicrobium sp. A1-2	2107713	S	1898	336	2234	0.00017
Aeromicrobium erythreum	2041	S	2834	1062	3896	0.00030
Aeromicrobium choanae	1736691	S	2635	989	3624	0.00028
Aeromicrobium chenweiae	2079793	S	2478	1032	3510	0.00027
Aeromicrobium marinum	219314	S	2445	675	3120	0.00024
Aeromicrobium yanjiei	2662028	S	2190	845	3035	0.00023
Friedmanniella luteola	546871	S	5089	1354	6443	0.00050
Pimelobacter simplex	2045	S	4278	2068	6346	0.00049
Marmoricola scoriae	642780	S	3831	1868	5699	0.00044
Mumia sp. ZJ1417	2708082	S	3341	750	4091	0.00032
Micropruina glycogenica	75385	S	2086	400	2486	0.00019
Microlunatus sagamiharensis	546874	S	4509	1385	5894	0.00045
Microlunatus phosphovorus	29405	S	3186	496	3682	0.00028
Microlunatus soli	630515	S	2973	408	3381	0.00026
Microlunatus elymi	2596828	S	2709	419	3128	0.00024
Microlunatus sp. Gsoil 973	2672569	S	2308	252	2560	0.00020
Tessaracoccus sp. J1M15	2829499	S	1804	633	2437	0.00019
Tessaracoccus sp. MC1865	2760310	S	1433	424	1857	0.00014
Tessaracoccus defluvii	1285901	S	1879	1315	3194	0.00025
Tessaracoccus aquimaris	1332264	S	1684	909	2593	0.00020
Tessaracoccus flavescens	399497	S	1606	1358	2964	0.00023
Tessaracoccus flavus	1610493	S	1465	1138	2603	0.00020
Tessaracoccus timonensis	2161816	S	936	481	1417	0.00011
Brevilactibacter coleopterorum	2714937	S	2916	1643	4559	0.00035
Brevilactibacter sp. MC1595	2819349	S	2553	1258	3811	0.00029
Acidipropionibacterium jensenii	1749	S	1695	1312	3007	0.00023
Acidipropionibacterium acidipropionici	1748	S	1613	1182	2795	0.00022
Acidipropionibacterium virtanenii	2057246	S	1163	277	1440	0.00011
Propionibacterium acidifaciens	556499	S	1699	450	2149	0.00017
Propionibacterium freudenreichii	1744	S	1439	1181	2620	0.00020
Propionibacterium australiense	119981	S	1306	254	1560	0.00012
Auraticoccus monumenti	675864	S	3433	814	4247	0.00033
Cutibacterium avidum	33010	S	1013	359	1372	0.00011
Cutibacterium granulosum	33011	S	666	163	829	0.00006
Cutibacterium acnes	1747	S	460	459	919	0.00007
Cutibacterium modestum	2559073	S	212	35	247	0.00002
Arachnia propionica	1750	S	1435	208	1643	0.00013
Arachnia rubra	1547448	S	774	107	881	0.00007
Raineyella fluvialis	2662261	S	2113	367	2480	0.00019
Vaginimicrobium propionicum	1871034	S	106	50	156	0.00001
Kribbella flavida	182640	S	12565	3542	16107	0.00124
Kribbella qitaiheensis	1544730	S	8774	1653	10427	0.00080
Actinopolymorpha singaporensis	117157	S	5981	862	6843	0.00053
Nonomuraea gerenzanensis	93944	S	14952	5684	20636	0.00159
Nonomuraea nitratireducens	2656914	S	14581	3739	18320	0.00141
Nonomuraea sp. ATCC 55076	1909395	S	14206	5179	19385	0.00149
Nonomuraea coxensis	404386	S	11905	4128	16033	0.00124
Streptosporangium roseum	2001	S	9479	3110	12589	0.00097
Streptosporangium sp. 'caverna'	2202249	S	8502	2198	10700	0.00082
Thermobispora bispora	2006	S	5440	1574	7014	0.00054
Actinomadura sp. WMMB 499	1219491	S	11165	3325	14490	0.00112
Actinomadura sp. NAK00032	2742128	S	10184	4497	14681	0.00113
Actinomadura sp. WMMA1423	2591108	S	9268	3440	12708	0.00098
Actinomadura madurae	1993	S	11917	4452	16369	0.00126
Actinomadura verrucosospora	46165	S	9867	3728	13595	0.00105
Actinomadura graeca	2750812	S	7813	2258	10071	0.00078
Thermomonospora amylolytica	1411117	S	6798	3091	9889	0.00076
Thermomonospora curvata	2020	S	4896	1756	6652	0.00051
Nocardiopsis sp. MT53	2865672	S	4368	1276	5644	0.00043
Nocardiopsis sp. HDS12	2831968	S	1703	1671	3374	0.00026
Nocardiopsis gilva	280236	S	3355	845	4200	0.00032
Nocardiopsis dassonvillei	2014	S	3239	2691	5930	0.00046
Nocardiopsis alba	53437	S	2132	479	2611	0.00020
Thermobifida halotolerans	483545	S	2790	1107	3897	0.00030
Thermobifida alba	53522	S	2607	1263	3870	0.00030
Thermobifida fusca	2021	S	1735	366	2101	0.00016
Streptomonospora litoralis	2498135	S	3773	924	4697	0.00036
Spiractinospora alimapuensis	2820884	S	2517	207	2724	0.00021
Blastococcus sp. PRF04-17	2933797	S	9385	3876	13261	0.00102
Blastococcus saxobsidens	138336	S	8368	3086	11454	0.00088
Modestobacter marinus	477641	S	8718	3605	12323	0.00095
Modestobacter sp. L9-4	2851567	S	5031	2296	7327	0.00056
Geodermatophilus obscurus	1861	S	11222	4548	15770	0.00121
Actinomyces sp. oral taxon 414	712122	S	1361	327	1688	0.00013
Actinomyces sp. MAS-1	2755559	S	925	213	1138	0.00009
Actinomyces sp. Z16	2079536	S	845	321	1166	0.00009
Actinomyces sp. Chiba101	1851395	S	651	328	979	0.00008
Actinomyces sp. 432	2057798	S	594	147	741	0.00006
Actinomyces sp. oral taxon 171	706438	S	320	268	588	0.00005
Actinomyces sp. oral taxon 169	712116	S	184	339	523	0.00004
Actinomyces sp. HMT897	2789424	S	137	454	591	0.00005
Actinomyces sp. oral taxon 897	2081702	S	136	460	596	0.00005
Actinomyces sp. HMT 175	2789425	S	115	475	590	0.00005
Actinomyces sp. zg-332	2708340	S	23	5	28	0.00000
Actinomyces radicidentis	111015	S	1419	695	2114	0.00016
Actinomyces howellii	52771	S	1225	226	1451	0.00011
Actinomyces slackii	52774	S	893	176	1069	0.00008
Actinomyces respiraculi	2744574	S	876	243	1119	0.00009
Actinomyces procaprae	2560010	S	781	303	1084	0.00008
Actinomyces weissii	675090	S	700	162	862	0.00007
Actinomyces faecalis	2722820	S	653	111	764	0.00006
Actinomyces qiguomingii	2057800	S	614	94	708	0.00005
Actinomyces viscosus	1656	S	594	265	859	0.00007
Actinomyces naeslundii	1655	S	525	320	845	0.00007
Actinomyces oris	544580	S	474	1335	1809	0.00014
Actinomyces wuliandei	2057743	S	462	131	593	0.00005
Actinomyces gaoshouyii	1960083	S	435	238	673	0.00005
Actinomyces lilanjuaniae	2321394	S	402	104	506	0.00004
Actinomyces marmotae	2737173	S	387	229	616	0.00005
Actinomyces trachealis	2763540	S	289	62	351	0.00003
Actinomyces pacaensis	1852377	S	114	17	131	0.00001
Schaalia sp. 19OD2882	2794089	S	669	111	780	0.00006
Schaalia sp. JY-X169	2758572	S	243	11	254	0.00002
Schaalia sp. ZJ405	2709403	S	209	24	233	0.00002
Schaalia odontolytica	1660	S	817	230	1047	0.00008
Schaalia meyeri	52773	S	463	99	562	0.00004
Schaalia cardiffensis	181487	S	292	52	344	0.00003
Schaalia turicensis	131111	S	146	186	332	0.00003
Flaviflexus salsibiostraticola	1282737	S	828	270	1098	0.00008
Flaviflexus sp. dk850	2758573	S	444	203	647	0.00005
Flaviflexus ciconiae	2496867	S	306	48	354	0.00003
Trueperella pecoris	2733571	S	617	211	828	0.00006
Trueperella pyogenes	1661	S	439	305	744	0.00006
Trueperella bialowiezensis	312285	S	318	21	339	0.00003
Pauljensenia hongkongensis	178339	S	771	330	1101	0.00008
Nanchangia anserum	2692125	S	692	94	786	0.00006
Actinobaculum sp. 313	2495645	S	356	24	380	0.00003
Actinotignum schaalii	59505	S	273	23	296	0.00002
Changpingibacter yushuensis	2758440	S	230	80	310	0.00002
Arcanobacterium haemolyticum	28264	S	82	45	127	0.00001
Arcanobacterium phocae	131112	S	43	13	56	0.00000
Arcanobacterium phocisimile	1302235	S	36	10	46	0.00000
Arcanobacterium sp. 2701	2722751	S	33	8	41	0.00000
Mobiluncus curtisii	2051	S	155	56	211	0.00002
Varibaculum sp. EMRHCC_39	2811781	S	78	29	107	0.00001
Fannyhessea vaginae	82135	S	69	26	95	0.00001
Boudabousia tangfeifanii	1912795	S	52	5	57	0.00000
Frankia inefficax	298654	S	8672	1269	9941	0.00077
Frankia sp. QA3	710111	S	3427	1660	5087	0.00039
Frankia sp. ArI3	1858	S	2563	1952	4515	0.00035
Candidatus Frankia datiscae	2716812	S	3973	648	4621	0.00036
Frankia casuarinae	106370	S	3270	425	3695	0.00028
Frankia alni	1859	S	2874	2302	5176	0.00040
Jiangella sp. DSM 45060	1798224	S	10848	3837	14685	0.00113
Jiangella alkaliphila	419479	S	9527	3235	12762	0.00098
Bifidobacterium choerinum	35760	S	947	494	1441	0.00011
Bifidobacterium pseudolongum	1694	S	923	387	1310	0.00010
Bifidobacterium scardovii	158787	S	856	88	944	0.00007
Bifidobacterium longum	216816	S	846	3033	3879	0.00030
Bifidobacterium bifidum	1681	S	678	366	1044	0.00008
Bifidobacterium pullorum	78448	S	655	307	962	0.00007
Bifidobacterium animalis	28025	S	518	647	1165	0.00009
Bifidobacterium asteroides	1684	S	489	16	505	0.00004
Bifidobacterium adolescentis	1680	S	457	91	548	0.00004
Bifidobacterium subtile	77635	S	454	85	539	0.00004
Bifidobacterium thermophilum	33905	S	348	98	446	0.00003
Bifidobacterium breve	1685	S	337	366	703	0.00005
Bifidobacterium eulemuris	1765219	S	326	60	386	0.00003
Bifidobacterium actinocoloniiforme	638619	S	307	12	319	0.00002
Bifidobacterium lemurum	1603886	S	286	55	341	0.00003
Bifidobacterium dentium	1689	S	254	18	272	0.00002
Bifidobacterium angulatum	1683	S	228	61	289	0.00002
Bifidobacterium catenulatum	1686	S	171	226	397	0.00003
Bifidobacterium pseudocatenulatum	28026	S	144	89	233	0.00002
Bifidobacterium imperatoris	2020965	S	76	31	107	0.00001
Bifidobacterium saguini	762210	S	69	24	93	0.00001
Bifidobacterium indicum	1691	S	54	49	103	0.00001
Bifidobacterium coryneforme	1687	S	41	37	78	0.00001
Parascardovia denticolens	78258	S	239	53	292	0.00002
Gardnerella vaginalis	2702	S	29	52	81	0.00001
Scardovia inopinata	78259	S	22	10	32	0.00000
Nakamurella multipartita	53461	S	4430	1024	5454	0.00042
Nakamurella panacisegetis	1090615	S	2515	430	2945	0.00023
Nakamurella sp. PAMC28650	2762325	S	2227	293	2520	0.00019
Nakamurella antarctica	1902245	S	509	47	556	0.00004
Catenulispora acidiphila	304895	S	5951	1064	7015	0.00054
Stackebrandtia nassauensis	283811	S	4223	471	4694	0.00036
Natronoglycomyces albus	2811108	S	741	32	773	0.00006
Jatrophihabitans telluris	2038343	S	2294	249	2543	0.00020
Jatrophihabitans sp. GAS493	1907575	S	2285	264	2549	0.00020
Kineococcus radiotolerans	131568	S	3418	1160	4578	0.00035
Actinopolyspora erythraea	414996	S	2253	282	2535	0.00020
Epidermidibacterium keratini	1891644	S	2122	1251	3373	0.00026
Acidothermus cellulolyticus	28049	S	1680	105	1785	0.00014
Candidatus Planktophila lacus	1884913	S	73	15	88	0.00001
Candidatus Planktophila versatilis	1884905	S	41	12	53	0.00000
Candidatus Planktophila sulfonica	1884904	S	40	18	58	0.00000
Candidatus Planktophila dulcis	1884914	S	40	34	74	0.00001
Candidatus Planktophila vernalis	1884907	S	30	8	38	0.00000
Candidatus Planktophila limnetica	573600	S	23	5	28	0.00000
Candidatus Nanopelagicus hibericus	1884915	S	24	19	43	0.00000
Candidatus Nanopelagicus limnes	1884634	S	13	26	39	0.00000
Aquihabitans sp. G128	2849779	S	15200	3625	18825	0.00145
Aquihabitans sp. Kera 3	2884263	S	13663	2629	16292	0.00126
Iamia sp. SCSIO 61187	2722752	S	17654	3316	20970	0.00162
Actinomarinicola tropica	2789776	S	16339	3783	20122	0.00155
Ilumatobacter coccineus	467094	S	5138	368	5506	0.00042
Acidimicrobium ferrooxidans	53635	S	2098	190	2288	0.00018
Rubrobacter xylanophilus	49319	S	18972	2933	21905	0.00169
Rubrobacter tropicus	2653851	S	16502	1405	17907	0.00138
Rubrobacter marinus	2653852	S	11974	1215	13189	0.00102
Rubrobacter radiotolerans	42256	S	4605	686	5291	0.00041
Rubrobacter indicoceani	2051957	S	2619	235	2854	0.00022
Baekduia soli	496014	S	11694	2369	14063	0.00108
Conexibacter sp. SYSU D00693	2812560	S	13866	3928	17794	0.00137
Conexibacter sp. DBS9H8	2937801	S	4673	517	5190	0.00040
Conexibacter sp. S30A1	2937800	S	4615	567	5182	0.00040
Conexibacter woesei	191495	S	18257	3783	22040	0.00170
Miltoncostaea marina	2843215	S	8773	2520	11293	0.00087
Miltoncostaea oceani	2843216	S	8144	1395	9539	0.00073
Eggerthella lenta	84112	S	1028	751	1779	0.00014
Eggerthella guodeyinii	2690837	S	899	485	1384	0.00011
Eggerthella sp. YY7918	502558	S	241	125	366	0.00003
Gordonibacter urolithinfaciens	1335613	S	538	467	1005	0.00008
Gordonibacter pamelaeae	471189	S	511	602	1113	0.00009
Adlercreutzia equolifaciens	446660	S	505	331	836	0.00006
Adlercreutzia hattorii	2707299	S	290	393	683	0.00005
Arabiibacter massiliensis	1870985	S	1112	269	1381	0.00011
Raoultibacter timonensis	1907662	S	704	65	769	0.00006
Berryella intestinalis	1531429	S	557	744	1301	0.00010
Slackia heliotrinireducens	84110	S	456	17	473	0.00004
Denitrobacterium detoxificans	79604	S	320	159	479	0.00004
Phoenicibacter congonensis	1944646	S	79	42	121	0.00001
Cryptobacterium curtum	84163	S	44	6	50	0.00000
Olsenella timonensis	1805478	S	1093	405	1498	0.00012
Olsenella uli	133926	S	521	67	588	0.00005
Olsenella sp. oral taxon 807	712411	S	448	32	480	0.00004
Parolsenella massiliensis	1871022	S	531	353	884	0.00007
Parolsenella catena	2003188	S	454	323	777	0.00006
Parafannyhessea umbonata	604330	S	661	474	1135	0.00009
Thermophilibacter immobilis	2779519	S	639	308	947	0.00007
Atopobium sp. oral taxon 416	712157	S	196	25	221	0.00002
Lancefieldella parvula	1382	S	38	4	42	0.00000
Collinsella aerofaciens	74426	S	939	581	1520	0.00012
Collinsella stercoris	147206	S	633	113	746	0.00006
Collinsella sp. zg1085	2844380	S	47	2	49	0.00000
Coriobacterium glomerans	33871	S	438	17	455	0.00004
Euzebya pacifica	1608957	S	5173	545	5718	0.00044
Egicoccus halophilus	1670830	S	5159	986	6145	0.00047
Egibacter rhizosphaerae	1670831	S	4998	372	5370	0.00041
Bacillus sp. Y1	352858	S	1037	528	1565	0.00012
Bacillus sp. S3	486398	S	452	174	626	0.00005
Bacillus sp. 1NLA3E	666686	S	215	101	316	0.00002
Bacillus sp. FJAT-18017	1705566	S	204	73	277	0.00002
Bacillus sp. OxB-1	98228	S	158	54	212	0.00002
Bacillus sp. JY-23	2933872	S	157	80	237	0.00002
Bacillus sp. NSP9.1	1071078	S	140	15	155	0.00001
Bacillus sp. KH172YL63	2709784	S	125	58	183	0.00001
Bacillus sp. SB49	1071080	S	112	26	138	0.00001
Bacillus sp. FJAT-42376	2014076	S	105	52	157	0.00001
Bacillus sp. PAMC26568	2760090	S	104	14	118	0.00001
Bacillus sp. THAF10	2587848	S	79	35	114	0.00001
Bacillus sp. FJAT-22090	1581038	S	76	29	105	0.00001
Bacillus sp. M4U3P1	2592382	S	68	12	80	0.00001
Bacillus sp. WP8	756828	S	39	73	112	0.00001
Bacillus sp. N1-1	2682541	S	39	50	89	0.00001
Bacillus sp. Cs-700	2589818	S	29	39	68	0.00001
Bacillus sp. NP247	2846779	S	15	28	43	0.00000
Bacillus velezensis	492670	S	211	5307	5518	0.00043
Bacillus amyloliquefaciens	1390	S	125	3528	3653	0.00028
Bacillus siamensis	659243	S	35	141	176	0.00001
Bacillus subtilis	1423	S	484	8905	9389	0.00072
Bacillus paralicheniformis	1648923	S	197	169	366	0.00003
Bacillus mojavensis	72360	S	50	77	127	0.00001
Bacillus halotolerans	260554	S	23	76	99	0.00001
Bacillus atrophaeus	1452	S	72	129	201	0.00002
Bacillus vallismortis	72361	S	64	102	166	0.00001
Bacillus tequilensis	227866	S	56	67	123	0.00001
Bacillus licheniformis	1402	S	41	475	516	0.00004
Bacillus spizizenii	96241	S	14	65	79	0.00001
Bacillus inaquosorum	483913	S	11	135	146	0.00001
Bacillus cereus	1396	S	208	11968	12176	0.00094
Bacillus pseudomycoides	64104	S	156	90	246	0.00002
Bacillus thuringiensis	1428	S	151	8437	8588	0.00066
Bacillus mycoides	1405	S	136	262	398	0.00003
Bacillus cytotoxicus	580165	S	131	112	243	0.00002
Bacillus wiedmannii	1890302	S	21	43	64	0.00000
Bacillus anthracis	1392	S	21	1488	1509	0.00012
Bacillus luti	2026191	S	18	24	42	0.00000
Bacillus nitratireducens	2026193	S	11	24	35	0.00000
Bacillus toyonensis	155322	S	10	97	107	0.00001
Bacillus infantis	324767	S	286	108	394	0.00003
Bacillus glycinifermentans	1664069	S	260	113	373	0.00003
[Brevibacterium] frigoritolerans	450367	S	244	123	367	0.00003
Bacillus badius	1455	S	216	118	334	0.00003
Bacillus methanolicus	1471	S	192	164	356	0.00003
Bacillus dafuensis	1742359	S	171	83	254	0.00002
Bacillus gobiensis	1441095	S	131	52	183	0.00001
Bacillus safensis	561879	S	119	223	342	0.00003
Bacillus pumilus	1408	S	113	139	252	0.00002
Bacillus weihaiensis	1547283	S	103	47	150	0.00001
Bacillus fonticola	2728853	S	100	37	137	0.00001
Bacillus cabrialesii	2487276	S	98	125	223	0.00002
Bacillus smithii	1479	S	95	78	173	0.00001
Bacillus aquiflavi	2672567	S	84	30	114	0.00001
Bacillus altitudinis	293387	S	68	360	428	0.00003
Bacillus rugosus	2715209	S	51	68	119	0.00001
Bacillus shivajii	1983719	S	42	8	50	0.00000
Priestia megaterium	1404	S	5428	9191	14619	0.00113
Priestia filamentosa	1402861	S	3534	611	4145	0.00032
Priestia koreensis	284581	S	163	76	239	0.00002
Priestia flexa	86664	S	150	63	213	0.00002
Priestia aryabhattai	412384	S	149	1083	1232	0.00009
Priestia sp. J2	2886505	S	20	244	264	0.00002
Cytobacillus oceanisediminis	665099	S	1957	1262	3219	0.00025
Cytobacillus firmus	1399	S	605	360	965	0.00007
Cytobacillus gottheilii	859144	S	180	79	259	0.00002
Cytobacillus ciccensis	1670641	S	155	77	232	0.00002
Cytobacillus sp. CY-G	2901381	S	109	51	160	0.00001
Cytobacillus kochii	859143	S	90	37	127	0.00001
Geobacillus subterraneus	129338	S	479	384	863	0.00007
Geobacillus genomosp. 3	1921421	S	305	118	423	0.00003
Geobacillus stearothermophilus	1422	S	246	362	608	0.00005
Geobacillus sp. 46C-IIa	1963025	S	114	61	175	0.00001
Geobacillus sp. Y412MC52	550542	S	28	93	121	0.00001
Geobacillus sp. C56-T3	691437	S	23	93	116	0.00001
Geobacillus sp. JS12	1813182	S	21	69	90	0.00001
Geobacillus thermocatenulatus	33938	S	89	98	187	0.00001
Geobacillus thermoleovorans	33941	S	25	847	872	0.00007
Geobacillus zalihae	213419	S	31	213	244	0.00002
Geobacillus thermodenitrificans	33940	S	29	153	182	0.00001
Metabacillus sediminilitoris	2567941	S	1298	649	1947	0.00015
Metabacillus sp. KUDC1714	2745198	S	564	260	824	0.00006
Metabacillus sp. cB07	2806989	S	107	54	161	0.00001
Metabacillus sp. B2-18	2897333	S	44	78	122	0.00001
Metabacillus dongyingensis	2874282	S	192	91	283	0.00002
Metabacillus litoralis	152268	S	93	113	206	0.00002
Metabacillus endolithicus	1535204	S	47	70	117	0.00001
Hydrogenibacillus sp. N12	2866627	S	1785	323	2108	0.00016
Mesobacillus foraminis	279826	S	706	252	958	0.00007
Mesobacillus jeotgali	129985	S	361	193	554	0.00004
Mesobacillus sp. S13	2880221	S	349	205	554	0.00004
Anoxybacillus sediminis	2613334	S	766	248	1014	0.00008
Anoxybacillus caldiproteolyticus	247480	S	125	38	163	0.00001
Anoxybacillus amylolyticus	294699	S	104	30	134	0.00001
Anoxybacillus flavithermus	33934	S	90	92	182	0.00001
Anoxybacillus sp. PDR2	1636720	S	16	85	101	0.00001
Anoxybacillus kamchatkensis	196180	S	14	89	103	0.00001
Peribacillus asahii	228899	S	533	360	893	0.00007
Peribacillus simplex	1478	S	239	198	437	0.00003
Peribacillus butanolivorans	421767	S	172	78	250	0.00002
Peribacillus muralis	264697	S	95	30	125	0.00001
Peribacillus psychrosaccharolyticus	1407	S	92	43	135	0.00001
Alkalihalobacillus clausii	79880	S	915	258	1173	0.00009
Alkalihalobacillus krulwichiae	199441	S	84	34	118	0.00001
Alkalihalobacillus sp. LMS39	2924032	S	56	16	72	0.00001
Alkalihalobacillus miscanthi	2598861	S	35	17	52	0.00000
Alkalihalobacillus lehensis	300825	S	23	10	33	0.00000
Terribacillus goriensis	386490	S	937	216	1153	0.00009
Terribacillus aidingensis	586416	S	86	20	106	0.00001
Neobacillus drentensis	220684	S	449	263	712	0.00005
Neobacillus mesonae	1193713	S	316	142	458	0.00004
Lysinibacillus sp. SGAir0095	2070463	S	91	51	142	0.00001
Lysinibacillus sp. PLM2	2929796	S	46	25	71	0.00001
Lysinibacillus sp. Ag94	2936682	S	27	4	31	0.00000
Lysinibacillus sp. CD3-6	2892541	S	26	14	40	0.00000
Lysinibacillus sp. 2017	2169540	S	25	16	41	0.00000
Lysinibacillus sp. YS11	2072025	S	11	43	54	0.00000
Lysinibacillus timonensis	2086577	S	74	52	126	0.00001
Lysinibacillus fusiformis	28031	S	50	79	129	0.00001
Lysinibacillus sphaericus	1421	S	47	84	131	0.00001
Lysinibacillus parviboronicapiens	436516	S	33	16	49	0.00000
Lysinibacillus agricola	2590012	S	33	14	47	0.00000
Parageobacillus caldoxylosilyticus	81408	S	137	80	217	0.00002
Parageobacillus genomosp. 1	1295642	S	112	58	170	0.00001
Parageobacillus thermoglucosidasius	1426	S	105	77	182	0.00001
Parageobacillus toebii	153151	S	83	90	173	0.00001
Parageobacillus sp. KH3-4	2916802	S	69	41	110	0.00001
Virgibacillus sp. NKC19-16	2831673	S	66	7	73	0.00001
Virgibacillus sp. Bac332	2419842	S	54	7	61	0.00000
Virgibacillus sp. MSP4-1	2700081	S	51	14	65	0.00001
Virgibacillus sp. SK37	403957	S	28	10	38	0.00000
Virgibacillus sp. Bac330	2419841	S	17	5	22	0.00000
Virgibacillus sp. 6R	1911587	S	11	61	72	0.00001
Virgibacillus necropolis	163877	S	66	11	77	0.00001
Virgibacillus halodenitrificans	1482	S	63	24	87	0.00001
Virgibacillus phasianinus	2017483	S	52	9	61	0.00000
Virgibacillus dokdonensis	302167	S	22	7	29	0.00000
Virgibacillus pantothenticus	1473	S	10	54	64	0.00000
Oceanobacillus kimchii	746691	S	308	42	350	0.00003
Oceanobacillus iheyensis	182710	S	133	36	169	0.00001
Oceanobacillus zhaokaii	2052660	S	74	19	93	0.00001
Niallia sp. Man26	2912824	S	222	70	292	0.00002
Niallia circulans	1397	S	218	85	303	0.00002
Rossellomorea marisflavi	189381	S	306	159	465	0.00004
Rossellomorea vietnamensis	218284	S	103	54	157	0.00001
Weizmannia coagulans	1398	S	376	230	606	0.00005
Salicibibacter halophilus	2502791	S	104	27	131	0.00001
Salicibibacter cibarius	2743000	S	93	21	114	0.00001
Salicibibacter kimchii	2099786	S	84	9	93	0.00001
Salicibibacter cibi	2743001	S	49	7	56	0.00000
Halobacillus sp. SSBR10-3	2932257	S	73	12	85	0.00001
Halobacillus sp. SSHM10-5	2932259	S	68	17	85	0.00001
Halobacillus sp. SSTM10-2	2932258	S	63	14	77	0.00001
Halobacillus litoralis	45668	S	53	11	64	0.00000
Halobacillus mangrovi	402384	S	46	9	55	0.00000
Halobacillus halophilus	1570	S	34	6	40	0.00000
Salisediminibacterium selenitireducens	85683	S	151	30	181	0.00001
Salisediminibacterium beveridgei	632773	S	85	17	102	0.00001
Sutcliffiella horikoshii	79883	S	150	54	204	0.00002
Sutcliffiella cohnii	33932	S	85	48	133	0.00001
Gracilibacillus sp. SSPM10-3	2932255	S	67	22	89	0.00001
Gracilibacillus sp. SSWR10-1	2932256	S	43	14	57	0.00000
Gracilibacillus salitolerans	2663022	S	98	14	112	0.00001
Heyndrickxia oleronia	38875	S	119	61	180	0.00001
Heyndrickxia vini	1476025	S	89	35	124	0.00001
Fictibacillus arsenicus	255247	S	108	26	134	0.00001
Fictibacillus phosphorivorans	1221500	S	65	15	80	0.00001
Lentibacillus sp. CBA3610	2518176	S	95	10	105	0.00001
Lentibacillus amyloliquefaciens	1472767	S	74	11	85	0.00001
Caldalkalibacillus thermarum	296745	S	168	43	211	0.00002
Caldibacillus thermoamylovorans	35841	S	115	57	172	0.00001
Aeribacillus pallidus	33936	S	114	82	196	0.00002
Psychrobacillus sp. INOP01	2829187	S	58	25	83	0.00001
Psychrobacillus glaciei	2283160	S	47	22	69	0.00001
Gottfriedia acidiceleris	371036	S	105	41	146	0.00001
Pontibacillus sp. HMF3514	2692425	S	52	10	62	0.00000
Pontibacillus sp. ALD_SL1	2777185	S	48	8	56	0.00000
Salimicrobium jeotgali	1230341	S	98	20	118	0.00001
Halalkalibacterium halodurans	86665	S	97	91	188	0.00001
Sediminibacillus sp. DP4-553-S	2729421	S	82	19	101	0.00001
Radiobacillus deserti	2594883	S	39	10	49	0.00000
Radiobacillus sp. 80	2844358	S	37	10	47	0.00000
Lederbergia lenta	1467	S	76	25	101	0.00001
Pradoshia sp. D12	2651284	S	73	29	102	0.00001
Alkalihalophilus pseudofirmus	79885	S	72	17	89	0.00001
Anaerobacillus isosaccharinicus	1532552	S	68	21	89	0.00001
Evansella cellulosilytica	1413	S	59	12	71	0.00001
Mangrovibacillus cuniculi	2593652	S	45	32	77	0.00001
Paraliobacillus zengyii	2213194	S	43	10	53	0.00000
Amphibacillus xylanus	1449	S	38	9	47	0.00000
Paenibacillus sp. B01	2660554	S	1838	692	2530	0.00019
Paenibacillus sp. RUD330	2023772	S	1096	147	1243	0.00010
Paenibacillus sp. 32O-W	1695218	S	917	113	1030	0.00008
Paenibacillus sp. H1-7	2282849	S	461	52	513	0.00004
Paenibacillus sp. R14(2021)	2859228	S	435	77	512	0.00004
Paenibacillus sp. sptzw28	715179	S	299	34	333	0.00003
Paenibacillus sp. URB8-2	2741301	S	257	73	330	0.00003
Paenibacillus sp. FSL R7-0273	1536772	S	253	54	307	0.00002
Paenibacillus sp. YPD9-1	2908839	S	246	39	285	0.00002
Paenibacillus sp. JZ16	1906272	S	221	66	287	0.00002
Paenibacillus sp. BIHB4019	1870819	S	214	21	235	0.00002
Paenibacillus sp. PK3_47	2072642	S	211	37	248	0.00002
Paenibacillus sp. PAMC21692	2762320	S	209	205	414	0.00003
Paenibacillus sp. HWE-109	1306526	S	203	21	224	0.00002
Paenibacillus sp. FSL R7-0331	1536773	S	188	42	230	0.00002
Paenibacillus sp. FSL H7-0357	1536774	S	185	31	216	0.00002
Paenibacillus sp. Y412MC10	481743	S	180	447	627	0.00005
Paenibacillus sp. JNUCC-32	2777984	S	171	448	619	0.00005
Paenibacillus sp. CAA11	1532905	S	153	37	190	0.00001
Paenibacillus sp. YPG26	2878915	S	150	38	188	0.00001
Paenibacillus sp. FSL P4-0081	1536769	S	125	88	213	0.00002
Paenibacillus sp. FSL R5-0912	1536771	S	112	72	184	0.00001
Paenibacillus sp. 481	2835869	S	110	13	123	0.00001
Paenibacillus sp. 19GGS1-52	2758563	S	107	13	120	0.00001
Paenibacillus sp. DCT19	2211212	S	105	22	127	0.00001
Paenibacillus sp. IHB B 3084	867076	S	84	56	140	0.00001
Paenibacillus sp. JNUCC-31	2777983	S	71	24	95	0.00001
Paenibacillus sp. E222	2748863	S	67	28	95	0.00001
Paenibacillus sp. IHBB 10380	1566358	S	52	12	64	0.00000
Paenibacillus sp. N3/727	2925845	S	48	67	115	0.00001
Paenibacillus sp. FSL R5-0345	1536770	S	39	14	53	0.00000
Paenibacillus sp. FSL H7-0737	1536775	S	33	13	46	0.00000
Paenibacillus sp. Cedars	1980674	S	21	140	161	0.00001
Paenibacillus mucilaginosus	61624	S	1876	160	2036	0.00016
Paenibacillus albicereus	2726185	S	1502	522	2024	0.00016
Paenibacillus lycopersici	2704462	S	1191	182	1373	0.00011
Paenibacillus macerans	44252	S	677	78	755	0.00006
Paenibacillus rhizovicinus	2704463	S	654	108	762	0.00006
Paenibacillus cellulositrophicus	562959	S	649	81	730	0.00006
Paenibacillus konkukensis	2020716	S	616	83	699	0.00005
Paenibacillus dendritiformis	130049	S	598	125	723	0.00006
Paenibacillus beijingensis	1126833	S	506	73	579	0.00004
Paenibacillus chitinolyticus	79263	S	474	72	546	0.00004
Paenibacillus stellifer	169760	S	458	102	560	0.00004
Paenibacillus thiaminolyticus	49283	S	452	94	546	0.00004
Paenibacillus ihbetae	1870820	S	452	79	531	0.00004
Paenibacillus durus	44251	S	386	168	554	0.00004
Paenibacillus cellulosilyticus	375489	S	362	58	420	0.00003
Paenibacillus sabinae	365617	S	332	100	432	0.00003
Paenibacillus lautus	1401	S	314	449	763	0.00006
Paenibacillus albus	2495582	S	309	52	361	0.00003
Paenibacillus donghaensis	414771	S	308	41	349	0.00003
Paenibacillus naphthalenovorans	162209	S	298	53	351	0.00003
Paenibacillus riograndensis	483937	S	92	92	184	0.00001
Paenibacillus sonchi	373687	S	72	142	214	0.00002
Paenibacillus polymyxa	1406	S	237	1100	1337	0.00010
Paenibacillus protaetiae	2509456	S	235	44	279	0.00002
Paenibacillus azoreducens	116718	S	229	34	263	0.00002
Paenibacillus agaridevorans	171404	S	227	302	529	0.00004
Paenibacillus xylanilyticus	248903	S	224	58	282	0.00002
Paenibacillus tritici	1873425	S	223	41	264	0.00002
Paenibacillus physcomitrellae	1619311	S	217	89	306	0.00002
Paenibacillus sophorae	1333845	S	205	87	292	0.00002
Paenibacillus algicola	2565926	S	196	40	236	0.00002
Paenibacillus borealis	160799	S	189	78	267	0.00002
Paenibacillus tianjinensis	2810347	S	187	39	226	0.00002
Paenibacillus swuensis	1178515	S	182	33	215	0.00002
Paenibacillus yonginensis	1462996	S	182	98	280	0.00002
Paenibacillus psychroresistens	1778678	S	164	12	176	0.00001
Paenibacillus guangzhouensis	1473112	S	163	20	183	0.00001
Paenibacillus lutimineralis	2707005	S	152	26	178	0.00001
Paenibacillus alvei	44250	S	147	24	171	0.00001
Paenibacillus lentus	1338368	S	139	18	157	0.00001
Paenibacillus bovis	1616788	S	124	21	145	0.00001
Paenibacillus jilunlii	682956	S	122	97	219	0.00002
Paenibacillus graminis	189425	S	120	74	194	0.00001
Paenibacillus barcinonensis	198119	S	106	22	128	0.00001
Paenibacillus baekrokdamisoli	1712516	S	103	13	116	0.00001
Paenibacillus kribbensis	172713	S	94	42	136	0.00001
Paenibacillus odorifer	189426	S	92	20	112	0.00001
Paenibacillus larvae	1464	S	79	8	87	0.00001
Paenibacillus terrae	159743	S	70	40	110	0.00001
Paenibacillus xylanexedens	528191	S	70	58	128	0.00001
Paenibacillus pabuli	1472	S	68	29	97	0.00001
Paenibacillus brasilensis	128574	S	63	34	97	0.00001
Paenibacillus uliginis	683737	S	50	62	112	0.00001
Paenibacillus crassostreae	1763538	S	48	10	58	0.00000
Paenibacillus antarcticus	253703	S	41	8	49	0.00000
Paenibacillus glucanolyticus	59843	S	32	222	254	0.00002
Paenibacillus peoriae	59893	S	22	147	169	0.00001
Brevibacillus marinus	2496837	S	806	167	973	0.00007
Brevibacillus choshinensis	54911	S	686	195	881	0.00007
Brevibacillus agri	51101	S	588	175	763	0.00006
Brevibacillus composti	2796470	S	541	167	708	0.00005
Brevibacillus sp. MMS20-4M-10-Y	2895522	S	330	56	386	0.00003
Brevibacillus sp. HD3.3A	2738979	S	56	222	278	0.00002
Brevibacillus sp. DP1.3A	2738867	S	38	34	72	0.00001
Brevibacillus brevis	1393	S	328	198	526	0.00004
Brevibacillus laterosporus	1465	S	128	156	284	0.00002
Brevibacillus formosus	54913	S	55	48	103	0.00001
Brevibacillus parabrevis	54914	S	55	225	280	0.00002
Cohnella candidum	2674991	S	1023	161	1184	0.00009
Cohnella sp. LGH	1619153	S	518	225	743	0.00006
Cohnella sp. MFER-1	2728023	S	293	48	341	0.00003
Cohnella cholangitidis	2598458	S	298	61	359	0.00003
Cohnella abietis	2507935	S	79	10	89	0.00001
Thermobacillus composti	377615	S	1774	312	2086	0.00016
Saccharibacillus brassicae	2583377	S	1062	158	1220	0.00009
Aneurinibacillus soli	1500254	S	186	225	411	0.00003
Novibacillus thermophilus	1471761	S	5578	1003	6581	0.00051
Kroppenstedtia eburnea	714067	S	1102	151	1253	0.00010
Kroppenstedtia pulmonis	1380685	S	147	15	162	0.00001
Staphylospora marina	2490858	S	513	105	618	0.00005
Laceyella sacchari	37482	S	489	144	633	0.00005
Thermoactinomyces vulgaris	2026	S	345	89	434	0.00003
Polycladomyces abyssicola	1125966	S	332	40	372	0.00003
Alicyclobacillus acidocaldarius	405212	S	2030	210	2240	0.00017
Alicyclobacillus acidoterrestris	1450	S	236	45	281	0.00002
Alicyclobacillus mengziensis	2931921	S	214	18	232	0.00002
Alicyclobacillus sp. SO9	2665646	S	142	12	154	0.00001
Alicyclobacillus sp. TC	2606450	S	40	5	45	0.00000
Tumebacillus avium	1903704	S	1274	685	1959	0.00015
Tumebacillus algifaecis	1214604	S	489	222	711	0.00005
Kyrpidia spormannii	2055160	S	271	163	434	0.00003
Kyrpidia tusciae	33943	S	182	155	337	0.00003
Effusibacillus dendaii	2743772	S	164	27	191	0.00001
Planococcus maritimus	192421	S	166	90	256	0.00002
Planococcus sp. MB-3u-03	2058136	S	79	61	140	0.00001
Planococcus sp. 107-1	2908840	S	72	39	111	0.00001
Planococcus sp. PAMC 21323	1526927	S	15	8	23	0.00000
Planococcus plakortidis	1038856	S	163	118	281	0.00002
Planococcus lenghuensis	2213202	S	159	45	204	0.00002
Planococcus glaciei	459472	S	145	56	201	0.00002
Planococcus halotolerans	2233542	S	97	40	137	0.00001
Planococcus rifietoensis	200991	S	93	76	169	0.00001
Planococcus massiliensis	1499687	S	93	24	117	0.00001
Planococcus antarcticus	161360	S	50	20	70	0.00001
Planococcus versutus	1302659	S	28	16	44	0.00000
Planococcus halocryophilus	1215089	S	24	15	39	0.00000
Planococcus donghaensis	414778	S	23	16	39	0.00000
Planococcus faecalis	1598147	S	10	34	44	0.00000
Sporosarcina sp. Te-1	2818390	S	89	34	123	0.00001
Sporosarcina sp. Marseille-Q4063	2810514	S	48	19	67	0.00001
Sporosarcina sp. PTS2304	2283194	S	20	32	52	0.00000
Sporosarcina sp. resist	2762563	S	16	51	67	0.00001
Sporosarcina ureae	1571	S	120	43	163	0.00001
Sporosarcina ureilytica	298596	S	30	12	42	0.00000
Sporosarcina pasteurii	1474	S	21	8	29	0.00000
Sporosarcina psychrophila	1476	S	12	42	54	0.00000
Solibacillus silvestris	76853	S	103	55	158	0.00001
Solibacillus sp. R5-41	2048654	S	40	24	64	0.00001
Ureibacillus thermosphaericus	51173	S	62	103	165	0.00001
Ureibacillus thermophilus	367743	S	40	30	70	0.00001
Paenisporosarcina antarctica	417367	S	46	18	64	0.00000
Paenisporosarcina cavernae	2320858	S	20	15	35	0.00000
Jeotgalibacillus malaysiensis	1508404	S	54	24	78	0.00001
Kurthia sp. 11kri321	1750719	S	27	22	49	0.00000
Kurthia zopfii	1650	S	16	11	27	0.00000
Rummeliibacillus stabekisii	241244	S	32	21	53	0.00000
Viridibacillus sp. JNUCC-6	2779527	S	25	12	37	0.00000
Staphylococcus aureus	1280	S	96	654	750	0.00006
Staphylococcus epidermidis	1282	S	47	262	309	0.00002
Staphylococcus pseudintermedius	283734	S	24	30	54	0.00000
Staphylococcus sp. 17KM0847	2583989	S	11	6	17	0.00000
Staphylococcus sp. MI 10-1553	1912064	S	10	6	16	0.00000
Staphylococcus gallinarum	1293	S	27	2	29	0.00000
Staphylococcus pseudoxylosus	2282419	S	24	16	40	0.00000
Staphylococcus haemolyticus	1283	S	23	30	53	0.00000
Staphylococcus pettenkoferi	170573	S	22	7	29	0.00000
Staphylococcus lugdunensis	28035	S	17	10	27	0.00000
Staphylococcus muscae	1294	S	15	8	23	0.00000
Staphylococcus roterodami	2699836	S	14	18	32	0.00000
Staphylococcus piscifermentans	70258	S	13	7	20	0.00000
Staphylococcus succinus	61015	S	13	5	18	0.00000
Staphylococcus arlettae	29378	S	12	11	23	0.00000
Staphylococcus xylosus	1288	S	12	7	19	0.00000
Staphylococcus simulans	1286	S	12	5	17	0.00000
Staphylococcus auricularis	29379	S	11	5	16	0.00000
Staphylococcus hominis	1290	S	11	8	19	0.00000
Staphylococcus schleiferi	1295	S	10	25	35	0.00000
Staphylococcus capitis	29388	S	10	11	21	0.00000
Staphylococcus nepalensis	214473	S	10	4	14	0.00000
Macrococcus brunensis	198483	S	25	9	34	0.00000
Macrococcus canis	1855823	S	23	12	35	0.00000
Macrococcus armenti	2875764	S	19	11	30	0.00000
Macrococcus caseolyticus	69966	S	12	26	38	0.00000
Mammaliicoccus sciuri	1296	S	72	56	128	0.00001
Mammaliicoccus lentus	42858	S	13	11	24	0.00000
Jeotgalicoccus sp. WY2	2708346	S	44	11	55	0.00000
Jeotgalicoccus sp. ATCC 8456	946435	S	11	2	13	0.00000
Jeotgalicoccus saudimassiliensis	1461582	S	40	5	45	0.00000
Salinicoccus halodurans	407035	S	60	23	83	0.00001
Nosocomiicoccus ampullae	489910	S	22	4	26	0.00000
Exiguobacterium alkaliphilum	1428684	S	264	113	377	0.00003
Exiguobacterium mexicanum	340146	S	257	121	378	0.00003
Exiguobacterium sp. N4-1P	2051906	S	53	42	95	0.00001
Exiguobacterium sp. Helios	2735868	S	48	26	74	0.00001
Exiguobacterium sp. AT1b	360911	S	25	33	58	0.00000
Exiguobacterium sp. PFWT01	2829816	S	24	32	56	0.00000
Exiguobacterium sp. MH3	1399115	S	16	24	40	0.00000
Exiguobacterium acetylicum	41170	S	82	149	231	0.00002
Exiguobacterium antarcticum	132920	S	63	28	91	0.00001
Exiguobacterium sibiricum	332410	S	60	34	94	0.00001
Listeria monocytogenes	1639	S	65	2872	2937	0.00023
Listeria innocua	1642	S	39	42	81	0.00001
Listeria weihenstephanensis	1006155	S	37	10	47	0.00000
Listeria grayi	1641	S	20	7	27	0.00000
Listeria ivanovii	1638	S	15	4	19	0.00000
Listeria sp. PSOL-1	1844999	S	14	4	18	0.00000
Listeria seeligeri	1640	S	11	7	18	0.00000
Listeria marthii	529731	S	11	5	16	0.00000
Brochothrix thermosphacta	2756	S	27	11	38	0.00000
Sporolactobacillus terrae	269673	S	106	19	125	0.00001
Limosilactobacillus fermentum	1613	S	188	167	355	0.00003
Limosilactobacillus pontis	35787	S	148	101	249	0.00002
Limosilactobacillus mucosae	97478	S	71	34	105	0.00001
Limosilactobacillus reuteri	1598	S	46	63	109	0.00001
Limosilactobacillus panis	47493	S	33	17	50	0.00000
Levilactobacillus zymae	267363	S	174	63	237	0.00002
Levilactobacillus brevis	1580	S	98	39	137	0.00001
Levilactobacillus koreensis	637971	S	55	10	65	0.00001
Levilactobacillus suantsaii	2292255	S	51	22	73	0.00001
Lacticaseibacillus rhamnosus	47715	S	60	25	85	0.00001
Lacticaseibacillus casei	1582	S	56	24	80	0.00001
Lacticaseibacillus manihotivorans	88233	S	51	18	69	0.00001
Lacticaseibacillus paracasei	1597	S	38	122	160	0.00001
Lacticaseibacillus zeae	57037	S	34	18	52	0.00000
Lacticaseibacillus chiayiensis	2100821	S	27	5	32	0.00000
Lactobacillus delbrueckii	1584	S	133	357	490	0.00004
Lactobacillus sp. CBA3605	2099788	S	10	6	16	0.00000
Lactobacillus panisapium	2012495	S	25	5	30	0.00000
Lactobacillus acetotolerans	1600	S	20	7	27	0.00000
Lactobacillus johnsonii	33959	S	13	20	33	0.00000
Lactobacillus crispatus	47770	S	11	9	20	0.00000
Lactobacillus apis	303541	S	11	3	14	0.00000
Weissella cibaria	137591	S	24	23	47	0.00000
Weissella confusa	1583	S	22	22	44	0.00000
Weissella jogaejeotgali	1631871	S	11	16	27	0.00000
Weissella viridescens	1629	S	10	5	15	0.00000
Weissella soli	155866	S	10	3	13	0.00000
Schleiferilactobacillus harbinensis	304207	S	146	19	165	0.00001
Lactiplantibacillus pentosus	1589	S	47	16	63	0.00000
Lactiplantibacillus plantarum	1590	S	44	71	115	0.00001
Lactiplantibacillus paraplantarum	60520	S	20	6	26	0.00000
Ligilactobacillus ruminis	1623	S	52	22	74	0.00001
Ligilactobacillus agilis	1601	S	19	15	34	0.00000
Ligilactobacillus salivarius	1624	S	17	21	38	0.00000
Ligilactobacillus murinus	1622	S	12	15	27	0.00000
Ligilactobacillus acidipiscis	89059	S	12	5	17	0.00000
Ligilactobacillus animalis	1605	S	10	13	23	0.00000
Leuconostoc lactis	1246	S	27	50	77	0.00001
Leuconostoc pseudomesenteroides	33968	S	14	18	32	0.00000
Leuconostoc carnosum	1252	S	11	3	14	0.00000
Lentilactobacillus buchneri	1581	S	31	13	44	0.00000
Lentilactobacillus hilgardii	1588	S	20	5	25	0.00000
Lentilactobacillus parabuchneri	152331	S	20	7	27	0.00000
Lentilactobacillus kefiri	33962	S	13	5	18	0.00000
Oenococcus kitaharae	336988	S	38	3	41	0.00000
Oenococcus oeni	1247	S	15	2	17	0.00000
Oenococcus sicerae	2203724	S	14	0	14	0.00000
Oenococcus sp. UCMA 16435	2259623	S	13	2	15	0.00000
Secundilactobacillus paracollinoides	240427	S	65	27	92	0.00001
Loigolactobacillus coryniformis	1610	S	45	45	90	0.00001
Loigolactobacillus bifermentans	1607	S	14	4	18	0.00000
Latilactobacillus sakei	1599	S	26	23	49	0.00000
Latilactobacillus fuchuensis	164393	S	15	0	15	0.00000
Latilactobacillus curvatus	28038	S	10	6	16	0.00000
Pediococcus acidilactici	1254	S	25	14	39	0.00000
Pediococcus pentosaceus	1255	S	11	6	17	0.00000
Pediococcus damnosus	51663	S	11	6	17	0.00000
Liquorilactobacillus hordei	468911	S	14	10	24	0.00000
Liquorilactobacillus nagelii	82688	S	12	4	16	0.00000
Furfurilactobacillus rossiae	231049	S	31	6	37	0.00000
Paucilactobacillus nenjiangensis	1296540	S	11	10	21	0.00000
Amylolactobacillus amylophilus	1603	S	23	24	47	0.00000
Acetilactobacillus jinshanensis	1720083	S	20	1	21	0.00000
Apilactobacillus kunkeei	148814	S	13	2	15	0.00000
Periweissella cryptocerci	2506420	S	13	2	15	0.00000
Streptococcus sp. HKU75	2781599	S	22	4	26	0.00000
Streptococcus sp. oral taxon 061	712623	S	12	12	24	0.00000
Streptococcus sp. Marseille-Q3533	2759692	S	11	11	22	0.00000
Streptococcus suis	1307	S	54	62	116	0.00001
Streptococcus sanguinis	1305	S	51	19	70	0.00001
Streptococcus oralis	1303	S	40	50	90	0.00001
Streptococcus equi	1336	S	25	10	35	0.00000
Streptococcus pyogenes	1314	S	32	35	67	0.00001
Streptococcus anginosus	1328	S	10	25	35	0.00000
Streptococcus sobrinus	1310	S	22	4	26	0.00000
Streptococcus cristatus	45634	S	21	38	59	0.00000
Streptococcus ferus	1345	S	21	5	26	0.00000
Streptococcus gordonii	1302	S	20	9	29	0.00000
Streptococcus pantholopis	1811193	S	18	2	20	0.00000
Streptococcus merionis	400065	S	16	2	18	0.00000
Streptococcus himalayensis	1888195	S	13	3	16	0.00000
Streptococcus mutans	1309	S	13	9	22	0.00000
Streptococcus infantis	68892	S	13	5	18	0.00000
Streptococcus pneumoniae	1313	S	13	407	420	0.00003
Streptococcus chenjunshii	2173853	S	13	1	14	0.00000
Streptococcus salivarius	1304	S	13	28	41	0.00000
Streptococcus ratti	1341	S	12	2	14	0.00000
Streptococcus mitis	28037	S	12	11	23	0.00000
Streptococcus thermophilus	1308	S	12	358	370	0.00003
Streptococcus respiraculi	2021971	S	11	3	14	0.00000
Streptococcus iniae	1346	S	11	4	15	0.00000
Streptococcus equinus	1335	S	11	10	21	0.00000
Lactococcus raffinolactis	1366	S	27	16	43	0.00000
Lactococcus garvieae	1363	S	22	44	66	0.00001
Lactococcus lactis	1358	S	21	47	68	0.00001
Enterococcus avium	33945	S	41	27	68	0.00001
Enterococcus casseliflavus	37734	S	41	100	141	0.00001
Enterococcus faecalis	1351	S	37	47	84	0.00001
Enterococcus gilvus	160453	S	27	13	40	0.00000
Enterococcus faecium	1352	S	23	373	396	0.00003
Enterococcus raffinosus	71452	S	21	15	36	0.00000
Enterococcus hirae	1354	S	17	16	33	0.00000
Enterococcus mundtii	53346	S	15	8	23	0.00000
Enterococcus cecorum	44008	S	13	12	25	0.00000
Enterococcus durans	53345	S	13	15	28	0.00000
Enterococcus thailandicus	417368	S	12	7	19	0.00000
Enterococcus rotai	118060	S	10	0	10	0.00000
Vagococcus lutrae	81947	S	20	48	68	0.00001
Vagococcus fluvialis	2738	S	10	14	24	0.00000
Vagococcus coleopterorum	2714946	S	10	5	15	0.00000
Tetragenococcus osmophilus	526944	S	14	8	22	0.00000
Tetragenococcus halophilus	51669	S	13	7	20	0.00000
Tetragenococcus koreensis	290335	S	10	4	14	0.00000
Melissococcus plutonius	33970	S	11	3	14	0.00000
Aerococcus sanguinicola	119206	S	43	45	88	0.00001
Aerococcus urinae	1376	S	28	35	63	0.00000
Aerococcus christensenii	87541	S	14	35	49	0.00000
Aerococcus urinaehominis	128944	S	13	10	23	0.00000
Abiotrophia defectiva	46125	S	35	12	47	0.00000
Suicoccus acidiformans	2036206	S	28	21	49	0.00000
Ignavigranum ruoffiae	89093	S	11	1	12	0.00000
Jeotgalibaca arthritidis	1868794	S	21	38	59	0.00000
Jeotgalibaca dankookensis	708126	S	20	5	25	0.00000
Jeotgalibaca porci	1868793	S	19	15	34	0.00000
Jeotgalibaca sp. MA1X17-3	2908211	S	10	2	12	0.00000
Jeotgalibaca ciconiae	2496265	S	12	6	18	0.00000
Carnobacterium inhibens	147709	S	15	13	28	0.00000
Carnobacterium divergens	2748	S	13	3	16	0.00000
Carnobacterium maltaromaticum	2751	S	10	6	16	0.00000
Dolosigranulum pigrum	29394	S	32	11	43	0.00000
Marinilactibacillus sp. 15R	1911586	S	18	8	26	0.00000
Thermaerobacter sp. FW80	2546351	S	2575	582	3157	0.00024
Thermaerobacter sp. PB12/4term	2293838	S	1884	503	2387	0.00018
Thermaerobacter marianensis	73919	S	2124	569	2693	0.00021
Intestinimonas butyriciproducens	1297617	S	460	212	672	0.00005
Aminipila butyrica	433296	S	56	4	60	0.00000
Aminipila terrae	2697030	S	53	4	57	0.00000
Aminipila luticellarii	2507160	S	47	4	51	0.00000
Emergencia timonensis	1776384	S	139	60	199	0.00002
Mogibacterium diversum	114527	S	15	16	31	0.00000
Mogibacterium pumilum	86332	S	10	9	19	0.00000
Flintibacter sp. KGMB00164	2610895	S	319	46	365	0.00003
Massilistercora timonensis	2086584	S	149	183	332	0.00003
Carboxydocella thermautotrophica	178899	S	146	18	164	0.00001
Faecalibacterium prausnitzii	853	S	1462	1680	3142	0.00024
Dysosmobacter sp. Marseille-Q4140	2830675	S	591	286	877	0.00007
Dysosmobacter welbionis	2093857	S	418	342	760	0.00006
Flavonifractor plautii	292800	S	980	303	1283	0.00010
Vescimonas coprocola	2714355	S	284	299	583	0.00004
Vescimonas fastidiosa	2714353	S	183	346	529	0.00004
Ethanoligenens harbinense	253239	S	480	31	511	0.00004
Ruthenibacterium lactatiformans	1550024	S	460	168	628	0.00005
Caproiciproducens sp. NJN-50	2507162	S	375	56	431	0.00003
Anaerotruncus colihominis	169435	S	358	225	583	0.00004
Oscillibacter sp. NSJ-62	2763056	S	324	123	447	0.00003
Acutalibacter muris	1796620	S	262	15	277	0.00002
Caproicibacter fermentans	2576756	S	256	17	273	0.00002
Ruminococcus champanellensis	1161942	S	117	6	123	0.00001
Ruminococcus albus	1264	S	49	1	50	0.00000
Ruminococcus bovis	2564099	S	27	4	31	0.00000
Ruminococcus bicirculans	1160721	S	21	5	26	0.00000
Acetivibrio saccincola	1677857	S	107	79	186	0.00001
Acetivibrio thermocellus	1515	S	54	27	81	0.00001
Acetivibrio clariflavus	288965	S	34	26	60	0.00000
Pusillibacter faecalis	2714358	S	199	166	365	0.00003
Caproicibacterium lactatifermentans	2666138	S	83	13	96	0.00001
Caproicibacterium amylolyticum	2766537	S	71	7	78	0.00001
Solibaculum mannosilyticum	2780922	S	140	162	302	0.00002
Thermoclostridium stercorarium	1510	S	60	70	130	0.00001
Pseudoclostridium thermosuccinogenes	84032	S	60	17	77	0.00001
Ruminiclostridium herbifermentans	2488810	S	30	9	39	0.00000
Ruminiclostridium cellulolyticum	1521	S	13	3	16	0.00000
Mageeibacillus indolicus	884684	S	32	52	84	0.00001
Fastidiosipila sanguinis	236753	S	28	22	50	0.00000
Monoglobus pectinilyticus	1981510	S	24	15	39	0.00000
Symbiobacterium thermophilum	2734	S	3098	323	3421	0.00026
Clostridium tetani	1513	S	679	99	778	0.00006
Clostridium sp. M62/1	411486	S	88	136	224	0.00002
Clostridium sp. SY8519	1042156	S	88	31	119	0.00001
Clostridium sp. BNL1100	755731	S	32	4	36	0.00000
Clostridium sp. 'deep sea'	2779445	S	28	0	28	0.00000
Clostridium sp. JN-9	2507159	S	25	5	30	0.00000
Clostridium sp. AWRP	2212991	S	21	8	29	0.00000
Clostridium sp. DL-VIII	641107	S	20	4	24	0.00000
Clostridium sp. C1	1155388	S	19	21	40	0.00000
Clostridium sp. MD294	97138	S	14	1	15	0.00000
Clostridium sp. JN-1	2483110	S	13	2	15	0.00000
Clostridium sp. C5S11	704125	S	12	1	13	0.00000
Clostridium sp. BJN0001	2930219	S	12	3	15	0.00000
Clostridium perfringens	1502	S	69	25	94	0.00001
Clostridium botulinum	1491	S	67	92	159	0.00001
Clostridium kluyveri	1534	S	44	3	47	0.00000
Clostridium baratii	1561	S	42	14	56	0.00000
Clostridium argentinense	29341	S	41	7	48	0.00000
Clostridium thermarum	1716543	S	41	29	70	0.00001
Clostridium pasteurianum	1501	S	35	7	42	0.00000
Clostridium beijerinckii	1520	S	34	60	94	0.00001
Clostridium manihotivorum	2320868	S	27	3	30	0.00000
Clostridium cadaveris	1529	S	27	8	35	0.00000
Clostridium aceticum	84022	S	26	3	29	0.00000
Clostridium formicaceticum	1497	S	23	5	28	0.00000
Clostridium butyricum	1492	S	23	5	28	0.00000
Clostridium cellulovorans	1493	S	22	4	26	0.00000
Clostridium tyrobutyricum	1519	S	20	2	22	0.00000
Clostridium fermenticellae	2068654	S	18	2	20	0.00000
Clostridium intestinale	36845	S	18	2	20	0.00000
Clostridium bornimense	1216932	S	17	7	24	0.00000
Clostridium saccharoperbutylacetonicum	36745	S	16	4	20	0.00000
Clostridium acetobutylicum	1488	S	15	0	15	0.00000
Clostridium estertheticum	238834	S	13	3	16	0.00000
Clostridium sporogenes	1509	S	12	70	82	0.00001
Clostridium gasigenes	94869	S	12	2	14	0.00000
Clostridium scatologenes	1548	S	11	10	21	0.00000
Clostridium carboxidivorans	217159	S	11	3	14	0.00000
Clostridium novyi	1542	S	10	64	74	0.00001
Clostridium diolis	223919	S	10	125	135	0.00001
Hungatella hathewayi	154046	S	171	8	179	0.00001
Alkaliphilus oremlandii	461876	S	32	9	41	0.00000
Alkaliphilus sp. B6464	2731219	S	30	9	39	0.00000
Alkaliphilus metalliredigens	208226	S	25	6	31	0.00000
Crassaminicella thermophila	2599308	S	17	6	23	0.00000
Crassaminicella profunda	1286698	S	15	4	19	0.00000
Crassaminicella sp. 143-21	2855394	S	14	7	21	0.00000
Geosporobacter ferrireducens	1424294	S	45	10	55	0.00000
Caloramator sp. E03	2576307	S	37	4	41	0.00000
Serpentinicella alkaliphila	1734049	S	27	6	33	0.00000
Candidatus Arthromitus sp. SFB-rat-Yit	1041504	S	12	10	22	0.00000
Paraclostridium bifermentans	1490	S	18	6	24	0.00000
Hathewaya histolytica	1498	S	10	5	15	0.00000
[Clostridium] scindens	29347	S	159	83	242	0.00002
Lachnoclostridium phocaeense	1871021	S	138	145	283	0.00002
[Clostridium] hylemonae	89153	S	114	40	154	0.00001
Lachnoclostridium sp. YL32	1834196	S	18	37	55	0.00000
Blautia producta	33035	S	111	25	136	0.00001
Blautia sp. NBRC 113351	2877527	S	69	94	163	0.00001
Blautia sp. SC05B48	2479767	S	14	44	58	0.00000
Blautia pseudococcoides	1796616	S	47	7	54	0.00000
Blautia liquoris	2779518	S	35	3	38	0.00000
Blautia massiliensis	1737424	S	20	47	67	0.00001
Blautia argi	1912897	S	18	20	38	0.00000
Blautia obeum	40520	S	12	13	25	0.00000
Lachnospiraceae bacterium NSJ-29	2763667	S	115	43	158	0.00001
Lachnospiraceae bacterium NSJ-38	2763669	S	96	47	143	0.00001
Lachnospiraceae bacterium sunii NSJ-8	2763672	S	47	44	91	0.00001
Lachnospiraceae bacterium NSJ-4	2763670	S	23	27	50	0.00000
Roseburia hominis	301301	S	117	154	271	0.00002
Roseburia intestinalis	166486	S	28	42	70	0.00001
Roseburia sp. NSJ-69	2763062	S	12	6	18	0.00000
Anaerocolumna cellulosilytica	433286	S	82	4	86	0.00001
Anaerocolumna chitinilytica	1727145	S	50	2	52	0.00000
Anaerocolumna sedimenticola	2696063	S	36	2	38	0.00000
Enterocloster bolteae	208479	S	129	52	181	0.00001
Anaerostipes caccae	105841	S	59	19	78	0.00001
Anaerostipes rhamnosivorans	1229621	S	44	21	65	0.00001
Anaerostipes hadrus	649756	S	18	21	39	0.00000
Lacrimispora sphenoides	29370	S	67	6	73	0.00001
Lacrimispora saccharolytica	84030	S	41	7	48	0.00000
Herbinix luporum	1679721	S	102	82	184	0.00001
Coprococcus comes	410072	S	40	55	95	0.00001
Coprococcus catus	116085	S	30	21	51	0.00000
Coprococcus eutactus	33043	S	14	18	32	0.00000
Butyrivibrio fibrisolvens	831	S	34	10	44	0.00000
Butyrivibrio proteoclasticus	43305	S	13	2	15	0.00000
Butyrivibrio hungatei	185008	S	13	1	14	0.00000
Anaerotignum propionicum	28446	S	55	6	61	0.00000
[Ruminococcus] gnavus	33038	S	27	29	56	0.00000
[Ruminococcus] torques	33039	S	22	25	47	0.00000
Sellimonas intestinalis	1653434	S	42	29	71	0.00001
Anaerobutyricum hallii	39488	S	38	18	56	0.00000
Faecalicatena sp. Marseille-Q4148	2823316	S	32	19	51	0.00000
Novisyntrophococcus fermenticellae	2068655	S	30	4	34	0.00000
Dorea longicatena	88431	S	27	34	61	0.00000
Cellulosilyticum lentocellum	29360	S	12	13	25	0.00000
Lachnospira eligens	39485	S	16	3	19	0.00000
Pseudobutyrivibrio xylanivorans	185007	S	10	0	10	0.00000
Candidatus Desulforudis audaxviator	471827	S	796	55	851	0.00007
Desulforamulus ruminis	1564	S	148	27	175	0.00001
Desulforamulus ferrireducens	1833852	S	127	96	223	0.00002
Desulforamulus reducens	59610	S	59	15	74	0.00001
Acididesulfobacillus acetoxydans	1561005	S	260	12	272	0.00002
Candidatus Formimonas warabiya	1761012	S	182	16	198	0.00002
Thermanaerosceptrum fracticalcis	1712410	S	111	21	132	0.00001
Desulfofarcimen acetoxidans	58138	S	66	9	75	0.00001
Dehalobacterium formicoaceticum	51515	S	49	11	60	0.00000
Christensenella sp. Marseille-P3954	2086585	S	728	439	1167	0.00009
Christensenella minuta	626937	S	209	70	279	0.00002
Heliomicrobium modesticaldum	35701	S	776	449	1225	0.00009
Heliorestis convoluta	356322	S	56	4	60	0.00000
Desulfitobacterium hafniense	49338	S	131	21	152	0.00001
Desulfitobacterium dehalogenans	36854	S	56	13	69	0.00001
Desulfitobacterium dichloroeliminans	233055	S	36	37	73	0.00001
Desulfitobacterium metallireducens	142877	S	30	7	37	0.00000
Desulfosporosinus orientis	1563	S	63	18	81	0.00001
Desulfosporosinus youngiae	339862	S	56	23	79	0.00001
Desulfosporosinus acidiphilus	885581	S	55	14	69	0.00001
Desulfosporosinus meridiei	79209	S	48	24	72	0.00001
Dehalobacter restrictus	55583	S	52	93	145	0.00001
Syntrophobotulus glycolicus	51197	S	99	8	107	0.00001
Eubacterium limosum	1736	S	110	100	210	0.00002
Eubacterium callanderi	53442	S	50	34	84	0.00001
Eubacterium sp. c-25	2841037	S	20	12	32	0.00000
Eubacterium sp. MSJ-33	2841528	S	19	13	32	0.00000
Eubacterium maltosivorans	2041044	S	20	80	100	0.00001
Acetobacterium sp. KB-1	2184575	S	105	35	140	0.00001
Acetobacterium wieringae	52694	S	56	36	92	0.00001
Acetobacterium woodii	33952	S	26	6	32	0.00000
Alkalibacter sp. ES005	2815577	S	93	7	100	0.00001
Syntrophothermus lipocalidus	86170	S	173	16	189	0.00001
Candidatus Contubernalis alkalaceticum	338645	S	56	3	59	0.00000
Syntrophomonas wolfei	863	S	54	9	63	0.00000
Candidatus Syntrophocurvum alkaliphilum	2293317	S	18	4	22	0.00000
Peptoclostridium acidaminophilum	1731	S	69	14	83	0.00001
Terrisporobacter sp. MCA3	2813371	S	55	12	67	0.00001
Romboutsia ilealis	1115758	S	20	11	31	0.00000
Romboutsia sp. CE17	2724150	S	19	10	29	0.00000
Clostridioides difficile	1496	S	24	26	50	0.00000
Filifactor alocis	143361	S	15	26	41	0.00000
Tepidibacter sp. 8C15b	2925782	S	14	3	17	0.00000
Acetoanaerobium sticklandii	1511	S	13	1	14	0.00000
Paeniclostridium sordellii	1505	S	10	2	12	0.00000
Peptacetobacter hiranonis	89152	S	10	3	13	0.00000
Desulfoscipio gibsoniae	102134	S	191	19	210	0.00002
Thermincola potens	863643	S	126	13	139	0.00001
Desulfotomaculum nigrificans	1565	S	95	45	140	0.00001
Vallitalea pronyensis	1348613	S	21	3	24	0.00000
Vallitalea guaymasensis	1185412	S	20	4	24	0.00000
Petrocella atlantisensis	2173034	S	30	5	35	0.00000
Caloranaerobacter azorensis	116090	S	49	8	57	0.00000
Alkalicella caledoniensis	2731377	S	21	3	24	0.00000
Moorella sp. Hama-1	2138101	S	413	98	511	0.00004
Moorella thermoacetica	1525	S	346	67	413	0.00003
Moorella glycerini	55779	S	340	38	378	0.00003
Ammonifex degensii	42838	S	479	21	500	0.00004
Gelria sp. Kuro-4	2796927	S	1085	95	1180	0.00009
Thermacetogenium phaeum	85874	S	436	465	901	0.00007
Carboxydothermus hydrogenoformans	129958	S	155	15	170	0.00001
Thermanaeromonas toyohensis	161154	S	148	5	153	0.00001
Thermoanaerobacter mathranii	583357	S	33	92	125	0.00001
Thermoanaerobacter kivui	2325	S	20	18	38	0.00000
Caldanaerobacter subterraneus	911092	S	55	63	118	0.00001
Thermoanaerobacterium thermosaccharolyticum	1517	S	33	97	130	0.00001
Caldicellulosiruptor changbaiensis	1222016	S	12	41	53	0.00000
Caldicellulosiruptor acetigenus	301953	S	10	14	24	0.00000
Mahella australiensis	252966	S	104	63	167	0.00001
Zhaonella formicivorans	2528593	S	95	17	112	0.00001
Thermodesulfobium acidiphilum	1794699	S	23	29	52	0.00000
Iocasia fonsfrigidae	2682810	S	93	10	103	0.00001
Halothermothrix orenii	31909	S	59	11	70	0.00001
Halanaerobium hydrogeniformans	656519	S	16	7	23	0.00000
Halanaerobium praevalens	2331	S	15	9	24	0.00000
Anoxybacter fermentans	1323375	S	107	24	131	0.00001
Halobacteroides halobius	42422	S	46	14	60	0.00000
Acetohalobium arabaticum	28187	S	23	5	28	0.00000
Biomaibacter acetigenes	2316383	S	135	11	146	0.00001
Tepidanaerobacter acetatoxydans	499229	S	42	2	44	0.00000
Thermosediminibacter oceani	291990	S	154	18	172	0.00001
Natranaerofaba carboxydovora	2742683	S	74	3	77	0.00001
Natranaerobius thermophilus	375929	S	42	4	46	0.00000
Koleobacter methoxysyntrophicus	2751313	S	91	9	100	0.00001
Selenomonas sp. oral taxon 126	712528	S	465	128	593	0.00005
Selenomonas sp. oral taxon 920	1884263	S	346	83	429	0.00003
Selenomonas sp. oral taxon 478	712538	S	158	226	384	0.00003
Selenomonas sp. oral taxon 136	713030	S	133	181	314	0.00002
Selenomonas sputigena	69823	S	819	78	897	0.00007
Selenomonas timonae	2754044	S	393	189	582	0.00004
Selenomonas ruminantium	971	S	161	17	178	0.00001
Megamonas funiformis	437897	S	17	43	60	0.00000
Pectinatus frisingensis	865	S	28	2	30	0.00000
Sporomusa termitida	2377	S	181	29	210	0.00002
Methylomusa anaerophila	1930071	S	121	10	131	0.00001
Pelosinus fermentans	365349	S	42	9	51	0.00000
Pelosinus sp. UFO1	484770	S	31	11	42	0.00000
Megasphaera elsdenii	907	S	321	143	464	0.00004
Megasphaera stantonii	2144175	S	289	191	480	0.00004
Megasphaera massiliensis	1232428	S	123	50	173	0.00001
Dialister pneumosintes	39950	S	15	114	129	0.00001
Veillonella rodentium	248315	S	21	11	32	0.00000
Veillonella parvula	29466	S	13	11	24	0.00000
Acidaminococcus fermentans	905	S	221	51	272	0.00002
Acidaminococcus intestini	187327	S	57	10	67	0.00001
Phascolarctobacterium faecium	33025	S	65	6	71	0.00001
Phascolarctobacterium succinatutens	626940	S	35	101	136	0.00001
Phascolarctobacterium sp. Marseille-Q4147	2823317	S	30	30	60	0.00000
Limnochorda pilosa	1555112	S	3011	148	3159	0.00024
Allobaculum sp. Allo2	2853432	S	93	24	117	0.00001
Allobaculum mucolyticum	2834459	S	44	13	57	0.00000
Faecalibaculum rodentium	1702221	S	139	47	186	0.00001
[Clostridium] innocuum	1522	S	59	64	123	0.00001
Erysipelatoclostridium ramosum	1547	S	10	6	16	0.00000
Erysipelothrix sp. HDW6C	2714930	S	10	7	17	0.00000
Erysipelothrix larvae	1514105	S	21	6	27	0.00000
Bulleidia sp. zg-1006	2806552	S	43	20	63	0.00000
Intestinibaculum porci	2487118	S	29	15	44	0.00000
Faecalitalea cylindroides	39483	S	12	31	43	0.00000
Turicibacter sp. H121	1712675	S	93	103	196	0.00002
Turicibacter sp. TJ11	2806443	S	10	9	19	0.00000
Turicibacter sanguinis	154288	S	13	4	17	0.00000
Peptoniphilus ivorii	54006	S	128	34	162	0.00001
Peptoniphilus harei	54005	S	19	23	42	0.00000
Murdochiella vaginalis	1852373	S	86	106	192	0.00001
Anaerococcus mediterraneensis	1870984	S	12	38	50	0.00000
Parvimonas micra	33033	S	26	54	80	0.00001
Finegoldia magna	1260	S	14	15	29	0.00000
Schnuerera ultunensis	45497	S	52	10	62	0.00000
Tissierella sp. JN-28	2507161	S	37	9	46	0.00000
Keratinibaculum paraultunense	1278232	S	35	16	51	0.00000
Gudongella oleilytica	1582259	S	30	7	37	0.00000
Gottschalkia acidurici	1556	S	49	6	55	0.00000
Ezakiella coagulans	46507	S	76	242	318	0.00002
Ezakiella massiliensis	1852374	S	22	16	38	0.00000
Sedimentibacter sp. zth1	2816908	S	29	4	33	0.00000
Ndongobacter massiliensis	1871025	S	100	103	203	0.00002
endosymbiont 'TC1' of Trimyema compressum	243899	S	46	3	49	0.00000
Synechococcus sp. CBW1004	1353136	S	910	255	1165	0.00009
Synechococcus sp. CBW1107	2789857	S	764	161	925	0.00007
Synechococcus sp. RSCCF101	2511069	S	759	196	955	0.00007
Synechococcus sp. JA-3-3Ab	321327	S	528	143	671	0.00005
Synechococcus sp. SynAce01	1916956	S	478	57	535	0.00004
Synechococcus sp. CBW1108	1353147	S	466	70	536	0.00004
Synechococcus sp. CB0101	232348	S	370	89	459	0.00004
Synechococcus sp. NB0720_10	2907159	S	344	100	444	0.00003
Synechococcus sp. JA-2-3B'a(2-13)	321332	S	294	72	366	0.00003
Synechococcus sp. LA31	2741953	S	292	72	364	0.00003
Synechococcus sp. RS9909	221352	S	292	116	408	0.00003
Synechococcus sp. PCC 7336	195250	S	269	10	279	0.00002
Synechococcus sp. LTW-R	2751170	S	268	72	340	0.00003
Synechococcus sp. HK01-R	2751171	S	235	43	278	0.00002
Synechococcus sp. A10-1-5-1	2936507	S	229	57	286	0.00002
Synechococcus sp. KORDI-100	1280380	S	220	16	236	0.00002
Synechococcus sp. WH 8101	59932	S	214	79	293	0.00002
Synechococcus sp. Minos11	221341	S	192	15	207	0.00002
Synechococcus sp. NOUM97013	1442555	S	154	26	180	0.00001
Synechococcus sp. PROS-U-1	1400866	S	147	28	175	0.00001
Synechococcus sp. BMK-MC-1	1442551	S	143	61	204	0.00002
Synechococcus sp. KORDI-52	585425	S	141	47	188	0.00001
Synechococcus sp. BIOS-E4-1	1400864	S	123	14	137	0.00001
Synechococcus sp. MEDNS5	1442554	S	121	42	163	0.00001
Synechococcus sp. A15-127	1050624	S	112	116	228	0.00002
Synechococcus sp. KORDI-49	585423	S	110	115	225	0.00002
Synechococcus sp. A15-62	1050657	S	95	69	164	0.00001
Synechococcus sp. PROS-7-1	1442556	S	91	42	133	0.00001
Synechococcus sp. BIOS-U3-1	1400865	S	89	11	100	0.00001
Synechococcus sp. MIT S9220	166309	S	83	13	96	0.00001
Synechococcus sp. NIES-970	1827144	S	82	17	99	0.00001
Synechococcus sp. PCC 6312	195253	S	75	4	79	0.00001
Synechococcus sp. PCC 7003	374981	S	70	23	93	0.00001
Synechococcus sp. RS9907	221350	S	66	158	224	0.00002
Synechococcus sp. CBW1002	1353134	S	66	577	643	0.00005
Synechococcus sp. CC9902	316279	S	61	6	67	0.00001
Synechococcus sp. CBW1006	1353138	S	58	446	504	0.00004
Synechococcus sp. WH 8109	166314	S	57	45	102	0.00001
Synechococcus sp. RS9902	221345	S	55	116	171	0.00001
Synechococcus sp. WH 8020	32052	S	54	11	65	0.00001
Synechococcus sp. ROS8604	1442557	S	53	14	67	0.00001
Synechococcus sp. A15-44	1050646	S	51	93	144	0.00001
Synechococcus sp. PROS-9-1	1968775	S	43	11	54	0.00000
Synechococcus sp. TAK9802	1442558	S	41	103	144	0.00001
Synechococcus sp. PCC 7502	1173263	S	39	2	41	0.00000
Synechococcus sp. M16.1	1442553	S	34	104	138	0.00001
Synechococcus sp. CC9311	64471	S	33	8	41	0.00000
Synechococcus sp. SYN20	1050714	S	25	38	63	0.00000
Synechococcus sp. PCC 11901	2579791	S	20	98	118	0.00001
Synechococcus sp. A18-25c	1866938	S	18	135	153	0.00001
Synechococcus sp. A15-60	1050655	S	16	116	132	0.00001
Synechococcus sp. MVIR-18-1	1386941	S	16	29	45	0.00000
Synechococcus sp. PCC 73109	374982	S	10	47	57	0.00000
Synechococcus elongatus	32046	S	441	21	462	0.00004
Dactylococcopsis salina	292566	S	52	23	75	0.00001
Cyanobium sp. NIES-981	1851505	S	816	274	1090	0.00008
Cyanobium sp. NS01	261284	S	651	244	895	0.00007
Cyanobium gracile	59930	S	944	207	1151	0.00009
Parasynechococcus marenigrum	2881428	S	198	63	261	0.00002
Prochlorococcus marinus	1219	S	134	23	157	0.00001
Acaryochloris marina	155978	S	110	27	137	0.00001
Acaryochloris sp. 'Moss Beach'	2740837	S	33	55	88	0.00001
Chamaesiphon minutus	1173032	S	206	13	219	0.00002
Synechocystis sp. PCC 6714	1147	S	40	11	51	0.00000
Synechocystis sp. CACIAM 05	1933929	S	26	123	149	0.00001
Nostoc sp. NIES-4103	2005458	S	336	75	411	0.00003
Nostoc sp. UHCC 0702	2814655	S	214	45	259	0.00002
Nostoc sp. C052	2576902	S	128	31	159	0.00001
Nostoc sp. TCL26-01	2576904	S	121	18	139	0.00001
Nostoc sp. ATCC 53789	76335	S	120	164	284	0.00002
Nostoc sp. UHCC 0870	2914041	S	111	39	150	0.00001
Nostoc sp. MS1	2764711	S	111	33	144	0.00001
Nostoc sp. CENA543	1869241	S	111	18	129	0.00001
Nostoc sp. PCC 7524	28072	S	105	23	128	0.00001
Nostoc sp. 'Lobaria pulmonaria (5183) cyanobiont'	1618022	S	93	19	112	0.00001
Nostoc sp. 'Peltigera membranacea cyanobiont' N6	1261031	S	93	27	120	0.00001
Nostoc sp. PCC 7107	317936	S	67	36	103	0.00001
Nostoc sp. C057	2576903	S	64	92	156	0.00001
Nostoc sp. NIES-2111	1973475	S	44	95	139	0.00001
Nostoc sp. TCL240-02	2572090	S	40	20	60	0.00000
Nostoc sp. NIES-3756	1751286	S	22	56	78	0.00001
Nostoc linckia	92942	S	387	94	481	0.00004
Nostoc sphaeroides	446679	S	133	75	208	0.00002
Nostoc punctiforme	272131	S	111	72	183	0.00001
Nostoc flagelliforme	1306274	S	107	37	144	0.00001
Nostoc edaphicum	264686	S	101	26	127	0.00001
Nostoc piscinale	224012	S	100	50	150	0.00001
Nostoc commune	1178	S	71	22	93	0.00001
Anabaena sp. WA102	1647413	S	97	202	299	0.00002
Anabaena sp. 90	46234	S	31	276	307	0.00002
Anabaena cylindrica	1165	S	92	29	121	0.00001
Cylindrospermum stagnale	142864	S	163	58	221	0.00002
Trichormus azollae	1164	S	75	15	90	0.00001
Richelia sinica	1357545	S	48	9	57	0.00000
Calothrix sp. PCC 7716	2853227	S	184	136	320	0.00002
Calothrix sp. NIES-3974	2005462	S	164	15	179	0.00001
Calothrix sp. NIES-2100	1954172	S	138	99	237	0.00002
Calothrix sp. PCC 7507	99598	S	127	31	158	0.00001
Calothrix sp. NIES-2098	1954171	S	89	59	148	0.00001
Calothrix sp. PCC 6303	1170562	S	51	16	67	0.00001
Calothrix sp. 336/3	1337936	S	49	16	65	0.00001
Calothrix parasitica	1973486	S	205	13	218	0.00002
Calothrix brevissima	938406	S	155	75	230	0.00002
Scytonema sp. NIES-4073	2005464	S	381	170	551	0.00004
Scytonema sp. HK-05	1137095	S	231	88	319	0.00002
Brasilonema sennae	1397703	S	152	17	169	0.00001
Sphaerospermopsis kisseleviana	289435	S	122	48	170	0.00001
Sphaerospermopsis torques-reginae	984207	S	117	42	159	0.00001
Nodularia sphaerocarpa	137816	S	115	31	146	0.00001
Nodularia spumigena	70799	S	82	14	96	0.00001
Dolichospermum compactum	136073	S	71	102	173	0.00001
Dolichospermum sp. UHCC 0315A	1914871	S	30	237	267	0.00002
Dolichospermum flos-aquae	1166	S	12	112	124	0.00001
Anabaenopsis circularis	109266	S	43	28	71	0.00001
Anabaenopsis elenkinii	156213	S	33	6	39	0.00000
Fischerella sp. NIES-4106	2005456	S	158	22	180	0.00001
Fischerella sp. NIES-3754	1752063	S	133	32	165	0.00001
Tolypothrix sp. PCC 7910	2099387	S	157	51	208	0.00002
Tolypothrix tenuis	457083	S	70	32	102	0.00001
Rivularia sp. PCC 7116	373994	S	56	3	59	0.00000
Leptolyngbya sp. 7M	2812896	S	2617	213	2830	0.00022
Leptolyngbya sp. BL0902	1115757	S	417	30	447	0.00003
Leptolyngbya sp. NIES-3755	1752064	S	103	14	117	0.00001
Leptolyngbya sp. PCC 7376	111781	S	70	7	77	0.00001
Leptolyngbya boryana	1184	S	109	0	109	0.00001
Kovacikia minuta	2931930	S	446	49	495	0.00004
Leptodesmis sichuanensis	2906798	S	217	27	244	0.00002
Leptothermofonsia sichuanensis	2917832	S	203	21	224	0.00002
Thermoleptolyngbya sp. PKUAC-SCTB121	2811482	S	32	456	488	0.00004
Thermoleptolyngbya sichuanensis	2885951	S	10	156	166	0.00001
Thermosynechococcus sp. NK55a	1394889	S	79	30	109	0.00001
Thermosynechococcus sp. TA-1	2813673	S	40	35	75	0.00001
Thermosynechococcus sp. CL-1	2583530	S	33	30	63	0.00000
Thermosynechococcus vestitus	146786	S	123	35	158	0.00001
Halomicronema hongdechloris	1209493	S	315	15	330	0.00003
Pseudanabaena sp. PCC 7367	82654	S	119	5	124	0.00001
Pseudanabaena sp. ABRG5-3	685565	S	72	4	76	0.00001
Gloeobacter kilaueensis	1416614	S	1315	41	1356	0.00010
Gloeobacter morelensis	2907343	S	1049	425	1474	0.00011
Gloeobacter violaceus	33072	S	942	419	1361	0.00010
Anthocerotibacter panamensis	2857077	S	339	10	349	0.00003
Moorena producens	1155739	S	585	18	603	0.00005
Oscillatoria nigro-viridis	482564	S	177	83	260	0.00002
Oscillatoria acuminata	118323	S	137	10	147	0.00001
Geitlerinema sp. PCC 7407	1173025	S	663	115	778	0.00006
Allocoleopsis franciscana	2886352	S	133	17	150	0.00001
Oxynema aestuarii	2874213	S	303	31	334	0.00003
Microcoleus vaginatus	119532	S	211	68	279	0.00002
Planktothrix agardhii	1160	S	30	23	53	0.00000
Planktothrix rubescens	59512	S	22	10	32	0.00000
[Phormidium] sp. ETS-05	222819	S	239	16	255	0.00002
Crinalium epipsammum	241425	S	72	11	83	0.00001
Microcystis aeruginosa	1126	S	243	315	558	0.00004
Microcystis sp. MC19	1967666	S	29	22	51	0.00000
Halothece sp. PCC 7418	65093	S	102	39	141	0.00001
Euhalothece natronophila	577489	S	25	4	29	0.00000
Gloeothece citriformis	2546356	S	48	6	54	0.00000
Gloeothece verrucosa	2546359	S	47	6	53	0.00000
Crocosphaera subtropica	2546360	S	67	10	77	0.00001
Rippkaea orientalis	2546366	S	66	11	77	0.00001
Geminocystis herdmanii	669359	S	61	22	83	0.00001
Geminocystis sp. NIES-3709	1617448	S	22	10	32	0.00000
Geminocystis sp. NIES-3708	1615909	S	12	6	18	0.00000
Gloeocapsa sp. PCC 7428	1173026	S	84	11	95	0.00001
Chondrocystis sp. NIES-4102	2005460	S	65	11	76	0.00001
Cyanobacterium aponinum	379064	S	40	21	61	0.00000
Chroococcidiopsis sp. CCMEE 29	155894	S	264	54	318	0.00002
Chroococcidiopsis sp. CCNUC1	2653189	S	75	79	154	0.00001
Chroococcidiopsis thermalis	54299	S	110	124	234	0.00002
Pleurocapsa sp. PCC 7327	118163	S	122	16	138	0.00001
Stanieria cyanosphaera	102116	S	30	10	40	0.00000
Stanieria sp. NIES-3757	1807358	S	30	13	43	0.00000
Gloeomargarita lithophora	1188228	S	122	5	127	0.00001
Thermostichus lividus	33070	S	63	10	73	0.00001
cyanobacterium endosymbiont of Epithemia turgida	718217	S	12	6	18	0.00000
Deinococcus sp. NW-56	2080419	S	1315	211	1526	0.00012
Deinococcus sp. TS-293	2737050	S	1102	131	1233	0.00009
Deinococcus sp. KNUC1210	2917691	S	943	46	989	0.00008
Deinococcus sp. AJ005	2652443	S	731	71	802	0.00006
Deinococcus sp. QL22	2939437	S	508	48	556	0.00004
Deinococcus maricopensis	309887	S	1808	189	1997	0.00015
Deinococcus ficus	317577	S	1726	186	1912	0.00015
Deinococcus gobiensis	502394	S	1654	254	1908	0.00015
Deinococcus metallilatus	1211322	S	1650	215	1865	0.00014
Deinococcus actinosclerus	1768108	S	1553	1038	2591	0.00020
Deinococcus irradiatisoli	2202254	S	1235	130	1365	0.00011
Deinococcus peraridilitoris	432329	S	1134	66	1200	0.00009
Deinococcus wulumuqiensis	980427	S	1101	487	1588	0.00012
Deinococcus radiopugnans	57497	S	968	136	1104	0.00009
Deinococcus geothermalis	68909	S	821	144	965	0.00007
Deinococcus radiodurans	1299	S	813	1145	1958	0.00015
Deinococcus psychrotolerans	2489213	S	696	23	719	0.00006
Deinococcus soli (ex Cha et al. 2016)	1309411	S	682	706	1388	0.00011
Deinococcus deserti	310783	S	621	51	672	0.00005
Deinococcus proteolyticus	55148	S	589	143	732	0.00006
Deinococcus radiophilus	32062	S	358	81	439	0.00003
Deinococcus puniceus	1182568	S	285	49	334	0.00003
Thermus thermophilus	274	S	1003	1296	2299	0.00018
Thermus sp. CCB_US3_UF1	1111069	S	471	79	550	0.00004
Thermus sp. NEB1569	2918899	S	127	242	369	0.00003
Thermus oshimai	56957	S	570	118	688	0.00005
Thermus aquaticus	271	S	467	75	542	0.00004
Thermus brockianus	56956	S	458	95	553	0.00004
Thermus caldilimi	2483360	S	214	57	271	0.00002
Thermus scotoductus	37636	S	108	173	281	0.00002
Thermus parvatiensis	456163	S	72	365	437	0.00003
Meiothermus silvanus	52022	S	908	161	1069	0.00008
Meiothermus taiwanensis	172827	S	715	282	997	0.00008
Meiothermus ruber	277	S	608	253	861	0.00007
Oceanithermus profundus	187137	S	2627	331	2958	0.00023
Marinithermus hydrothermalis	186192	S	1779	330	2109	0.00016
Truepera radiovictrix	332249	S	2067	135	2202	0.00017
Sphaerobacter thermophilus	2057	S	8918	574	9492	0.00073
Thermomicrobium roseum	500	S	1565	33	1598	0.00012
Roseiflexus castenholzii	120962	S	1869	330	2199	0.00017
Roseiflexus sp. RS-1	357808	S	1864	313	2177	0.00017
Chloroflexus aurantiacus	1108	S	720	75	795	0.00006
Chloroflexus aggregans	152260	S	665	107	772	0.00006
Tepidiforma bonchosmolovskayae	2601677	S	4912	243	5155	0.00040
Candidatus Promineofilum breve	1806508	S	4810	114	4924	0.00038
Anaerolinea thermophila	167964	S	1450	176	1626	0.00013
Pelolinea submarina	913107	S	1145	66	1211	0.00009
Brevefilum fermentans	1986204	S	443	21	464	0.00004
Caldilinea aerophila	133453	S	2230	153	2383	0.00018
Dehalogenimonas formicexedens	1839801	S	481	142	623	0.00005
Dehalogenimonas sp. GP	1536648	S	294	86	380	0.00003
Dehalococcoides mccartyi	61435	S	140	294	434	0.00003
Phototrophicus methaneseepsis	2710758	S	1065	12	1077	0.00008
Ktedonosporobacter rubrisoli	2509675	S	864	27	891	0.00007
Thermobaculum terrenum	166501	S	687	117	804	0.00006
Fimbriimonas ginsengisoli	1005039	S	2493	17	2510	0.00019
Chthonomonas calidirosea	454171	S	779	7	786	0.00006
Mycoplasma sp. Pen4	640330	S	13	18	31	0.00000
Mycoplasma sp. SG1	2810348	S	13	0	13	0.00000
Mycoplasma sp. (ex Biomphalaria glabrata)	1749074	S	11	0	11	0.00000
Mycoplasma mycoides	2102	S	27	207	234	0.00002
Mycoplasma genitalium	2097	S	25	0	25	0.00000
Candidatus Hepatoplasma crinochetorum	295596	S	16	1	17	0.00000
Alteracholeplasma palmae	38986	S	71	9	80	0.00001
Haploplasma axanthum	29552	S	15	6	21	0.00000
Malacoplasma iowae	2116	S	14	2	16	0.00000
Candidatus Izimaplasma sp. HR1	1541959	S	17	0	17	0.00000
Gemmata obscuriglobus	114	S	35850	5894	41744	0.00322
Gemmata massiliana	1210884	S	13800	6180	19980	0.00154
Gemmata sp. SH-PL17	1630693	S	12704	6410	19114	0.00147
Urbifossiella limnaea	2528023	S	67510	6886	74396	0.00573
Frigoriglobus tundricola	2774151	S	41201	7392	48593	0.00374
Limnoglobus roseus	2598579	S	32801	1789	34590	0.00266
Tuwongella immobilis	692036	S	3025	155	3180	0.00024
Telmatocola sphagniphila	1123043	S	2452	29	2481	0.00019
Lacipirellula parvula	2650471	S	13159	1916	15075	0.00116
Lacipirellula limnantheis	2528024	S	12267	2085	14352	0.00111
Pirellulimonas nuda	2528009	S	11088	1553	12641	0.00097
Botrimarina mediterranea	2528022	S	9306	1121	10427	0.00080
Aeoliella mucimassa	2527972	S	3702	396	4098	0.00032
Adhaeretor mobilis	1930276	S	2325	294	2619	0.00020
Bythopirellula goksoeyrii	1400387	S	2037	190	2227	0.00017
Lignipirellula cremea	2528010	S	6984	973	7957	0.00061
Stieleria maiorica	2795974	S	3030	734	3764	0.00029
Stieleria neptunia	2527979	S	2853	368	3221	0.00025
Anatilimnocola aggregata	2528021	S	5866	773	6639	0.00051
Rosistilla oblonga	2527990	S	1599	835	2434	0.00019
Rosistilla carotiformis	2528017	S	1137	540	1677	0.00013
Rosistilla ulvae	1930277	S	1074	687	1761	0.00014
Bremerella volcania	2527984	S	4354	405	4759	0.00037
Pirellula staleyi	125	S	3140	148	3288	0.00025
Pirellula sp. SH-Sr6A	1632865	S	869	30	899	0.00007
Roseimaritima ulvae	980254	S	2694	220	2914	0.00022
Roseimaritima multifibrata	1930274	S	755	107	862	0.00007
Rubripirellula lacrimiformis	1930273	S	1423	336	1759	0.00014
Mariniblastus fucicola	980251	S	1057	25	1082	0.00008
Aureliella helgolandensis	2527968	S	963	96	1059	0.00008
Rhodopirellula baltica	265606	S	916	80	996	0.00008
Thermogutta terrifontis	1331910	S	1289	52	1341	0.00010
Tautonia plasticadhaerens	2527974	S	33386	3595	36981	0.00285
Aquisphaera giovannonii	406548	S	25085	5305	30390	0.00234
Paludisphaera borealis	1387353	S	15499	4286	19785	0.00152
Singulisphaera acidiphila	466153	S	11185	2060	13245	0.00102
Isosphaera pallida	128	S	2939	261	3200	0.00025
Planctomyces sp. SH-PL62	1636152	S	15013	6898	21911	0.00169
Planctomyces sp. SH-PL14	1632864	S	11766	890	12656	0.00097
Gimesia panareensis	2527978	S	2504	329	2833	0.00022
Gimesia chilikensis	2605989	S	1419	877	2296	0.00018
Gimesia maris	122	S	933	156	1089	0.00008
Gimesia alba	2527973	S	685	130	815	0.00006
Gimesia fumaroli	2527976	S	595	128	723	0.00006
Gimesia algae	2527971	S	568	153	721	0.00006
Gimesia aquarii	2527964	S	405	31	436	0.00003
Gimesia benthica	2608982	S	401	572	973	0.00008
Caulifigura coniformis	2527983	S	9234	732	9966	0.00077
Maioricimonas rarisocia	2528026	S	8838	1334	10172	0.00078
Alienimonas californiensis	2527989	S	6752	601	7353	0.00057
Symmachiella dynata	2527995	S	3150	223	3373	0.00026
Rubinisphaera brasiliensis	119	S	1857	218	2075	0.00016
Fuerstiella marisgermanici	1891926	S	1809	39	1848	0.00014
Planctopirus limnophila	120	S	578	257	835	0.00006
Planctopirus ephydatiae	2528019	S	568	271	839	0.00006
Calycomorphotria hydatis	2528027	S	1515	67	1582	0.00012
Crateriforma conspicua	2527996	S	1344	360	1704	0.00013
Polystyrenella longa	2528007	S	610	64	674	0.00005
Thalassoglobus polymorphus	2527994	S	588	38	626	0.00005
Humisphaera borealis	2807512	S	10289	289	10578	0.00081
Phycisphaera mikurensis	547188	S	4198	394	4592	0.00035
Mucisphaera calidilacus	2527982	S	2101	138	2239	0.00017
Poriferisphaera corsica	2528020	S	256	2	258	0.00002
Anaerohalosphaera lusitana	1936003	S	419	19	438	0.00003
Sedimentisphaera cyanobacteriorum	1940790	S	81	117	198	0.00002
Sedimentisphaera salicampi	1941349	S	71	26	97	0.00001
Limihaloglobus sulfuriphilus	1851148	S	192	17	209	0.00002
Candidatus Kuenenia stuttgartiensis	174633	S	231	1	232	0.00002
Candidatus Uabimicrobium amorphum	2596890	S	136	2	138	0.00001
Opitutus terrae	107709	S	6482	344	6826	0.00053
Opitutus sp. GAS368	1882749	S	5056	844	5900	0.00045
Lacunisphaera limnophila	1838286	S	4467	703	5170	0.00040
Oleiharenicola sp. KSB-15	2862869	S	2598	155	2753	0.00021
Nibricoccus aquaticus	2576891	S	2469	125	2594	0.00020
Ereboglobus luteus	1796921	S	1741	97	1838	0.00014
Ruficoccus sp. ZRK36	2866311	S	864	150	1014	0.00008
Coraliomargarita akajimensis	395922	S	200	6	206	0.00002
Verrucomicrobium sp. GAS474	1882831	S	2607	321	2928	0.00023
Verrucomicrobium spinosum	2736	S	1773	100	1873	0.00014
Luteolibacter luteus	2728835	S	1984	90	2074	0.00016
Luteolibacter ambystomatis	2824561	S	1765	122	1887	0.00015
Roseimicrobium sp. ORNL1	2711231	S	3296	112	3408	0.00026
Sulfuriroseicoccus oceanibius	2707525	S	511	50	561	0.00004
Akkermansia muciniphila	239935	S	1071	134	1205	0.00009
Akkermansia glycaniphila	1679444	S	358	27	385	0.00003
Methylacidimicrobium sp. AP8	2730359	S	758	125	883	0.00007
Methylacidimicrobium sp. B4	2796139	S	627	141	768	0.00006
Methylacidiphilum sp. IT5	2795384	S	29	64	93	0.00001
Methylacidiphilum sp. IT6	2795386	S	22	1	23	0.00000
Methylacidiphilum kamchatkense	431057	S	33	2	35	0.00000
Methylacidiphilum infernorum	511746	S	23	50	73	0.00001
Candidatus Xiphinematobacter sp. Idaho Grape	1704307	S	113	9	122	0.00001
Kiritimatiella glycovorans	1307763	S	1172	1523	2695	0.00021
Tichowtungia aerotolerans	2697043	S	416	15	431	0.00003
Candidatus Protochlamydia naegleriophila	389348	S	49	30	79	0.00001
Candidatus Protochlamydia amoebophila	362787	S	17	10	27	0.00000
Parachlamydia acanthamoebae	83552	S	36	12	48	0.00000
Neochlamydia sp. S13	1353976	S	27	6	33	0.00000
Waddlia chondrophila	71667	S	70	15	85	0.00001
Candidatus Rhabdochlamydia porcellionis	225148	S	12	50	62	0.00000
Simkania negevensis	83561	S	45	5	50	0.00000
Chlamydia sp. 2742-308	1806891	S	10	44	54	0.00000
Candidatus Velamenicoccus archaeovorus	1930593	S	351	1	352	0.00003
Hymenobacter sp. PAMC 26628	1484118	S	989	262	1251	0.00010
Hymenobacter sp. 5317J-9	2932250	S	920	235	1155	0.00009
Hymenobacter sp. PAMC 26554	1484116	S	803	89	892	0.00007
Hymenobacter sp. APR13	1356852	S	784	344	1128	0.00009
Hymenobacter sp. BRD128	2675878	S	783	117	900	0.00007
Hymenobacter sp. 5116S-3	2932248	S	573	96	669	0.00005
Hymenobacter sp. 5116S-27	2932249	S	554	95	649	0.00005
Hymenobacter sp. BT18	2835648	S	531	76	607	0.00005
Hymenobacter sp. DG01	2584940	S	529	155	684	0.00005
Hymenobacter sp. NBH84	2596915	S	453	74	527	0.00004
Hymenobacter sp. 5420S-77	2932254	S	441	66	507	0.00004
Hymenobacter sp. S2-20-2	2761579	S	409	69	478	0.00004
Hymenobacter sp. 5413J-13	2932251	S	384	61	445	0.00003
Hymenobacter sp. DG25B	1385664	S	378	149	527	0.00004
Hymenobacter sp. BRD67	2675877	S	309	320	629	0.00005
Hymenobacter sp. DG25A	1385663	S	279	113	392	0.00003
Hymenobacter sp. HDW8	2714932	S	156	539	695	0.00005
Hymenobacter sp. 5516S-25	2933777	S	117	512	629	0.00005
Hymenobacter sp. 5516J-16	2932253	S	106	492	598	0.00005
Hymenobacter busanensis	2607656	S	964	115	1079	0.00008
Hymenobacter monticola	1705399	S	917	184	1101	0.00008
Hymenobacter sedentarius	1411621	S	797	132	929	0.00007
Hymenobacter nivis	1850093	S	661	183	844	0.00007
Hymenobacter jejuensis	2502781	S	608	51	659	0.00005
Hymenobacter oligotrophus	2319843	S	607	73	680	0.00005
Hymenobacter swuensis	1446467	S	457	109	566	0.00004
Hymenobacter tibetensis	497967	S	428	72	500	0.00004
Hymenobacter qilianensis	1385715	S	325	63	388	0.00003
Hymenobacter baengnokdamensis	2615203	S	306	355	661	0.00005
Hymenobacter radiodurans	2496028	S	179	647	826	0.00006
Pontibacter russatus	2694929	S	1243	143	1386	0.00011
Pontibacter pudoricolor	2694930	S	999	132	1131	0.00009
Pontibacter actiniarum	323450	S	744	214	958	0.00007
Pontibacter akesuensis	388950	S	500	87	587	0.00005
Pontibacter korlensis	400092	S	337	57	394	0.00003
Pontibacter sp. SGAir0037	2571030	S	278	56	334	0.00003
Rufibacter radiotolerans	1379910	S	363	46	409	0.00003
Rufibacter tibetensis	512763	S	245	45	290	0.00002
Rufibacter sp. DG15C	1379909	S	226	131	357	0.00003
Adhaeribacter swui	2086471	S	193	30	223	0.00002
Adhaeribacter radiodurans	2745197	S	142	19	161	0.00001
Nibribacter ruber	2698458	S	227	129	356	0.00003
Spirosoma sp. CJU-R4	2728024	S	577	48	625	0.00005
Spirosoma sp. KUDC1026	2745947	S	369	35	404	0.00003
Spirosoma sp. KCTC 42546	2520506	S	259	35	294	0.00002
Spirosoma sp. RHs26	2898794	S	252	19	271	0.00002
Spirosoma sp. KCTC 72228	2710596	S	109	14	123	0.00001
Spirosoma rigui	564064	S	476	36	512	0.00004
Spirosoma taeanense	2735870	S	425	42	467	0.00004
Spirosoma montaniterrae	1178516	S	355	23	378	0.00003
Spirosoma aerolatum	1211326	S	266	14	280	0.00002
Spirosoma endbachense	2666025	S	232	119	351	0.00003
Spirosoma radiotolerans	1379870	S	229	17	246	0.00002
Spirosoma pollinicola	2057025	S	200	26	226	0.00002
Spirosoma aureum	2692134	S	172	106	278	0.00002
Rhodocytophaga rosea	2704465	S	202	7	209	0.00002
Aquirufa sp. 9H-EGSE	2696560	S	55	17	72	0.00001
Aquirufa nivalisilvae	2516557	S	35	9	44	0.00000
Cytophaga hutchinsonii	985	S	76	6	82	0.00001
Dyadobacter fermentans	94254	S	784	68	852	0.00007
Dyadobacter sandarakinus	2747268	S	268	24	292	0.00002
Dyadobacter sp. LJ419	2906456	S	159	12	171	0.00001
Dyadobacter sp. NIV53	2861765	S	90	6	96	0.00001
Fibrella aestuarina	651143	S	863	80	943	0.00007
Fibrella sp. ES10-3-2-2	1834519	S	346	28	374	0.00003
Runella slithyformis	106	S	323	28	351	0.00003
Runella rosea	2259595	S	202	21	223	0.00002
Runella sp. SP2	2268026	S	137	8	145	0.00001
Larkinella sp. IE-0392	2907205	S	245	18	263	0.00002
Leadbetterella byssophila	316068	S	51	27	78	0.00001
Arcticibacterium luteifluviistationis	1784714	S	27	1	28	0.00000
Chryseolinea soli	2321403	S	1859	58	1917	0.00015
Fulvivirga sp. SS9-22	2904245	S	93	8	101	0.00001
Fulvivirga sp. SW1-E11	2904247	S	55	22	77	0.00001
Fulvivirga sp. W9P-11	2904246	S	49	14	63	0.00000
Fulvivirga lutea	2810512	S	50	7	57	0.00000
Echinicola vietnamensis	390884	S	91	46	137	0.00001
Echinicola sp. 20G	2781961	S	48	7	55	0.00000
Echinicola sp. SCS 3-6	2859768	S	39	17	56	0.00000
Echinicola rosea	1807691	S	84	37	121	0.00001
Echinicola soli	2591634	S	77	7	84	0.00001
Echinicola strongylocentroti	1795355	S	76	13	89	0.00001
Algoriphagus sp. Y33	2772483	S	66	7	73	0.00001
Algoriphagus sp. NBT04N3	2705473	S	40	13	53	0.00000
Algoriphagus sanaruensis	1727163	S	75	6	81	0.00001
Algoriphagus machipongonensis	388413	S	31	2	33	0.00000
Cyclobacterium amurskyense	320787	S	36	6	42	0.00000
Cyclobacterium marinum	104	S	33	10	43	0.00000
Aquiflexum balticum	280473	S	68	10	78	0.00001
Belliella baltica	232259	S	52	25	77	0.00001
Mongoliitalea daihaiensis	2782006	S	38	4	42	0.00000
Flammeovirga yaeyamensis	367791	S	26	20	46	0.00000
Flammeovirga pectinis	2494373	S	22	4	26	0.00000
Flammeovirga sp. MY04	1191459	S	13	10	23	0.00000
Flammeovirga kamogawensis	373891	S	10	1	11	0.00000
Cardinium endosymbiont of Oedothorax gibbosus	931101	S	12	24	36	0.00000
Candidatus Cardinium hertigii	247481	S	12	3	15	0.00000
Candidatus Amoebophilus asiaticus	281120	S	32	1	33	0.00000
Marivirga tractuosa	1006	S	61	23	84	0.00001
Mangrovivirga cuniculi	2715131	S	58	4	62	0.00000
Bernardetia litoralis	999	S	34	3	37	0.00000
Niastella koreensis	354356	S	6883	574	7457	0.00057
Chitinophaga sp. XS-30	2604421	S	579	168	747	0.00006
Chitinophaga sp. KRA15-503	2829818	S	345	152	497	0.00004
Chitinophaga oryzae	2725414	S	623	80	703	0.00005
Chitinophaga alhagiae	2203219	S	380	7	387	0.00003
Chitinophaga filiformis	104663	S	361	49	410	0.00003
Chitinophaga pinensis	79329	S	294	54	348	0.00003
Chitinophaga agri	2703787	S	265	58	323	0.00002
Chitinophaga caeni	2029983	S	175	27	202	0.00002
Flavisolibacter tropicus	1492898	S	871	112	983	0.00008
Flavisolibacter ginsenosidimutans	661481	S	734	38	772	0.00006
Paraflavitalea soli	2315862	S	1025	62	1087	0.00008
Pseudocnuella soli	2502779	S	1000	100	1100	0.00008
Flavihumibacter sp. IMCC34838	2838156	S	460	39	499	0.00004
Flavihumibacter sp. IMCC34837	2838157	S	316	20	336	0.00003
Pseudobacter ginsenosidimutans	661488	S	716	50	766	0.00006
Niabella ginsenosidivorans	1176587	S	327	28	355	0.00003
Niabella soli	446683	S	306	31	337	0.00003
Arachidicoccus sp. BS20	1850526	S	104	38	142	0.00001
Arachidicoccus sp. 5GH13-10	2875539	S	104	18	122	0.00001
Arachidicoccus sp. B3-10	2545455	S	63	5	68	0.00001
Arachidicoccus soli	2341117	S	82	8	90	0.00001
Arachidicoccus ginsenosidivorans	496057	S	72	11	83	0.00001
Lacibacter sp. S13-6-6	2760713	S	335	12	347	0.00003
Phnomibacter ginsenosidimutans	2676868	S	327	33	360	0.00003
Filimonas lacunae	477680	S	324	32	356	0.00003
Panacibacter ginsenosidivorans	1813871	S	314	12	326	0.00003
Ferruginibacter sp. KIS38-8	2875540	S	155	11	166	0.00001
Ferruginibacter lapsinanis	563172	S	133	10	143	0.00001
Rhodocaloribacter litoris	2558931	S	6005	708	6713	0.00052
Rhodothermus marinus	29549	S	5026	328	5354	0.00041
Salinibacter ruber	146919	S	3042	59	3101	0.00024
Alistipes onderdonkii	328813	S	614	778	1392	0.00011
Alistipes communis	2585118	S	614	487	1101	0.00008
Alistipes dispar	2585119	S	609	80	689	0.00005
Alistipes finegoldii	214856	S	486	490	976	0.00008
Alistipes senegalensis	1288121	S	476	115	591	0.00005
Alistipes megaguti	2364787	S	470	56	526	0.00004
Alistipes sp. dk3624	2662363	S	412	96	508	0.00004
Alistipes shahii	328814	S	390	245	635	0.00005
Alistipes indistinctus	626932	S	372	82	454	0.00004
Prevotella sp. Rep29	2691580	S	92	9	101	0.00001
Prevotella sp. oral taxon 475	712471	S	83	7	90	0.00001
Prevotella sp. E15-22	2937774	S	80	9	89	0.00001
Prevotella sp. E13-17	2913616	S	69	4	73	0.00001
Prevotella sp. E2-28	2913620	S	37	2	39	0.00000
Prevotella sp. E9-3	2913621	S	32	7	39	0.00000
Prevotella sp. E13-3	2913617	S	14	94	108	0.00001
Prevotella dentalis	52227	S	300	65	365	0.00003
Prevotella melaninogenica	28132	S	106	37	143	0.00001
Prevotella multiformis	282402	S	98	40	138	0.00001
Prevotella denticola	28129	S	88	28	116	0.00001
Prevotella ruminicola	839	S	77	3	80	0.00001
Prevotella intermedia	28131	S	70	32	102	0.00001
Prevotella buccalis	28127	S	62	72	134	0.00001
Prevotella enoeca	76123	S	49	9	58	0.00000
Prevotella copri	165179	S	39	19	58	0.00000
Prevotella fusca	589436	S	38	8	46	0.00000
Prevotella nigrescens	28133	S	25	17	42	0.00000
Prevotella jejuni	1177574	S	18	7	25	0.00000
Prevotella bryantii	77095	S	17	1	18	0.00000
Prevotella oris	28135	S	17	2	19	0.00000
Prevotella histicola	470565	S	12	2	14	0.00000
Prevotella herbatica	2801997	S	11	0	11	0.00000
Pseudoprevotella muciniphila	2133944	S	102	10	112	0.00001
Paraprevotella xylaniphila	454155	S	77	70	147	0.00001
Bacteroides fragilis	817	S	100	192	292	0.00002
Bacteroides sp. CBA7301	2715212	S	48	15	63	0.00000
Bacteroides sp. M10	2763022	S	16	35	51	0.00000
Bacteroides thetaiotaomicron	818	S	83	55	138	0.00001
Bacteroides cellulosilyticus	246787	S	80	29	109	0.00001
Bacteroides stercoris	46506	S	67	68	135	0.00001
Bacteroides zoogleoformans	28119	S	59	15	74	0.00001
Bacteroides eggerthii	28111	S	54	61	115	0.00001
Bacteroides salyersiae	291644	S	54	54	108	0.00001
Bacteroides helcogenes	290053	S	51	2	53	0.00000
Bacteroides heparinolyticus	28113	S	47	11	58	0.00000
Bacteroides uniformis	820	S	47	135	182	0.00001
Bacteroides nordii	291645	S	35	27	62	0.00000
Bacteroides xylanisolvens	371601	S	34	76	110	0.00001
Bacteroides caccae	47678	S	26	11	37	0.00000
Bacteroides zhangwenhongii	2650157	S	26	17	43	0.00000
Bacteroides luhongzhouii	2650158	S	25	11	36	0.00000
Bacteroides ovatus	28116	S	24	47	71	0.00001
Bacteroides faecis	674529	S	23	19	42	0.00000
Bacteroides intestinalis	329854	S	23	4	27	0.00000
Bacteroides caecimuris	1796613	S	12	17	29	0.00000
Bacteroides coprosuis	151276	S	10	0	10	0.00000
Phocaeicola salanitronis	376805	S	106	48	154	0.00001
Phocaeicola coprophilus	387090	S	63	36	99	0.00001
Phocaeicola vulgatus	821	S	31	47	78	0.00001
Phocaeicola dorei	357276	S	29	61	90	0.00001
Tannerella serpentiformis	712710	S	402	21	423	0.00003
Tannerella forsythia	28112	S	117	10	127	0.00001
Parabacteroides goldsteinii	328812	S	119	32	151	0.00001
Parabacteroides merdae	46503	S	90	104	194	0.00001
Parabacteroides distasonis	823	S	56	197	253	0.00002
Parabacteroides johnsonii	387661	S	54	46	100	0.00001
Sodaliphilus pleomorphus	2606626	S	276	144	420	0.00003
Duncaniella dubosii	2518971	S	89	13	102	0.00001
Muribaculum gordoncarteri	2530390	S	109	13	122	0.00001
Muribaculum intestinale	1796646	S	106	12	118	0.00001
Porphyromonas sp. oral taxon 275	712435	S	330	34	364	0.00003
Porphyromonas asaccharolytica	28123	S	99	7	106	0.00001
Porphyromonas gingivalis	837	S	98	14	112	0.00001
Porphyromonas somerae	322095	S	43	11	54	0.00000
Porphyromonas cangingivalis	36874	S	38	5	43	0.00000
Porphyromonas crevioricanis	393921	S	27	6	33	0.00000
Porphyromonas endodontalis	28124	S	25	2	27	0.00000
Petrimonas mucosa	1642646	S	136	7	143	0.00001
Proteiniphilum saccharofermentans	1642647	S	78	8	86	0.00001
Proteiniphilum sp. JNU-WLY501	2829812	S	30	1	31	0.00000
Barnesiella viscericola	397865	S	163	222	385	0.00003
Coprobacter secundus	1501392	S	25	23	48	0.00000
Butyricimonas virosa	544645	S	41	17	58	0.00000
Butyricimonas faecalis	2093856	S	40	53	93	0.00001
Odoribacter splanchnicus	28118	S	50	34	84	0.00001
Paludibacter propionicigenes	185300	S	53	1	54	0.00000
Tenuifilum thalassicum	2590900	S	36	1	37	0.00000
Salinivirga cyanobacteriivorans	1307839	S	35	0	35	0.00000
Draconibacterium orientale	1168034	S	79	5	84	0.00001
Draconibacterium halophilum	2706887	S	53	3	56	0.00000
Maribellus comscasis	2681766	S	71	1	72	0.00001
Alkalitalea saponilacus	889453	S	37	2	39	0.00000
Labilibaculum antarcticum	1717717	S	37	2	39	0.00000
Flavobacterium sp. HJ-32-4	1160795	S	208	16	224	0.00002
Flavobacterium sp. MDT1-60	1979344	S	56	14	70	0.00001
Flavobacterium sp. CJ74	2294119	S	47	4	51	0.00000
Flavobacterium sp. CLA17	2724135	S	45	10	55	0.00000
Flavobacterium sp. B183	907046	S	38	11	49	0.00000
Flavobacterium sp. KBS0721	1179672	S	37	15	52	0.00000
Flavobacterium sp. F-29	2893883	S	32	8	40	0.00000
Flavobacterium sp. IGB 4-14	1871076	S	29	3	32	0.00000
Flavobacterium sp. K5-23	2746225	S	26	7	33	0.00000
Flavobacterium sp. MMS21-Er5	2937442	S	25	14	39	0.00000
Flavobacterium sp. KSM-R2A25	2895947	S	23	7	30	0.00000
Flavobacterium sp. M31R6	2739062	S	22	4	26	0.00000
Flavobacterium sp. F-323	2893885	S	22	6	28	0.00000
Flavobacterium sp. WSW3-B6	2856519	S	22	3	25	0.00000
Flavobacterium sp. F-70	2893884	S	21	5	26	0.00000
Flavobacterium sp. Sr18	935222	S	19	4	23	0.00000
Flavobacterium sp. SLB02	2665645	S	18	5	23	0.00000
Flavobacterium sp. KK2020170	2830782	S	17	6	23	0.00000
Flavobacterium sp. F-340	2893886	S	17	6	23	0.00000
Flavobacterium sp. KSM-R2A30	2897181	S	15	6	21	0.00000
Flavobacterium sp. xlx-214	2654325	S	14	3	17	0.00000
Flavobacterium sp. CS20	2775246	S	14	6	20	0.00000
Flavobacterium sp. 140616W15	2478552	S	14	3	17	0.00000
Flavobacterium sp. LPB0248	2614441	S	12	9	21	0.00000
Flavobacterium sp. I3-2	2748319	S	11	17	28	0.00000
Flavobacterium album	2175091	S	136	11	147	0.00001
Flavobacterium magnum	2162713	S	132	17	149	0.00001
Flavobacterium pallidum	2172098	S	105	12	117	0.00001
Flavobacterium nackdongense	2547394	S	61	6	67	0.00001
Flavobacterium commune	1306519	S	52	10	62	0.00000
Flavobacterium inviolabile	2748320	S	47	8	55	0.00000
Flavobacterium anhuiense	459526	S	36	19	55	0.00000
Flavobacterium johnsoniae	986	S	36	24	60	0.00000
Flavobacterium enshiense	1341165	S	36	4	40	0.00000
Flavobacterium gilvum	1492737	S	35	6	41	0.00000
Flavobacterium alkalisoli	2602769	S	34	3	37	0.00000
Flavobacterium endoglycinae	2816357	S	30	8	38	0.00000
Flavobacterium kingsejongi	1678728	S	28	4	32	0.00000
Flavobacterium crocinum	2183896	S	28	11	39	0.00000
Flavobacterium fluviale	2249356	S	26	13	39	0.00000
Flavobacterium faecale	1355330	S	23	3	26	0.00000
Flavobacterium sangjuense	2518177	S	23	2	25	0.00000
Flavobacterium branchiophilum	55197	S	19	2	21	0.00000
Flavobacterium sediminis	2201181	S	18	18	36	0.00000
Flavobacterium psychrophilum	96345	S	18	4	22	0.00000
Flavobacterium nitrogenifigens	1617283	S	17	12	29	0.00000
Flavobacterium davisii	2906077	S	14	7	21	0.00000
Flavobacterium indicum	312277	S	13	2	15	0.00000
Flavobacterium columnare	996	S	13	20	33	0.00000
Flavobacterium sediminilitoris	2024526	S	12	2	14	0.00000
Flavobacterium haoranii	683124	S	12	6	18	0.00000
Flavobacterium oreochromis	2906078	S	10	5	15	0.00000
Flavobacterium jumunjinense	998845	S	10	1	11	0.00000
Muricauda sp. SCSIO 65647	2908843	S	70	2	72	0.00001
Muricauda sp. SCSIO 64092	2908842	S	48	1	49	0.00000
Muricauda oceani	2698672	S	85	45	130	0.00001
Muricauda lutaonensis	516051	S	81	21	102	0.00001
Muricauda aquimarina	254955	S	74	40	114	0.00001
Muricauda ruestringensis	111501	S	65	5	70	0.00001
Muricauda aurantiaca	1383885	S	35	3	38	0.00000
Capnocytophaga gingivalis	1017	S	81	13	94	0.00001
Capnocytophaga haemolytica	45243	S	66	7	73	0.00001
Capnocytophaga sp. oral taxon 878	1316596	S	16	17	33	0.00000
Capnocytophaga sp. FDAARGOS_737	2545799	S	10	15	25	0.00000
Capnocytophaga sputigena	1019	S	46	22	68	0.00001
Capnocytophaga stomatis	1848904	S	31	9	40	0.00000
Capnocytophaga canimorsus	28188	S	25	8	33	0.00000
Capnocytophaga ochracea	1018	S	16	35	51	0.00000
Capnocytophaga endodontalis	2708117	S	14	10	24	0.00000
Capnocytophaga leadbetteri	327575	S	10	8	18	0.00000
Gramella fulva	2126553	S	96	10	106	0.00001
Gramella sp. GC03-9	2920386	S	43	13	56	0.00000
Gramella sp. MT6	2705471	S	29	4	33	0.00000
Gramella sp. MAR_2010_147	1250205	S	19	3	22	0.00000
Gramella flava	1486245	S	60	21	81	0.00001
Gramella forsetii	411153	S	32	9	41	0.00000
Gramella echinicola	279359	S	25	3	28	0.00000
Gramella salexigens	1913577	S	20	2	22	0.00000
Robiginitalea biformata	252307	S	334	23	357	0.00003
Nonlabens sp. Hel1_33_55	1336802	S	44	9	53	0.00000
Nonlabens sp. Ci31	2608253	S	15	8	23	0.00000
Nonlabens spongiae	331648	S	40	22	62	0.00000
Nonlabens ponticola	2496866	S	27	4	31	0.00000
Nonlabens dokdonensis	328515	S	21	6	27	0.00000
Nonlabens marinus	930802	S	11	4	15	0.00000
Polaribacter sp. G4M1	2808900	S	19	11	30	0.00000
Polaribacter sp. SM13	2818493	S	17	12	29	0.00000
Polaribacter sp. Hel1_33_78	1336804	S	12	5	17	0.00000
Polaribacter vadi	1774273	S	14	5	19	0.00000
Polaribacter litorisediminis	1908341	S	13	3	16	0.00000
Kordia antarctica	1218801	S	117	9	126	0.00001
Kordia sp. SMS9	2282170	S	20	1	21	0.00000
Winogradskyella sp. PC-19	754417	S	16	5	21	0.00000
Winogradskyella sp. J14-2	1936080	S	15	2	17	0.00000
Winogradskyella sp. PG-2	754409	S	14	1	15	0.00000
Winogradskyella forsetii	2686077	S	28	10	38	0.00000
Winogradskyella schleiferi	2686078	S	15	8	23	0.00000
Winogradskyella sediminis	1382466	S	13	5	18	0.00000
Winogradskyella helgolandensis	2697010	S	11	3	14	0.00000
Aequorivita sublithincola	101385	S	40	42	82	0.00001
Aequorivita sp. H23M31	2494375	S	37	18	55	0.00000
Antarcticibacterium flavum	2058175	S	51	13	64	0.00000
Antarcticibacterium sp. 1MA-6-2	2908210	S	42	6	48	0.00000
Antarcticibacterium arcticum	2585771	S	27	4	31	0.00000
Sinomicrobium sp. HD2P242	2900738	S	108	5	113	0.00001
Salegentibacter salegens	143223	S	38	5	43	0.00000
Salegentibacter mishustinae	270918	S	30	29	59	0.00000
Salegentibacter sp. T436	1729720	S	30	32	62	0.00000
Maribacter sp. MJ134	2496865	S	24	5	29	0.00000
Maribacter sp. HTCC2170	313603	S	15	2	17	0.00000
Maribacter cobaltidurans	1178778	S	23	23	46	0.00000
Maribacter hydrothermalis	1836467	S	15	9	24	0.00000
Myroides odoratus	256	S	27	4	31	0.00000
Myroides fluvii	2572594	S	15	3	18	0.00000
Myroides sp. ZB35	1458492	S	10	30	40	0.00000
Myroides phaeus	702745	S	11	9	20	0.00000
Tenacibaculum sp. SZ-18	754423	S	15	13	28	0.00000
Tenacibaculum todarodis	1850252	S	18	9	27	0.00000
Tenacibaculum jejuense	584609	S	16	3	19	0.00000
Formosa sp. Hel1_33_131	1336794	S	25	2	27	0.00000
Formosa sp. L2A11	2686363	S	14	5	19	0.00000
Formosa sp. Hel3_A1_48	1336795	S	11	3	14	0.00000
Formosa sp. Hel1_31_208	1798225	S	10	1	11	0.00000
Formosa sediminum	2594004	S	13	3	16	0.00000
Aggregatimonas sangjinii	2583587	S	74	4	78	0.00001
Flagellimonas sp. HMM57	2905121	S	42	3	45	0.00000
Flagellimonas sp. CMM7	2654676	S	29	2	31	0.00000
Cellulophaga lytica	979	S	21	26	47	0.00000
Pukyongia salina	2094025	S	58	4	62	0.00000
Zunongwangia sp. SCSIO 43204	2779359	S	34	25	59	0.00000
Zunongwangia profunda	398743	S	20	17	37	0.00000
Aquimarina sp. TRL1	2736252	S	16	1	17	0.00000
Aquimarina sp. AD1	1714848	S	13	1	14	0.00000
Aquimarina sp. BL5	1714860	S	13	1	14	0.00000
Dokdonia sp. 4H-3-7-5	983548	S	12	21	33	0.00000
Zobellia galactanivorans	63186	S	48	3	51	0.00000
Arenibacter algicola	616991	S	47	17	64	0.00000
Leeuwenhoekiella palythoae	573501	S	14	14	28	0.00000
Leeuwenhoekiella sp. ZYFB001	2719912	S	11	9	20	0.00000
Zhouia spongiae	2202721	S	39	10	49	0.00000
Gilvibacter sp. SZ-19	754429	S	37	5	42	0.00000
Seonamhaeicola sp. ML3	2937786	S	22	3	25	0.00000
Seonamhaeicola sp. S2-3	1936081	S	12	3	15	0.00000
Lacinutrix sp. Bg11-31	2057808	S	10	4	14	0.00000
Muriicola soli	2507538	S	34	2	36	0.00000
Costertonia aggregata	343403	S	33	8	41	0.00000
Euzebyella marina	1761453	S	32	19	51	0.00000
Mariniflexile sp. TRM1-10	2027857	S	31	3	34	0.00000
Algibacter sp. L3A6	2686366	S	12	5	17	0.00000
Lutibacter sp. A64	2918526	S	14	2	16	0.00000
Constantimarinum furrinae	2562285	S	29	3	32	0.00000
Galbibacter sp. BG1	1170699	S	28	3	31	0.00000
Tamlana sp. s12	1630406	S	13	7	20	0.00000
Aegicerativicinus sediminis	2893202	S	23	1	24	0.00000
Sediminicola sp. YIK13	1453352	S	23	2	25	0.00000
Amniculibacterium sp. G2-70	2767188	S	22	28	50	0.00000
Flavivirga eckloniae	1803846	S	22	2	24	0.00000
Changchengzhania lutea	2049305	S	18	2	20	0.00000
Flavobacteriaceae bacterium 10Alg115	2584122	S	18	1	19	0.00000
Croceibacter atlanticus	313588	S	18	3	21	0.00000
Psychroflexus sp. ALD_RP9	2777186	S	10	1	11	0.00000
Marixanthomonas sp. SCSIO 43207	2779360	S	17	5	22	0.00000
Bizionia sp. M204	2675331	S	17	4	21	0.00000
Urechidicola croceus	1850246	S	15	9	24	0.00000
Gillisia sp. Hel1_33_143	1336796	S	13	5	18	0.00000
Oceanihabitans sp. IOP_32	2529032	S	11	5	16	0.00000
Siansivirga zeaxanthinifaciens	762954	S	11	3	14	0.00000
Wenyingzhuangia fucanilytica	1790137	S	10	2	12	0.00000
Chryseobacterium sp. 6424	2039166	S	76	22	98	0.00001
Chryseobacterium sp.	1871047	S	62	29	91	0.00001
Chryseobacterium sp. SC2-2	2929800	S	47	34	81	0.00001
Chryseobacterium sp. cx-624	2758037	S	35	7	42	0.00000
Chryseobacterium sp. Y16C	2920939	S	31	25	56	0.00000
Chryseobacterium sp. PCH239	2825845	S	27	22	49	0.00000
Chryseobacterium sp. F4	2852098	S	26	2	28	0.00000
Chryseobacterium sp. T16E-39	2015076	S	24	3	27	0.00000
Chryseobacterium sp. MEBOG06	2879938	S	24	6	30	0.00000
Chryseobacterium sp. ZHDP1	2838877	S	23	24	47	0.00000
Chryseobacterium sp. POL2	2713414	S	23	19	42	0.00000
Chryseobacterium sp. IHB B 17019	1721091	S	19	4	23	0.00000
Chryseobacterium sp. ADR-1	2929799	S	19	7	26	0.00000
Chryseobacterium sp. StRB126	878220	S	19	7	26	0.00000
Chryseobacterium sp. G0201	2487065	S	18	5	23	0.00000
Chryseobacterium sp. MEBOG07	2879939	S	18	6	24	0.00000
Chryseobacterium sp. DH-B6	2759528	S	17	9	26	0.00000
Chryseobacterium sp. G0186	2487064	S	15	11	26	0.00000
Chryseobacterium sp. LJ668	2864040	S	15	3	18	0.00000
Chryseobacterium sp. G0162	2487063	S	12	14	26	0.00000
Chryseobacterium sp. SNU WT5	2594269	S	11	5	16	0.00000
Chryseobacterium sp. 3008163	2478663	S	11	6	17	0.00000
Chryseobacterium cucumeris	1813611	S	112	66	178	0.00001
Chryseobacterium indologenes	253	S	87	49	136	0.00001
Chryseobacterium taklimakanense	536441	S	85	58	143	0.00001
Chryseobacterium camelliae	1265445	S	57	43	100	0.00001
Chryseobacterium arthrosphaerae	651561	S	52	33	85	0.00001
Chryseobacterium gallinarum	1324352	S	51	22	73	0.00001
Chryseobacterium shandongense	1493872	S	43	32	75	0.00001
Chryseobacterium nepalense	1854498	S	38	7	45	0.00000
Chryseobacterium indoltheticum	254	S	34	9	43	0.00000
Chryseobacterium salivictor	2547600	S	34	6	40	0.00000
Chryseobacterium manosquense	2754694	S	26	25	51	0.00000
Chryseobacterium aureum	2497456	S	24	6	30	0.00000
Chryseobacterium gleum	250	S	22	34	56	0.00000
Chryseobacterium glaciei	1685010	S	22	5	27	0.00000
Chryseobacterium piperi	558152	S	22	3	25	0.00000
Chryseobacterium lactis	1241981	S	21	28	49	0.00000
Chryseobacterium carnipullorum	1124835	S	20	8	28	0.00000
Chryseobacterium daecheongense	192389	S	20	3	23	0.00000
Chryseobacterium joostei	112234	S	16	7	23	0.00000
Chryseobacterium nakagawai	1241982	S	15	27	42	0.00000
Chryseobacterium balustinum	246	S	11	4	15	0.00000
Kaistella sp. 97-N-M2	2908645	S	55	9	64	0.00000
Kaistella sp. GW4-15	2878534	S	18	2	20	0.00000
Kaistella daneshvariae	2487074	S	28	3	31	0.00000
Kaistella antarctica	266748	S	27	3	30	0.00000
Candidatus Kaistella beijingensis	2820270	S	23	11	34	0.00000
Kaistella carnis	1241979	S	18	7	25	0.00000
Kaistella flava (ex Peng et al. 2021)	2038776	S	18	3	21	0.00000
Kaistella jeonii	266749	S	17	1	18	0.00000
Epilithonimonas zeae	1416779	S	29	5	34	0.00000
Epilithonimonas vandammei	2487072	S	23	45	68	0.00001
Elizabethkingia anophelis	1117645	S	444	431	875	0.00007
Elizabethkingia sp. JS20170427COW	2583851	S	16	2	18	0.00000
Elizabethkingia sp. M8	2796140	S	10	28	38	0.00000
Elizabethkingia meningoseptica	238	S	29	2	31	0.00000
Elizabethkingia miricola	172045	S	19	11	30	0.00000
Elizabethkingia ursingii	1756150	S	14	3	17	0.00000
Cruoricaptor ignavus	1118202	S	95	14	109	0.00001
Apibacter raozihei	2500547	S	11	12	23	0.00000
Empedobacter brevis	247	S	21	9	30	0.00000
Empedobacter falsenii	343874	S	15	12	27	0.00000
Ornithobacterium rhinotracheale	28251	S	36	33	69	0.00001
Cloacibacterium caeni	2004710	S	23	29	52	0.00000
Riemerella anatipestifer	34085	S	30	15	45	0.00000
Bergeyella cardium	1585976	S	30	7	37	0.00000
Weeksella virosa	1014	S	24	13	37	0.00000
Blattabacterium cuenoti	1653831	S	121	42	163	0.00001
Owenweeksia hongkongensis	253245	S	43	3	46	0.00000
Croceimicrobium hydrocarbonivorans	2761580	S	40	9	49	0.00000
Fluviicola taffensis	191579	S	43	3	46	0.00000
Crocinitomix sp. GM2_3_6_6	2862509	S	32	1	33	0.00000
Candidatus Sulcia muelleri	336810	S	20	6	26	0.00000
Candidatus Walczuchella monophlebidarum	1415657	S	13	1	14	0.00000
Ichthyobacterium seriolicida	242600	S	14	0	14	0.00000
Mucilaginibacter sp. 14171R-50	2703789	S	137	6	143	0.00001
Mucilaginibacter sp. SMC90	2929803	S	131	7	138	0.00001
Mucilaginibacter sp. 21P	2778902	S	81	4	85	0.00001
Mucilaginibacter sp. F39-2	2728022	S	71	4	75	0.00001
Mucilaginibacter daejeonensis	398049	S	240	14	254	0.00002
Mucilaginibacter ginsenosidivorans	398053	S	228	7	235	0.00002
Mucilaginibacter mali	2740462	S	220	8	228	0.00002
Mucilaginibacter gotjawali	1550579	S	195	5	200	0.00002
Mucilaginibacter celer	2305508	S	158	6	164	0.00001
Mucilaginibacter paludis	423351	S	151	7	158	0.00001
Mucilaginibacter ginsenosidivorax	862126	S	139	5	144	0.00001
Mucilaginibacter rubeus	2027860	S	123	305	428	0.00003
Mucilaginibacter xinganensis	1234841	S	119	5	124	0.00001
Mucilaginibacter ginkgonis	2682091	S	113	5	118	0.00001
Mucilaginibacter mallensis	652787	S	110	3	113	0.00001
Mucilaginibacter gossypii	551996	S	60	45	105	0.00001
Pedobacter sp. KBS0701	2578106	S	92	26	118	0.00001
Pedobacter sp. PACM 27299	1727164	S	77	11	88	0.00001
Pedobacter sp. HDW13	2714940	S	62	7	69	0.00001
Pedobacter sp. D749	2856523	S	51	14	65	0.00001
Pedobacter sp. G11	2482728	S	40	5	45	0.00000
Pedobacter sp. Q8-18	2895286	S	40	3	43	0.00000
Pedobacter sp. SW-16	2766984	S	37	6	43	0.00000
Pedobacter heparinus	984	S	91	7	98	0.00001
Pedobacter endophyticus	2789740	S	85	8	93	0.00001
Pedobacter steynii	430522	S	80	7	87	0.00001
Pedobacter schmidteae	2201271	S	76	6	82	0.00001
Pedobacter suwonensis	332999	S	72	14	86	0.00001
Pedobacter roseus	336820	S	71	19	90	0.00001
Pedobacter aquae	2605747	S	58	6	64	0.00000
Pedobacter cryoconitis	188932	S	46	4	50	0.00000
Pedobacter ginsengisoli	363852	S	43	5	48	0.00000
Sphingobacterium sp. DR205	2713573	S	72	8	80	0.00001
Sphingobacterium sp. CZ-2	2557994	S	50	14	64	0.00000
Sphingobacterium sp. UDSM-2020	2795738	S	27	8	35	0.00000
Sphingobacterium sp. PCS056	2931400	S	25	4	29	0.00000
Sphingobacterium sp. ML3W	1538644	S	23	7	30	0.00000
Sphingobacterium sp. dk4302	2662364	S	22	2	24	0.00000
Sphingobacterium sp. SRCM116780	2907623	S	20	3	23	0.00000
Sphingobacterium sp. G1-14	2003121	S	11	53	64	0.00000
Sphingobacterium thalpophilum	259	S	134	167	301	0.00002
Sphingobacterium mizutaii	1010	S	130	20	150	0.00001
Sphingobacterium spiritivorum	258	S	100	78	178	0.00001
Sphingobacterium lactis	797291	S	72	68	140	0.00001
Sphingobacterium hotanense	649196	S	44	15	59	0.00000
Sphingobacterium multivorum	28454	S	42	102	144	0.00001
Sphingobacterium psychroaquaticum	561061	S	42	8	50	0.00000
Sphingobacterium daejeonense	371142	S	25	7	32	0.00000
Sphingobacterium paramultivorum	2886510	S	14	15	29	0.00000
Anseongella ginsenosidimutans	496056	S	267	11	278	0.00002
Olivibacter sp. LS-1	2592345	S	127	8	135	0.00001
Olivibacter sp. SDN3	2764720	S	64	10	74	0.00001
Solitalea canadensis	995	S	65	6	71	0.00001
Solitalea sp. S2-8	2911172	S	55	7	62	0.00000
Pseudopedobacter saltans	151895	S	34	30	64	0.00000
Haliscomenobacter hydrossis	2350	S	338	4	342	0.00003
Saprospira grandis	1008	S	58	1	59	0.00000
Candidatus Sulfidibacterium hydrothermale	2875962	S	79	3	82	0.00001
Chlorobaculum limnaeum	274537	S	903	152	1055	0.00008
Chlorobaculum tepidum	1097	S	538	157	695	0.00005
Chlorobaculum parvum	274539	S	501	99	600	0.00005
Pelodictyon luteolum	1100	S	434	68	502	0.00004
Pelodictyon phaeoclathratiforme	34090	S	73	4	77	0.00001
Chlorobium limicola	1092	S	238	18	256	0.00002
Chlorobium phaeobacteroides	1096	S	126	16	142	0.00001
Chlorobium phaeovibrioides	1094	S	123	24	147	0.00001
Prosthecochloris sp. GSB1	281093	S	429	34	463	0.00004
Prosthecochloris sp. CIB 2401	1868325	S	129	39	168	0.00001
Prosthecochloris sp. HL-130-GSB	1974213	S	116	26	142	0.00001
Prosthecochloris aestuarii	1102	S	129	14	143	0.00001
Chloroherpeton thalassium	100716	S	219	4	223	0.00002
Candidatus Cyclonatronum proteinivorum	1457365	S	310	36	346	0.00003
Melioribacter roseus	1134405	S	142	15	157	0.00001
Ignavibacterium album	591197	S	61	8	69	0.00001
Gemmatirosa kalamazoonesis	861299	S	65907	7389	73296	0.00565
Gemmatimonas groenlandica	2732249	S	9289	1244	10533	0.00081
Gemmatimonas aurantiaca	173480	S	7492	898	8390	0.00065
Gemmatimonas phototrophica	1379270	S	5866	952	6818	0.00053
Fibrobacter succinogenes	833	S	162	3	165	0.00001
Candidatus Cloacimonas acidaminovorans	456827	S	133	3	136	0.00001
Luteitalea sp. TBR-22	2802971	S	44918	9328	54246	0.00418
Luteitalea pratensis	1855912	S	37461	5018	42479	0.00327
Granulicella sp. WH15	2602070	S	3187	670	3857	0.00030
Granulicella sp. 5B5	1617967	S	2445	463	2908	0.00022
Granulicella mallensis	940614	S	2175	302	2477	0.00019
Granulicella tundricola	940615	S	1713	262	1975	0.00015
Terriglobus roseus	392734	S	2783	706	3489	0.00027
Terriglobus albidus	1592106	S	2216	250	2466	0.00019
Terriglobus saanensis	870903	S	1438	225	1663	0.00013
Acidobacterium capsulatum	33075	S	2904	411	3315	0.00026
Acidobacterium sp. 4Y35	2763107	S	2470	197	2667	0.00021
Candidatus Koribacter versatilis	658062	S	4618	182	4800	0.00037
Edaphobacter sp. 12200R-103	2703788	S	1841	365	2206	0.00017
Edaphobacter sp. 4G125	2763071	S	983	166	1149	0.00009
Acidisarcina polymorpha	2211140	S	1827	156	1983	0.00015
Paludibaculum fermentans	1473598	S	8647	278	8925	0.00069
Chloracidobacterium aggregatum	2851959	S	1353	905	2258	0.00017
Chloracidobacterium validum	2821543	S	1163	26	1189	0.00009
Chloracidobacterium sp. D	2821536	S	120	609	729	0.00006
Chloracidobacterium thermophilum	458033	S	76	356	432	0.00003
Sulfidibacter corallicola	2818388	S	2488	64	2552	0.00020
Thermotomaculum hydrothermale	981385	S	95	5	100	0.00001
Nitrospira moscoviensis	42253	S	7257	674	7931	0.00061
Nitrospira japonica	1325564	S	4191	525	4716	0.00036
Nitrospira sp. KM1	1936990	S	3172	310	3482	0.00027
Candidatus Nitrospira inopinata	1715989	S	2547	234	2781	0.00021
Leptospirillum ferrooxidans	180	S	160	4	164	0.00001
Leptospirillum ferriphilum	178606	S	68	133	201	0.00002
Leptospirillum sp. Group II 'CF-1'	1660083	S	42	110	152	0.00001
Thermodesulfovibrio yellowstonii	28262	S	140	5	145	0.00001
Dissulfurispira thermophila	2715679	S	77	6	83	0.00001
Treponema brennaborense	81028	S	172	65	237	0.00002
Treponema azotonutricium	150829	S	131	4	135	0.00001
Treponema primitia	88058	S	117	5	122	0.00001
Treponema socranskii	53419	S	106	46	152	0.00001
Treponema sp. Marseille-Q4132	2766701	S	79	34	113	0.00001
Treponema sp. OMZ 838	1539298	S	24	23	47	0.00000
Treponema caldarium	215591	S	94	10	104	0.00001
Treponema parvum	138851	S	64	3	67	0.00001
Treponema succinifaciens	167	S	54	46	100	0.00001
Treponema vincentii	69710	S	39	37	76	0.00001
Treponema denticola	158	S	34	6	40	0.00000
Treponema medium	58231	S	29	33	62	0.00000
Treponema peruense	2787628	S	26	3	29	0.00000
Treponema phagedenis	162	S	26	11	37	0.00000
Treponema pedis	409322	S	12	2	14	0.00000
Spirochaeta thermophila	154	S	674	17	691	0.00005
Spirochaeta africana	46355	S	209	10	219	0.00002
Sediminispirochaeta smaragdinae	55206	S	96	2	98	0.00001
Salinispira pacifica	1307761	S	92	2	94	0.00001
Oceanispirochaeta crateris	2518645	S	40	2	42	0.00000
Sphaerochaeta associata	1129264	S	129	15	144	0.00001
Sphaerochaeta coccoides	273376	S	106	4	110	0.00001
Sphaerochaeta globosa	1131703	S	52	6	58	0.00000
Sphaerochaeta pleomorpha	1131707	S	43	7	50	0.00000
Breznakiella homolactica	2798577	S	180	12	192	0.00001
Borrelia sp. HM	1882662	S	14	66	80	0.00001
Leptospira santarosai	28183	S	95	1	96	0.00001
Leptospira kmetyi	408139	S	85	1	86	0.00001
Leptospira tipperaryensis	2564040	S	49	0	49	0.00000
Leptospira weilii	28184	S	44	0	44	0.00000
Leptospira kobayashii	1917830	S	36	0	36	0.00000
Leptospira mayottensis	1137606	S	29	0	29	0.00000
Leptospira noguchii	28182	S	23	0	23	0.00000
Leptospira interrogans	173	S	13	209	222	0.00002
Leptospira biflexa	172	S	10	0	10	0.00000
Turneriella parva	29510	S	299	3	302	0.00002
Brachyspira pilosicoli	52584	S	10	47	57	0.00000
Pyramidobacter piscolens	638849	S	625	46	671	0.00005
Fretibacterium fastidiosum	651822	S	624	10	634	0.00005
Aminomonas paucivorans	81412	S	543	74	617	0.00005
Thermanaerovibrio acidaminovorans	81462	S	296	121	417	0.00003
Thermanaerovibrio velox	108007	S	168	44	212	0.00002
Cloacibacillus porcorum	1197717	S	411	98	509	0.00004
Jonquetella anthropi	428712	S	331	60	391	0.00003
Acetomicrobium mobile	97477	S	103	3	106	0.00001
Aminobacterium colombiense	81468	S	84	6	90	0.00001
Thermovirga lienii	336261	S	55	53	108	0.00001
Candidatus Bipolaricaulis anaerobius	2026885	S	706	35	741	0.00006
Candidatus Nanosynbacter featherlites	2572088	S	48	24	72	0.00001
Candidatus Nanosynbacter lyticus	2093824	S	32	103	135	0.00001
Nanosynbacter sp. HMT-352	2899133	S	19	62	81	0.00001
Candidatus Nanosynbacter sp. HMT352	2902423	S	10	39	49	0.00000
Candidatus Saccharimonas aalborgensis	1332188	S	117	2	119	0.00001
Candidatus Babela massiliensis	673862	S	119	3	122	0.00001
Candidatus Absconditicoccus praedator	2735562	S	53	0	53	0.00000
Candidatus Chazhemtobacterium aquaticus	2715735	S	52	0	52	0.00000
Thermotoga caldifontis	1508419	S	130	2	132	0.00001
Thermotoga maritima	2336	S	11	336	347	0.00003
Thermotoga profunda	1508420	S	11	0	11	0.00000
Pseudothermotoga hypogea	57487	S	74	31	105	0.00001
Pseudothermotoga thermarum	119394	S	18	5	23	0.00000
Fervidobacterium nodosum	2424	S	24	20	44	0.00000
Fervidobacterium pennivorans	93466	S	19	42	61	0.00000
Thermosipho ferrireducens	2571116	S	16	11	27	0.00000
Kosmotoga olearia	651457	S	27	38	65	0.00001
Kosmotoga pacifica	1330330	S	20	30	50	0.00000
Mesotoga infera	1236046	S	68	14	82	0.00001
Mesotoga prima	1184387	S	30	6	36	0.00000
Petrotoga mobilis	69499	S	20	12	32	0.00000
Defluviitoga tunisiensis	1006576	S	15	26	41	0.00000
Tepiditoga spiralis	2108365	S	12	2	14	0.00000
Athalassotoga saccharophila	1441386	S	79	2	81	0.00001
Thermocrinis minervae	381751	S	68	6	74	0.00001
Thermocrinis albus	136094	S	25	2	27	0.00000
Thermocrinis ruber	75906	S	21	1	22	0.00000
Hydrogenobacter sp. T-8	1632019	S	41	15	56	0.00000
Hydrogenobacter thermophilus	940	S	23	10	33	0.00000
Aquifex aeolicus	63363	S	50	1	51	0.00000
Sulfurihydrogenibium azorense	309806	S	100	9	109	0.00001
Persephonella marina	309805	S	63	3	66	0.00001
Thermosulfidibacter takaii	412593	S	104	3	107	0.00001
Thermovibrio ammonificans	228745	S	106	24	130	0.00001
Desulfurobacterium thermolithotrophum	64160	S	37	6	43	0.00000
Thermosulfurimonas marina	2047767	S	234	32	266	0.00002
Thermosulfuriphilus ammonigenes	1936021	S	144	6	150	0.00001
Thermodesulfatator indicus	171695	S	84	12	96	0.00001
Thermodesulfobacterium geofontis	1295609	S	21	12	33	0.00000
Thermodesulfobacterium sp. TA1	2234087	S	13	9	22	0.00000
Caldimicrobium thiodismutans	1653476	S	31	5	36	0.00000
Caldithrix abyssi	187145	S	439	5	444	0.00003
Geovibrio thiophilus	139438	S	97	14	111	0.00001
Flexistipes sinusarabici	2352	S	67	6	73	0.00001
Calditerrivibrio nitroreducens	477976	S	47	5	52	0.00000
Mucispirillum schaedleri	248039	S	42	4	46	0.00000
Denitrovibrio acetiphilus	118000	S	39	4	43	0.00000
Deferribacter desulfuricans	197162	S	29	4	33	0.00000
Desulfurispirillum indicum	936456	S	345	183	528	0.00004
Fusobacterium gonidiaformans	849	S	33	19	52	0.00000
Fusobacterium ulcerans	861	S	22	7	29	0.00000
Fusobacterium sp. NSJ-57	2764326	S	14	25	39	0.00000
Fusobacterium nucleatum	851	S	13	40	53	0.00000
Fusobacterium mortiferum	850	S	11	2	13	0.00000
Leptotrichia sp. oral taxon 212	712357	S	21	42	63	0.00000
Pseudoleptotrichia goodfellowii	157692	S	23	6	29	0.00000
Sebaldella termitidis	826	S	12	0	12	0.00000
Endomicrobium proavitum	1408281	S	75	26	101	0.00001
Candidatus Endomicrobium trichonymphae	1408204	S	28	9	37	0.00000
Elusimicrobium minutum	423605	S	114	2	116	0.00001
Dictyoglomus thermophilum	14	S	20	126	146	0.00001
Coprothermobacter proteolyticus	35786	S	139	34	173	0.00001
Caldisericum exile	693075	S	134	0	134	0.00001
Atribacter laminatus	2847778	S	70	2	72	0.00001
Fusarium sambucinum	5128	S	5912	620	6532	0.00050
Fusarium pseudograminearum	101028	S	114	6	120	0.00001
Fusarium poae	36050	S	104	22	126	0.00001
Fusarium longipes	694270	S	91	2	93	0.00001
Fusarium sporotrichioides	5514	S	69	2	71	0.00001
Fusarium culmorum	5516	S	41	4	45	0.00000
Fusarium venenatum	56646	S	37	50	87	0.00001
Fusarium graminearum	5518	S	31	71	102	0.00001
Fusarium acuminatum	5515	S	3433	178	3611	0.00028
Fusarium avenaceum	40199	S	111	4	115	0.00001
Fusarium oxysporum	5507	S	1122	398	1520	0.00012
Fusarium nygamai	42673	S	107	29	136	0.00001
Fusarium fujikuroi	5127	S	74	6	80	0.00001
Fusarium thapsinum	120644	S	58	11	69	0.00001
Fusarium pseudonygamai	47755	S	44	9	53	0.00000
Fusarium verticillioides	117187	S	27	34	61	0.00000
Fusarium decemcellulare	57161	S	265	5	270	0.00002
Fusarium heterosporum	42747	S	102	16	118	0.00001
Fusarium graminum	86546	S	85	14	99	0.00001
Fusarium dimerum	57145	S	198	5	203	0.00002
Fusarium scirpi	2211609	S	87	16	103	0.00001
Fusarium equiseti	61235	S	71	15	86	0.00001
Fusarium nelsonii	77846	S	77	23	100	0.00001
Fusarium chlamydosporum	86545	S	59	18	77	0.00001
Fusarium lateritium	5523	S	136	3	139	0.00001
Fusarium musae	1042133	S	29	34	63	0.00000
Metarhizium humberi	2596975	S	463	233	696	0.00005
Metarhizium album	92629	S	403	11	414	0.00003
Metarhizium guizhouense	169041	S	335	148	483	0.00004
Metarhizium rileyi	1649241	S	295	47	342	0.00003
Metarhizium robertsii	568076	S	246	144	390	0.00003
Metarhizium acridum	92637	S	176	104	280	0.00002
Metarhizium anisopliae	5530	S	154	195	349	0.00003
Metarhizium majus	1650735	S	154	57	211	0.00002
Metarhizium brunneum	500148	S	138	94	232	0.00002
Ustilaginoidea virens	1159556	S	675	31	706	0.00005
Pochonia chlamydosporia	280754	S	186	10	196	0.00002
Beauveria pseudobassiana	931006	S	1188	156	1344	0.00010
Beauveria felina	37994	S	581	29	610	0.00005
Beauveria brongniartii	118266	S	164	36	200	0.00002
Beauveria rudraprayagi	1481906	S	127	138	265	0.00002
Beauveria bassiana	176275	S	95	108	203	0.00002
Cordyceps fumosorosea	114497	S	748	46	794	0.00006
Trichoderma erinaceum	202914	S	622	90	712	0.00005
Trichoderma reesei	51453	S	268	22	290	0.00002
Trichoderma citrinoviride	58853	S	232	24	256	0.00002
Trichoderma pleuroti	500994	S	176	17	193	0.00001
Trichoderma afroharzianum	1567482	S	154	31	185	0.00001
Trichoderma atroviride	63577	S	153	34	187	0.00001
Trichoderma hamatum	49224	S	138	10	148	0.00001
Trichoderma asperellum	101201	S	128	8	136	0.00001
Trichoderma harzianum	5544	S	100	20	120	0.00001
Trichoderma gamsii	398673	S	97	12	109	0.00001
Trichoderma koningiopsis	337941	S	92	13	105	0.00001
Trichoderma virens	29875	S	36	356	392	0.00003
Trichoderma longibrachiatum	5548	S	20	195	215	0.00002
Trichoderma koningii	97093	S	19	177	196	0.00002
Purpureocillium lilacinum	33203	S	838	56	894	0.00007
Drechmeria coniospora	98403	S	634	28	662	0.00005
Clonostachys rosea	29856	S	293	20	313	0.00002
Colletotrichum higginsianum	80884	S	906	180	1086	0.00008
Thermothielavioides terrestris	2587410	S	1273	95	1368	0.00011
Thermothelomyces thermophilus	78579	S	1189	66	1255	0.00010
Neurospora crassa	5141	S	368	17	385	0.00003
Pyricularia oryzae	318829	S	346	72	418	0.00003
Pyricularia pennisetigena	1578925	S	327	40	367	0.00003
Pyricularia grisea	148305	S	204	24	228	0.00002
Neopestalotiopsis clavispora	289240	S	120	125	245	0.00002
Neopestalotiopsis rosae	1562205	S	110	106	216	0.00002
Botrytis cinerea	40559	S	242	1	243	0.00002
Aspergillus chevalieri	182096	S	1391	143	1534	0.00012
Aspergillus luchuensis	1069201	S	903	68	971	0.00007
Aspergillus oryzae	5062	S	87	175	262	0.00002
Aspergillus flavus	5059	S	35	77	112	0.00001
Aspergillus puulaauensis	1220207	S	290	11	301	0.00002
Aspergillus fumigatus	746128	S	254	13	267	0.00002
Penicillium citrinum	5077	S	234	31	265	0.00002
Penicillium chrysogenum	5076	S	183	37	220	0.00002
Penicillium expansum	27334	S	133	57	190	0.00001
Penicillium aurantiogriseum	36655	S	119	42	161	0.00001
Penicillium italicum	40296	S	101	39	140	0.00001
Penicillium digitatum	36651	S	82	17	99	0.00001
Paecilomyces niveus	5093	S	169	7	176	0.00001
Paecilomyces variotii	264951	S	134	12	146	0.00001
Talaromyces rugulosus	121627	S	215	13	228	0.00002
Paraphaeosphaeria minitans	565426	S	345	108	453	0.00003
Ampelomyces quisqualis	50730	S	277	27	304	0.00002
Zymoseptoria tritici	1047171	S	176	3	179	0.00001
Cercospora beticola	122368	S	129	0	129	0.00001
Eremothecium gossypii	33169	S	145	107	252	0.00002
Eremothecium cymbalariae	45285	S	26	1	27	0.00000
Eremothecium sinecaudum	45286	S	17	9	26	0.00000
Lachancea thermotolerans	381046	S	74	4	78	0.00001
Naumovozyma castellii	27288	S	32	2	34	0.00000
Naumovozyma dairenensis	27289	S	27	1	28	0.00000
Kluyveromyces marxianus	4911	S	43	6	49	0.00000
Kluyveromyces lactis	28985	S	16	0	16	0.00000
Saccharomyces eubayanus	1080349	S	24	0	24	0.00000
Saccharomyces paradoxus	27291	S	17	1	18	0.00000
Saccharomyces cerevisiae	4932	S	15	2	17	0.00000
Tetrapisispora blattae	1071379	S	31	1	32	0.00000
Tetrapisispora phaffii	113608	S	23	0	23	0.00000
Torulaspora globosa	48254	S	26	1	27	0.00000
Torulaspora delbrueckii	4950	S	12	1	13	0.00000
Kazachstania naganishii	588726	S	27	1	28	0.00000
[Candida] glabrata	5478	S	30	1	31	0.00000
Zygosaccharomyces rouxii	4956	S	24	1	25	0.00000
Zygotorulaspora mrakii	42260	S	20	2	22	0.00000
Brettanomyces bruxellensis	5007	S	29	1	30	0.00000
Brettanomyces nanus	13502	S	27	2	29	0.00000
Ogataea parapolymorpha	1005962	S	43	1	44	0.00000
Pichia kudriavzevii	4909	S	39	1	40	0.00000
Candida dubliniensis	42374	S	45	2	47	0.00000
Candida albicans	5476	S	25	1	26	0.00000
Candida orthopsilosis	273371	S	13	0	13	0.00000
Scheffersomyces stipitis	4924	S	27	1	28	0.00000
Debaryomyces hansenii	4959	S	20	0	20	0.00000
Yarrowia lipolytica	4952	S	109	1	110	0.00001
Sugiyamaella lignohabitans	796027	S	55	4	59	0.00000
Saccharomycodes ludwigii	36035	S	21	3	24	0.00000
Komagataella phaffii	460519	S	13	0	13	0.00000
Schizosaccharomyces pombe	4896	S	26	0	26	0.00000
Pseudozyma flocculosa	84751	S	1319	9	1328	0.00010
Ustilago maydis	5270	S	418	7	425	0.00003
Sporisorium graminicola	280036	S	297	35	332	0.00003
Malassezia restricta	76775	S	111	14	125	0.00001
Phlebiopsis gigantea	82310	S	362	2	364	0.00003
Rhizoctonia solani	456999	S	71	2	73	0.00001
Marasmius oreades	181124	S	66	2	68	0.00001
Cryptococcus neoformans	5207	S	69	2	71	0.00001
Cryptococcus gattii VGI	37769	S	39	23	62	0.00000
Phytophthora cryptogea	4786	S	4185	189	4374	0.00034
Phytophthora cinnamomi	4785	S	837	76	913	0.00007
Phytophthora fragariae	53985	S	594	45	639	0.00005
Phytophthora infestans	4787	S	299	369	668	0.00005
Phytophthora cactorum	29920	S	260	21	281	0.00002
Phytophthora boehmeriae	109152	S	200	12	212	0.00002
Phytophthora parasitica	4792	S	145	10	155	0.00001
Pythium aphanidermatum	65070	S	325	4	329	0.00003
