name	taxonomy_id	taxonomy_lvl	kraken_assigned_reads	added_reads	new_est_reads	fraction_total_reads
Bradyrhizobiaceae	41294	F	394680	30526	425206	0.03613
Rhizobiaceae	82115	F	281286	97568	378854	0.03219
Phyllobacteriaceae	69277	F	171561	21674	193235	0.01642
Methylobacteriaceae	119045	F	170190	16839	187029	0.01589
Devosiaceae	2831106	F	58275	3636	61911	0.00526
Xanthobacteraceae	335928	F	45233	5721	50954	0.00433
Hyphomicrobiaceae	45401	F	32080	2379	34459	0.00293
Boseaceae	2831100	F	28131	3065	31196	0.00265
Aurantimonadaceae	255475	F	25183	3726	28909	0.00246
Stappiaceae	2821832	F	13701	2357	16058	0.00136
Methylocystaceae	31993	F	13648	15005	28653	0.00244
Phreatobacteraceae	2843305	F	12104	1522	13626	0.00116
Chelatococcaceae	2036754	F	9084	1474	10558	0.00090
Parvibaculaceae	2813035	F	8735	1571	10306	0.00088
Blastochloridaceae	2831090	F	6761	1158	7919	0.00067
Beijerinckiaceae	45404	F	6381	335	6716	0.00057
Amorphaceae	2685818	F	4795	394	5189	0.00044
Brucellaceae	118882	F	4602	7260	11862	0.00101
Kaistiaceae	2831111	F	4266	754	5020	0.00043
Pleomorphomonadaceae	2843308	F	3051	388	3439	0.00029
Breoghaniaceae	2831104	F	2785	271	3056	0.00026
Lichenihabitantaceae	2723775	F	2238	78	2316	0.00020
Cohaesibacteraceae	655351	F	526	16	542	0.00005
Bartonellaceae	772	F	468	21	489	0.00004
Sphingomonadaceae	41297	F	474703	55242	529945	0.04503
Erythrobacteraceae	335929	F	70672	11718	82390	0.00700
Sphingosinicellaceae	2820280	F	23368	1832	25200	0.00214
Zymomonadaceae	2844881	F	141	123	264	0.00002
Azospirillaceae	2829815	F	107777	10028	117805	0.01001
Acetobacteraceae	433	F	69004	7232	76236	0.00648
Rhodospirillaceae	41295	F	42255	137419	179674	0.01527
Stellaceae	2844601	F	7652	467	8119	0.00069
Elioraeaceae	2690195	F	3795	163	3958	0.00034
Thalassospiraceae	2844866	F	2126	118	2244	0.00019
Terasakiellaceae	2813951	F	85	1	86	0.00001
Rhodobacteraceae	31989	F	91465	11406	102871	0.00874
Roseobacteraceae	2854170	F	56297	6666	62963	0.00535
Caulobacteraceae	76892	F	127345	11306	138651	0.01178
Maricaulaceae	2800061	F	3982	365	4347	0.00037
Hyphomonadaceae	69657	F	3576	118	3694	0.00031
Parvularculaceae	255474	F	1190	72	1262	0.00011
Anaplasmataceae	942	F	352	4	356	0.00003
Rickettsiaceae	775	F	275	17	292	0.00002
Candidatus Midichloriaceae	1328881	F	44	34	78	0.00001
Candidatus Deianiraeaceae	2603433	F	17	594	611	0.00005
Emcibacteraceae	2066491	F	568	46	614	0.00005
Holosporaceae	44746	F	116	1	117	0.00001
Candidatus Paracaedibacteraceae	1777752	F	51	2	53	0.00000
Caedimonadaceae	2100208	F	47	2	49	0.00000
Magnetococcaceae	1191479	F	141	2	143	0.00001
Pelagibacteraceae	1655514	F	86	39	125	0.00001
Kordiimonadaceae	1331809	F	82	1	83	0.00001
Comamonadaceae	80864	F	411950	113655	525605	0.04467
Burkholderiaceae	119060	F	253045	98835	351880	0.02990
Oxalobacteraceae	75682	F	120658	118661	239319	0.02034
Alcaligenaceae	506	F	77112	46749	123861	0.01053
Sutterellaceae	995019	F	1474	105	1579	0.00013
Azonexaceae	2008795	F	75836	6938	82774	0.00703
Zoogloeaceae	2008794	F	33455	11320	44775	0.00380
Rhodocyclaceae	75787	F	30515	8768	39283	0.00334
Fluviibacteraceae	2808923	F	266	78	344	0.00003
Nitrosomonadaceae	206379	F	46525	1373	47898	0.00407
Usitatibacteraceae	2803844	F	17283	1193	18476	0.00157
Sterolibacteriaceae	2008793	F	10221	2267	12488	0.00106
Gallionellaceae	90627	F	6428	587	7015	0.00060
Thiobacillaceae	2008790	F	4312	1124	5436	0.00046
Sulfuricellaceae	2772226	F	3831	432	4263	0.00036
Methylophilaceae	32011	F	2129	167	2296	0.00020
Chromobacteriaceae	1499392	F	21450	3719	25169	0.00214
Neisseriaceae	481	F	9655	1908	11563	0.00098
Casimicrobiaceae	2705999	F	1378	629	2007	0.00017
Xanthomonadaceae	32033	F	364346	67111	431457	0.03667
Rhodanobacteraceae	1775411	F	35633	4675	40308	0.00343
Pseudomonadaceae	135621	F	192401	43920	236321	0.02008
Marinobacteraceae	2887365	F	4942	385	5327	0.00045
Enterobacteriaceae	543	F	27824	109892	137716	0.01170
Yersiniaceae	1903411	F	9539	2615	12154	0.00103
Erwiniaceae	1903409	F	7532	1062	8594	0.00073
Pectobacteriaceae	1903410	F	4838	709	5547	0.00047
Morganellaceae	1903414	F	1489	917	2406	0.00020
Hafniaceae	1903412	F	1487	251	1738	0.00015
Bruguierivoracaceae	2812006	F	843	49	892	0.00008
Budviciaceae	1903416	F	220	24	244	0.00002
Ectothiorhodospiraceae	72276	F	19685	1755	21440	0.00182
Chromatiaceae	1046	F	13905	890	14795	0.00126
Wenzhouxiangellaceae	1676141	F	2273	2135	4408	0.00037
Thioalkalispiraceae	1096778	F	1275	451	1726	0.00015
Thioalkalibacteraceae	2035710	F	1172	260	1432	0.00012
Halothiobacillaceae	255526	F	826	65	891	0.00008
Woeseiaceae	1738654	F	814	12	826	0.00007
Granulosicoccaceae	449719	F	593	12	605	0.00005
Halomonadaceae	28256	F	30440	3141	33581	0.00285
Alcanivoracaceae	224372	F	3141	1187	4328	0.00037
Oceanospirillaceae	135620	F	2381	240	2621	0.00022
Saccharospirillaceae	255527	F	658	30	688	0.00006
Hahellaceae	224379	F	629	23	652	0.00006
Litoricolaceae	449732	F	211	9	220	0.00002
Endozoicomonadaceae	2066474	F	103	5	108	0.00001
Oleiphilaceae	191033	F	101	8	109	0.00001
Zooshikellaceae	2898533	F	34	0	34	0.00000
Cellvibrionaceae	1706371	F	11116	341	11457	0.00097
Microbulbiferaceae	1706373	F	4332	231	4563	0.00039
Halieaceae	1706372	F	1744	170	1914	0.00016
Spongiibacteraceae	1706375	F	857	70	927	0.00008
Methylococcaceae	403	F	13991	547	14538	0.00124
Steroidobacteraceae	2689614	F	7939	1954	9893	0.00084
Sinobacteraceae	568386	F	5282	603	5885	0.00050
Aeromonadaceae	84642	F	12751	8826	21577	0.00183
Succinivibrionaceae	83763	F	19	0	19	0.00000
Shewanellaceae	267890	F	3998	644	4642	0.00039
Alteromonadaceae	72275	F	1818	211	2029	0.00017
Pseudoalteromonadaceae	267888	F	1189	154	1343	0.00011
Ferrimonadaceae	267892	F	480	55	535	0.00005
Colwelliaceae	267889	F	264	23	287	0.00002
Idiomarinaceae	267893	F	224	19	243	0.00002
Moritellaceae	267891	F	115	24	139	0.00001
Psychromonadaceae	267894	F	53	5	58	0.00000
Acidiferrobacteraceae	1692041	F	8302	344	8646	0.00073
Vibrionaceae	641	F	5430	4348	9778	0.00083
Moraxellaceae	468	F	3556	3546	7102	0.00060
Pasteurellaceae	712	F	2779	5772	8551	0.00073
Celerinatantimonadaceae	412032	F	41	114	155	0.00001
Immundisolibacteraceae	1934946	F	2141	338	2479	0.00021
Piscirickettsiaceae	135616	F	1129	101	1230	0.00010
Thiotrichaceae	135617	F	802	19	821	0.00007
Francisellaceae	34064	F	160	160	320	0.00003
Legionellaceae	444	F	1223	62	1285	0.00011
Coxiellaceae	118968	F	730	48	778	0.00007
Salinisphaeraceae	742031	F	1183	1231	2414	0.00021
Cardiobacteriaceae	868	F	737	82	819	0.00007
Kangiellaceae	1920240	F	175	10	185	0.00002
Orbaceae	1240483	F	62	9	71	0.00001
Archangiaceae	39	F	111897	6965	118862	0.01010
Anaeromyxobacteraceae	1524215	F	86342	5784	92126	0.00783
Myxococcaceae	31	F	82834	14814	97648	0.00830
Vulgatibacteraceae	1524213	F	5614	399	6013	0.00051
Polyangiaceae	49	F	123257	8630	131887	0.01121
Sandaracinaceae	1055686	F	28928	1342	30270	0.00257
Labilitrichaceae	1524216	F	10368	397	10765	0.00091
Kofleriaceae	224464	F	9712	479	10191	0.00087
Geobacteraceae	213422	F	22096	2028	24124	0.00205
Desulfuromonadaceae	213421	F	6188	903	7091	0.00060
Syntrophotaleaceae	2812024	F	925	106	1031	0.00009
Desulfovibrionaceae	194924	F	16258	1468	17726	0.00151
Desulfomicrobiaceae	213116	F	863	119	982	0.00008
Desulfohalobiaceae	213117	F	236	12	248	0.00002
Desulfobacteraceae	213119	F	3677	355	4032	0.00034
Desulfobulbaceae	213121	F	1724	268	1992	0.00017
Desulfosudaceae	2904715	F	474	28	502	0.00004
Desulfocapsaceae	2886822	F	281	27	308	0.00003
Bradymonadaceae	1779135	F	4552	551	5103	0.00043
Syntrophobacteraceae	213465	F	1380	365	1745	0.00015
Desulfarculaceae	453228	F	1223	777	2000	0.00017
Syntrophaceae	213468	F	706	131	837	0.00007
Candidatus Desulfofervidaceae	1902584	F	40	0	40	0.00000
Desulfurellaceae	117942	F	40	1	41	0.00000
Campylobacteraceae	72294	F	681	124	805	0.00007
Thiovulaceae	2771471	F	478	33	511	0.00004
Helicobacteraceae	72293	F	396	25	421	0.00004
Sulfurovaceae	2771472	F	320	19	339	0.00003
Hydrogenimonaceae	292630	F	175	13	188	0.00002
Arcobacteraceae	2808963	F	169	23	192	0.00002
Sulfurospirillaceae	2932623	F	119	5	124	0.00001
Nitratiruptoraceae	2795691	F	96	4	100	0.00001
Nautiliaceae	224467	F	63	4	67	0.00001
Acidithiobacillaceae	225058	F	1601	132	1733	0.00015
Bdellovibrionaceae	213483	F	1094	11	1105	0.00009
Bacteriovoracaceae	263369	F	70	9	79	0.00001
Halobacteriovoraceae	1652132	F	45	7	52	0.00000
Silvanigrellaceae	2024974	F	44	0	44	0.00000
Hydrogenophilaceae	206349	F	473	76	549	0.00005
Mariprofundaceae	580372	F	344	8	352	0.00003
Streptomycetaceae	2062	F	935725	189841	1125566	0.09565
Microbacteriaceae	85023	F	231480	29568	261048	0.02218
Micrococcaceae	1268	F	119891	26730	146621	0.01246
Cellulomonadaceae	85016	F	59972	20064	80036	0.00680
Promicromonosporaceae	85017	F	28667	11323	39990	0.00340
Intrasporangiaceae	85021	F	27952	7445	35397	0.00301
Ornithinimicrobiaceae	2805590	F	20492	4220	24712	0.00210
Bogoriellaceae	145358	F	14799	4442	19241	0.00164
Dermabacteraceae	85020	F	13179	2444	15623	0.00133
Brevibacteriaceae	85019	F	12614	2564	15178	0.00129
Ruaniaceae	1331736	F	8644	1059	9703	0.00082
Dermacoccaceae	145357	F	7848	9589	17437	0.00148
Beutenbergiaceae	125316	F	5689	1882	7571	0.00064
Sanguibacteraceae	145360	F	4006	1271	5277	0.00045
Dermatophilaceae	85018	F	1757	166	1923	0.00016
Kytococcaceae	2805426	F	1638	613	2251	0.00019
Demequinaceae	1042322	F	611	48	659	0.00006
Jonesiaceae	85022	F	125	22	147	0.00001
Tropherymataceae	2805591	F	33	0	33	0.00000
Micromonosporaceae	28056	F	487318	66729	554047	0.04708
Nocardioidaceae	85015	F	382886	73214	456100	0.03876
Propionibacteriaceae	31957	F	40211	11424	51635	0.00439
Kribbellaceae	2726069	F	15747	2381	18128	0.00154
Actinopolymorphaceae	2805400	F	4680	522	5202	0.00044
Pseudonocardiaceae	2070	F	429921	61036	490957	0.04172
Mycobacteriaceae	1762	F	191286	27417	218703	0.01859
Nocardiaceae	85025	F	106491	20846	127337	0.01082
Corynebacteriaceae	1653	F	31217	6846	38063	0.00323
Gordoniaceae	85026	F	25591	5650	31241	0.00265
Tsukamurellaceae	85028	F	7944	2028	9972	0.00085
Dietziaceae	85029	F	5087	4796	9883	0.00084
Segniliparaceae	316606	F	632	34	666	0.00006
Lawsonellaceae	2805586	F	130	14	144	0.00001
Thermomonosporaceae	2012	F	133807	24188	157995	0.01343
Streptosporangiaceae	2004	F	131906	20641	152547	0.01296
Nocardiopsaceae	83676	F	24996	4045	29041	0.00247
Geodermatophilaceae	85030	F	102906	25292	128198	0.01089
Actinomycetaceae	2049	F	20423	2779	23202	0.00197
Frankiaceae	74712	F	17922	1689	19611	0.00167
Jiangellaceae	1217100	F	15651	2693	18344	0.00156
Bifidobacteriaceae	31953	F	7202	1874	9076	0.00077
Nakamurellaceae	85031	F	6573	838	7411	0.00063
Catenulisporaceae	414877	F	3961	560	4521	0.00038
Glycomycetaceae	85034	F	3059	238	3297	0.00028
Jatrophihabitantaceae	2805416	F	3000	253	3253	0.00028
Kineosporiaceae	83778	F	2947	789	3736	0.00032
Actinopolysporaceae	622451	F	1745	172	1917	0.00016
Sporichthyaceae	85033	F	1592	757	2349	0.00020
Acidothermaceae	85032	F	879	41	920	0.00008
Candidatus Nanopelagicaceae	2162846	F	316	4	320	0.00003
Conexibacteraceae	320583	F	77717	10614	88331	0.00751
Miltoncostaeaceae	2843199	F	14646	1762	16408	0.00139
Iamiaceae	633392	F	48313	5576	53889	0.00458
Ilumatobacteraceae	2448023	F	3196	178	3374	0.00029
Acidimicrobiaceae	84994	F	1107	77	1184	0.00010
Rubrobacteraceae	84997	F	26916	988	27904	0.00237
Baekduiaceae	2600303	F	23945	3705	27650	0.00235
Eggerthellaceae	1643826	F	6095	954	7049	0.00060
Atopobiaceae	1643824	F	3022	626	3648	0.00031
Coriobacteriaceae	84107	F	1381	295	1676	0.00014
Euzebyaceae	908622	F	2941	239	3180	0.00027
Egibacteraceae	1747769	F	2879	165	3044	0.00026
Egicoccaceae	1755824	F	2834	418	3252	0.00028
Bacillaceae	186817	F	82864	62003	144867	0.01231
Paenibacillaceae	186822	F	31433	2318	33751	0.00287
Alicyclobacillaceae	186823	F	3246	455	3701	0.00031
Planococcaceae	186818	F	2478	688	3166	0.00027
Staphylococcaceae	90964	F	1752	7602	9354	0.00079
Thermoactinomycetaceae	186824	F	1447	1072	2519	0.00021
Listeriaceae	186820	F	430	149	579	0.00005
Sporolactobacillaceae	186821	F	86	11	97	0.00001
Lactobacillaceae	33958	F	2046	682	2728	0.00023
Streptococcaceae	1300	F	867	431	1298	0.00011
Enterococcaceae	81852	F	616	1403	2019	0.00017
Carnobacteriaceae	186828	F	236	87	323	0.00003
Aerococcaceae	186827	F	147	43	190	0.00002
Oscillospiraceae	216572	F	5069	1486	6555	0.00056
Clostridiales Family XVII. Incertae Sedis	539000	F	3973	597	4570	0.00039
Eubacteriales Family XIII. Incertae Sedis	543314	F	173	387	560	0.00005
Clostridiales Family XVI. Incertae Sedis	543347	F	81	24	105	0.00001
Clostridiaceae	31979	F	4457	498	4955	0.00042
Symbiobacteriaceae	543349	F	2234	165	2399	0.00020
Lachnospiraceae	186803	F	1629	452	2081	0.00018
Peptococcaceae	186807	F	982	73	1055	0.00009
Christensenellaceae	990719	F	585	215	800	0.00007
Heliobacteriaceae	31984	F	519	191	710	0.00006
Desulfitobacteriaceae	2937909	F	502	46	548	0.00005
Eubacteriaceae	186806	F	385	61	446	0.00004
Peptostreptococcaceae	186804	F	277	5190	5467	0.00046
Syntrophomonadaceae	68298	F	160	6	166	0.00001
Desulfallaceae	2867375	F	118	8	126	0.00001
Thermincolaceae	2937911	F	57	4	61	0.00001
Vallitaleaceae	2603322	F	47	2	49	0.00000
Desulfotomaculaceae	2937910	F	43	14	57	0.00000
Proteinivoraceae	1491775	F	30	3	33	0.00000
Thermohalobacteraceae	2848916	F	24	2	26	0.00000
Thermoanaerobacteraceae	186814	F	2068	276	2344	0.00020
Thermoanaerobacterales Family III. Incertae Sedis	543371	F	152	28	180	0.00002
Thermoanaerobacterales Family IV. Incertae Sedis	543372	F	59	25	84	0.00001
Zhaonellaceae	2748673	F	53	6	59	0.00001
Thermodesulfobiaceae	227387	F	37	0	37	0.00000
Halanaerobiaceae	972	F	114	72	186	0.00002
Halobacteroidaceae	53434	F	41	3	44	0.00000
Thermosediminibacteraceae	2770093	F	107	9	116	0.00001
Tepidanaerobacteraceae	2770092	F	90	4	94	0.00001
Natranaerofabaceae	2807496	F	34	1	35	0.00000
Natranaerobiaceae	485255	F	20	5	25	0.00000
Koleobacteraceae	2786988	F	48	3	51	0.00000
Selenomonadaceae	1843491	F	1837	80	1917	0.00016
Sporomusaceae	1843490	F	252	17	269	0.00002
Veillonellaceae	31977	F	580	159	739	0.00006
Acidaminococcaceae	909930	F	285	53	338	0.00003
Limnochordaceae	1676650	F	1568	54	1622	0.00014
Peptoniphilaceae	1570339	F	220	105	325	0.00003
Tissierellaceae	1737406	F	93	11	104	0.00001
Gottschalkiaceae	2042895	F	54	117	171	0.00001
Erysipelotrichaceae	128827	F	337	69	406	0.00003
Turicibacteraceae	2810281	F	44	112	156	0.00001
Deinococcaceae	183710	F	17575	945	18520	0.00157
Thermaceae	188786	F	7528	423	7951	0.00068
Trueperaceae	332247	F	1474	74	1548	0.00013
Synechococcaceae	1890426	F	7664	859	8523	0.00072
Prochlorococcaceae	2881426	F	1812	421	2233	0.00019
Acaryochloridaceae	1890429	F	121	4	125	0.00001
Chamaesiphonaceae	1890431	F	103	7	110	0.00001
Merismopediaceae	1890428	F	87	4	91	0.00001
Nostocaceae	1162	F	1921	552	2473	0.00021
Calotrichaceae	2661849	F	747	76	823	0.00007
Aphanizomenonaceae	1892259	F	468	423	891	0.00008
Scytonemataceae	1182	F	325	39	364	0.00003
Tolypothrichaceae	119859	F	124	28	152	0.00001
Hapalosiphonaceae	1892263	F	117	17	134	0.00001
Rivulariaceae	1185	F	36	2	38	0.00000
Leptolyngbyaceae	1890438	F	2419	175	2594	0.00022
Oculatellaceae	2303507	F	315	30	345	0.00003
Thermosynechococcaceae	2881378	F	215	26	241	0.00002
Prochlorotrichaceae	2303730	F	194	10	204	0.00002
Pseudanabaenaceae	1890436	F	129	7	136	0.00001
Oscillatoriaceae	1892254	F	534	81	615	0.00005
Coleofasciculaceae	1892251	F	501	98	599	0.00005
Microcoleaceae	1892252	F	318	233	551	0.00005
Gomontiellaceae	1892255	F	50	9	59	0.00001
Sirenicapillariaceae	2934961	F	39	2	41	0.00000
Microcystaceae	1890449	F	261	125	386	0.00003
Aphanothecaceae	1890450	F	240	55	295	0.00003
Chroococcaceae	1890464	F	221	52	273	0.00002
Geminocystaceae	2815910	F	21	15	36	0.00000
Gloeobacteraceae	1890422	F	2424	56	2480	0.00021
Chroococcidiopsidaceae	1890528	F	266	60	326	0.00003
Hyellaceae	1890500	F	72	11	83	0.00001
Dermocarpellaceae	1890498	F	44	6	50	0.00000
Gloeomargaritaceae	1955043	F	68	3	71	0.00001
Thermostichaceae	2881384	F	44	23	67	0.00001
Sphaerobacteraceae	85002	F	6354	407	6761	0.00057
Thermomicrobiaceae	189777	F	1292	29	1321	0.00011
Roseiflexaceae	1508635	F	3159	186	3345	0.00028
Chloroflexaceae	1106	F	1243	52	1295	0.00011
Tepidiformaceae	2682227	F	3322	129	3451	0.00029
Ardenticatenaceae	1382930	F	2650	48	2698	0.00023
Caldilineaceae	475964	F	1435	103	1538	0.00013
Anaerolineaceae	292628	F	1279	607	1886	0.00016
Dehalococcoidaceae	1202464	F	283	684	967	0.00008
Ktedonosporobacteraceae	2692416	F	582	19	601	0.00005
Phototrophicaceae	2922432	F	478	5	483	0.00004
Fimbriimonadaceae	1663426	F	1283	6	1289	0.00011
Chthonomonadaceae	1077264	F	307	2	309	0.00003
Mycoplasmataceae	2092	F	237	72	309	0.00003
Spiroplasmataceae	2131	F	70	3	73	0.00001
Entomoplasmataceae	33925	F	22	10	32	0.00000
Acholeplasmataceae	2146	F	87	5	92	0.00001
Metamycoplasmataceae	2895623	F	14	4	18	0.00000
Mycoplasmoidaceae	2790998	F	10	5	15	0.00000
Gemmataceae	1914233	F	98826	3596	102422	0.00870
Isosphaeraceae	1763524	F	54679	5374	60053	0.00510
Lacipirellulaceae	2691359	F	28024	1526	29550	0.00251
Pirellulaceae	2691357	F	22780	1095	23875	0.00203
Thermoguttaceae	2691358	F	541	19	560	0.00005
Planctomycetaceae	126	F	40121	4011	44132	0.00375
Tepidisphaeraceae	1771355	F	8766	223	8989	0.00076
Phycisphaeraceae	666507	F	4821	284	5105	0.00043
Anaerohalosphaeraceae	2690158	F	277	13	290	0.00002
Sedimentisphaeraceae	2483367	F	193	46	239	0.00002
Candidatus Brocadiaceae	1127830	F	107	0	107	0.00001
Candidatus Uabimicrobiaceae	2897348	F	69	1	70	0.00001
Opitutaceae	134623	F	40625	1356	41981	0.00357
Puniceicoccaceae	415002	F	933	91	1024	0.00009
Verrucomicrobiaceae	203557	F	15678	411	16089	0.00137
Akkermansiaceae	1647988	F	1058	1159	2217	0.00019
Methylacidiphilaceae	717964	F	87	3	90	0.00001
Kiritimatiellaceae	1921783	F	641	762	1403	0.00012
Tichowtungiaceae	2907186	F	223	9	232	0.00002
Parachlamydiaceae	92713	F	195	9	204	0.00002
Waddliaceae	92714	F	36	3	39	0.00000
Simkaniaceae	92712	F	32	1	33	0.00000
Rhabdochlamydiaceae	689704	F	32	1	33	0.00000
Chlamydiaceae	809	F	87	201	288	0.00002
Hymenobacteraceae	1853232	F	24979	1224	26203	0.00223
Spirosomaceae	2896860	F	4724	288	5012	0.00043
Cytophagaceae	89373	F	4394	223	4617	0.00039
Fulvivirgaceae	2762286	F	2259	74	2333	0.00020
Cyclobacteriaceae	563798	F	1275	149	1424	0.00012
Flammeovirgaceae	200667	F	126	9	135	0.00001
Mangrovivirgaceae	2858885	F	90	6	96	0.00001
Amoebophilaceae	1501348	F	81	7	88	0.00001
Marivirgaceae	2762301	F	69	23	92	0.00001
Bernardetiaceae	1937968	F	37	3	40	0.00000
Flavobacteriaceae	49546	F	17840	1276	19116	0.00162
Weeksellaceae	2762318	F	6185	1347	7532	0.00064
Crocinitomicaceae	1853230	F	795	41	836	0.00007
Blattabacteriaceae	39782	F	198	17	215	0.00002
Schleiferiaceae	1333713	F	144	59	203	0.00002
Ichthyobacteriaceae	1755828	F	10	0	10	0.00000
Chitinophagaceae	563835	F	21512	344	21856	0.00186
Rikenellaceae	171550	F	3284	1227	4511	0.00038
Prevotellaceae	171552	F	1501	237	1738	0.00015
Bacteroidaceae	815	F	1427	746	2173	0.00018
Tannerellaceae	2005525	F	764	268	1032	0.00009
Muribaculaceae	2005473	F	508	115	623	0.00005
Porphyromonadaceae	171551	F	475	52	527	0.00004
Dysgonomonadaceae	2005520	F	254	10	264	0.00002
Barnesiellaceae	2005519	F	153	214	367	0.00003
Odoribacteraceae	1853231	F	127	57	184	0.00002
Paludibacteraceae	2005523	F	54	1	55	0.00000
Tenuifilaceae	2760872	F	40	0	40	0.00000
Salinivirgaceae	1970190	F	39	0	39	0.00000
Prolixibacteraceae	1471398	F	231	5	236	0.00002
Marinilabiliaceae	558415	F	57	5	62	0.00001
Marinifilaceae	1573805	F	53	4	57	0.00000
Sphingobacteriaceae	84566	F	9095	1105	10200	0.00087
Rhodothermaceae	563843	F	8844	372	9216	0.00078
Haliscomenobacteraceae	1937961	F	441	5	446	0.00004
Saprospiraceae	89374	F	53	75	128	0.00001
Chlorobiaceae	191412	F	2621	282	2903	0.00025
Melioribacteraceae	1334117	F	80	6	86	0.00001
Ignavibacteriaceae	795749	F	65	6	71	0.00001
Gemmatimonadaceae	219687	F	76464	3872	80336	0.00683
Fibrobacteraceae	204431	F	118	72	190	0.00002
Vicinamibacteraceae	2211325	F	51568	2497	54065	0.00459
Acidobacteriaceae	204434	F	16531	331	16862	0.00143
Bryobacteraceae	1962910	F	4332	2086	6418	0.00055
Acanthopleuribacteraceae	533207	F	1351	22	1373	0.00012
Thermotomaculaceae	2562244	F	48	2	50	0.00000
Nitrospiraceae	189779	F	10965	138	11103	0.00094
Dissulfurispiraceae	2811505	F	54	2	56	0.00000
Thermodesulfovibrionaceae	2811504	F	41	0	41	0.00000
Spirochaetaceae	137	F	705	15	720	0.00006
Treponemataceae	2845253	F	659	65	724	0.00006
Sphaerochaetaceae	2791015	F	183	7	190	0.00002
Borreliaceae	1643685	F	82	87	169	0.00001
Leptospiraceae	170	F	632	53	685	0.00006
Brachyspiraceae	143786	F	42	0	42	0.00000
Synergistaceae	649777	F	1931	523	2454	0.00021
Candidatus Nanosynbacteraceae	2093822	F	157	203	360	0.00003
Candidatus Chazhemtobacteraceae	2715733	F	36	0	36	0.00000
Candidatus Absconditicoccaceae	2900569	F	21	0	21	0.00000
Candidatus Babeliaceae	2497645	F	11	0	11	0.00000
Thermotogaceae	188709	F	214	8	222	0.00002
Fervidobacteriaceae	1643950	F	101	17	118	0.00001
Kosmotogaceae	1643948	F	92	2	94	0.00001
Petrotogaceae	1643949	F	50	11	61	0.00001
Mesoaciditogaceae	1769717	F	35	0	35	0.00000
Aquificaceae	64898	F	136	14	150	0.00001
Hydrogenothermaceae	224027	F	86	63	149	0.00001
Desulfurobacteriaceae	558314	F	99	3	102	0.00001
Thermodesulfobacteriaceae	188711	F	285	4	289	0.00002
Calditrichaceae	1962854	F	249	2	251	0.00002
Fusobacteriaceae	203492	F	140	29	169	0.00001
Leptotrichiaceae	1129771	F	74	11	85	0.00001
Deferribacteraceae	191394	F	188	4	192	0.00002
Chrysiogenaceae	189770	F	146	55	201	0.00002
Endomicrobiaceae	1783343	F	59	1	60	0.00001
Elusimicrobiaceae	641876	F	59	0	59	0.00001
Dictyoglomaceae	203488	F	78	0	78	0.00001
Coprothermobacteraceae	2138247	F	53	8	61	0.00001
Caldisericaceae	693073	F	48	0	48	0.00000
Atribacteraceae	2847776	F	34	0	34	0.00000
Nectriaceae	110618	F	22835	1871	24706	0.00210
Cordycipitaceae	474943	F	4384	187	4571	0.00039
Hypocreaceae	5129	F	4327	282	4609	0.00039
Clavicipitaceae	34397	F	3322	387	3709	0.00032
Ophiocordycipitaceae	474942	F	1888	137	2025	0.00017
Bionectriaceae	103887	F	364	36	400	0.00003
Glomerellaceae	681950	F	1039	297	1336	0.00011
Chaetomiaceae	35718	F	23398	1085	24483	0.00208
Sordariaceae	5148	F	6642	484	7126	0.00061
Pyriculariaceae	2528436	F	1250	14	1264	0.00011
Sporocadaceae	1812776	F	749	10	759	0.00006
Sclerotiniaceae	28983	F	2283	17	2300	0.00020
Aspergillaceae	1131492	F	5998	311	6309	0.00054
Thermoascaceae	1131624	F	237	10	247	0.00002
Trichocomaceae	28568	F	131	9	140	0.00001
Leptosphaeriaceae	34374	F	361	44	405	0.00003
Didymosphaeriaceae	221678	F	337	133	470	0.00004
Mycosphaerellaceae	93133	F	341	3	344	0.00003
Saccharomycetaceae	4893	F	514	88	602	0.00005
Pichiaceae	1156497	F	172	5	177	0.00002
Debaryomycetaceae	766764	F	136	2	138	0.00001
Dipodascaceae	34353	F	103	1	104	0.00001
Trichomonascaceae	410830	F	59	5	64	0.00001
Saccharomycodaceae	34365	F	18	3	21	0.00000
Phaffomycetaceae	115784	F	11	0	11	0.00000
Schizosaccharomycetaceae	4894	F	106	4	110	0.00001
Ustilaginaceae	5268	F	1548	28	1576	0.00013
Malasseziaceae	742845	F	95	14	109	0.00001
Phanerochaetaceae	396331	F	267	3	270	0.00002
Ceratobasidiaceae	5250	F	144	4	148	0.00001
Marasmiaceae	654128	F	50	2	52	0.00000
Cryptococcaceae	1884633	F	106	13	119	0.00001
Unikaryonidae	36734	F	22	0	22	0.00000
Peronosporaceae	4777	F	10688	244	10932	0.00093
Pythiaceae	4782	F	224	3	227	0.00002
