name	taxonomy_id	taxonomy_lvl	kraken_assigned_reads	added_reads	new_est_reads	fraction_total_reads
Streptomyces sp. SCSIO 64649	2878388	S	9552	2091	11643	0.00084
Streptomyces sp. DSM 40868	2721173	S	8274	3404	11678	0.00084
Streptomyces sp. WAC 01438	2203204	S	8197	3172	11369	0.00082
Streptomyces sp. BJ20	2930049	S	7713	3562	11275	0.00081
Streptomyces sp. CB01881	2078691	S	7712	1785	9497	0.00069
Streptomyces sp. AMCC400023	2056258	S	7296	3211	10507	0.00076
Streptomyces sp. CdTB01	1725411	S	7267	2376	9643	0.00070
Streptomyces sp. SN-593	659352	S	7053	2002	9055	0.00065
Streptomyces sp. So13.3	2136173	S	6910	1536	8446	0.00061
Streptomyces sp. ZYC-3	2797636	S	6534	1480	8014	0.00058
Streptomyces sp. MA3_2.13	2867410	S	6482	1007	7489	0.00054
Streptomyces sp. P3	2135430	S	6046	1733	7779	0.00056
Streptomyces sp. Z423-1	2730915	S	5996	1992	7988	0.00058
Streptomyces sp. NHF165	2175864	S	5981	1237	7218	0.00052
Streptomyces sp. SCUT-3	2684469	S	5687	2679	8366	0.00060
Streptomyces sp. HM190	2695266	S	5617	2035	7652	0.00055
Streptomyces sp. NA02950	2742137	S	5574	1296	6870	0.00050
Streptomyces sp. ST1015	1848900	S	5573	1347	6920	0.00050
Streptomyces sp. BH-MK-02	2880933	S	5365	1341	6706	0.00048
Streptomyces sp. LRE541	2931983	S	5014	1302	6316	0.00046
Streptomyces sp. 3025	2923272	S	4910	1033	5943	0.00043
Streptomyces sp. 3214.6	1882757	S	4842	1610	6452	0.00047
Streptomyces sp. 891-h	2720714	S	4635	998	5633	0.00041
Streptomyces sp. MST-110588	2833628	S	4595	1315	5910	0.00043
Streptomyces sp. MG28	2865673	S	4481	1741	6222	0.00045
Streptomyces sp. A2-16	2781734	S	4436	1559	5995	0.00043
Streptomyces sp. YIM 121038	2136401	S	4416	1476	5892	0.00043
Streptomyces sp. GQFP	2907545	S	4336	854	5190	0.00038
Streptomyces sp. C8S0	2585716	S	4251	1426	5677	0.00041
Streptomyces sp. GMY02	1333528	S	4229	878	5107	0.00037
Streptomyces sp. W1SF4	2305220	S	4189	1705	5894	0.00043
Streptomyces sp. NA04227	2742136	S	4182	1133	5315	0.00038
Streptomyces sp. JB150	2714844	S	4115	1580	5695	0.00041
Streptomyces sp. MBT27	1488356	S	4046	1373	5419	0.00039
Streptomyces sp. GS7	2692234	S	3993	1241	5234	0.00038
Streptomyces sp. QHH-9511	2684468	S	3932	1253	5185	0.00037
Streptomyces sp. Go-475	2072505	S	3866	1980	5846	0.00042
Streptomyces sp. NEAU-sy36	2751189	S	3833	1626	5459	0.00039
Streptomyces sp. SAT1	1849967	S	3786	1618	5404	0.00039
Streptomyces sp. RPA4-2	2721244	S	3782	1245	5027	0.00036
Streptomyces sp. BHT-5-2	2866715	S	3672	1305	4977	0.00036
Streptomyces sp. MG62	2838015	S	3654	1524	5178	0.00037
Streptomyces sp. SYP-A7193	2662065	S	3587	2216	5803	0.00042
Streptomyces sp. CMB-StM0423	2059884	S	3548	1670	5218	0.00038
Streptomyces sp. RTd22	1841249	S	3524	1480	5004	0.00036
Streptomyces sp. Rer75	2750011	S	3486	1609	5095	0.00037
Streptomyces sp. HP-A2021	2927875	S	3458	2074	5532	0.00040
Streptomyces sp. Tu 2975	2676871	S	3453	1247	4700	0.00034
Streptomyces sp. Go 40/10	2825844	S	3436	1674	5110	0.00037
Streptomyces sp. SirexAA-E	862751	S	3276	1103	4379	0.00032
Streptomyces sp. 135	2838850	S	3272	1191	4463	0.00032
Streptomyces sp. SGAir0924	2109593	S	3245	15432	18677	0.00135
Streptomyces sp. HSG2	2797167	S	3211	819	4030	0.00029
Streptomyces sp. SM18	1736046	S	3189	999	4188	0.00030
Streptomyces sp. fd1-xmd	1812480	S	3028	1418	4446	0.00032
Streptomyces sp. INR7	2607753	S	2964	1573	4537	0.00033
Streptomyces sp. A144	2871487	S	2878	12589	15467	0.00112
Streptomyces sp. WAC 01529	2203205	S	2862	1129	3991	0.00029
Streptomyces sp. SS52	2563602	S	2718	12486	15204	0.00110
Streptomyces sp. TN58	234612	S	2654	1289	3943	0.00028
Streptomyces sp. CNQ-509	444103	S	2639	2354	4993	0.00036
Streptomyces sp. S4.7	2705439	S	2591	959	3550	0.00026
Streptomyces sp. CB09001	2083284	S	2586	1786	4372	0.00032
Streptomyces sp. jing01	2726118	S	2537	1544	4081	0.00029
Streptomyces sp. WAC 06738	2203210	S	2513	2281	4794	0.00035
Streptomyces sp. CCM_MD2014	1561022	S	2278	2010	4288	0.00031
Streptomyces sp. S1D4-11	2721246	S	2148	1555	3703	0.00027
Streptomyces sp. WY228	2855836	S	2037	1161	3198	0.00023
Streptomyces sp. SUK 48	2582831	S	1987	1295	3282	0.00024
Streptomyces sp. ADI95-16	1522758	S	1955	1640	3595	0.00026
Streptomyces sp. YPW6	2840373	S	1886	1041	2927	0.00021
Streptomyces sp. Mg1	465541	S	1788	1596	3384	0.00024
Streptomyces sp. 769	1262452	S	1713	1343	3056	0.00022
Streptomyces sp. HF10	2692233	S	1651	1204	2855	0.00021
Streptomyces sp. RPA4-5	2721245	S	1571	1065	2636	0.00019
Streptomyces sp. AgN23	1188315	S	1513	1392	2905	0.00021
Streptomyces sp. 3211	1964449	S	1375	1676	3051	0.00022
Streptomyces sp. 2323.1	1938841	S	1352	874	2226	0.00016
Streptomyces sp. NA02536	2742133	S	1322	3630	4952	0.00036
Streptomyces sp. S063	2005885	S	1308	945	2253	0.00016
Streptomyces sp. S8	1837283	S	1301	1169	2470	0.00018
Streptomyces sp. EAS-AB2608	2779671	S	1253	1918	3171	0.00023
Streptomyces sp. NEAU-S7GS2	2202000	S	1226	1028	2254	0.00016
Streptomyces sp. XC 2026	2782004	S	1217	1114	2331	0.00017
Streptomyces sp. PBH53	1577075	S	1155	1632	2787	0.00020
Streptomyces sp. RLB1-33	2721243	S	1152	3420	4572	0.00033
Streptomyces sp. Sge12	1972846	S	1082	1621	2703	0.00020
Streptomyces sp. ID38640	1265399	S	1048	753	1801	0.00013
Streptomyces sp. MOE7	1961713	S	924	1158	2082	0.00015
Streptomyces sp. HNA39	2850561	S	921	1086	2007	0.00015
Streptomyces sp. WA6-1-16	2879427	S	908	945	1853	0.00013
Streptomyces sp. Tue 6075	1661694	S	844	992	1836	0.00013
Streptomyces sp. 11-1-2	1851167	S	834	1606	2440	0.00018
Streptomyces sp. CFMR 7	1649184	S	766	1361	2127	0.00015
Streptomyces sp. CB00271	2750025	S	720	1012	1732	0.00013
Streptomyces sp. M56	1495638	S	596	1636	2232	0.00016
Streptomyces sp. WAC00303	2933779	S	595	886	1481	0.00011
Streptomyces sp. BSE6.1	2605730	S	519	2231	2750	0.00020
Streptomyces sp. CLI2509	1984801	S	514	1685	2199	0.00016
Streptomyces sp. CB04723	2748873	S	499	927	1426	0.00010
Streptomyces sp. V17-9	2831149	S	490	2227	2717	0.00020
Streptomyces sp. Tu6071	355249	S	487	1426	1913	0.00014
Streptomyces sp. PAMC 26508	1265601	S	482	1644	2126	0.00015
Streptomyces sp. M2	646637	S	474	2430	2904	0.00021
Streptomyces sp. CB09030	2913412	S	464	1613	2077	0.00015
Streptomyces sp. CRSS-Y-16	2906474	S	428	2322	2750	0.00020
Streptomyces sp. NA03103	2742134	S	406	2507	2913	0.00021
Streptomyces sp. VN1	1821625	S	386	1695	2081	0.00015
Streptomyces sp. endophyte_N2	2153485	S	380	1142	1522	0.00011
Streptomyces sp. WAC00288	2094021	S	379	1644	2023	0.00015
Streptomyces sp. HU2014	2939414	S	373	1332	1705	0.00012
Streptomyces sp. S501	2420135	S	340	1252	1592	0.00012
Streptomyces sp. WA1-19	2884220	S	328	1824	2152	0.00016
Streptomyces sp. LBUM 1480	2609808	S	311	3220	3531	0.00026
Streptomyces sp. 2114.2	1881022	S	294	1893	2187	0.00016
Streptomyces sp. A1-5	2738410	S	293	1415	1708	0.00012
Streptomyces sp. KPB2	2305221	S	287	2240	2527	0.00018
Streptomyces sp. CA-256286	2801033	S	271	1758	2029	0.00015
Streptomyces sp. GF20	2692235	S	244	1422	1666	0.00012
Streptomyces sp. S1A1-7	2594459	S	243	2208	2451	0.00018
Streptomyces sp. R527F	1664033	S	213	1262	1475	0.00011
Streptomyces sp. RLB3-17	2594455	S	179	2705	2884	0.00021
Streptomyces sp. NBU3104	2911367	S	173	1177	1350	0.00010
Streptomyces sp. 604F	1476754	S	169	1498	1667	0.00012
Streptomyces sp. LBUM 1482	2609809	S	165	4359	4524	0.00033
Streptomyces sp. LBUM 1475	2609807	S	161	4988	5149	0.00037
Streptomyces sp. FR-008	206662	S	148	1252	1400	0.00010
Streptomyces sp. RLB3-6	2594457	S	131	3966	4097	0.00030
Streptomyces sp. OUCMDZ-3434	1535304	S	129	1329	1458	0.00011
Streptomyces sp. S1D4-20	2594462	S	116	3044	3160	0.00023
Streptomyces sp. CC0208	2306165	S	116	3248	3364	0.00024
Streptomyces sp. GBA 94-10	1218177	S	110	1375	1485	0.00011
Streptomyces sp. A10(2020)	2782013	S	104	1259	1363	0.00010
Streptomyces sp. PLM4	2929798	S	99	847	946	0.00007
Streptomyces sp. PVA_94-07	1225337	S	96	1387	1483	0.00011
Streptomyces sp. S1D4-14	2594461	S	94	5926	6020	0.00043
Streptomyces sp. RLB1-9	2594454	S	72	3828	3900	0.00028
Streptomyces sp. S1D4-23	2594463	S	47	2428	2475	0.00018
Streptomyces sp. SM17	565560	S	41	1758	1799	0.00013
Streptomyces sp. ICC1	2099583	S	31	1717	1748	0.00013
Streptomyces sp. ICC4	2099584	S	23	1474	1497	0.00011
Streptomyces venezuelae	54571	S	22492	8794	31286	0.00226
Streptomyces cadmiisoli	2184053	S	4990	1327	6317	0.00046
Streptomyces aurantiacus	47760	S	3955	1004	4959	0.00036
Streptomyces qaidamensis	1783515	S	3755	1637	5392	0.00039
Streptomyces alboniger	132473	S	2566	1000	3566	0.00026
Streptomyces koyangensis	188770	S	1805	1873	3678	0.00027
Streptomyces hygroscopicus	1912	S	6598	9541	16139	0.00117
Streptomyces rapamycinicus	1226757	S	4094	1008	5102	0.00037
Streptomyces violaceusniger	68280	S	1759	1184	2943	0.00021
Streptomyces yatensis	155177	S	1736	1288	3024	0.00022
Streptomyces malaysiensis	92644	S	494	1494	1988	0.00014
Streptomyces calvus	67282	S	11841	4862	16703	0.00121
Streptomyces chartreusis	1969	S	10890	4803	15693	0.00113
Streptomyces capitiformicae	2014920	S	9888	1640	11528	0.00083
Streptomyces xinghaiensis	1038928	S	9385	3085	12470	0.00090
Streptomyces griseus	1911	S	3613	3369	6982	0.00050
Streptomyces sp. M54	2759525	S	368	957	1325	0.00010
Streptomyces anulatus	1892	S	2609	2766	5375	0.00039
Streptomyces microflavus	1919	S	1298	5834	7132	0.00052
Streptomyces globisporus	1908	S	1049	7719	8768	0.00063
Streptomyces albus	1888	S	8583	4500	13083	0.00095
Streptomyces cyaneochromogenes	2496836	S	8000	2465	10465	0.00076
Streptomyces lydicus	47763	S	7978	5558	13536	0.00098
Streptomyces formicae	1616117	S	7961	2668	10629	0.00077
Streptomyces bathyalis	2710756	S	7315	1329	8644	0.00062
Streptomyces bingchenggensis	379067	S	7282	1505	8787	0.00063
Streptomyces ferrugineus	1413221	S	6887	2330	9217	0.00067
Streptomyces buecherae	2763006	S	6859	1890	8749	0.00063
Streptomyces armeniacus	83291	S	6768	1067	7835	0.00057
Streptomyces tsukubensis	83656	S	6498	1678	8176	0.00059
Streptomyces griseorubiginosus	67304	S	6405	2214	8619	0.00062
Streptomyces lunaelactis	1535768	S	6299	1415	7714	0.00056
Streptomyces niveus	193462	S	6187	2938	9125	0.00066
Streptomyces spectabilis	68270	S	6037	2072	8109	0.00059
Streptomyces cattleya	29303	S	5933	1878	7811	0.00056
Streptomyces harbinensis	1176198	S	5813	1730	7543	0.00055
Streptomyces viridosporus	67581	S	5807	2487	8294	0.00060
Streptomyces seoulensis	73044	S	5525	2257	7782	0.00056
Streptomyces lincolnensis	1915	S	5383	1639	7022	0.00051
Streptomyces davaonensis	348043	S	5365	1582	6947	0.00050
Streptomyces roseirectus	2768066	S	5335	1380	6715	0.00049
Streptomyces nigra	1827580	S	5275	2189	7464	0.00054
Streptomyces aquilus	2548456	S	5178	1611	6789	0.00049
Streptomyces rimosus	1927	S	4908	10531	15439	0.00112
Streptomyces xanthii	2768069	S	4800	1553	6353	0.00046
Streptomyces dengpaensis	2049881	S	4717	1385	6102	0.00044
Streptomyces tendae	1932	S	4659	2030	6689	0.00048
Streptomyces durmitorensis	319947	S	4575	1051	5626	0.00041
Streptomyces asoensis	249586	S	4569	1431	6000	0.00043
Streptomyces ambofaciens	1889	S	4551	2919	7470	0.00054
Streptomyces nodosus	40318	S	4543	1232	5775	0.00042
Streptomyces genisteinicus	2768068	S	4520	1530	6050	0.00044
Streptomyces clavuligerus	1901	S	4456	1156	5612	0.00041
Streptomyces deccanensis	424188	S	4440	1901	6341	0.00046
Streptomyces actuosus	1885	S	4429	1984	6413	0.00046
Streptomyces phaeolivaceus	2653200	S	4399	1268	5667	0.00041
Streptomyces olivoreticuli	68246	S	4391	1337	5728	0.00041
Streptomyces albulus	68570	S	4386	1418	5804	0.00042
Streptomyces liangshanensis	2717324	S	4367	1185	5552	0.00040
Streptomyces avermitilis	33903	S	4330	1315	5645	0.00041
Streptomyces griseoviridis	45398	S	4322	1483	5805	0.00042
Streptomyces griseochromogenes	68214	S	4300	1257	5557	0.00040
Streptomyces prasinus	67345	S	4286	1485	5771	0.00042
Streptomyces vietnamensis	362257	S	4229	1501	5730	0.00041
Streptomyces alboflavus	67267	S	4214	1241	5455	0.00039
Streptomyces exfoliatus	1905	S	4213	1535	5748	0.00042
Streptomyces globosus	68209	S	4176	1640	5816	0.00042
Streptomyces pactum	68249	S	4136	1751	5887	0.00043
Streptomyces rectiverticillatus	173860	S	4123	1424	5547	0.00040
Streptomyces luteoverticillatus	66425	S	4109	1467	5576	0.00040
Streptomyces parvulus	146923	S	4101	1905	6006	0.00043
Streptomyces griseocarneus	51201	S	4086	1539	5625	0.00041
Streptomyces aureoverticillatus	66871	S	4039	1158	5197	0.00038
Streptomyces antibioticus	1890	S	4012	1511	5523	0.00040
Streptomyces ficellus	1977088	S	3986	1530	5516	0.00040
Streptomyces paludis	2282738	S	3980	934	4914	0.00036
Streptomyces atratus	1893	S	3779	821	4600	0.00033
Streptomyces glaucescens	1907	S	3757	1713	5470	0.00040
Streptomyces peucetius	1950	S	3734	1092	4826	0.00035
Streptomyces lavendulae	1914	S	3668	1356	5024	0.00036
Streptomyces broussonetiae	2686304	S	3668	1166	4834	0.00035
Streptomyces collinus	42684	S	3659	2637	6296	0.00045
Streptomyces roseochromogenus	285450	S	3591	1180	4771	0.00034
Streptomyces subrutilus	36818	S	3498	1381	4879	0.00035
Streptomyces pristinaespiralis	38300	S	3456	1391	4847	0.00035
Streptomyces chromofuscus	42881	S	3403	1382	4785	0.00035
Streptomyces galilaeus	33899	S	3373	1197	4570	0.00033
Streptomyces katrae	68223	S	3333	1333	4666	0.00034
Streptomyces vinaceus	1960	S	3319	1262	4581	0.00033
Streptomyces incarnatus	665007	S	3311	1015	4326	0.00031
Streptomyces inhibens	2293571	S	3266	1043	4309	0.00031
Streptomyces tirandamycinicus	2174846	S	3262	1153	4415	0.00032
Streptomyces fodineus	1904616	S	3233	1196	4429	0.00032
Streptomyces hundungensis	1077946	S	3218	1071	4289	0.00031
Streptomyces nitrosporeus	28894	S	3144	949	4093	0.00030
Streptomyces gilvosporeus	553510	S	3126	1056	4182	0.00030
Streptomyces kanamyceticus	1967	S	3018	1059	4077	0.00029
Streptomyces dangxiongensis	1442032	S	3010	1098	4108	0.00030
Streptomyces spongiicola	1690221	S	3003	1303	4306	0.00031
Streptomyces mobaraensis	35621	S	3002	117970	120972	0.00874
Streptomyces gobiensis	2875706	S	2995	613	3608	0.00026
Streptomyces finlayi	67296	S	2977	725	3702	0.00027
Streptomyces gardneri	66892	S	2975	1254	4229	0.00031
Streptomyces coeruleorubidus	116188	S	2973	1468	4441	0.00032
Streptomyces pluripotens	1355015	S	2951	721	3672	0.00027
Streptomyces hawaiiensis	67305	S	2869	1298	4167	0.00030
Streptomyces pratensis	1169025	S	2864	742	3606	0.00026
Streptomyces rutgersensis	53451	S	2850	1464	4314	0.00031
Streptomyces qinzhouensis	2599401	S	2812	714	3526	0.00025
Streptomyces angustmyceticus	285578	S	2799	1199	3998	0.00029
Streptomyces tuirus	68278	S	2762	1452	4214	0.00030
Streptomyces nojiriensis	66374	S	2723	1217	3940	0.00028
Streptomyces cyanogenus	80860	S	2690	1241	3931	0.00028
Streptomyces fagopyri	2662397	S	2684	956	3640	0.00026
Streptomyces huasconensis	1854574	S	2563	1047	3610	0.00026
Streptomyces leeuwenhoekii	1437453	S	2016	1446	3462	0.00025
Streptomyces cyaneogriseus	68192	S	1811	1445	3256	0.00024
Streptomyces decoyicus	249567	S	1549	886	2435	0.00018
Streptomyces lydicamycinicus	1546107	S	1327	816	2143	0.00015
Streptomyces auratus	114687	S	1288	877	2165	0.00016
Streptomyces antimycoticus	68175	S	1277	1324	2601	0.00019
Streptomyces xiamenensis	408015	S	1215	1065	2280	0.00016
Streptomyces fungicidicus	68203	S	1160	3442	4602	0.00033
Streptomyces platensis	58346	S	1144	871	2015	0.00015
Streptomyces albidoflavus	1886	S	365	5588	5953	0.00043
Streptomyces coelicolor	1902	S	329	3627	3956	0.00029
Streptomyces sampsonii	42239	S	184	1508	1692	0.00012
Streptomyces olivaceus	47716	S	810	3022	3832	0.00028
Streptomyces alfalfae	1642299	S	736	4221	4957	0.00036
Streptomyces filamentosus	67294	S	705	906	1611	0.00012
Streptomyces californicus	67351	S	640	2125	2765	0.00020
Streptomyces mirabilis	68239	S	613	3701	4314	0.00031
Streptomyces cavourensis	67258	S	601	1132	1733	0.00013
Streptomyces fradiae	1906	S	507	7812	8319	0.00060
Streptomyces autolyticus	75293	S	413	1407	1820	0.00013
Streptomyces griseofuscus	146922	S	384	1748	2132	0.00015
Streptomyces scabiei	1930	S	369	3288	3657	0.00026
Streptomyces noursei	1971	S	368	1468	1836	0.00013
Streptomyces murinus	33900	S	364	1053	1417	0.00010
Streptomyces albireticuli	1940	S	330	1419	1749	0.00013
Streptomyces lividans	1916	S	284	3085	3369	0.00024
Streptomyces cinereoruber	67260	S	262	1397	1659	0.00012
Streptomyces rubrolavendulae	285473	S	202	1501	1703	0.00012
Streptomyces violaceoruber	1935	S	170	762	932	0.00007
Streptomyces rochei	1928	S	126	961	1087	0.00008
Kitasatospora sp. MMS16-BH015	2018025	S	5409	1994	7403	0.00053
Kitasatospora sp. NA04385	2742135	S	4288	2573	6861	0.00050
Kitasatospora setae	2066	S	4484	2602	7086	0.00051
Kitasatospora aureofaciens	1894	S	3837	1768	5605	0.00041
Kitasatospora albolonga	68173	S	1472	1272	2744	0.00020
Streptacidiphilus sp. P02-A3a	2704468	S	5147	1795	6942	0.00050
Streptacidiphilus sp. PB12-B1b	2705012	S	4640	2069	6709	0.00048
Streptacidiphilus bronchialis	2126346	S	4366	1592	5958	0.00043
Yinghuangia sp. ASG 101	2896848	S	6573	1244	7817	0.00056
Microbacterium sp. No. 7	1714373	S	3744	1755	5499	0.00040
Microbacterium sp. 4R-513	2567934	S	3615	701	4316	0.00031
Microbacterium sp. YJN-G	2763257	S	3214	1099	4313	0.00031
Microbacterium sp. 10M-3C3	2483401	S	2924	936	3860	0.00028
Microbacterium sp. JZ31	1906274	S	2778	821	3599	0.00026
Microbacterium sp. SSW1-51	2851650	S	2231	591	2822	0.00020
Microbacterium sp. ABRD_28	2268461	S	2189	315	2504	0.00018
Microbacterium sp. BH-3-3-3	1906742	S	1960	496	2456	0.00018
Microbacterium sp. XT11	367477	S	1949	437	2386	0.00017
Microbacterium sp. H1-D42	2925844	S	1839	323	2162	0.00016
Microbacterium sp. LKL04	912630	S	1751	440	2191	0.00016
Microbacterium sp. NIBRBAC000506063	2734618	S	1742	750	2492	0.00018
Microbacterium sp. SSW1-36	2851648	S	1740	400	2140	0.00015
Microbacterium sp. A18JL241	2782166	S	1717	425	2142	0.00015
Microbacterium sp. PM5	2014534	S	1680	328	2008	0.00015
Microbacterium sp. cx-55	2875948	S	1639	256	1895	0.00014
Microbacterium sp. Y-01	2048898	S	1634	678	2312	0.00017
Microbacterium sp. CBA3102	2603598	S	1472	378	1850	0.00013
Microbacterium sp. 1S1	2606451	S	1395	625	2020	0.00015
Microbacterium sp. TPU 3598	1938334	S	1293	355	1648	0.00012
Microbacterium sp. Nx66	2766784	S	1127	766	1893	0.00014
Microbacterium sp. RG1	2489212	S	742	576	1318	0.00010
Microbacterium sp. SGAir0570	2070348	S	374	1328	1702	0.00012
Microbacterium sp. CGR1	1696072	S	334	1329	1663	0.00012
Microbacterium sp. PAMC22086	2861281	S	319	678	997	0.00007
Microbacterium sp. 1.5R	1916917	S	309	1187	1496	0.00011
Microbacterium sp. str. 'China'	2103230	S	174	902	1076	0.00008
Microbacterium sp. PAMC 28756	1795053	S	71	1120	1191	0.00009
Microbacterium sp. KUDC0406	2909588	S	26	2313	2339	0.00017
Microbacterium sp. Se5.02b	2864103	S	18	1622	1640	0.00012
Microbacterium cremeum	2782169	S	9297	2086	11383	0.00082
Microbacterium atlanticum	2782168	S	5262	1236	6498	0.00047
Microbacterium hominis	162426	S	4005	11221	15226	0.00110
Microbacterium foliorum	104336	S	3904	853	4757	0.00034
Microbacterium oleivorans	273677	S	3695	763	4458	0.00032
Microbacterium lemovicicum	1072463	S	2719	656	3375	0.00024
Microbacterium resistens	156977	S	2613	515	3128	0.00023
Microbacterium sediminis	904291	S	2504	1205	3709	0.00027
Microbacterium oryzae	743009	S	2465	785	3250	0.00023
Microbacterium pygmaeum	370764	S	2367	314	2681	0.00019
Microbacterium testaceum	2033	S	2180	419	2599	0.00019
Microbacterium chocolatum	84292	S	2158	519	2677	0.00019
Microbacterium wangchenii	2541726	S	2136	511	2647	0.00019
Microbacterium caowuchunii	2614638	S	2101	427	2528	0.00018
Microbacterium lushaniae	2614639	S	1991	486	2477	0.00018
Microbacterium aurum	36805	S	1965	655	2620	0.00019
Microbacterium luteum	2782167	S	1923	851	2774	0.00020
Microbacterium protaetiae	2509458	S	1775	425	2200	0.00016
Microbacterium oxydans	82380	S	1740	1363	3103	0.00022
Microbacterium esteraromaticum	57043	S	1637	386	2023	0.00015
Microbacterium hydrocarbonoxydans	273678	S	1425	269	1694	0.00012
Microbacterium schleiferi	69362	S	1199	443	1642	0.00012
Microbacterium fandaimingii	2708079	S	922	84	1006	0.00007
Microbacterium binotii	462710	S	756	577	1333	0.00010
Microbacterium amylolyticum	936337	S	754	174	928	0.00007
Microbacterium chengjingii	2769067	S	671	38	709	0.00005
Microbacterium endophyticum	1526412	S	517	39	556	0.00004
Microbacterium paludicola	300019	S	375	1391	1766	0.00013
Microbacterium paraoxydans	199592	S	258	1757	2015	0.00015
Agromyces sp. H17E-10	2932244	S	6498	2469	8967	0.00065
Agromyces sp. LHK192	2498704	S	5646	1891	7537	0.00054
Agromyces sp. CFWR-12	2929802	S	3707	2614	6321	0.00046
Agromyces flavus	589382	S	14817	5344	20161	0.00146
Agromyces marinus	1389020	S	5898	2460	8358	0.00060
Agromyces aureus	453304	S	5850	1884	7734	0.00056
Agromyces soli	659012	S	5005	2066	7071	0.00051
Agromyces badenianii	2080742	S	4631	1737	6368	0.00046
Agromyces protaetiae	2509455	S	4035	1315	5350	0.00039
Agromyces laixinhei	2585717	S	3713	979	4692	0.00034
Agromyces intestinalis	2592652	S	3556	2367	5923	0.00043
Agromyces archimandritae	2781962	S	3149	1026	4175	0.00030
Curtobacterium sp. L6-1	2841594	S	1857	669	2526	0.00018
Curtobacterium sp. BH-2-1-1	1905847	S	1794	654	2448	0.00018
Curtobacterium sp. YC1	2795488	S	1460	731	2191	0.00016
Curtobacterium sp. MR_MD2014	1561023	S	1418	722	2140	0.00015
Curtobacterium sp. TC1	2862880	S	1209	677	1886	0.00014
Curtobacterium sp. 24E2	2804758	S	1115	663	1778	0.00013
Curtobacterium sp. SGAir0471	2070337	S	1046	918	1964	0.00014
Curtobacterium sp. TXMA1	2876939	S	891	809	1700	0.00012
Curtobacterium sp. C1	2898151	S	383	1272	1655	0.00012
Curtobacterium sp. Csp2	2495430	S	288	1082	1370	0.00010
Curtobacterium sp. Csp1	2495429	S	54	1326	1380	0.00010
Curtobacterium flaccumfaciens	2035	S	2855	1438	4293	0.00031
Curtobacterium luteum	33881	S	1827	719	2546	0.00018
Rathayibacter sp. VKM Ac-2759	2609252	S	2602	1015	3617	0.00026
Rathayibacter sp. VKM Ac-2760	2609253	S	2058	1154	3212	0.00023
Rathayibacter sp. VKM Ac-2804	2609257	S	1506	1191	2697	0.00019
Rathayibacter sp. VKM Ac-2801	2609255	S	1022	958	1980	0.00014
Rathayibacter sp. VKM Ac-2762	2609254	S	479	1239	1718	0.00012
Rathayibacter sp. VKM Ac-2805	2609258	S	420	1118	1538	0.00011
Rathayibacter festucae	110937	S	2370	2695	5065	0.00037
Rathayibacter tanaceti	1671680	S	1497	430	1927	0.00014
Rathayibacter iranicus	59737	S	974	147	1121	0.00008
Rathayibacter tritici	33888	S	935	318	1253	0.00009
Rathayibacter rathayi	33887	S	876	264	1140	0.00008
Rathayibacter toxicus	145458	S	343	33	376	0.00003
Agrococcus sp. SCSIO52902	2933290	S	3777	2129	5906	0.00043
Agrococcus sp. Marseille-Q4369	2810513	S	3168	1275	4443	0.00032
Agrococcus sp. SGAir0287	2070347	S	2806	973	3779	0.00027
Agrococcus carbonis	684552	S	3441	1826	5267	0.00038
Agrococcus jejuensis	399736	S	2990	1085	4075	0.00029
Leifsonia sp. ZF2019	2781978	S	2723	867	3590	0.00026
Leifsonia sp. PS1209	2724914	S	2640	833	3473	0.00025
Leifsonia sp. 21MFCrub1.1	1798223	S	2604	3641	6245	0.00045
Leifsonia shinshuensis	150026	S	3550	1155	4705	0.00034
Leifsonia xyli	1575	S	2161	338	2499	0.00018
Leucobacter sp. H25R-14	2932245	S	1793	331	2124	0.00015
Leucobacter sp. NB 10	2873270	S	1766	547	2313	0.00017
Leucobacter sp. Psy1	2875729	S	1501	209	1710	0.00012
Leucobacter sp. CX169	2813744	S	1284	378	1662	0.00012
Leucobacter sp. H21R-36	2932246	S	630	1526	2156	0.00016
Leucobacter sp. H21R-40	2932247	S	529	1278	1807	0.00013
Leucobacter muris	1935379	S	2014	803	2817	0.00020
Leucobacter triazinivorans	1784719	S	1759	1124	2883	0.00021
Leucobacter luti	340320	S	710	76	786	0.00006
Leucobacter viscericola	2714935	S	502	55	557	0.00004
Leucobacter insecticola	2714934	S	470	45	515	0.00004
Leucobacter coleopterorum	2714933	S	367	41	408	0.00003
Leucobacter denitrificans	683042	S	343	59	402	0.00003
Clavibacter michiganensis	28447	S	10348	11137	21485	0.00155
Clavibacter zhangzhiyongii	2768071	S	1376	784	2160	0.00016
Clavibacter sp. A6099	2860285	S	856	668	1524	0.00011
Protaetiibacter sp. SSC-01	2759943	S	2753	1187	3940	0.00028
Protaetiibacter intestinalis	2419774	S	2460	1039	3499	0.00025
Protaetiibacter larvae	2592654	S	1935	725	2660	0.00019
Salinibacterium sp. ZJ450	2708338	S	2276	407	2683	0.00019
Salinibacterium sp. ZJ70	2708084	S	1640	479	2119	0.00015
Salinibacterium sp. dk2585	2603292	S	1448	277	1725	0.00012
Salinibacterium sp. UTAS2018	2508880	S	449	50	499	0.00004
Salinibacterium sp. M195	2583374	S	376	49	425	0.00003
Salinibacterium hongtaonis	2079791	S	717	86	803	0.00006
Cryobacterium sp. LW097	1978566	S	1626	390	2016	0.00015
Cryobacterium sp. PAMC25264	2861288	S	880	559	1439	0.00010
Cryobacterium soli	2220095	S	1193	658	1851	0.00013
Cryobacterium arcticum	670052	S	985	784	1769	0.00013
Frondihabitans sp. PAMC 28766	1795630	S	2333	359	2692	0.00019
Frondihabitans sp. 762G35	1446794	S	2098	514	2612	0.00019
Microterricola viridarii	412690	S	4455	1275	5730	0.00041
Plantibacter sp. M259	2583822	S	748	794	1542	0.00011
Plantibacter sp. PA-3-X8	2480625	S	689	756	1445	0.00010
Plantibacter flavus	150123	S	829	778	1607	0.00012
Microcella flavibacter	1804990	S	2281	1264	3545	0.00026
Microcella alkaliphila	279828	S	1574	315	1889	0.00014
Cnuibacter physcomitrellae	1619308	S	2963	748	3711	0.00027
Herbiconiux sp. SALV-R1	2735133	S	2896	675	3571	0.00026
Subtercola sp. AK-R2A1-2	2895559	S	1650	183	1833	0.00013
Subtercola sp. PAMC28395	2846775	S	1078	129	1207	0.00009
Mycetocola zhujimingii	2079792	S	1017	139	1156	0.00008
Mycetocola sp. JXN-3	2116510	S	925	156	1081	0.00008
Mycetocola spongiae	2859226	S	793	118	911	0.00007
Frigoribacterium sp. NBH87	2596916	S	2540	869	3409	0.00025
Gryllotalpicola protaetiae	2419771	S	2528	570	3098	0.00022
Humibacter sp. WJ7-1	2599293	S	2451	630	3081	0.00022
Chryseoglobus sp. 28M-23	2772253	S	411	960	1371	0.00010
Chryseoglobus indicus	2750620	S	376	925	1301	0.00009
Amnibacterium sp. L3-i23	2905871	S	2111	590	2701	0.00020
Diaminobutyricimonas sp. LJ205	2683590	S	1923	420	2343	0.00017
Marisediminicola antarctica	674079	S	1813	261	2074	0.00015
Gulosibacter sediminis	1729695	S	1686	573	2259	0.00016
Agreia sp. COWG	2773266	S	1373	192	1565	0.00011
Glaciihabitans sp. INWT7	2596912	S	1290	119	1409	0.00010
Aquiluna borgnonia	2499157	S	188	16	204	0.00001
Candidatus Aquiluna sp. UB-MaderosW2red	1855377	S	87	4	91	0.00001
Rhodoluna limnophila	232537	S	124	9	133	0.00001
Candidatus Rhodoluna planktonica	535712	S	73	4	77	0.00001
Rhodoluna lacicola	529884	S	72	5	77	0.00001
Pseudoclavibacter sp. Marseille-Q3772	2866588	S	340	76	416	0.00003
Aurantimicrobium photophilum	1987356	S	135	11	146	0.00001
Aurantimicrobium sp. MWH-Uga1	2079575	S	50	11	61	0.00000
Aurantimicrobium minutum	708131	S	49	11	60	0.00000
Pontimonas salivibrio	1159327	S	190	10	200	0.00001
Arthrobacter sp. QXT-31	1357915	S	18002	5797	23799	0.00172
Arthrobacter sp. FW305-BF8	2879617	S	3890	1232	5122	0.00037
Arthrobacter sp. PGP41	2079227	S	2409	957	3366	0.00024
Arthrobacter sp. NicSoilC5	2831000	S	2304	1352	3656	0.00026
Arthrobacter sp. QL17	2895818	S	2255	609	2864	0.00021
Arthrobacter sp. PM3	2017685	S	2229	407	2636	0.00019
Arthrobacter sp. 24S4-2	2575374	S	2199	574	2773	0.00020
Arthrobacter sp. NicSoilB8	2830998	S	2132	643	2775	0.00020
Arthrobacter sp. U41	1849032	S	1830	603	2433	0.00018
Arthrobacter sp. FB24	290399	S	1771	649	2420	0.00017
Arthrobacter sp. UKPF54-2	2600159	S	1746	855	2601	0.00019
Arthrobacter sp. NicSoilB4	2830997	S	1692	616	2308	0.00017
Arthrobacter sp. PAMC25564	2565366	S	1688	533	2221	0.00016
Arthrobacter sp. KBS0702	2578107	S	1657	765	2422	0.00018
Arthrobacter sp. ERGS1:01	1704044	S	1568	351	1919	0.00014
Arthrobacter sp. Helios	2828862	S	1392	265	1657	0.00012
Arthrobacter sp. FW306-2-2C-D06B	2879618	S	1297	293	1590	0.00011
Arthrobacter sp. PAMC25284	2861279	S	1232	372	1604	0.00012
Arthrobacter sp. NtRootA1	2830983	S	1024	357	1381	0.00010
Arthrobacter sp. zg-Y462	2886936	S	1000	237	1237	0.00009
Arthrobacter sp. PAMC 25486	1494608	S	818	156	974	0.00007
Arthrobacter sp. StoSoilB20	2830995	S	763	245	1008	0.00007
Arthrobacter sp. zg-Y809	2886940	S	748	300	1048	0.00008
Arthrobacter sp. StoSoilB5	2830992	S	708	233	941	0.00007
Arthrobacter sp. D5-1	1477518	S	628	475	1103	0.00008
Arthrobacter sp. YN	2020486	S	522	247	769	0.00006
Arthrobacter sp. FW306-06-A	2879621	S	425	1653	2078	0.00015
Arthrobacter sp. NicSoilB11	2830999	S	365	1610	1975	0.00014
Arthrobacter sp. C1-1	2813727	S	342	55	397	0.00003
Arthrobacter sp. FW306-07-I	2879622	S	288	1787	2075	0.00015
Arthrobacter sp. StoSoilA2	2830990	S	265	529	794	0.00006
Arthrobacter sp. StoSoilB19	2830994	S	264	1337	1601	0.00012
Arthrobacter sp. FW306-05-C	2879620	S	263	1530	1793	0.00013
Arthrobacter sp. StoSoilB13	2830993	S	232	478	710	0.00005
Arthrobacter sp. AQ5-05	2184581	S	34	645	679	0.00005
Arthrobacter crystallopoietes	37928	S	4151	873	5024	0.00036
Arthrobacter agilis	37921	S	3471	588	4059	0.00029
Arthrobacter sulfonylureivorans	2486855	S	2100	389	2489	0.00018
Arthrobacter woluwensis	156980	S	1528	402	1930	0.00014
Arthrobacter dokdonellae	2211210	S	1500	294	1794	0.00013
Arthrobacter jiangjiafuii	2817475	S	1114	347	1461	0.00011
Arthrobacter alpinus	656366	S	896	1463	2359	0.00017
Arthrobacter sunyaminii	2816859	S	634	235	869	0.00006
Pseudarthrobacter sp. L1SW	2851598	S	2389	1060	3449	0.00025
Pseudarthrobacter sp. BIM B-2242	2772401	S	1674	470	2144	0.00015
Pseudarthrobacter sp. NIBRBAC000502772	2590775	S	852	669	1521	0.00011
Pseudarthrobacter sp. SSS035	2931399	S	796	748	1544	0.00011
Pseudarthrobacter sp. NBSH8	2596911	S	782	326	1108	0.00008
Pseudarthrobacter sp. NIBRBAC000502771	2590774	S	461	1606	2067	0.00015
Pseudarthrobacter sp. NIBRBAC000502770	2590785	S	417	1282	1699	0.00012
Pseudarthrobacter phenanthrenivorans	361575	S	2963	1588	4551	0.00033
Pseudarthrobacter chlorophenolicus	85085	S	1856	755	2611	0.00019
Pseudarthrobacter equi	728066	S	1761	755	2516	0.00018
Pseudarthrobacter psychrotolerans	2697569	S	1044	462	1506	0.00011
Pseudarthrobacter sulfonivorans	121292	S	802	911	1713	0.00012
Kocuria rosea	1275	S	4169	1478	5647	0.00041
Kocuria flava	446860	S	3552	1981	5533	0.00040
Kocuria turfanensis	388357	S	3348	1290	4638	0.00034
Kocuria palustris	71999	S	1665	745	2410	0.00017
Kocuria rhizophila	72000	S	1237	1971	3208	0.00023
Kocuria varians	1272	S	1024	801	1825	0.00013
Kocuria sp. TGY1127_2	2711328	S	424	80	504	0.00004
Kocuria sp. KD4	2719588	S	222	384	606	0.00004
Kocuria sp. BT304	1702043	S	129	675	804	0.00006
Kocuria indica	1049583	S	202	415	617	0.00004
Micrococcus luteus	1270	S	3531	6875	10406	0.00075
Micrococcus sp. KD337-16	2856555	S	1487	1026	2513	0.00018
Micrococcus sp. KBS0714	1179670	S	42	384	426	0.00003
Micrococcus yunnanensis	566027	S	36	309	345	0.00002
Sinomonas atrocyanea	37927	S	3720	1429	5149	0.00037
Sinomonas sp. R1AF57	2020377	S	3364	921	4285	0.00031
Glutamicibacter creatinolyticus	162496	S	1102	299	1401	0.00010
Glutamicibacter protophormiae	37930	S	1034	718	1752	0.00013
Glutamicibacter halophytocola	1933880	S	596	122	718	0.00005
Glutamicibacter mishrai	1775880	S	420	102	522	0.00004
Glutamicibacter nicotianae	37929	S	351	1050	1401	0.00010
Glutamicibacter arilaitensis	256701	S	329	136	465	0.00003
Glutamicibacter sp. ZJUTW	1155384	S	69	288	357	0.00003
Paenarthrobacter ureafaciens	37931	S	1171	1955	3126	0.00023
Paenarthrobacter aurescens	43663	S	823	585	1408	0.00010
Paenarthrobacter sp. YJN-5	2735316	S	320	687	1007	0.00007
Paenarthrobacter sp. YJN-D	2735317	S	173	343	516	0.00004
Paenarthrobacter nicotinovorans	29320	S	168	282	450	0.00003
Rothia kristinae	37923	S	1818	1200	3018	0.00022
Rothia mucilaginosa	43675	S	628	143	771	0.00006
Rothia nasimurium	85336	S	330	182	512	0.00004
Rothia aeria	172042	S	289	134	423	0.00003
Rothia dentocariosa	2047	S	179	88	267	0.00002
Rothia terrae	396015	S	113	55	168	0.00001
Rothia amarae	169480	S	99	51	150	0.00001
Rothia sp. ZJ932	2810516	S	72	12	84	0.00001
Citricoccus sp. SGAir0253	2567881	S	2906	915	3821	0.00028
Nesterenkonia sp. NBAIMH1	2600320	S	1023	77	1100	0.00008
Paeniglutamicibacter sp. Y32M11	2853258	S	547	99	646	0.00005
Psychromicrobium lacuslunae	1618207	S	418	66	484	0.00004
Auritidibacter sp. NML130574	2170745	S	358	44	402	0.00003
Neomicrococcus aestuarii	556325	S	314	157	471	0.00003
Renibacterium salmoninarum	1646	S	214	14	228	0.00002
Cellulomonas sp. Y8	2591145	S	5109	2744	7853	0.00057
Cellulomonas sp. H30R-01	2704467	S	4462	2173	6635	0.00048
Cellulomonas sp. C5510	2871170	S	3858	1934	5792	0.00042
Cellulomonas sp. zg-ZUI188	2819978	S	3788	1330	5118	0.00037
Cellulomonas sp. JZ18	2654191	S	3763	2012	5775	0.00042
Cellulomonas sp. zg-ZUI222	2816956	S	3143	1485	4628	0.00033
Cellulomonas sp. zg-ZUI157	2819979	S	3110	1352	4462	0.00032
Cellulomonas sp. EW123	2608402	S	2627	1923	4550	0.00033
Cellulomonas sp. PSBB021	2003551	S	2572	2532	5104	0.00037
Cellulomonas fimi	1708	S	4202	4304	8506	0.00061
Cellulomonas shaoxiangyii	2566013	S	3452	1783	5235	0.00038
Cellulomonas iranensis	76862	S	3323	1927	5250	0.00038
Cellulomonas flavigena	1711	S	3198	1511	4709	0.00034
Cellulomonas gilvus	11	S	2840	1542	4382	0.00032
Cellulomonas taurus	2729175	S	2627	1051	3678	0.00027
Actinotalea sp. JY-7876	2758442	S	3899	1742	5641	0.00041
Oerskovia sp. KBS0722	1179673	S	3110	1229	4339	0.00031
Pseudactinotalea sp. HY158	2654547	S	2786	502	3288	0.00024
Paraoerskovia marina	545619	S	2140	690	2830	0.00020
Janibacter melonis	262209	S	3667	1519	5186	0.00037
Janibacter limosus	53458	S	2574	835	3409	0.00025
Janibacter indicus	857417	S	1371	2303	3674	0.00027
Janibacter sp. YB324	2761047	S	755	1699	2454	0.00018
Phycicoccus sp. HDW14	2714941	S	5185	2088	7273	0.00053
Phycicoccus endophyticus	1690220	S	4263	1522	5785	0.00042
Intrasporangium calvum	53358	S	8250	2717	10967	0.00079
Pedococcus dokdonensis	443156	S	4638	1643	6281	0.00045
Tetrasphaera sp. HKS02	1813880	S	3990	1247	5237	0.00038
Arsenicicoccus sp. oral taxon 190	1658671	S	3645	1709	5354	0.00039
Cellulosimicrobium cellulans	1710	S	7973	9469	17442	0.00126
Cellulosimicrobium sp. BI34T	2587808	S	3342	1829	5171	0.00037
Cellulosimicrobium sp. JZ28	1906273	S	641	1646	2287	0.00017
Cellulosimicrobium sp. 72-3	2731680	S	362	1760	2122	0.00015
Cellulosimicrobium sp. TH-20	1980001	S	329	1649	1978	0.00014
Isoptericola variabilis	139208	S	6661	4311	10972	0.00079
Isoptericola dokdonensis	372663	S	3748	1798	5546	0.00040
Xylanimonas protaetiae	2509457	S	3470	1886	5356	0.00039
Xylanimonas cellulosilytica	186189	S	3159	1395	4554	0.00033
Xylanimonas allomyrinae	2509459	S	2920	1144	4064	0.00029
Ornithinimicrobium avium	2283195	S	4594	1488	6082	0.00044
Ornithinimicrobium sp. HY006	2508882	S	3050	1234	4284	0.00031
Ornithinimicrobium sp. INDO-MA30-4	2908651	S	574	125	699	0.00005
Ornithinimicrobium flavum	1288636	S	3461	1348	4809	0.00035
Ornithinimicrobium ciconiae	2594265	S	2581	490	3071	0.00022
Ornithinimicrobium pratense	2593973	S	2284	787	3071	0.00022
Serinicoccus chungangensis	767452	S	3067	1279	4346	0.00031
Serinicoccus hydrothermalis	1758689	S	2625	1464	4089	0.00030
Serinicoccus profundi	1078471	S	2460	1081	3541	0.00026
Serinicoccus marinus	247333	S	2405	1413	3818	0.00028
Brevibacterium sp. CS2	2575923	S	2541	1250	3791	0.00027
Brevibacterium sp. SMBL_HHYL_HB1	2777556	S	1221	330	1551	0.00011
Brevibacterium sp. HY170	2898795	S	541	185	726	0.00005
Brevibacterium sp. 'Marine'	2725563	S	391	298	689	0.00005
Brevibacterium sp. W7.2	2823518	S	387	2159	2546	0.00018
Brevibacterium casei	33889	S	2450	1968	4418	0.00032
Brevibacterium linens	1703	S	1518	1046	2564	0.00019
Brevibacterium luteolum	199591	S	1413	691	2104	0.00015
Brevibacterium atlanticum	2697563	S	893	218	1111	0.00008
Brevibacterium sandarakinum	629680	S	853	182	1035	0.00007
Brevibacterium aurantiacum	273384	S	829	646	1475	0.00011
Brevibacterium oceani	358099	S	789	204	993	0.00007
Brevibacterium limosum	2697565	S	571	243	814	0.00006
Brevibacterium siliguriense	1136497	S	472	158	630	0.00005
Brevibacterium pigmentatum	1496080	S	385	326	711	0.00005
Brachybacterium sp. SGAir0954	2571029	S	2514	828	3342	0.00024
Brachybacterium sp. CBA3105	2887346	S	2479	684	3163	0.00023
Brachybacterium sp. P6-10-X1	1903186	S	2289	470	2759	0.00020
Brachybacterium ginsengisoli	1331682	S	2131	711	2842	0.00021
Brachybacterium faecium	43669	S	2041	713	2754	0.00020
Brachybacterium saurashtrense	556288	S	2038	669	2707	0.00020
Brachybacterium vulturis	2017484	S	1625	666	2291	0.00017
Brachybacterium avium	2017485	S	1371	559	1930	0.00014
Dermabacter vaginalis	1630135	S	691	556	1247	0.00009
Dermabacter jinjuensis	1667168	S	601	609	1210	0.00009
Devriesea agamarum	472569	S	331	22	353	0.00003
Georgenia yuyongxinii	2589797	S	5164	1584	6748	0.00049
Georgenia sp. TF02-10	2917725	S	5108	2336	7444	0.00054
Georgenia faecalis	2483799	S	3758	1302	5060	0.00037
Georgenia wutianyii	2585135	S	3549	1537	5086	0.00037
Haloactinobacterium kanbiaonis	2675754	S	4488	802	5290	0.00038
Ruania sp. LR1S40	2897774	S	2356	603	2959	0.00021
Ruania sp. M4N3S171	2897773	S	1472	247	1719	0.00012
Ruania zhangjianzhongii	2603206	S	2888	358	3246	0.00023
Ruania alkalisoli	2779775	S	1792	363	2155	0.00016
Dermacoccus nishinomiyaensis	1274	S	2294	1191	3485	0.00025
Dermacoccus sp. PAMC28757	2762331	S	1578	686	2264	0.00016
Luteipulveratus mongoliensis	571913	S	3385	585	3970	0.00029
Allobranchiibius sp. GilTou73	2904523	S	2544	692	3236	0.00023
Yimella sp. cx-51	2770551	S	1757	434	2191	0.00016
Beutenbergia cavernae	84757	S	5039	1040	6079	0.00044
Miniimonas sp. S16	2171623	S	3271	2104	5375	0.00039
Pengzhenrongella sicca	2819238	S	4609	1575	6184	0.00045
Luteimicrobium xylanilyticum	1133546	S	3693	1401	5094	0.00037
Sanguibacter keddieii	60920	S	2882	1055	3937	0.00028
Sanguibacter sp. HDW7	2714931	S	2557	984	3541	0.00026
Gephyromycinifex aptenodytis	2716227	S	1408	200	1608	0.00012
Austwickia chelonae	100225	S	1090	103	1193	0.00009
Dermatophilus congolensis	1863	S	261	29	290	0.00002
Kytococcus sedentarius	1276	S	2574	1142	3716	0.00027
Demequina sp. TMPB413	2881056	S	977	95	1072	0.00008
Jonesia denitrificans	43674	S	192	41	233	0.00002
Tropheryma whipplei	2039	S	63	0	63	0.00000
Micromonospora sp. WMMC415	2675222	S	35394	14268	49662	0.00359
Micromonospora sp. WMMA2032	2039870	S	8792	6118	14910	0.00108
Micromonospora sp. HM134	2583243	S	8053	3822	11875	0.00086
Micromonospora sp. B006	2201999	S	6725	5497	12222	0.00088
Micromonospora sp. L5	648999	S	653	7171	7824	0.00057
Micromonospora echinaurantiaca	47857	S	23964	12393	36357	0.00263
Micromonospora inositola	47865	S	19713	10427	30140	0.00218
Micromonospora echinofusca	47858	S	17370	8535	25905	0.00187
Micromonospora krabiensis	307121	S	15825	5882	21707	0.00157
Micromonospora purpureochromogenes	47872	S	15107	8580	23687	0.00171
Micromonospora terminaliae	1914461	S	13525	7329	20854	0.00151
Micromonospora viridifaciens	1881	S	13365	6272	19637	0.00142
Micromonospora carbonacea	47853	S	12975	6247	19222	0.00139
Micromonospora coriariae	285665	S	12802	4915	17717	0.00128
Micromonospora coxensis	356852	S	12653	7521	20174	0.00146
Micromonospora siamensis	299152	S	11421	5860	17281	0.00125
Micromonospora echinospora	1877	S	10167	3828	13995	0.00101
Micromonospora auratinigra	261654	S	9997	5625	15622	0.00113
Micromonospora sagamiensis	47875	S	9852	4060	13912	0.00101
Micromonospora narathiwatensis	299146	S	9776	4898	14674	0.00106
Micromonospora maris	1003110	S	9744	3183	12927	0.00093
Micromonospora endophytica (Xie et al. 2001) Li et al. 2019	515350	S	9108	2945	12053	0.00087
Micromonospora zamorensis	709883	S	9063	3139	12202	0.00088
Micromonospora ferruginea	2749844	S	8947	5527	14474	0.00105
Micromonospora chokoriensis	356851	S	8895	3104	11999	0.00087
Micromonospora rifamycinica	291594	S	7587	3648	11235	0.00081
Micromonospora craniellae	2294034	S	6637	4150	10787	0.00078
Micromonospora tulbaghiae	479978	S	4815	5434	10249	0.00074
Micromonospora aurantiaca	47850	S	4002	27064	31066	0.00224
Actinoplanes sp. L3-i22	2836373	S	16559	12606	29165	0.00211
Actinoplanes sp. N902-109	649831	S	16489	5479	21968	0.00159
Actinoplanes sp. OR16	946334	S	14405	7474	21879	0.00158
Actinoplanes friuliensis	196914	S	16294	3017	19311	0.00140
Actinoplanes ianthinogenes	122358	S	13704	6263	19967	0.00144
Actinoplanes missouriensis	1866	S	13600	5068	18668	0.00135
Actinoplanes teichomyceticus	1867	S	13241	6336	19577	0.00141
Actinoplanes derwentensis	113562	S	11370	1997	13367	0.00097
Phytohabitans suffuscus	624315	S	27866	7907	35773	0.00258
Phytohabitans flavus	1076124	S	23518	5114	28632	0.00207
Plantactinospora sp. KBS50	2024580	S	13126	3651	16777	0.00121
Plantactinospora sp. BB1	2071627	S	2699	8141	10840	0.00078
Plantactinospora sp. BC1	2108470	S	2686	8190	10876	0.00079
Dactylosporangium vinaceum	53362	S	21501	2856	24357	0.00176
Catellatospora sp. IY07-71	2728827	S	19431	5069	24500	0.00177
Actinocatenispora thailandica	227318	S	8280	2725	11005	0.00080
Actinocatenispora sera	390989	S	7873	2733	10606	0.00077
Couchioplanes caeruleus	56438	S	17479	4985	22464	0.00162
Polymorphospora rubra	338584	S	15406	3841	19247	0.00139
Natronosporangium hydrolyticum	2811111	S	8117	666	8783	0.00063
Verrucosispora sp. NA02020	2742132	S	5162	3988	9150	0.00066
Salinispora tropica	168695	S	5028	924	5952	0.00043
Mycolicibacterium litorale	758802	S	5035	1464	6499	0.00047
Mycolicibacterium neoaurum	1795	S	4777	1308	6085	0.00044
Mycolicibacterium smegmatis	1772	S	4019	1734	5753	0.00042
Mycolicibacterium sp. YH-1	2908837	S	2545	1472	4017	0.00029
Mycolicibacterium fortuitum	1766	S	3721	1455	5176	0.00037
Mycolicibacterium rutilum	370526	S	3552	1113	4665	0.00034
Mycolicibacterium sediminis	1286180	S	3214	623	3837	0.00028
Mycolicibacterium hassiacum	46351	S	3211	919	4130	0.00030
Mycolicibacterium mageritense	53462	S	3142	565	3707	0.00027
Mycolicibacterium phlei	1771	S	3109	1120	4229	0.00031
Mycolicibacterium madagascariense	212765	S	3101	507	3608	0.00026
Mycolicibacterium arabiense	1286181	S	3071	507	3578	0.00026
Mycolicibacterium pulveris	36813	S	3012	538	3550	0.00026
Mycolicibacterium parafortuitum	39692	S	2963	631	3594	0.00026
Mycolicibacterium chitae	1792	S	2886	735	3621	0.00026
Mycolicibacterium vaccae	1810	S	2874	607	3481	0.00025
Mycolicibacterium chubuense	1800	S	2866	686	3552	0.00026
Mycolicibacterium thermoresistibile	1797	S	2757	655	3412	0.00025
Mycolicibacterium psychrotolerans	216929	S	2749	661	3410	0.00025
Mycolicibacterium fluoranthenivorans	258505	S	2677	375	3052	0.00022
Mycolicibacterium monacense	85693	S	2606	1346	3952	0.00029
Mycolicibacterium moriokaense	39691	S	2586	338	2924	0.00021
Mycolicibacterium tokaiense	39695	S	2570	436	3006	0.00022
Mycolicibacterium celeriflavum	1249101	S	2557	530	3087	0.00022
Mycolicibacterium duvalii	39688	S	2532	529	3061	0.00022
Mycolicibacterium fallax	1793	S	2499	1066	3565	0.00026
Mycolicibacterium rhodesiae	36814	S	2312	399	2711	0.00020
Mycolicibacterium phocaicum	319706	S	2308	1219	3527	0.00025
Mycolicibacterium baixiangningiae	2761578	S	2294	393	2687	0.00019
Mycolicibacterium poriferae	39694	S	2280	508	2788	0.00020
Mycolicibacterium aurum	1791	S	2264	317	2581	0.00019
Mycolicibacterium confluentis	28047	S	2165	353	2518	0.00018
Mycolicibacterium insubricum	444597	S	2137	643	2780	0.00020
Mycolicibacterium gadium	1794	S	2130	302	2432	0.00018
Mycolicibacterium gilvum	1804	S	2125	818	2943	0.00021
Mycolicibacterium boenickei	146017	S	2092	2686	4778	0.00035
Mycolicibacterium anyangense	1431246	S	1921	337	2258	0.00016
Mycolicibacterium mengxianglii	2736649	S	1864	215	2079	0.00015
Mycolicibacterium austroafricanum	39687	S	1773	6541	8314	0.00060
Mycolicibacterium helvum	1534349	S	1734	220	1954	0.00014
Mycolicibacterium aichiense	1799	S	1717	316	2033	0.00015
Mycobacterium doricum	126673	S	1681	403	2084	0.00015
Mycolicibacterium alvei	67081	S	1463	418	1881	0.00014
Mycolicibacterium mucogenicum	56689	S	1399	575	1974	0.00014
Mycolicibacterium sarraceniae	1534348	S	1125	153	1278	0.00009
Mycolicibacterium septicum	98668	S	1039	693	1732	0.00013
Mycolicibacterium farcinogenes	1802	S	688	2443	3131	0.00023
Mycolicibacterium vanbaalenii	110539	S	351	5493	5844	0.00042
Mycolicibacterium nivoides	2487344	S	246	1094	1340	0.00010
Mycobacterium sp. JS623	212767	S	2645	238	2883	0.00021
Mycobacterium sp. IDR2000157661	2867005	S	2457	480	2937	0.00021
Mycobacterium sp. YC-RL4	1682113	S	2405	922	3327	0.00024
Mycobacterium sp. DL592	2675524	S	1830	321	2151	0.00016
Mycobacterium sp. MS1601	1936029	S	1798	273	2071	0.00015
Mycobacterium sp. EPa45	1545728	S	1616	290	1906	0.00014
Mycobacterium sp. DL440	2675523	S	1355	322	1677	0.00012
Mycobacterium sp. TY59	2775496	S	1100	193	1293	0.00009
Mycobacterium sp. WY10	1920667	S	252	722	974	0.00007
Mycobacterium sp. 20KCMC460	2903536	S	120	1927	2047	0.00015
Mycobacterium sp. PYR15	2051552	S	94	780	874	0.00006
Mycobacterium sp. MOTT36Y	1168287	S	26	323	349	0.00003
Mycobacterium sp. IWGMT90018-18076	2871094	S	16	460	476	0.00003
Mycobacterium saskatchewanense	220927	S	2412	502	2914	0.00021
Mycobacterium parmense	185642	S	2206	432	2638	0.00019
Mycobacterium kubicae	120959	S	1941	330	2271	0.00016
Mycobacterium simiae	1784	S	1603	150	1753	0.00013
Mycobacterium shigaense	722731	S	1600	245	1845	0.00013
Mycobacterium florentinum	292462	S	1494	352	1846	0.00013
Mycobacterium heidelbergense	53376	S	1444	359	1803	0.00013
Mycobacterium stomatepiae	470076	S	1412	298	1710	0.00012
Mycobacterium lentiflavum	141349	S	1384	344	1728	0.00012
Mycobacterium avium	1764	S	3432	3216	6648	0.00048
Mycobacterium intracellulare	1767	S	1771	15553	17324	0.00125
Mycobacterium mantenii	560555	S	1619	210	1829	0.00013
Mycobacterium colombiense	339268	S	1499	271	1770	0.00013
Mycobacterium marseillense	701042	S	1354	327	1681	0.00012
Mycobacterium paraintracellulare	1138383	S	411	2579	2990	0.00022
Mycobacterium goodii	134601	S	4683	1790	6473	0.00047
Mycobacterium grossiae	1552759	S	3278	1048	4326	0.00031
Mycobacterium rufum	318424	S	2977	937	3914	0.00028
Mycobacterium diernhoferi	1801	S	2800	599	3399	0.00025
Mycobacterium frederiksbergense	117567	S	2761	902	3663	0.00026
Mycobacterium dioxanotrophicus	482462	S	2654	690	3344	0.00024
Mycobacterium canettii	78331	S	1031	858	1889	0.00014
Mycobacterium tuberculosis	1773	S	479	12589	13068	0.00094
Mycobacterium holsaticum	152142	S	2290	386	2676	0.00019
Mycobacterium branderi	43348	S	2227	288	2515	0.00018
Mycobacterium paragordonae	1389713	S	2012	254	2266	0.00016
Mycobacterium conspicuum	44010	S	1986	255	2241	0.00016
Mycobacterium koreense	1069220	S	1904	598	2502	0.00018
Mycobacterium gordonae	1778	S	1714	152	1866	0.00013
Mycobacterium cookii	1775	S	1652	178	1830	0.00013
Mycobacterium heckeshornense	110505	S	1634	134	1768	0.00013
Mycobacterium paraterrae	577492	S	1627	192	1819	0.00013
Mycobacterium riyadhense	486698	S	1581	71	1652	0.00012
Mycobacterium shinjukuense	398694	S	1474	152	1626	0.00012
Mycobacterium noviomagense	459858	S	1459	125	1584	0.00011
Mycobacterium lacus	169765	S	1458	114	1572	0.00011
Mycobacterium ostraviense	2738409	S	1427	145	1572	0.00011
Mycobacterium kansasii	1768	S	1404	141	1545	0.00011
Mycobacterium vicinigordonae	1719132	S	1398	80	1478	0.00011
Mycobacterium paraseoulense	590652	S	1351	279	1630	0.00012
Mycobacterium malmoense	1780	S	1332	219	1551	0.00011
Mycobacterium xenopi	1789	S	1319	160	1479	0.00011
Mycobacterium virginiense	1795032	S	1258	358	1616	0.00012
Mycobacterium seoulense	386911	S	1184	285	1469	0.00011
Mycobacterium basiliense	2094119	S	1123	43	1166	0.00008
Mycobacterium spongiae	886343	S	1056	31	1087	0.00008
Mycobacterium crocinum	388459	S	924	521	1445	0.00010
Mycobacterium haemophilum	29311	S	710	37	747	0.00005
Mycobacterium marinum	1781	S	438	1513	1951	0.00014
Mycobacterium senegalense	1796	S	308	1783	2091	0.00015
Mycobacterium lepromatosis	480418	S	168	4	172	0.00001
Mycobacterium novum	2492438	S	149	2158	2307	0.00017
Mycobacterium leprae	1769	S	142	4	146	0.00001
Mycobacterium ulcerans	1809	S	134	618	752	0.00005
Mycobacterium shottsii	133549	S	92	157	249	0.00002
Mycobacterium pallens	370524	S	68	635	703	0.00005
Mycobacterium pseudoshottsii	265949	S	27	160	187	0.00001
Mycolicibacter sp. MYC340	2855503	S	1200	323	1523	0.00011
Mycolicibacter sp. MYC098	2872309	S	1024	275	1299	0.00009
Mycolicibacter sp. MYC017	2875777	S	777	618	1395	0.00010
Mycolicibacter sp. MYC101	2872311	S	252	982	1234	0.00009
Mycolicibacter sp. MYC123	2855502	S	235	949	1184	0.00009
Mycolicibacter terrae	1788	S	1351	469	1820	0.00013
Mycolicibacter hiberniae	29314	S	1349	320	1669	0.00012
Mycolicibacter minnesotensis	1118379	S	947	184	1131	0.00008
Mycolicibacter sinensis	875328	S	187	2213	2400	0.00017
Mycobacteroides abscessus	36809	S	2270	2025	4295	0.00031
Mycobacteroides chelonae	1774	S	1423	1061	2484	0.00018
Mycobacteroides saopaulense	1578165	S	927	135	1062	0.00008
Mycobacteroides immunogenum	83262	S	869	194	1063	0.00008
Mycobacteroides salmoniphilum	404941	S	783	89	872	0.00006
[Mycobacterium] stephanolepidis	1520670	S	450	135	585	0.00004
Mycolicibacillus parakoreensis	1069221	S	2036	639	2675	0.00019
Hoyosella subflava	639313	S	983	62	1045	0.00008
Rhodococcus sp. X156	2499145	S	3797	1524	5321	0.00038
Rhodococcus sp. MTM3W5.2	1805827	S	3387	940	4327	0.00031
Rhodococcus sp. W8901	2742603	S	2727	830	3557	0.00026
Rhodococcus sp. SGAir0479	2567884	S	2620	885	3505	0.00025
Rhodococcus sp. PBTS 1	1653478	S	2184	659	2843	0.00021
Rhodococcus sp. ABRD24	2507582	S	1785	364	2149	0.00016
Rhodococcus sp. R79	2811421	S	1781	1153	2934	0.00021
Rhodococcus sp. USK10	2789739	S	1458	991	2449	0.00018
Rhodococcus sp. B7740	1564114	S	1198	189	1387	0.00010
Rhodococcus sp. WMMA185	679318	S	1086	161	1247	0.00009
Rhodococcus sp. P1Y	1302308	S	1046	111	1157	0.00008
Rhodococcus sp. WAY2	2663121	S	949	831	1780	0.00013
Rhodococcus sp. RDE2	2885078	S	809	826	1635	0.00012
Rhodococcus sp. USK13	2806442	S	778	550	1328	0.00010
Rhodococcus sp. WB9	2594007	S	546	756	1302	0.00009
Rhodococcus sp. ZPP	2749906	S	458	1257	1715	0.00012
Rhodococcus sp. DMU1	2722825	S	362	1394	1756	0.00013
Rhodococcus sp. S2-17	1990687	S	353	1009	1362	0.00010
Rhodococcus sp. M8	1925550	S	340	1085	1425	0.00010
Rhodococcus sp. 2G	1570939	S	167	703	870	0.00006
Rhodococcus sp. 21391	2683591	S	146	686	832	0.00006
Rhodococcus sp. WB1	1033922	S	140	1231	1371	0.00010
Rhodococcus sp. P-2	2795031	S	122	150	272	0.00002
Rhodococcus sp. YL-1	1045808	S	113	504	617	0.00004
Rhodococcus sp. p52	935199	S	112	622	734	0.00005
Rhodococcus sp. DMF-1	2907624	S	102	832	934	0.00007
Rhodococcus sp. LW-XY12	2856851	S	83	774	857	0.00006
Rhodococcus sp. PSBB049	2812863	S	76	1124	1200	0.00009
Rhodococcus sp. AQ5-07	2054902	S	74	261	335	0.00002
Rhodococcus sp. NJ-530	2490853	S	47	275	322	0.00002
Rhodococcus sp. BH4	1807790	S	42	279	321	0.00002
Rhodococcus sp. 008	1723645	S	42	264	306	0.00002
Rhodococcus sp. H-CA8f	1727214	S	37	164	201	0.00001
Rhodococcus opacus	37919	S	8705	9151	17856	0.00129
Rhodococcus equi	43767	S	4148	1790	5938	0.00043
Rhodococcus fascians	1828	S	3172	787	3959	0.00029
Rhodococcus rhodochrous	1829	S	3096	1924	5020	0.00036
Rhodococcus triatomae	300028	S	2102	694	2796	0.00020
Rhodococcus koreensis	99653	S	2078	658	2736	0.00020
Rhodococcus coprophilus	38310	S	1771	359	2130	0.00015
Rhodococcus jostii	132919	S	1748	763	2511	0.00018
Rhodococcus pyridinivorans	103816	S	1421	5657	7078	0.00051
Rhodococcus ruber	1830	S	1420	4758	6178	0.00045
Rhodococcus qingshengii	334542	S	484	2601	3085	0.00022
Rhodococcus erythropolis	1833	S	478	2126	2604	0.00019
Rhodococcus globerulus	33008	S	984	128	1112	0.00008
Rhodococcus aetherivorans	191292	S	367	3484	3851	0.00028
Nocardia asteroides	1824	S	14980	5688	20668	0.00149
Nocardia brasiliensis	37326	S	8147	2479	10626	0.00077
Nocardia cyriacigeorgica	135487	S	6913	3377	10290	0.00074
Nocardia terpenica	455432	S	5873	1186	7059	0.00051
Nocardia farcinica	37329	S	5772	4211	9983	0.00072
Nocardia gipuzkoensis	2749991	S	4127	1634	5761	0.00042
Nocardia huaxiensis	2755382	S	3635	796	4431	0.00032
Nocardia wallacei	480035	S	3574	1116	4690	0.00034
Nocardia arthritidis	228602	S	3569	505	4074	0.00029
Nocardia otitidiscaviarum	1823	S	3288	731	4019	0.00029
Nocardia sp. CS682	1047172	S	3053	807	3860	0.00028
Nocardia iowensis	204891	S	2928	697	3625	0.00026
Nocardia yamanashiensis	209247	S	2910	646	3556	0.00026
Nocardia tengchongensis	2055889	S	2827	781	3608	0.00026
Nocardia yunnanensis	2382165	S	2811	753	3564	0.00026
Nocardia nova	37330	S	2748	438	3186	0.00023
Nocardia seriolae	37332	S	2708	802	3510	0.00025
Nocardia mangyaensis	2213200	S	2615	774	3389	0.00024
Corynebacterium cyclohexanicum	322009	S	2813	1230	4043	0.00029
Corynebacterium sphenisci	191493	S	1931	625	2556	0.00018
Corynebacterium frankenforstense	1230998	S	1910	613	2523	0.00018
Corynebacterium bovis	36808	S	1687	408	2095	0.00015
Corynebacterium xerosis	1725	S	1660	982	2642	0.00019
Corynebacterium halotolerans	225326	S	1424	350	1774	0.00013
Corynebacterium nuruki	1032851	S	1361	342	1703	0.00012
Corynebacterium freneyi	134034	S	1289	535	1824	0.00013
Corynebacterium vitaeruminis	38305	S	1122	354	1476	0.00011
Corynebacterium sp. CNCTC7651	2815361	S	490	100	590	0.00004
Corynebacterium sp. NML98-0116	702967	S	344	132	476	0.00003
Corynebacterium sp. 4H37-19	2684405	S	92	10	102	0.00001
Corynebacterium sp. 1864	2820399	S	85	186	271	0.00002
Corynebacterium sp. FDAARGOS 1242	2778078	S	69	186	255	0.00002
Corynebacterium sp. sy039	2599641	S	27	3	30	0.00000
Corynebacterium humireducens	1223514	S	1100	339	1439	0.00010
Corynebacterium maris	575200	S	1080	185	1265	0.00009
Corynebacterium variabile	1727	S	1020	629	1649	0.00012
Corynebacterium marinum	349751	S	970	390	1360	0.00010
Corynebacterium doosanense	1121358	S	890	447	1337	0.00010
Corynebacterium timonense	441500	S	822	209	1031	0.00007
Corynebacterium uterequi	1072256	S	800	144	944	0.00007
Corynebacterium provencense	1737425	S	796	193	989	0.00007
Corynebacterium mycetoides	38302	S	787	398	1185	0.00009
Corynebacterium yudongzhengii	2080740	S	764	152	916	0.00007
Corynebacterium liangguodongii	2079535	S	757	179	936	0.00007
Corynebacterium jeikeium	38289	S	712	1855	2567	0.00019
Corynebacterium comes	2675218	S	702	186	888	0.00006
Corynebacterium terpenotabidum	89154	S	644	194	838	0.00006
Corynebacterium glyciniphilum	1404244	S	640	85	725	0.00005
Corynebacterium atypicum	191610	S	610	192	802	0.00006
Corynebacterium uberis	2883169	S	609	79	688	0.00005
Corynebacterium urealyticum	43771	S	608	759	1367	0.00010
Corynebacterium sanguinis	2594913	S	573	409	982	0.00007
Corynebacterium imitans	156978	S	572	367	939	0.00007
Corynebacterium ureicelerivorans	401472	S	561	196	757	0.00005
Corynebacterium lujinxingii	2763010	S	561	202	763	0.00006
Corynebacterium falsenii	108486	S	546	245	791	0.00006
Corynebacterium glaucum	187491	S	491	112	603	0.00004
Corynebacterium qintianiae	2709392	S	486	143	629	0.00005
Corynebacterium efficiens	152794	S	474	93	567	0.00004
Corynebacterium testudinoris	136857	S	461	100	561	0.00004
Corynebacterium genitalium	38288	S	440	103	543	0.00004
Corynebacterium coyleae	53374	S	434	117	551	0.00004
Corynebacterium glucuronolyticum	39791	S	424	106	530	0.00004
Corynebacterium aurimucosum	169292	S	423	208	631	0.00005
Corynebacterium kroppenstedtii	161879	S	401	43	444	0.00003
Corynebacterium tuberculostearicum	38304	S	384	246	630	0.00005
Corynebacterium incognita	2754725	S	379	92	471	0.00003
Corynebacterium striatum	43770	S	371	331	702	0.00005
Corynebacterium lactis	1231000	S	359	60	419	0.00003
Corynebacterium occultum	2675219	S	340	63	403	0.00003
Corynebacterium matruchotii	43768	S	320	24	344	0.00002
Corynebacterium aquilae	203263	S	282	46	328	0.00002
Corynebacterium endometrii	2488819	S	280	57	337	0.00002
Corynebacterium renale	1724	S	279	35	314	0.00002
Corynebacterium zhongnanshanii	2768834	S	271	40	311	0.00002
Corynebacterium riegelii	156976	S	268	73	341	0.00002
Corynebacterium flavescens	28028	S	266	81	347	0.00003
Corynebacterium kalinowskii	2675216	S	262	135	397	0.00003
Corynebacterium lizhenjunii	2709394	S	242	44	286	0.00002
Corynebacterium urogenitale	2487892	S	236	46	282	0.00002
Corynebacterium camporealensis	161896	S	227	61	288	0.00002
Corynebacterium simulans	146827	S	212	171	383	0.00003
Corynebacterium minutissimum	38301	S	212	227	439	0.00003
Corynebacterium singulare	161899	S	209	188	397	0.00003
Corynebacterium cystitidis	35757	S	208	14	222	0.00002
Corynebacterium epidermidicanis	1050174	S	193	35	228	0.00002
Corynebacterium stationis	1705	S	187	51	238	0.00002
Corynebacterium argentoratense	42817	S	174	40	214	0.00002
Corynebacterium casei	160386	S	171	220	391	0.00003
Corynebacterium propinquum	43769	S	169	77	246	0.00002
Corynebacterium gerontici	2079234	S	169	36	205	0.00001
Corynebacterium macginleyi	38290	S	157	40	197	0.00001
Corynebacterium diphtheriae	1717	S	149	222	371	0.00003
Corynebacterium pseudopelargi	2080757	S	148	56	204	0.00001
Corynebacterium phocae	161895	S	141	20	161	0.00001
Corynebacterium pelargi	1471400	S	138	49	187	0.00001
Corynebacterium choanae	1862358	S	136	15	151	0.00001
Corynebacterium pseudodiphtheriticum	37637	S	126	44	170	0.00001
Corynebacterium resistens	258224	S	120	73	193	0.00001
Corynebacterium kefirresidentii	1979527	S	118	84	202	0.00001
Corynebacterium glutamicum	1718	S	108	1584	1692	0.00012
Corynebacterium deserti	1408191	S	101	39	140	0.00001
Corynebacterium hindlerae	699041	S	96	199	295	0.00002
Corynebacterium ammoniagenes	1697	S	94	22	116	0.00001
Corynebacterium ulcerans	65058	S	89	33	122	0.00001
Corynebacterium segmentosum	43990	S	84	216	300	0.00002
Corynebacterium anserum	2684406	S	82	10	92	0.00001
Corynebacterium pseudotuberculosis	1719	S	79	19	98	0.00001
Corynebacterium callunae	1721	S	75	27	102	0.00001
Corynebacterium mustelae	571915	S	72	6	78	0.00001
Corynebacterium accolens	38284	S	70	179	249	0.00002
Corynebacterium amycolatum	43765	S	67	534	601	0.00004
Corynebacterium suranareeae	2506452	S	65	20	85	0.00001
Corynebacterium silvaticum	2320431	S	61	27	88	0.00001
Corynebacterium rouxii	2719119	S	48	30	78	0.00001
Corynebacterium crudilactis	1652495	S	44	53	97	0.00001
Corynebacterium kutscheri	35755	S	25	4	29	0.00000
Gordonia sp. PP30	2935861	S	2245	710	2955	0.00021
Gordonia sp. YC-JH1	2059875	S	1694	1354	3048	0.00022
Gordonia sp. KTR9	337191	S	1522	350	1872	0.00014
Gordonia sp. PDNC005	2811424	S	1266	215	1481	0.00011
Gordonia sp. WA4-43	2878678	S	333	1240	1573	0.00011
Gordonia sp. JH63	2698900	S	223	774	997	0.00007
Gordonia sp. 135	2676309	S	137	977	1114	0.00008
Gordonia sp. 1D	1737359	S	66	1055	1121	0.00008
Gordonia polyisoprenivorans	84595	S	3494	790	4284	0.00031
Gordonia terrae	2055	S	2644	1649	4293	0.00031
Gordonia insulae	2420509	S	2151	345	2496	0.00018
Gordonia amarae	36821	S	1976	451	2427	0.00018
Gordonia phthalatica	1136941	S	1863	848	2711	0.00020
Gordonia bronchialis	2054	S	1839	491	2330	0.00017
Gordonia iterans	1004901	S	1832	709	2541	0.00018
Gordonia jinghuaiqii	2758710	S	1702	379	2081	0.00015
Gordonia pseudoamarae	2831662	S	1554	335	1889	0.00014
Gordonia rubripertincta	36822	S	1443	939	2382	0.00017
Gordonia otitidis	249058	S	1308	246	1554	0.00011
Gordonia zhaorongruii	2597659	S	1155	238	1393	0.00010
Gordonia alkanivorans	84096	S	397	1569	1966	0.00014
Gordonia hongkongensis	1701090	S	279	933	1212	0.00009
Gordonia amicalis	89053	S	249	1920	2169	0.00016
Skermania piniformis	39122	S	2135	314	2449	0.00018
Tsukamurella paurometabola	2061	S	3678	2061	5739	0.00041
Tsukamurella tyrosinosolvens	57704	S	3068	1551	4619	0.00033
Tsukamurella sp. PLM1	2929795	S	2181	814	2995	0.00022
Tsukamurella pulmonis	47312	S	2007	821	2828	0.00020
Dietzia sp. oral taxon 368	712270	S	1239	2641	3880	0.00028
Dietzia lutea	546160	S	1599	1047	2646	0.00019
Dietzia psychralcaliphila	139021	S	1547	509	2056	0.00015
Dietzia timorensis	499555	S	1036	664	1700	0.00012
Tomitella gaofuii	2760083	S	2334	812	3146	0.00023
Tomitella fengzijianii	2597660	S	2044	767	2811	0.00020
Segniliparus rotundus	286802	S	1154	77	1231	0.00009
Lawsonella clevelandensis	1528099	S	222	29	251	0.00002
Amycolatopsis sp. YIM 10	2653857	S	19247	6120	25367	0.00183
Amycolatopsis sp. DSM 110486	2865832	S	9381	2127	11508	0.00083
Amycolatopsis sp. WQ 127309	2932773	S	9161	2814	11975	0.00087
Amycolatopsis sp. FDAARGOS 1241	2778070	S	8749	2167	10916	0.00079
Amycolatopsis sp. Hca4	2742131	S	8009	3113	11122	0.00080
Amycolatopsis sp. CA-230715	2745196	S	7882	1398	9280	0.00067
Amycolatopsis sp. BJA-103	1911175	S	4832	1997	6829	0.00049
Amycolatopsis sp. FU40	2914159	S	4495	2166	6661	0.00048
Amycolatopsis sp. AA4	1896961	S	3946	2215	6161	0.00045
Amycolatopsis sp. TNS106	2861750	S	3713	2206	5919	0.00043
Amycolatopsis sp. EV170708-02-1	2919322	S	2847	2708	5555	0.00040
Amycolatopsis albispora	1804986	S	18076	11506	29582	0.00214
Amycolatopsis acidiphila	715473	S	9672	2394	12066	0.00087
Amycolatopsis mediterranei	33910	S	7794	12503	20297	0.00147
Amycolatopsis keratiniphila	129921	S	4279	3456	7735	0.00056
Amycolatopsis japonica	208439	S	2356	2170	4526	0.00033
Amycolatopsis methanolica	1814	S	7479	3197	10676	0.00077
Amycolatopsis pretoriensis	218821	S	7317	2501	9818	0.00071
Amycolatopsis thermalba	944492	S	7197	3271	10468	0.00076
Amycolatopsis aidingensis	2842453	S	6416	885	7301	0.00053
Amycolatopsis orientalis	31958	S	5620	1937	7557	0.00055
Pseudonocardia sp. DSM 110487	2865833	S	37006	6220	43226	0.00312
Pseudonocardia sp. CGMCC 4.1532	2761535	S	8005	5123	13128	0.00095
Pseudonocardia sp. HH130630-07	1690815	S	6327	2130	8457	0.00061
Pseudonocardia sp. AL041005-10	445576	S	4987	2078	7065	0.00051
Pseudonocardia sp. HH130629-09	1641402	S	4044	1908	5952	0.00043
Pseudonocardia sp. EC080625-04	1096868	S	154	3839	3993	0.00029
Pseudonocardia sp. EC080619-01	1096856	S	23	5268	5291	0.00038
Pseudonocardia sp. EC080610-09	1688404	S	17	1324	1341	0.00010
Pseudonocardia broussonetiae	2736640	S	12174	4665	16839	0.00122
Pseudonocardia dioxanivorans	240495	S	11707	3730	15437	0.00112
Pseudonocardia autotrophica	2074	S	7122	2276	9398	0.00068
Pseudonocardia abyssalis	2792008	S	6639	3819	10458	0.00076
Saccharopolyspora erythraea	1836	S	23806	10054	33860	0.00245
Saccharopolyspora gregorii	33914	S	7338	1743	9081	0.00066
Saccharopolyspora spinosa	60894	S	4366	3055	7421	0.00054
Saccharopolyspora pogona	333966	S	3656	4665	8321	0.00060
Saccharopolyspora sp. ASAGF58	2719023	S	2492	3526	6018	0.00043
Saccharothrix syringae	103733	S	11449	4601	16050	0.00116
Saccharothrix sp. 6-C	2781735	S	10136	3977	14113	0.00102
Saccharothrix espanaensis	103731	S	9625	3277	12902	0.00093
Lentzea guizhouensis	1586287	S	23643	5800	29443	0.00213
Saccharomonospora marina	632569	S	5134	1342	6476	0.00047
Saccharomonospora cyanea	40989	S	3848	1589	5437	0.00039
Saccharomonospora azurea	40988	S	3215	1125	4340	0.00031
Saccharomonospora xinjiangensis	75294	S	2582	507	3089	0.00022
Saccharomonospora viridis	1852	S	2379	433	2812	0.00020
Saccharomonospora glauca	40990	S	2180	920	3100	0.00022
Allokutzneria albata	211114	S	18519	5234	23753	0.00172
Kutzneria sp. CA-103260	2802641	S	10248	2604	12852	0.00093
Kutzneria albida	43357	S	7949	2162	10111	0.00073
Actinoalloteichus hoggarensis	1470176	S	3667	589	4256	0.00031
Actinoalloteichus hymeniacidonis	340345	S	2797	319	3116	0.00023
Actinoalloteichus sp. GBA129-24	1612551	S	180	2381	2561	0.00019
Actinoalloteichus fjordicus	1612552	S	119	1901	2020	0.00015
Actinosynnema pretiosum	42197	S	3200	7123	10323	0.00075
Actinosynnema mirum	40567	S	297	2983	3280	0.00024
Kibdelosporangium phytohabitans	860235	S	9506	1344	10850	0.00078
Alloactinosynnema sp. L-07	1653480	S	6893	1790	8683	0.00063
Prauserella marina	530584	S	4239	442	4681	0.00034
Allosaccharopolyspora coralli	2665642	S	3790	944	4734	0.00034
Nocardioides sp. G188	2849501	S	13071	5033	18104	0.00131
Nocardioides sp. JS614	196162	S	10098	3651	13749	0.00099
Nocardioides sp. LMS-CY	2840457	S	8756	3516	12272	0.00089
Nocardioides sp. zg-1228	2763008	S	8369	4467	12836	0.00093
Nocardioides sp. S5	2017486	S	8293	5020	13313	0.00096
Nocardioides sp. TF02-7	2917724	S	8227	3321	11548	0.00083
Nocardioides sp. HDW12B	2714939	S	7413	3053	10466	0.00076
Nocardioides sp. W7	2931390	S	7010	2892	9902	0.00072
Nocardioides sp. SCSIO 67246	2872154	S	6220	2034	8254	0.00060
Nocardioides sp. cx-173	2898796	S	6025	2526	8551	0.00062
Nocardioides sp. zg-579	2663857	S	5925	3643	9568	0.00069
Nocardioides sp. S-1144	2582905	S	5905	2794	8699	0.00063
Nocardioides sp. InS609-2	2760705	S	5411	1537	6948	0.00050
Nocardioides sp. 603	2483798	S	5330	3005	8335	0.00060
Nocardioides sp. MC1495	2736757	S	5153	2254	7407	0.00054
Nocardioides sp. CF8	110319	S	4969	2480	7449	0.00054
Nocardioides sp. JQ2195	2592334	S	4470	1161	5631	0.00041
Nocardioides sp. zg-536	2803858	S	4354	2323	6677	0.00048
Nocardioides sp. WS12	2486272	S	3863	842	4705	0.00034
Nocardioides sp. dk884	2662361	S	3650	4324	7974	0.00058
Nocardioides sp. ZJ1313	2685869	S	3488	4158	7646	0.00055
Nocardioides sp. Kera G14	2884264	S	3408	893	4301	0.00031
Nocardioides mesophilus	433659	S	12138	4631	16769	0.00121
Nocardioides ungokensis	1643322	S	7788	3384	11172	0.00081
Nocardioides okcheonensis	2894081	S	7631	4310	11941	0.00086
Nocardioides anomalus	2712223	S	7481	2826	10307	0.00074
Nocardioides humi	449461	S	6676	2747	9423	0.00068
Nocardioides euryhalodurans	2518370	S	6460	2465	8925	0.00064
Nocardioides cynanchi	2558918	S	6156	1830	7986	0.00058
Nocardioides aromaticivorans	200618	S	6153	2896	9049	0.00065
Nocardioides dongkuii	2760089	S	5753	3508	9261	0.00067
Nocardioides rotundus	1774216	S	5465	2655	8120	0.00059
Nocardioides aquaticus	160826	S	5234	2000	7234	0.00052
Nocardioides marinisabuli	419476	S	5063	3449	8512	0.00062
Nocardioides sambongensis	2589074	S	4827	1739	6566	0.00047
Nocardioides seonyuensis	2518371	S	4758	1581	6339	0.00046
Nocardioides dokdonensis	450734	S	4531	2570	7101	0.00051
Nocardioides panacisoli	627624	S	4265	1326	5591	0.00040
Nocardioides houyundeii	2045452	S	4085	1556	5641	0.00041
Nocardioides piscis	2714938	S	3925	1799	5724	0.00041
Nocardioides daphniae	402297	S	3124	1769	4893	0.00035
Nocardioides jishulii	2575440	S	2817	1269	4086	0.00030
Nocardioides yefusunii	2500546	S	2021	743	2764	0.00020
Nocardioides baekrokdamisoli	1804624	S	1978	315	2293	0.00017
Aeromicrobium sp. Leaf245	1736306	S	3364	1308	4672	0.00034
Aeromicrobium sp. zg-629	2663859	S	2870	1185	4055	0.00029
Aeromicrobium sp. A1-2	2107713	S	2584	461	3045	0.00022
Aeromicrobium erythreum	2041	S	3585	1354	4939	0.00036
Aeromicrobium choanae	1736691	S	3464	1311	4775	0.00035
Aeromicrobium chenweiae	2079793	S	3373	1428	4801	0.00035
Aeromicrobium marinum	219314	S	3171	882	4053	0.00029
Aeromicrobium yanjiei	2662028	S	3063	1201	4264	0.00031
Friedmanniella luteola	546871	S	7085	1880	8965	0.00065
Pimelobacter simplex	2045	S	5815	2799	8614	0.00062
Marmoricola scoriae	642780	S	5287	2573	7860	0.00057
Mumia sp. ZJ1417	2708082	S	4813	1079	5892	0.00043
Micropruina glycogenica	75385	S	2656	506	3162	0.00023
Microlunatus sagamiharensis	546874	S	5977	1832	7809	0.00056
Microlunatus phosphovorus	29405	S	4526	708	5234	0.00038
Microlunatus soli	630515	S	3862	526	4388	0.00032
Microlunatus elymi	2596828	S	3644	561	4205	0.00030
Microlunatus sp. Gsoil 973	2672569	S	3301	359	3660	0.00026
Tessaracoccus sp. J1M15	2829499	S	2126	760	2886	0.00021
Tessaracoccus sp. MC1865	2760310	S	1669	511	2180	0.00016
Tessaracoccus defluvii	1285901	S	2291	1699	3990	0.00029
Tessaracoccus aquimaris	1332264	S	2234	1255	3489	0.00025
Tessaracoccus flavescens	399497	S	1912	1712	3624	0.00026
Tessaracoccus flavus	1610493	S	1758	1390	3148	0.00023
Tessaracoccus timonensis	2161816	S	1087	546	1633	0.00012
Brevilactibacter coleopterorum	2714937	S	3567	2028	5595	0.00040
Brevilactibacter sp. MC1595	2819349	S	3041	1507	4548	0.00033
Acidipropionibacterium jensenii	1749	S	2153	1691	3844	0.00028
Acidipropionibacterium acidipropionici	1748	S	2010	1419	3429	0.00025
Acidipropionibacterium virtanenii	2057246	S	1430	343	1773	0.00013
Propionibacterium acidifaciens	556499	S	2217	617	2834	0.00020
Propionibacterium freudenreichii	1744	S	1692	1615	3307	0.00024
Propionibacterium australiense	119981	S	1507	314	1821	0.00013
Auraticoccus monumenti	675864	S	4438	1049	5487	0.00040
Cutibacterium avidum	33010	S	1286	472	1758	0.00013
Cutibacterium granulosum	33011	S	705	178	883	0.00006
Cutibacterium acnes	1747	S	540	370	910	0.00007
Cutibacterium modestum	2559073	S	292	51	343	0.00002
Raineyella fluvialis	2662261	S	2768	473	3241	0.00023
Arachnia propionica	1750	S	1560	218	1778	0.00013
Arachnia rubra	1547448	S	1056	135	1191	0.00009
Vaginimicrobium propionicum	1871034	S	110	51	161	0.00001
Kribbella flavida	182640	S	21543	6115	27658	0.00200
Kribbella qitaiheensis	1544730	S	15212	2884	18096	0.00131
Actinopolymorpha singaporensis	117157	S	8365	1207	9572	0.00069
Nonomuraea gerenzanensis	93944	S	23193	8782	31975	0.00231
Nonomuraea nitratireducens	2656914	S	19471	5004	24475	0.00177
Nonomuraea sp. ATCC 55076	1909395	S	17378	6309	23687	0.00171
Nonomuraea coxensis	404386	S	16208	5648	21856	0.00158
Streptosporangium roseum	2001	S	13198	4370	17568	0.00127
Streptosporangium sp. 'caverna'	2202249	S	12348	3221	15569	0.00112
Thermobispora bispora	2006	S	7008	1984	8992	0.00065
Actinomadura sp. WMMB 499	1219491	S	16275	4844	21119	0.00153
Actinomadura sp. NAK00032	2742128	S	10794	4749	15543	0.00112
Actinomadura sp. WMMA1423	2591108	S	10017	3707	13724	0.00099
Actinomadura madurae	1993	S	16814	6300	23114	0.00167
Actinomadura verrucosospora	46165	S	11484	4361	15845	0.00114
Actinomadura graeca	2750812	S	9363	2709	12072	0.00087
Thermomonospora amylolytica	1411117	S	9831	4509	14340	0.00104
Thermomonospora curvata	2020	S	6170	2217	8387	0.00061
Nocardiopsis dassonvillei	2014	S	10332	7465	17797	0.00129
Nocardiopsis sp. MT53	2865672	S	5846	1638	7484	0.00054
Nocardiopsis sp. HDS12	2831968	S	2169	1424	3593	0.00026
Nocardiopsis gilva	280236	S	4521	1100	5621	0.00041
Nocardiopsis alba	53437	S	3643	782	4425	0.00032
Thermobifida halotolerans	483545	S	3482	1357	4839	0.00035
Thermobifida alba	53522	S	3313	1580	4893	0.00035
Thermobifida fusca	2021	S	1912	397	2309	0.00017
Streptomonospora litoralis	2498135	S	4862	1144	6006	0.00043
Spiractinospora alimapuensis	2820884	S	3217	260	3477	0.00025
Blastococcus sp. PRF04-17	2933797	S	14678	6026	20704	0.00150
Blastococcus saxobsidens	138336	S	11985	4391	16376	0.00118
Modestobacter marinus	477641	S	12681	5227	17908	0.00129
Modestobacter sp. L9-4	2851567	S	7055	3212	10267	0.00074
Geodermatophilus obscurus	1861	S	17724	7136	24860	0.00180
Jiangella sp. DSM 45060	1798224	S	19205	6943	26148	0.00189
Jiangella alkaliphila	419479	S	17188	5964	23152	0.00167
Frankia inefficax	298654	S	11293	1644	12937	0.00093
Frankia sp. QA3	710111	S	4394	2180	6574	0.00048
Frankia sp. ArI3	1858	S	3184	2488	5672	0.00041
Candidatus Frankia datiscae	2716812	S	5131	851	5982	0.00043
Frankia casuarinae	106370	S	4340	566	4906	0.00035
Frankia alni	1859	S	3649	2997	6646	0.00048
Actinomyces sp. oral taxon 414	712122	S	1517	369	1886	0.00014
Actinomyces sp. MAS-1	2755559	S	1176	271	1447	0.00010
Actinomyces sp. Z16	2079536	S	958	372	1330	0.00010
Actinomyces sp. Chiba101	1851395	S	777	403	1180	0.00009
Actinomyces sp. 432	2057798	S	711	178	889	0.00006
Actinomyces sp. oral taxon 171	706438	S	372	320	692	0.00005
Actinomyces sp. oral taxon 169	712116	S	228	432	660	0.00005
Actinomyces sp. HMT897	2789424	S	205	585	790	0.00006
Actinomyces sp. oral taxon 897	2081702	S	184	536	720	0.00005
Actinomyces sp. HMT 175	2789425	S	158	676	834	0.00006
Actinomyces sp. zg-332	2708340	S	17	3	20	0.00000
Actinomyces radicidentis	111015	S	1807	900	2707	0.00020
Actinomyces howellii	52771	S	1605	298	1903	0.00014
Actinomyces slackii	52774	S	1094	216	1310	0.00009
Actinomyces respiraculi	2744574	S	1047	296	1343	0.00010
Actinomyces procaprae	2560010	S	953	383	1336	0.00010
Actinomyces weissii	675090	S	854	198	1052	0.00008
Actinomyces faecalis	2722820	S	835	142	977	0.00007
Actinomyces qiguomingii	2057800	S	701	110	811	0.00006
Actinomyces viscosus	1656	S	681	314	995	0.00007
Actinomyces naeslundii	1655	S	609	383	992	0.00007
Actinomyces wuliandei	2057743	S	552	162	714	0.00005
Actinomyces oris	544580	S	503	1505	2008	0.00015
Actinomyces marmotae	2737173	S	487	298	785	0.00006
Actinomyces gaoshouyii	1960083	S	469	266	735	0.00005
Actinomyces lilanjuaniae	2321394	S	433	116	549	0.00004
Actinomyces trachealis	2763540	S	359	78	437	0.00003
Actinomyces pacaensis	1852377	S	107	16	123	0.00001
Schaalia sp. 19OD2882	2794089	S	738	128	866	0.00006
Schaalia sp. JY-X169	2758572	S	240	10	250	0.00002
Schaalia sp. ZJ405	2709403	S	208	25	233	0.00002
Schaalia odontolytica	1660	S	934	275	1209	0.00009
Schaalia meyeri	52773	S	560	128	688	0.00005
Schaalia cardiffensis	181487	S	329	61	390	0.00003
Schaalia turicensis	131111	S	158	189	347	0.00003
Flaviflexus salsibiostraticola	1282737	S	990	316	1306	0.00009
Flaviflexus sp. dk850	2758573	S	470	201	671	0.00005
Flaviflexus ciconiae	2496867	S	459	70	529	0.00004
Trueperella pecoris	2733571	S	690	242	932	0.00007
Trueperella pyogenes	1661	S	544	382	926	0.00007
Trueperella bialowiezensis	312285	S	347	22	369	0.00003
Pauljensenia hongkongensis	178339	S	867	383	1250	0.00009
Nanchangia anserum	2692125	S	830	111	941	0.00007
Actinobaculum sp. 313	2495645	S	383	26	409	0.00003
Actinotignum schaalii	59505	S	278	22	300	0.00002
Arcanobacterium haemolyticum	28264	S	63	36	99	0.00001
Arcanobacterium phocae	131112	S	54	26	80	0.00001
Arcanobacterium sp. 2701	2722751	S	40	16	56	0.00000
Arcanobacterium phocisimile	1302235	S	38	18	56	0.00000
Changpingibacter yushuensis	2758440	S	209	74	283	0.00002
Mobiluncus curtisii	2051	S	155	54	209	0.00002
Varibaculum sp. EMRHCC_39	2811781	S	91	33	124	0.00001
Boudabousia tangfeifanii	1912795	S	66	6	72	0.00001
Fannyhessea vaginae	82135	S	39	14	53	0.00000
Nakamurella multipartita	53461	S	6531	1523	8054	0.00058
Nakamurella panacisegetis	1090615	S	3436	602	4038	0.00029
Nakamurella sp. PAMC28650	2762325	S	2910	393	3303	0.00024
Nakamurella antarctica	1902245	S	604	55	659	0.00005
Bifidobacterium pseudolongum	1694	S	979	430	1409	0.00010
Bifidobacterium choerinum	35760	S	953	482	1435	0.00010
Bifidobacterium scardovii	158787	S	940	106	1046	0.00008
Bifidobacterium longum	216816	S	914	2119	3033	0.00022
Bifidobacterium bifidum	1681	S	675	326	1001	0.00007
Bifidobacterium pullorum	78448	S	632	291	923	0.00007
Bifidobacterium animalis	28025	S	626	1047	1673	0.00012
Bifidobacterium asteroides	1684	S	552	19	571	0.00004
Bifidobacterium subtile	77635	S	514	92	606	0.00004
Bifidobacterium adolescentis	1680	S	453	121	574	0.00004
Bifidobacterium actinocoloniiforme	638619	S	396	16	412	0.00003
Bifidobacterium lemurum	1603886	S	382	104	486	0.00004
Bifidobacterium breve	1685	S	364	448	812	0.00006
Bifidobacterium eulemuris	1765219	S	359	94	453	0.00003
Bifidobacterium thermophilum	33905	S	359	94	453	0.00003
Bifidobacterium dentium	1689	S	272	24	296	0.00002
Bifidobacterium angulatum	1683	S	225	73	298	0.00002
Bifidobacterium pseudocatenulatum	28026	S	169	112	281	0.00002
Bifidobacterium catenulatum	1686	S	152	282	434	0.00003
Bifidobacterium saguini	762210	S	76	42	118	0.00001
Bifidobacterium imperatoris	2020965	S	74	45	119	0.00001
Bifidobacterium indicum	1691	S	42	62	104	0.00001
Bifidobacterium coryneforme	1687	S	30	44	74	0.00001
Parascardovia denticolens	78258	S	277	61	338	0.00002
Gardnerella vaginalis	2702	S	21	42	63	0.00000
Scardovia inopinata	78259	S	42	19	61	0.00000
Catenulispora acidiphila	304895	S	7537	1353	8890	0.00064
Stackebrandtia nassauensis	283811	S	5363	600	5963	0.00043
Natronoglycomyces albus	2811108	S	901	38	939	0.00007
Jatrophihabitans sp. GAS493	1907575	S	3086	360	3446	0.00025
Jatrophihabitans telluris	2038343	S	2984	328	3312	0.00024
Kineococcus radiotolerans	131568	S	4517	1536	6053	0.00044
Actinopolyspora erythraea	414996	S	2935	368	3303	0.00024
Epidermidibacterium keratini	1891644	S	2613	1573	4186	0.00030
Acidothermus cellulolyticus	28049	S	2190	131	2321	0.00017
Candidatus Planktophila lacus	1884913	S	92	14	106	0.00001
Candidatus Planktophila versatilis	1884905	S	63	15	78	0.00001
Candidatus Planktophila sulfonica	1884904	S	55	21	76	0.00001
Candidatus Planktophila dulcis	1884914	S	35	20	55	0.00000
Candidatus Planktophila vernalis	1884907	S	30	5	35	0.00000
Candidatus Planktophila limnetica	573600	S	29	4	33	0.00000
Candidatus Nanopelagicus abundans	1884916	S	26	12	38	0.00000
Candidatus Nanopelagicus hibericus	1884915	S	17	10	27	0.00000
Candidatus Nanopelagicus limnes	1884634	S	14	18	32	0.00000
Rubrobacter xylanophilus	49319	S	41333	6078	47411	0.00343
Rubrobacter tropicus	2653851	S	33540	2763	36303	0.00262
Rubrobacter marinus	2653852	S	25997	2565	28562	0.00206
Rubrobacter radiotolerans	42256	S	8862	1290	10152	0.00073
Rubrobacter indicoceani	2051957	S	4875	426	5301	0.00038
Baekduia soli	496014	S	26022	5123	31145	0.00225
Conexibacter sp. SYSU D00693	2812560	S	31555	8985	40540	0.00293
Conexibacter sp. S30A1	2937800	S	10653	1343	11996	0.00087
Conexibacter sp. DBS9H8	2937801	S	10488	1197	11685	0.00084
Conexibacter woesei	191495	S	43737	9098	52835	0.00382
Miltoncostaea marina	2843215	S	17957	5139	23096	0.00167
Miltoncostaea oceani	2843216	S	15731	2682	18413	0.00133
Aquihabitans sp. G128	2849779	S	22319	5187	27506	0.00199
Aquihabitans sp. Kera 3	2884263	S	20039	3755	23794	0.00172
Iamia sp. SCSIO 61187	2722752	S	25675	4715	30390	0.00220
Actinomarinicola tropica	2789776	S	22766	5146	27912	0.00202
Ilumatobacter coccineus	467094	S	6702	465	7167	0.00052
Acidimicrobium ferrooxidans	53635	S	2614	227	2841	0.00021
Egicoccus halophilus	1670830	S	6691	1255	7946	0.00057
Euzebya pacifica	1608957	S	6682	694	7376	0.00053
Egibacter rhizosphaerae	1670831	S	6571	480	7051	0.00051
Eggerthella lenta	84112	S	1038	841	1879	0.00014
Eggerthella guodeyinii	2690837	S	928	491	1419	0.00010
Eggerthella sp. YY7918	502558	S	187	93	280	0.00002
Gordonibacter urolithinfaciens	1335613	S	543	457	1000	0.00007
Gordonibacter pamelaeae	471189	S	523	606	1129	0.00008
Arabiibacter massiliensis	1870985	S	1230	292	1522	0.00011
Adlercreutzia equolifaciens	446660	S	508	328	836	0.00006
Adlercreutzia hattorii	2707299	S	284	378	662	0.00005
Berryella intestinalis	1531429	S	587	769	1356	0.00010
Raoultibacter timonensis	1907662	S	579	55	634	0.00005
Slackia heliotrinireducens	84110	S	426	15	441	0.00003
Denitrobacterium detoxificans	79604	S	259	127	386	0.00003
Phoenicibacter congonensis	1944646	S	99	51	150	0.00001
Cryptobacterium curtum	84163	S	46	6	52	0.00000
Olsenella timonensis	1805478	S	1112	413	1525	0.00011
Olsenella uli	133926	S	556	76	632	0.00005
Olsenella sp. oral taxon 807	712411	S	432	33	465	0.00003
Parolsenella massiliensis	1871022	S	548	423	971	0.00007
Parolsenella catena	2003188	S	507	427	934	0.00007
Thermophilibacter immobilis	2779519	S	743	352	1095	0.00008
Parafannyhessea umbonata	604330	S	676	480	1156	0.00008
Atopobium sp. oral taxon 416	712157	S	221	28	249	0.00002
Lancefieldella parvula	1382	S	36	4	40	0.00000
Collinsella aerofaciens	74426	S	1001	612	1613	0.00012
Collinsella stercoris	147206	S	685	116	801	0.00006
Collinsella sp. zg1085	2844380	S	46	2	48	0.00000
Coriobacterium glomerans	33871	S	517	20	537	0.00004
Bacillus altitudinis	293387	S	5581	27624	33205	0.00240
Bacillus aerophilus	293389	S	15	296	311	0.00002
Bacillus siamensis	659243	S	728	2751	3479	0.00025
Bacillus velezensis	492670	S	613	12735	13348	0.00096
Bacillus amyloliquefaciens	1390	S	144	5507	5651	0.00041
Bacillus subtilis	1423	S	1904	52360	54264	0.00392
Bacillus paralicheniformis	1648923	S	721	551	1272	0.00009
Bacillus mojavensis	72360	S	68	95	163	0.00001
Bacillus halotolerans	260554	S	22	68	90	0.00001
Bacillus tequilensis	227866	S	83	88	171	0.00001
Bacillus vallismortis	72361	S	70	101	171	0.00001
Bacillus atrophaeus	1452	S	62	2150	2212	0.00016
Bacillus licheniformis	1402	S	30	345	375	0.00003
Bacillus spizizenii	96241	S	27	103	130	0.00001
Bacillus inaquosorum	483913	S	17	158	175	0.00001
Bacillus sp. Y1	352858	S	2125	955	3080	0.00022
Bacillus sp. S3	486398	S	452	154	606	0.00004
Bacillus sp. WP8	756828	S	317	492	809	0.00006
Bacillus sp. 1NLA3E	666686	S	270	111	381	0.00003
Bacillus sp. FJAT-18017	1705566	S	184	57	241	0.00002
Bacillus sp. JY-23	2933872	S	166	76	242	0.00002
Bacillus sp. OxB-1	98228	S	116	33	149	0.00001
Bacillus sp. NSP9.1	1071078	S	111	10	121	0.00001
Bacillus sp. KH172YL63	2709784	S	106	43	149	0.00001
Bacillus sp. FJAT-42376	2014076	S	103	45	148	0.00001
Bacillus sp. THAF10	2587848	S	92	36	128	0.00001
Bacillus sp. SB49	1071080	S	91	19	110	0.00001
Bacillus sp. PAMC26568	2760090	S	91	11	102	0.00001
Bacillus sp. FJAT-22090	1581038	S	75	24	99	0.00001
Bacillus sp. M4U3P1	2592382	S	74	11	85	0.00001
Bacillus sp. N1-1	2682541	S	34	13	47	0.00000
Bacillus sp. 3a	580459	S	30	219	249	0.00002
Bacillus sp. Cs-700	2589818	S	28	11	39	0.00000
Bacillus sp. PDNC022	2812759	S	18	88	106	0.00001
Bacillus sp. MBGLi79	2070759	S	14	67	81	0.00001
Bacillus sp. JNUCC-24	2842458	S	13	210	223	0.00002
Bacillus sp. NP247	2846779	S	12	21	33	0.00000
Bacillus sp. JS	1127744	S	11	114	125	0.00001
Bacillus sp. ZJS3	2928154	S	11	32	43	0.00000
Bacillus sp. ms-22	2683680	S	10	41	51	0.00000
Bacillus sp. 275	1941347	S	10	1531	1541	0.00011
Bacillus cereus	1396	S	204	14483	14687	0.00106
Bacillus pseudomycoides	64104	S	179	93	272	0.00002
Bacillus thuringiensis	1428	S	150	7197	7347	0.00053
Bacillus cytotoxicus	580165	S	121	93	214	0.00002
Bacillus mycoides	1405	S	118	214	332	0.00002
Bacillus wiedmannii	1890302	S	30	57	87	0.00001
Bacillus nitratireducens	2026193	S	18	36	54	0.00000
Bacillus luti	2026191	S	14	17	31	0.00000
Bacillus toyonensis	155322	S	12	109	121	0.00001
Bacillus anthracis	1392	S	12	120	132	0.00001
Bacillus safensis	561879	S	783	1460	2243	0.00016
Bacillus pumilus	1408	S	516	569	1085	0.00008
Bacillus cabrialesii	2487276	S	413	478	891	0.00006
[Brevibacterium] frigoritolerans	450367	S	282	131	413	0.00003
Bacillus glycinifermentans	1664069	S	244	95	339	0.00002
Bacillus badius	1455	S	197	93	290	0.00002
Bacillus infantis	324767	S	168	56	224	0.00002
Bacillus dafuensis	1742359	S	165	71	236	0.00002
Bacillus methanolicus	1471	S	164	106	270	0.00002
Bacillus gobiensis	1441095	S	132	46	178	0.00001
Bacillus weihaiensis	1547283	S	112	45	157	0.00001
Bacillus smithii	1479	S	81	55	136	0.00001
Bacillus aquiflavi	2672567	S	72	23	95	0.00001
Bacillus fonticola	2728853	S	67	22	89	0.00001
Bacillus shivajii	1983719	S	60	10	70	0.00001
Bacillus rugosus	2715209	S	41	50	91	0.00001
Bacillus xiamenensis	1178537	S	22	87	109	0.00001
Priestia filamentosa	1402861	S	6975	1070	8045	0.00058
Priestia megaterium	1404	S	4957	7174	12131	0.00088
Priestia flexa	86664	S	3583	1360	4943	0.00036
Priestia aryabhattai	412384	S	182	1387	1569	0.00011
Priestia koreensis	284581	S	126	52	178	0.00001
Priestia sp. J2	2886505	S	22	282	304	0.00002
Metabacillus sediminilitoris	2567941	S	2355	1046	3401	0.00025
Metabacillus sp. KUDC1714	2745198	S	761	314	1075	0.00008
Metabacillus sp. cB07	2806989	S	97	44	141	0.00001
Metabacillus sp. B2-18	2897333	S	76	128	204	0.00001
Metabacillus dongyingensis	2874282	S	266	112	378	0.00003
Metabacillus litoralis	152268	S	114	129	243	0.00002
Metabacillus endolithicus	1535204	S	58	82	140	0.00001
Cytobacillus oceanisediminis	665099	S	1785	1077	2862	0.00021
Cytobacillus firmus	1399	S	319	171	490	0.00004
Cytobacillus ciccensis	1670641	S	214	94	308	0.00002
Cytobacillus gottheilii	859144	S	194	76	270	0.00002
Cytobacillus sp. CY-G	2901381	S	105	44	149	0.00001
Cytobacillus kochii	859143	S	78	28	106	0.00001
Geobacillus subterraneus	129338	S	414	361	775	0.00006
Geobacillus genomosp. 3	1921421	S	217	84	301	0.00002
Geobacillus stearothermophilus	1422	S	216	373	589	0.00004
Geobacillus sp. 46C-IIa	1963025	S	97	58	155	0.00001
Geobacillus sp. JS12	1813182	S	21	90	111	0.00001
Geobacillus sp. Y412MC52	550542	S	15	70	85	0.00001
Geobacillus thermocatenulatus	33938	S	73	96	169	0.00001
Geobacillus thermoleovorans	33941	S	14	205	219	0.00002
Geobacillus thermodenitrificans	33940	S	29	267	296	0.00002
Geobacillus zalihae	213419	S	14	124	138	0.00001
Terribacillus goriensis	386490	S	1840	381	2221	0.00016
Terribacillus aidingensis	586416	S	236	50	286	0.00002
Alkalihalobacillus clausii	79880	S	1642	438	2080	0.00015
Alkalihalobacillus krulwichiae	199441	S	97	35	132	0.00001
Alkalihalobacillus lehensis	300825	S	69	24	93	0.00001
Alkalihalobacillus miscanthi	2598861	S	47	17	64	0.00000
Alkalihalobacillus sp. LMS39	2924032	S	36	9	45	0.00000
Mesobacillus foraminis	279826	S	1103	351	1454	0.00011
Mesobacillus sp. S13	2880221	S	324	171	495	0.00004
Mesobacillus jeotgali	129985	S	290	139	429	0.00003
Hydrogenibacillus sp. N12	2866627	S	1697	254	1951	0.00014
Peribacillus asahii	228899	S	539	321	860	0.00006
Peribacillus simplex	1478	S	294	229	523	0.00004
Peribacillus butanolivorans	421767	S	167	67	234	0.00002
Peribacillus psychrosaccharolyticus	1407	S	103	43	146	0.00001
Peribacillus muralis	264697	S	74	21	95	0.00001
Lysinibacillus sp. SGAir0095	2070463	S	141	68	209	0.00002
Lysinibacillus sp. PLM2	2929796	S	97	45	142	0.00001
Lysinibacillus sp. YS11	2072025	S	62	119	181	0.00001
Lysinibacillus sp. 2017	2169540	S	51	28	79	0.00001
Lysinibacillus sp. Ag94	2936682	S	49	4	53	0.00000
Lysinibacillus sp. CD3-6	2892541	S	31	13	44	0.00000
Lysinibacillus sp. ACHW1.5	2913506	S	26	44	70	0.00001
Lysinibacillus timonensis	2086577	S	215	130	345	0.00002
Lysinibacillus fusiformis	28031	S	66	52	118	0.00001
Lysinibacillus sphaericus	1421	S	51	49	100	0.00001
Lysinibacillus parviboronicapiens	436516	S	40	15	55	0.00000
Lysinibacillus agricola	2590012	S	29	9	38	0.00000
Lysinibacillus capsici	2115968	S	12	16	28	0.00000
Anoxybacillus sediminis	2613334	S	644	175	819	0.00006
Anoxybacillus flavithermus	33934	S	108	97	205	0.00001
Anoxybacillus amylolyticus	294699	S	85	21	106	0.00001
Anoxybacillus caldiproteolyticus	247480	S	71	19	90	0.00001
Anoxybacillus sp. PDR2	1636720	S	15	59	74	0.00001
Anoxybacillus gonensis	198467	S	10	54	64	0.00000
Oceanobacillus kimchii	746691	S	725	89	814	0.00006
Oceanobacillus iheyensis	182710	S	111	26	137	0.00001
Oceanobacillus zhaokaii	2052660	S	102	23	125	0.00001
Niallia circulans	1397	S	566	193	759	0.00005
Niallia sp. Man26	2912824	S	343	92	435	0.00003
Neobacillus drentensis	220684	S	474	250	724	0.00005
Neobacillus mesonae	1193713	S	308	125	433	0.00003
Parageobacillus caldoxylosilyticus	81408	S	118	57	175	0.00001
Parageobacillus thermoglucosidasius	1426	S	110	66	176	0.00001
Parageobacillus toebii	153151	S	96	111	207	0.00001
Parageobacillus genomosp. 1	1295642	S	73	29	102	0.00001
Parageobacillus sp. KH3-4	2916802	S	53	25	78	0.00001
Virgibacillus sp. Bac332	2419842	S	68	10	78	0.00001
Virgibacillus sp. NKC19-16	2831673	S	67	7	74	0.00001
Virgibacillus sp. MSP4-1	2700081	S	60	15	75	0.00001
Virgibacillus sp. SK37	403957	S	25	31	56	0.00000
Virgibacillus sp. Bac330	2419841	S	20	27	47	0.00000
Virgibacillus necropolis	163877	S	68	11	79	0.00001
Virgibacillus phasianinus	2017483	S	58	9	67	0.00000
Virgibacillus halodenitrificans	1482	S	43	37	80	0.00001
Virgibacillus dokdonensis	302167	S	13	19	32	0.00000
Rossellomorea marisflavi	189381	S	301	138	439	0.00003
Rossellomorea vietnamensis	218284	S	65	30	95	0.00001
Salicibibacter halophilus	2502791	S	92	25	117	0.00001
Salicibibacter cibarius	2743000	S	69	16	85	0.00001
Salicibibacter kimchii	2099786	S	65	6	71	0.00001
Salicibibacter cibi	2743001	S	65	10	75	0.00001
Halobacillus sp. SSBR10-3	2932257	S	72	10	82	0.00001
Halobacillus sp. SSHM10-5	2932259	S	52	9	61	0.00000
Halobacillus sp. SSTM10-2	2932258	S	45	7	52	0.00000
Halobacillus mangrovi	402384	S	48	8	56	0.00000
Halobacillus litoralis	45668	S	46	8	54	0.00000
Halobacillus halophilus	1570	S	36	5	41	0.00000
Sutcliffiella cohnii	33932	S	171	88	259	0.00002
Sutcliffiella horikoshii	79883	S	121	39	160	0.00001
Weizmannia coagulans	1398	S	281	203	484	0.00003
Heyndrickxia oleronia	38875	S	154	70	224	0.00002
Heyndrickxia vini	1476025	S	89	31	120	0.00001
Salisediminibacterium selenitireducens	85683	S	130	23	153	0.00001
Salisediminibacterium beveridgei	632773	S	77	13	90	0.00001
Gracilibacillus sp. SSPM10-3	2932255	S	63	15	78	0.00001
Gracilibacillus sp. SSWR10-1	2932256	S	52	12	64	0.00000
Gracilibacillus salitolerans	2663022	S	69	10	79	0.00001
Fictibacillus arsenicus	255247	S	72	17	89	0.00001
Fictibacillus phosphorivorans	1221500	S	65	14	79	0.00001
Psychrobacillus glaciei	2283160	S	62	27	89	0.00001
Psychrobacillus sp. INOP01	2829187	S	49	21	70	0.00001
Lentibacillus sp. CBA3610	2518176	S	62	5	67	0.00000
Lentibacillus amyloliquefaciens	1472767	S	51	6	57	0.00000
Caldalkalibacillus thermarum	296745	S	114	26	140	0.00001
Alkalihalophilus pseudofirmus	79885	S	113	23	136	0.00001
Caldibacillus thermoamylovorans	35841	S	95	40	135	0.00001
Gottfriedia acidiceleris	371036	S	86	30	116	0.00001
Pontibacillus sp. ALD_SL1	2777185	S	47	7	54	0.00000
Pontibacillus sp. HMF3514	2692425	S	36	6	42	0.00000
Halalkalibacterium halodurans	86665	S	82	64	146	0.00001
Radiobacillus sp. 80	2844358	S	48	14	62	0.00000
Radiobacillus deserti	2594883	S	21	6	27	0.00000
Anaerobacillus isosaccharinicus	1532552	S	73	20	93	0.00001
Salimicrobium jeotgali	1230341	S	73	13	86	0.00001
Lederbergia lenta	1467	S	73	21	94	0.00001
Mangrovibacillus cuniculi	2593652	S	66	42	108	0.00001
Pradoshia sp. D12	2651284	S	57	20	77	0.00001
Evansella cellulosilytica	1413	S	53	9	62	0.00000
Aeribacillus pallidus	33936	S	51	30	81	0.00001
Sediminibacillus sp. DP4-553-S	2729421	S	49	10	59	0.00000
Amphibacillus xylanus	1449	S	35	7	42	0.00000
Paraliobacillus zengyii	2213194	S	34	6	40	0.00000
Paenibacillus sp. B01	2660554	S	1773	562	2335	0.00017
Paenibacillus sp. RUD330	2023772	S	1004	117	1121	0.00008
Paenibacillus sp. 32O-W	1695218	S	864	91	955	0.00007
Paenibacillus sp. H1-7	2282849	S	420	41	461	0.00003
Paenibacillus sp. R14(2021)	2859228	S	391	60	451	0.00003
Paenibacillus sp. Y412MC10	481743	S	335	643	978	0.00007
Paenibacillus sp. JNUCC-32	2777984	S	270	546	816	0.00006
Paenibacillus sp. sptzw28	715179	S	263	26	289	0.00002
Paenibacillus sp. JZ16	1906272	S	245	59	304	0.00002
Paenibacillus sp. PAMC21692	2762320	S	242	191	433	0.00003
Paenibacillus sp. CAA11	1532905	S	235	50	285	0.00002
Paenibacillus sp. URB8-2	2741301	S	226	54	280	0.00002
Paenibacillus sp. FSL R7-0273	1536772	S	221	39	260	0.00002
Paenibacillus sp. YPD9-1	2908839	S	207	28	235	0.00002
Paenibacillus sp. FSL R7-0331	1536773	S	206	37	243	0.00002
Paenibacillus sp. PK3_47	2072642	S	194	29	223	0.00002
Paenibacillus sp. BIHB4019	1870819	S	178	15	193	0.00001
Paenibacillus sp. HWE-109	1306526	S	173	16	189	0.00001
Paenibacillus sp. FSL H7-0357	1536774	S	173	24	197	0.00001
Paenibacillus sp. YPG26	2878915	S	100	22	122	0.00001
Paenibacillus sp. FSL R5-0912	1536771	S	100	50	150	0.00001
Paenibacillus sp. FSL P4-0081	1536769	S	98	54	152	0.00001
Paenibacillus sp. 481	2835869	S	91	9	100	0.00001
Paenibacillus sp. 19GGS1-52	2758563	S	83	8	91	0.00001
Paenibacillus sp. JNUCC-31	2777983	S	71	20	91	0.00001
Paenibacillus sp. IHB B 3084	867076	S	70	38	108	0.00001
Paenibacillus sp. E222	2748863	S	69	23	92	0.00001
Paenibacillus sp. DCT19	2211212	S	68	12	80	0.00001
Paenibacillus sp. IHBB 10380	1566358	S	43	8	51	0.00000
Paenibacillus sp. N3/727	2925845	S	38	43	81	0.00001
Paenibacillus sp. FSL R5-0345	1536770	S	32	9	41	0.00000
Paenibacillus sp. FSL H7-0737	1536775	S	24	7	31	0.00000
Paenibacillus sp. Cedars	1980674	S	21	112	133	0.00001
Paenibacillus sp. S02	2823904	S	11	81	92	0.00001
Paenibacillus mucilaginosus	61624	S	1993	148	2141	0.00015
Paenibacillus albicereus	2726185	S	1468	428	1896	0.00014
Paenibacillus lycopersici	2704462	S	1138	151	1289	0.00009
Paenibacillus ihbetae	1870820	S	851	127	978	0.00007
Paenibacillus rhizovicinus	2704463	S	618	89	707	0.00005
Paenibacillus cellulositrophicus	562959	S	610	65	675	0.00005
Paenibacillus macerans	44252	S	601	60	661	0.00005
Paenibacillus dendritiformis	130049	S	587	102	689	0.00005
Paenibacillus konkukensis	2020716	S	541	63	604	0.00004
Paenibacillus lautus	1401	S	520	598	1118	0.00008
Paenibacillus beijingensis	1126833	S	501	63	564	0.00004
Paenibacillus thiaminolyticus	49283	S	426	73	499	0.00004
Paenibacillus chitinolyticus	79263	S	423	56	479	0.00003
Paenibacillus stellifer	169760	S	406	77	483	0.00003
Paenibacillus durus	44251	S	379	134	513	0.00004
Paenibacillus cellulosilyticus	375489	S	272	38	310	0.00002
Paenibacillus sabinae	365617	S	270	68	338	0.00002
Paenibacillus naphthalenovorans	162209	S	260	40	300	0.00002
Paenibacillus riograndensis	483937	S	99	76	175	0.00001
Paenibacillus sonchi	373687	S	90	146	236	0.00002
Paenibacillus albus	2495582	S	252	37	289	0.00002
Paenibacillus xylanilyticus	248903	S	244	54	298	0.00002
Paenibacillus donghaensis	414771	S	235	26	261	0.00002
Paenibacillus polymyxa	1406	S	234	860	1094	0.00008
Paenibacillus protaetiae	2509456	S	219	35	254	0.00002
Paenibacillus azoreducens	116718	S	215	27	242	0.00002
Paenibacillus tritici	1873425	S	201	31	232	0.00002
Paenibacillus yonginensis	1462996	S	189	84	273	0.00002
Paenibacillus algicola	2565926	S	186	33	219	0.00002
Paenibacillus sophorae	1333845	S	180	63	243	0.00002
Paenibacillus physcomitrellae	1619311	S	175	59	234	0.00002
Paenibacillus swuensis	1178515	S	168	26	194	0.00001
Paenibacillus agaridevorans	171404	S	167	183	350	0.00003
Paenibacillus tianjinensis	2810347	S	165	29	194	0.00001
Paenibacillus guangzhouensis	1473112	S	149	15	164	0.00001
Paenibacillus borealis	160799	S	145	48	193	0.00001
Paenibacillus alvei	44250	S	133	19	152	0.00001
Paenibacillus psychroresistens	1778678	S	130	8	138	0.00001
Paenibacillus jilunlii	682956	S	128	83	211	0.00002
Paenibacillus kribbensis	172713	S	123	45	168	0.00001
Paenibacillus graminis	189425	S	118	59	177	0.00001
Paenibacillus barcinonensis	198119	S	113	20	133	0.00001
Paenibacillus lutimineralis	2707005	S	109	16	125	0.00001
Paenibacillus lentus	1338368	S	104	11	115	0.00001
Paenibacillus bovis	1616788	S	98	14	112	0.00001
Paenibacillus pabuli	1472	S	81	29	110	0.00001
Paenibacillus brasilensis	128574	S	74	33	107	0.00001
Paenibacillus baekrokdamisoli	1712516	S	73	8	81	0.00001
Paenibacillus crassostreae	1763538	S	66	11	77	0.00001
Paenibacillus odorifer	189426	S	66	12	78	0.00001
Paenibacillus terrae	159743	S	63	29	92	0.00001
Paenibacillus larvae	1464	S	60	9	69	0.00001
Paenibacillus uliginis	683737	S	52	51	103	0.00001
Paenibacillus xylanexedens	528191	S	43	29	72	0.00001
Paenibacillus peoriae	59893	S	33	177	210	0.00002
Paenibacillus antarcticus	253703	S	30	5	35	0.00000
Paenibacillus glucanolyticus	59843	S	21	116	137	0.00001
Brevibacillus choshinensis	54911	S	973	244	1217	0.00009
Brevibacillus marinus	2496837	S	727	130	857	0.00006
Brevibacillus agri	51101	S	509	135	644	0.00005
Brevibacillus composti	2796470	S	496	133	629	0.00005
Brevibacillus sp. MMS20-4M-10-Y	2895522	S	294	43	337	0.00002
Brevibacillus sp. HD3.3A	2738979	S	49	198	247	0.00002
Brevibacillus sp. DP1.3A	2738867	S	40	35	75	0.00001
Brevibacillus brevis	1393	S	361	189	550	0.00004
Brevibacillus laterosporus	1465	S	122	160	282	0.00002
Brevibacillus formosus	54913	S	49	41	90	0.00001
Brevibacillus parabrevis	54914	S	39	162	201	0.00001
Cohnella candidum	2674991	S	885	120	1005	0.00007
Cohnella sp. LGH	1619153	S	557	208	765	0.00006
Cohnella sp. MFER-1	2728023	S	278	38	316	0.00002
Cohnella cholangitidis	2598458	S	253	43	296	0.00002
Cohnella abietis	2507935	S	71	8	79	0.00001
Thermobacillus composti	377615	S	1562	240	1802	0.00013
Saccharibacillus brassicae	2583377	S	958	126	1084	0.00008
Aneurinibacillus soli	1500254	S	147	177	324	0.00002
Alicyclobacillus acidocaldarius	405212	S	1897	188	2085	0.00015
Alicyclobacillus acidoterrestris	1450	S	206	38	244	0.00002
Alicyclobacillus mengziensis	2931921	S	189	15	204	0.00001
Alicyclobacillus sp. SO9	2665646	S	125	11	136	0.00001
Alicyclobacillus sp. TC	2606450	S	27	4	31	0.00000
Tumebacillus avium	1903704	S	1111	534	1645	0.00012
Tumebacillus algifaecis	1214604	S	422	171	593	0.00004
Kyrpidia spormannii	2055160	S	283	146	429	0.00003
Kyrpidia tusciae	33943	S	197	143	340	0.00002
Effusibacillus dendaii	2743772	S	120	18	138	0.00001
Kroppenstedtia eburnea	714067	S	406	51	457	0.00003
Kroppenstedtia pulmonis	1380685	S	89	8	97	0.00001
Novibacillus thermophilus	1471761	S	484	74	558	0.00004
Staphylospora marina	2490858	S	433	93	526	0.00004
Polycladomyces abyssicola	1125966	S	246	31	277	0.00002
Laceyella sacchari	37482	S	160	48	208	0.00002
Thermoactinomyces vulgaris	2026	S	108	28	136	0.00001
Planococcus sp. MB-3u-03	2058136	S	86	70	156	0.00001
Planococcus sp. 107-1	2908840	S	56	29	85	0.00001
Planococcus sp. PAMC 21323	1526927	S	10	5	15	0.00000
Planococcus plakortidis	1038856	S	132	93	225	0.00002
Planococcus maritimus	192421	S	119	61	180	0.00001
Planococcus lenghuensis	2213202	S	116	29	145	0.00001
Planococcus glaciei	459472	S	102	36	138	0.00001
Planococcus rifietoensis	200991	S	85	73	158	0.00001
Planococcus massiliensis	1499687	S	72	19	91	0.00001
Planococcus halotolerans	2233542	S	59	22	81	0.00001
Planococcus halocryophilus	1215089	S	34	21	55	0.00000
Planococcus donghaensis	414778	S	32	21	53	0.00000
Planococcus antarcticus	161360	S	29	10	39	0.00000
Planococcus versutus	1302659	S	19	10	29	0.00000
Sporosarcina sp. Te-1	2818390	S	51	14	65	0.00000
Sporosarcina sp. Marseille-Q4063	2810514	S	31	6	37	0.00000
Sporosarcina sp. PTS2304	2283194	S	23	7	30	0.00000
Sporosarcina sp. resist	2762563	S	15	59	74	0.00001
Sporosarcina sp. P33	1930764	S	11	58	69	0.00000
Sporosarcina ureae	1571	S	102	34	136	0.00001
Sporosarcina pasteurii	1474	S	21	7	28	0.00000
Sporosarcina ureilytica	298596	S	15	5	20	0.00000
Solibacillus silvestris	76853	S	82	36	118	0.00001
Solibacillus sp. R5-41	2048654	S	33	17	50	0.00000
Ureibacillus thermosphaericus	51173	S	43	55	98	0.00001
Ureibacillus thermophilus	367743	S	36	21	57	0.00000
Kurthia sp. 11kri321	1750719	S	35	24	59	0.00000
Kurthia zopfii	1650	S	20	12	32	0.00000
Paenisporosarcina cavernae	2320858	S	31	21	52	0.00000
Paenisporosarcina antarctica	417367	S	28	10	38	0.00000
Jeotgalibacillus malaysiensis	1508404	S	54	21	75	0.00001
Viridibacillus sp. JNUCC-6	2779527	S	32	14	46	0.00000
Rummeliibacillus stabekisii	241244	S	25	15	40	0.00000
Staphylococcus aureus	1280	S	87	630	717	0.00005
Staphylococcus gallinarum	1293	S	50	4	54	0.00000
Staphylococcus epidermidis	1282	S	40	404	444	0.00003
Staphylococcus pseudintermedius	283734	S	28	28	56	0.00000
Staphylococcus piscifermentans	70258	S	26	12	38	0.00000
Staphylococcus haemolyticus	1283	S	24	27	51	0.00000
Staphylococcus pseudoxylosus	2282419	S	24	14	38	0.00000
Staphylococcus simiae	308354	S	18	11	29	0.00000
Staphylococcus hominis	1290	S	18	12	30	0.00000
Staphylococcus pettenkoferi	170573	S	17	4	21	0.00000
Staphylococcus xylosus	1288	S	15	8	23	0.00000
Staphylococcus lugdunensis	28035	S	13	6	19	0.00000
Staphylococcus muscae	1294	S	11	5	16	0.00000
Staphylococcus schleiferi	1295	S	11	22	33	0.00000
Staphylococcus simulans	1286	S	10	4	14	0.00000
Staphylococcus hyicus	1284	S	10	5	15	0.00000
Staphylococcus capitis	29388	S	10	9	19	0.00000
Jeotgalicoccus sp. ATCC 8456	946435	S	35	6	41	0.00000
Jeotgalicoccus sp. WY2	2708346	S	20	5	25	0.00000
Jeotgalicoccus saudimassiliensis	1461582	S	47	6	53	0.00000
Mammaliicoccus sciuri	1296	S	78	55	133	0.00001
Mammaliicoccus lentus	42858	S	11	8	19	0.00000
Macrococcus brunensis	198483	S	20	7	27	0.00000
Macrococcus canis	1855823	S	18	9	27	0.00000
Macrococcus armenti	2875764	S	12	6	18	0.00000
Macrococcus caseolyticus	69966	S	10	23	33	0.00000
Salinicoccus halodurans	407035	S	53	18	71	0.00001
Nosocomiicoccus ampullae	489910	S	20	3	23	0.00000
Abyssicoccus albus	1817405	S	11	3	14	0.00000
Exiguobacterium sp. N4-1P	2051906	S	48	34	82	0.00001
Exiguobacterium sp. Helios	2735868	S	33	15	48	0.00000
Exiguobacterium sp. AT1b	360911	S	31	42	73	0.00001
Exiguobacterium sp. PFWT01	2829816	S	24	33	57	0.00000
Exiguobacterium sp. MH3	1399115	S	18	23	41	0.00000
Exiguobacterium alkaliphilum	1428684	S	209	76	285	0.00002
Exiguobacterium mexicanum	340146	S	174	67	241	0.00002
Exiguobacterium acetylicum	41170	S	82	125	207	0.00001
Exiguobacterium sibiricum	332410	S	51	25	76	0.00001
Exiguobacterium antarcticum	132920	S	46	18	64	0.00000
Listeria monocytogenes	1639	S	57	1575	1632	0.00012
Listeria innocua	1642	S	50	48	98	0.00001
Listeria weihenstephanensis	1006155	S	29	7	36	0.00000
Listeria grayi	1641	S	27	9	36	0.00000
Listeria marthii	529731	S	24	10	34	0.00000
Listeria sp. PSOL-1	1844999	S	17	5	22	0.00000
Listeria ivanovii	1638	S	16	3	19	0.00000
Listeria seeligeri	1640	S	12	5	17	0.00000
Brochothrix thermosphacta	2756	S	21	7	28	0.00000
Sporolactobacillus terrae	269673	S	78	12	90	0.00001
Limosilactobacillus fermentum	1613	S	174	137	311	0.00002
Limosilactobacillus pontis	35787	S	115	71	186	0.00001
Limosilactobacillus mucosae	97478	S	55	21	76	0.00001
Limosilactobacillus panis	47493	S	36	16	52	0.00000
Limosilactobacillus reuteri	1598	S	26	24	50	0.00000
Limosilactobacillus gastricus	227942	S	10	4	14	0.00000
Weissella confusa	1583	S	205	89	294	0.00002
Weissella cibaria	137591	S	43	18	61	0.00000
Weissella soli	155866	S	17	4	21	0.00000
Lactobacillus delbrueckii	1584	S	129	275	404	0.00003
Lactobacillus sp. CBA3606	2099789	S	12	8	20	0.00000
Lactobacillus amylovorus	1604	S	24	55	79	0.00001
Lactobacillus panisapium	2012495	S	16	3	19	0.00000
Lactobacillus amylolyticus	83683	S	13	8	21	0.00000
Lactobacillus acetotolerans	1600	S	10	2	12	0.00000
Lactobacillus johnsonii	33959	S	10	10	20	0.00000
Lactobacillus iners	147802	S	10	15	25	0.00000
Levilactobacillus zymae	267363	S	165	52	217	0.00002
Levilactobacillus brevis	1580	S	86	30	116	0.00001
Levilactobacillus suantsaii	2292255	S	32	11	43	0.00000
Levilactobacillus koreensis	637971	S	31	5	36	0.00000
Lacticaseibacillus casei	1582	S	56	23	79	0.00001
Lacticaseibacillus rhamnosus	47715	S	42	8	50	0.00000
Lacticaseibacillus manihotivorans	88233	S	32	10	42	0.00000
Lacticaseibacillus zeae	57037	S	31	16	47	0.00000
Lacticaseibacillus paracasei	1597	S	20	85	105	0.00001
Lacticaseibacillus chiayiensis	2100821	S	19	3	22	0.00000
Lactiplantibacillus pentosus	1589	S	54	17	71	0.00001
Lactiplantibacillus plantarum	1590	S	45	40	85	0.00001
Lactiplantibacillus paraplantarum	60520	S	20	6	26	0.00000
Schleiferilactobacillus harbinensis	304207	S	131	15	146	0.00001
Ligilactobacillus ruminis	1623	S	52	20	72	0.00001
Ligilactobacillus animalis	1605	S	15	18	33	0.00000
Ligilactobacillus salivarius	1624	S	11	9	20	0.00000
Ligilactobacillus acidipiscis	89059	S	10	4	14	0.00000
Leuconostoc lactis	1246	S	24	53	77	0.00001
Leuconostoc mesenteroides	1245	S	10	7	17	0.00000
Lentilactobacillus buchneri	1581	S	19	7	26	0.00000
Lentilactobacillus hilgardii	1588	S	12	3	15	0.00000
Lentilactobacillus parabuchneri	152331	S	12	3	15	0.00000
Pediococcus acidilactici	1254	S	24	13	37	0.00000
Pediococcus damnosus	51663	S	11	6	17	0.00000
Secundilactobacillus paracollinoides	240427	S	49	18	67	0.00000
Oenococcus kitaharae	336988	S	14	2	16	0.00000
Oenococcus sicerae	2203724	S	10	1	11	0.00000
Latilactobacillus sakei	1599	S	12	6	18	0.00000
Latilactobacillus curvatus	28038	S	11	7	18	0.00000
Furfurilactobacillus rossiae	231049	S	35	6	41	0.00000
Loigolactobacillus coryniformis	1610	S	20	17	37	0.00000
Paucilactobacillus hokkaidonensis	1193095	S	10	5	15	0.00000
Periweissella cryptocerci	2506420	S	16	2	18	0.00000
Bombilactobacillus bombi	1303590	S	12	2	14	0.00000
Amylolactobacillus amylophilus	1603	S	11	10	21	0.00000
Acetilactobacillus jinshanensis	1720083	S	10	0	10	0.00000
Streptococcus sp. HKU75	2781599	S	15	4	19	0.00000
Streptococcus equi	1336	S	38	10	48	0.00000
Streptococcus dysgalactiae	1334	S	11	83	94	0.00001
Streptococcus sanguinis	1305	S	44	17	61	0.00000
Streptococcus oralis	1303	S	41	55	96	0.00001
Streptococcus suis	1307	S	39	41	80	0.00001
Streptococcus anginosus	1328	S	14	44	58	0.00000
Streptococcus intermedius	1338	S	12	21	33	0.00000
Streptococcus gordonii	1302	S	21	8	29	0.00000
Streptococcus thermophilus	1308	S	20	575	595	0.00004
Streptococcus ferus	1345	S	18	4	22	0.00000
Streptococcus mutans	1309	S	17	4	21	0.00000
Streptococcus cristatus	45634	S	17	26	43	0.00000
Streptococcus sobrinus	1310	S	17	3	20	0.00000
Streptococcus pyogenes	1314	S	16	29	45	0.00000
Streptococcus respiraculi	2021971	S	16	3	19	0.00000
Streptococcus merionis	400065	S	14	1	15	0.00000
Streptococcus agalactiae	1311	S	12	583	595	0.00004
Streptococcus pluranimalium	82348	S	12	6	18	0.00000
Streptococcus porcinus	1340	S	10	5	15	0.00000
Lactococcus garvieae	1363	S	72	80	152	0.00001
Lactococcus raffinolactis	1366	S	24	10	34	0.00000
Lactococcus cremoris	1359	S	20	18	38	0.00000
Lactococcus lactis	1358	S	15	7	22	0.00000
Enterococcus casseliflavus	37734	S	49	75	124	0.00001
Enterococcus avium	33945	S	37	20	57	0.00000
Enterococcus faecalis	1351	S	36	98	134	0.00001
Enterococcus faecium	1352	S	26	790	816	0.00006
Enterococcus mundtii	53346	S	19	12	31	0.00000
Enterococcus raffinosus	71452	S	18	11	29	0.00000
Enterococcus gilvus	160453	S	17	7	24	0.00000
Enterococcus cecorum	44008	S	16	13	29	0.00000
Enterococcus wangshanyuanii	2005703	S	14	1	15	0.00000
Enterococcus hirae	1354	S	12	10	22	0.00000
Enterococcus durans	53345	S	11	11	22	0.00000
Vagococcus lutrae	81947	S	15	31	46	0.00000
Vagococcus fluvialis	2738	S	13	13	26	0.00000
Vagococcus coleopterorum	2714946	S	10	4	14	0.00000
Tetragenococcus halophilus	51669	S	22	13	35	0.00000
Tetragenococcus koreensis	290335	S	14	5	19	0.00000
Jeotgalibaca dankookensis	708126	S	34	11	45	0.00000
Jeotgalibaca porci	1868793	S	20	17	37	0.00000
Carnobacterium maltaromaticum	2751	S	15	6	21	0.00000
Dolosigranulum pigrum	29394	S	27	9	36	0.00000
Granulicatella elegans	137732	S	10	29	39	0.00000
Marinilactibacillus sp. 15R	1911586	S	11	4	15	0.00000
Aerococcus sanguinicola	119206	S	31	6	37	0.00000
Aerococcus urinaeequi	51665	S	25	63	88	0.00001
Aerococcus urinae	1376	S	14	5	19	0.00000
Ignavigranum ruoffiae	89093	S	13	2	15	0.00000
Abiotrophia defectiva	46125	S	12	4	16	0.00000
Thermaerobacter sp. FW80	2546351	S	2759	599	3358	0.00024
Thermaerobacter sp. PB12/4term	2293838	S	2044	525	2569	0.00019
Thermaerobacter marianensis	73919	S	2261	565	2826	0.00020
Intestinimonas butyriciproducens	1297617	S	440	188	628	0.00005
Flintibacter sp. KGMB00164	2610895	S	295	42	337	0.00002
Aminipila luticellarii	2507160	S	44	5	49	0.00000
Aminipila terrae	2697030	S	39	4	43	0.00000
Aminipila butyrica	433296	S	38	4	42	0.00000
Emergencia timonensis	1776384	S	112	48	160	0.00001
Mogibacterium pumilum	86332	S	15	11	26	0.00000
Massilistercora timonensis	2086584	S	170	199	369	0.00003
Carboxydocella thermautotrophica	178899	S	131	14	145	0.00001
Faecalibacterium prausnitzii	853	S	1338	1446	2784	0.00020
Dysosmobacter sp. Marseille-Q4140	2830675	S	624	291	915	0.00007
Dysosmobacter welbionis	2093857	S	386	292	678	0.00005
Flavonifractor plautii	292800	S	924	266	1190	0.00009
Vescimonas coprocola	2714355	S	252	243	495	0.00004
Vescimonas fastidiosa	2714353	S	211	368	579	0.00004
Ruthenibacterium lactatiformans	1550024	S	431	143	574	0.00004
Ethanoligenens harbinense	253239	S	423	172	595	0.00004
Anaerotruncus colihominis	169435	S	367	210	577	0.00004
Oscillibacter sp. NSJ-62	2763056	S	353	126	479	0.00003
Caproiciproducens sp. NJN-50	2507162	S	320	43	363	0.00003
Acutalibacter muris	1796620	S	262	15	277	0.00002
Caproicibacter fermentans	2576756	S	219	13	232	0.00002
Ruminococcus champanellensis	1161942	S	103	4	107	0.00001
Ruminococcus albus	1264	S	45	1	46	0.00000
Ruminococcus bovis	2564099	S	23	3	26	0.00000
Ruminococcus bicirculans	1160721	S	13	2	15	0.00000
Pusillibacter faecalis	2714358	S	181	137	318	0.00002
Caproicibacterium amylolyticum	2766537	S	60	6	66	0.00000
Caproicibacterium lactatifermentans	2666138	S	53	8	61	0.00000
Solibaculum mannosilyticum	2780922	S	110	117	227	0.00002
Acetivibrio clariflavus	288965	S	42	30	72	0.00001
Acetivibrio saccincola	1677857	S	31	22	53	0.00000
Acetivibrio thermocellus	1515	S	30	0	30	0.00000
Pseudoclostridium thermosuccinogenes	84032	S	66	17	83	0.00001
Ruminiclostridium herbifermentans	2488810	S	40	11	51	0.00000
Ruminiclostridium cellulolyticum	1521	S	10	2	12	0.00000
Thermoclostridium stercorarium	1510	S	39	10	49	0.00000
Mageeibacillus indolicus	884684	S	34	50	84	0.00001
Fastidiosipila sanguinis	236753	S	17	11	28	0.00000
Monoglobus pectinilyticus	1981510	S	11	6	17	0.00000
Symbiobacterium thermophilum	2734	S	2965	282	3247	0.00023
Clostridium sp. SY8519	1042156	S	74	24	98	0.00001
Clostridium sp. M62/1	411486	S	72	105	177	0.00001
Clostridium sp. C5S11	704125	S	48	6	54	0.00000
Clostridium sp. DL-VIII	641107	S	43	8	51	0.00000
Clostridium sp. BNL1100	755731	S	33	4	37	0.00000
Clostridium sp. AWRP	2212991	S	33	14	47	0.00000
Clostridium sp. JN-9	2507159	S	25	4	29	0.00000
Clostridium sp. MD294	97138	S	17	1	18	0.00000
Clostridium sp. 'deep sea'	2779445	S	15	0	15	0.00000
Clostridium sp. JN-1	2483110	S	14	2	16	0.00000
Clostridium sp. C1	1155388	S	13	13	26	0.00000
Clostridium saccharoperbutylacetonicum	36745	S	102	23	125	0.00001
Clostridium botulinum	1491	S	78	84	162	0.00001
Clostridium beijerinckii	1520	S	70	104	174	0.00001
Clostridium perfringens	1502	S	62	20	82	0.00001
Clostridium intestinale	36845	S	53	7	60	0.00000
Clostridium kluyveri	1534	S	45	3	48	0.00000
Clostridium pasteurianum	1501	S	43	7	50	0.00000
Clostridium tetani	1513	S	37	12	49	0.00000
Clostridium argentinense	29341	S	34	5	39	0.00000
Clostridium baratii	1561	S	34	10	44	0.00000
Clostridium thermarum	1716543	S	33	21	54	0.00000
Clostridium cellulovorans	1493	S	33	5	38	0.00000
Clostridium saccharobutylicum	169679	S	30	6	36	0.00000
Clostridium fermenticellae	2068654	S	28	3	31	0.00000
Clostridium butyricum	1492	S	26	5	31	0.00000
Clostridium tyrobutyricum	1519	S	25	2	27	0.00000
Clostridium sporogenes	1509	S	24	112	136	0.00001
Clostridium formicaceticum	1497	S	24	5	29	0.00000
Clostridium estertheticum	238834	S	22	4	26	0.00000
Clostridium manihotivorum	2320868	S	21	2	23	0.00000
Clostridium carboxidivorans	217159	S	21	5	26	0.00000
Clostridium cadaveris	1529	S	20	5	25	0.00000
Clostridium aceticum	84022	S	18	2	20	0.00000
Clostridium isatidis	182773	S	17	8	25	0.00000
Clostridium scatologenes	1548	S	13	10	23	0.00000
Clostridium taeniosporum	394958	S	12	2	14	0.00000
Clostridium chauvoei	46867	S	11	3	14	0.00000
Clostridium septicum	1504	S	11	3	14	0.00000
Clostridium diolis	223919	S	11	109	120	0.00001
Clostridium gasigenes	94869	S	10	2	12	0.00000
Clostridium drakei	332101	S	10	6	16	0.00000
Hungatella hathewayi	154046	S	148	6	154	0.00001
Alkaliphilus sp. B6464	2731219	S	46	14	60	0.00000
Alkaliphilus oremlandii	461876	S	36	11	47	0.00000
Alkaliphilus metalliredigens	208226	S	18	4	22	0.00000
Crassaminicella thermophila	2599308	S	24	11	35	0.00000
Crassaminicella profunda	1286698	S	23	7	30	0.00000
Geosporobacter ferrireducens	1424294	S	52	10	62	0.00000
Paraclostridium bifermentans	1490	S	37	12	49	0.00000
Caloramator sp. E03	2576307	S	34	3	37	0.00000
Serpentinicella alkaliphila	1734049	S	11	2	13	0.00000
Hathewaya histolytica	1498	S	10	4	14	0.00000
[Clostridium] scindens	29347	S	132	61	193	0.00001
[Clostridium] hylemonae	89153	S	130	41	171	0.00001
Lachnoclostridium phocaeense	1871021	S	117	115	232	0.00002
Lachnoclostridium sp. YL32	1834196	S	21	29	50	0.00000
Lachnoclostridium phytofermentans	66219	S	10	0	10	0.00000
Blautia sp. NBRC 113351	2877527	S	58	71	129	0.00001
Blautia sp. SC05B48	2479767	S	14	39	53	0.00000
Blautia producta	33035	S	69	14	83	0.00001
Blautia pseudococcoides	1796616	S	49	7	56	0.00000
Blautia liquoris	2779518	S	22	1	23	0.00000
Blautia obeum	40520	S	17	17	34	0.00000
Blautia massiliensis	1737424	S	15	31	46	0.00000
Blautia argi	1912897	S	14	14	28	0.00000
Lachnospiraceae bacterium NSJ-29	2763667	S	105	35	140	0.00001
Lachnospiraceae bacterium NSJ-38	2763669	S	75	33	108	0.00001
Lachnospiraceae bacterium sunii NSJ-8	2763672	S	60	51	111	0.00001
Lachnospiraceae bacterium NSJ-4	2763670	S	29	32	61	0.00000
Anaerocolumna cellulosilytica	433286	S	116	5	121	0.00001
Anaerocolumna sedimenticola	2696063	S	66	4	70	0.00001
Anaerocolumna chitinilytica	1727145	S	44	1	45	0.00000
Roseburia hominis	301301	S	101	120	221	0.00002
Roseburia intestinalis	166486	S	29	35	64	0.00000
Enterocloster bolteae	208479	S	124	41	165	0.00001
Enterocloster clostridioformis	1531	S	20	54	74	0.00001
Coprococcus comes	410072	S	60	71	131	0.00001
Coprococcus catus	116085	S	22	13	35	0.00000
Coprococcus eutactus	33043	S	14	18	32	0.00000
Anaerostipes caccae	105841	S	50	14	64	0.00000
Anaerostipes rhamnosivorans	1229621	S	42	22	64	0.00000
Lacrimispora sphenoides	29370	S	53	4	57	0.00000
Lacrimispora saccharolytica	84030	S	45	7	52	0.00000
Butyrivibrio fibrisolvens	831	S	35	9	44	0.00000
Butyrivibrio proteoclasticus	43305	S	11	1	12	0.00000
Butyrivibrio hungatei	185008	S	11	1	12	0.00000
[Ruminococcus] gnavus	33038	S	37	27	64	0.00000
[Ruminococcus] torques	33039	S	22	20	42	0.00000
Anaerotignum propionicum	28446	S	53	5	58	0.00000
Sellimonas intestinalis	1653434	S	44	27	71	0.00001
Novisyntrophococcus fermenticellae	2068655	S	28	4	32	0.00000
[Clostridium] colinum	36835	S	21	2	23	0.00000
Anaerobutyricum hallii	39488	S	20	7	27	0.00000
Herbinix luporum	1679721	S	19	14	33	0.00000
Dorea longicatena	88431	S	16	16	32	0.00000
Faecalicatena sp. Marseille-Q4148	2823316	S	10	5	15	0.00000
Pseudobutyrivibrio xylanivorans	185007	S	10	0	10	0.00000
Candidatus Desulforudis audaxviator	471827	S	821	52	873	0.00006
Desulforamulus ruminis	1564	S	110	21	131	0.00001
Desulforamulus ferrireducens	1833852	S	93	68	161	0.00001
Desulforamulus reducens	59610	S	34	9	43	0.00000
Candidatus Formimonas warabiya	1761012	S	195	20	215	0.00002
Acididesulfobacillus acetoxydans	1561005	S	187	8	195	0.00001
Thermanaerosceptrum fracticalcis	1712410	S	75	13	88	0.00001
Desulfofarcimen acetoxidans	58138	S	70	10	80	0.00001
Dehalobacterium formicoaceticum	51515	S	55	13	68	0.00000
Christensenella sp. Marseille-P3954	2086585	S	675	364	1039	0.00008
Christensenella minuta	626937	S	178	56	234	0.00002
Heliomicrobium modesticaldum	35701	S	717	376	1093	0.00008
Heliorestis convoluta	356322	S	27	1	28	0.00000
Eubacterium limosum	1736	S	98	108	206	0.00001
Eubacterium sp. c-25	2841037	S	21	12	33	0.00000
Eubacterium sp. MSJ-33	2841528	S	16	11	27	0.00000
Eubacterium sp. NSJ-61	2764325	S	11	18	29	0.00000
Eubacterium callanderi	53442	S	39	33	72	0.00001
Eubacterium maltosivorans	2041044	S	21	97	118	0.00001
Acetobacterium sp. KB-1	2184575	S	85	25	110	0.00001
Acetobacterium wieringae	52694	S	57	32	89	0.00001
Acetobacterium woodii	33952	S	29	6	35	0.00000
Alkalibacter sp. ES005	2815577	S	84	6	90	0.00001
Desulfosporosinus youngiae	339862	S	74	22	96	0.00001
Desulfosporosinus orientis	1563	S	60	12	72	0.00001
Desulfosporosinus meridiei	79209	S	38	13	51	0.00000
Desulfosporosinus acidiphilus	885581	S	38	7	45	0.00000
Desulfitobacterium hafniense	49338	S	92	20	112	0.00001
Desulfitobacterium dichloroeliminans	233055	S	42	41	83	0.00001
Desulfitobacterium metallireducens	142877	S	37	9	46	0.00000
Desulfitobacterium dehalogenans	36854	S	28	6	34	0.00000
Dehalobacter restrictus	55583	S	45	74	119	0.00001
Syntrophobotulus glycolicus	51197	S	62	4	66	0.00000
Syntrophothermus lipocalidus	86170	S	136	9	145	0.00001
Syntrophomonas wolfei	863	S	71	7	78	0.00001
Candidatus Contubernalis alkalaceticum	338645	S	43	2	45	0.00000
Candidatus Syntrophocurvum alkaliphilum	2293317	S	18	2	20	0.00000
Peptoclostridium acidaminophilum	1731	S	53	10	63	0.00000
Clostridioides difficile	1496	S	30	36	66	0.00000
Terrisporobacter sp. MCA3	2813371	S	32	12	44	0.00000
Filifactor alocis	143361	S	31	48	79	0.00001
Romboutsia sp. CE17	2724150	S	10	11	21	0.00000
Acetoanaerobium sticklandii	1511	S	19	2	21	0.00000
Tepidibacter sp. 8C15b	2925782	S	19	5	24	0.00000
Desulfoscipio gibsoniae	102134	S	188	17	205	0.00001
Thermincola potens	863643	S	116	11	127	0.00001
Desulfotomaculum nigrificans	1565	S	75	35	110	0.00001
Caloranaerobacter azorensis	116090	S	49	7	56	0.00000
Vallitalea pronyensis	1348613	S	16	2	18	0.00000
Vallitalea guaymasensis	1185412	S	10	2	12	0.00000
Petrocella atlantisensis	2173034	S	16	2	18	0.00000
Alkalicella caledoniensis	2731377	S	30	4	34	0.00000
Moorella sp. Hama-1	2138101	S	408	97	505	0.00004
Moorella thermoacetica	1525	S	343	67	410	0.00003
Moorella glycerini	55779	S	312	34	346	0.00003
Ammonifex degensii	42838	S	438	17	455	0.00003
Gelria sp. Kuro-4	2796927	S	980	79	1059	0.00008
Thermacetogenium phaeum	85874	S	417	407	824	0.00006
Carboxydothermus hydrogenoformans	129958	S	118	11	129	0.00001
Thermanaeromonas toyohensis	161154	S	107	3	110	0.00001
Thermoanaerobacter mathranii	583357	S	22	55	77	0.00001
Thermoanaerobacter kivui	2325	S	12	12	24	0.00000
Caldanaerobacter subterraneus	911092	S	37	56	93	0.00001
Caldicellulosiruptor changbaiensis	1222016	S	12	34	46	0.00000
Caldicellulosiruptor acetigenus	301953	S	11	14	25	0.00000
Thermoanaerobacterium thermosaccharolyticum	1517	S	16	44	60	0.00000
Mahella australiensis	252966	S	119	65	184	0.00001
Zhaonella formicivorans	2528593	S	74	12	86	0.00001
Thermodesulfobium acidiphilum	1794699	S	12	21	33	0.00000
Iocasia fonsfrigidae	2682810	S	89	4	93	0.00001
Halothermothrix orenii	31909	S	69	5	74	0.00001
Halanaerobium praevalens	2331	S	18	17	35	0.00000
Halobacteroides halobius	42422	S	51	7	58	0.00000
Acetohalobium arabaticum	28187	S	44	4	48	0.00000
Anoxybacter fermentans	1323375	S	74	13	87	0.00001
Thermosediminibacter oceani	291990	S	149	16	165	0.00001
Biomaibacter acetigenes	2316383	S	71	5	76	0.00001
Tepidanaerobacter acetatoxydans	499229	S	28	1	29	0.00000
Natranaerofaba carboxydovora	2742683	S	79	4	83	0.00001
Natranaerobius thermophilus	375929	S	42	7	49	0.00000
Koleobacter methoxysyntrophicus	2751313	S	110	11	121	0.00001
Selenomonas sp. oral taxon 126	712528	S	440	111	551	0.00004
Selenomonas sp. oral taxon 920	1884263	S	303	68	371	0.00003
Selenomonas sp. oral taxon 136	713030	S	148	242	390	0.00003
Selenomonas sp. oral taxon 478	712538	S	86	149	235	0.00002
Selenomonas sputigena	69823	S	800	67	867	0.00006
Selenomonas timonae	2754044	S	328	139	467	0.00003
Selenomonas ruminantium	971	S	161	15	176	0.00001
Megamonas hypermegale	158847	S	10	68	78	0.00001
Pectinatus frisingensis	865	S	21	1	22	0.00000
Sporomusa termitida	2377	S	171	21	192	0.00001
Methylomusa anaerophila	1930071	S	107	7	114	0.00001
Pelosinus sp. UFO1	484770	S	40	12	52	0.00000
Pelosinus fermentans	365349	S	39	7	46	0.00000
Megasphaera elsdenii	907	S	259	117	376	0.00003
Megasphaera stantonii	2144175	S	228	136	364	0.00003
Megasphaera massiliensis	1232428	S	133	49	182	0.00001
Dialister pneumosintes	39950	S	12	89	101	0.00001
Veillonella rodentium	248315	S	19	7	26	0.00000
Veillonella parvula	29466	S	16	14	30	0.00000
Acidaminococcus fermentans	905	S	198	28	226	0.00002
Acidaminococcus intestini	187327	S	72	11	83	0.00001
Phascolarctobacterium faecium	33025	S	53	4	57	0.00000
Phascolarctobacterium succinatutens	626940	S	31	68	99	0.00001
Phascolarctobacterium sp. Marseille-Q4147	2823317	S	29	18	47	0.00000
Limnochorda pilosa	1555112	S	3255	146	3401	0.00025
Peptoniphilus ivorii	54006	S	110	30	140	0.00001
Peptoniphilus harei	54005	S	13	14	27	0.00000
Murdochiella vaginalis	1852373	S	73	78	151	0.00001
Anaerococcus mediterraneensis	1870984	S	28	53	81	0.00001
Anaerococcus prevotii	33034	S	10	9	19	0.00000
Parvimonas micra	33033	S	23	43	66	0.00000
Finegoldia magna	1260	S	19	18	37	0.00000
Miniphocaeibacter halophilus	2931922	S	12	1	13	0.00000
Tissierella sp. JN-28	2507161	S	44	10	54	0.00000
Schnuerera ultunensis	45497	S	26	4	30	0.00000
Gudongella oleilytica	1582259	S	22	5	27	0.00000
Keratinibaculum paraultunense	1278232	S	17	7	24	0.00000
Gottschalkia acidurici	1556	S	78	9	87	0.00001
Ezakiella coagulans	46507	S	44	121	165	0.00001
Ezakiella massiliensis	1852374	S	26	15	41	0.00000
Sedimentibacter sp. zth1	2816908	S	22	2	24	0.00000
Faecalibaculum rodentium	1702221	S	132	43	175	0.00001
Allobaculum sp. Allo2	2853432	S	75	18	93	0.00001
Allobaculum mucolyticum	2834459	S	48	14	62	0.00000
Erysipelothrix larvae	1514105	S	29	13	42	0.00000
[Clostridium] innocuum	1522	S	59	57	116	0.00001
Bulleidia sp. zg-1006	2806552	S	19	7	26	0.00000
Faecalitalea cylindroides	39483	S	17	39	56	0.00000
Intestinibaculum porci	2487118	S	14	6	20	0.00000
Longicatena caecimuris	1796635	S	11	23	34	0.00000
Turicibacter sp. H121	1712675	S	10	17	27	0.00000
Ndongobacter massiliensis	1871025	S	106	95	201	0.00001
endosymbiont 'TC1' of Trimyema compressum	243899	S	79	5	84	0.00001
Deinococcus sp. NW-56	2080419	S	1355	184	1539	0.00011
Deinococcus sp. TS-293	2737050	S	1193	122	1315	0.00010
Deinococcus sp. KNUC1210	2917691	S	970	41	1011	0.00007
Deinococcus sp. AJ005	2652443	S	744	60	804	0.00006
Deinococcus sp. QL22	2939437	S	502	39	541	0.00004
Deinococcus maricopensis	309887	S	1701	161	1862	0.00013
Deinococcus metallilatus	1211322	S	1675	193	1868	0.00013
Deinococcus ficus	317577	S	1635	157	1792	0.00013
Deinococcus gobiensis	502394	S	1605	220	1825	0.00013
Deinococcus actinosclerus	1768108	S	1514	874	2388	0.00017
Deinococcus irradiatisoli	2202254	S	1232	116	1348	0.00010
Deinococcus peraridilitoris	432329	S	1116	59	1175	0.00008
Deinococcus radiopugnans	57497	S	1075	133	1208	0.00009
Deinococcus wulumuqiensis	980427	S	1044	370	1414	0.00010
Deinococcus geothermalis	68909	S	805	124	929	0.00007
Deinococcus radiodurans	1299	S	764	1703	2467	0.00018
Deinococcus proteolyticus	55148	S	648	136	784	0.00006
Deinococcus soli (ex Cha et al. 2016)	1309411	S	636	567	1203	0.00009
Deinococcus deserti	310783	S	581	42	623	0.00005
Deinococcus psychrotolerans	2489213	S	549	16	565	0.00004
Deinococcus radiophilus	32062	S	326	64	390	0.00003
Deinococcus puniceus	1182568	S	259	38	297	0.00002
Thermus thermophilus	274	S	1060	1264	2324	0.00017
Thermus sp. CCB_US3_UF1	1111069	S	466	69	535	0.00004
Thermus sp. NEB1569	2918899	S	117	202	319	0.00002
Thermus aquaticus	271	S	572	84	656	0.00005
Thermus oshimai	56957	S	536	103	639	0.00005
Thermus brockianus	56956	S	472	92	564	0.00004
Thermus caldilimi	2483360	S	267	65	332	0.00002
Thermus scotoductus	37636	S	100	144	244	0.00002
Thermus parvatiensis	456163	S	70	320	390	0.00003
Meiothermus silvanus	52022	S	885	151	1036	0.00007
Meiothermus taiwanensis	172827	S	716	272	988	0.00007
Meiothermus ruber	277	S	627	251	878	0.00006
Oceanithermus profundus	187137	S	2697	317	3014	0.00022
Marinithermus hydrothermalis	186192	S	1688	317	2005	0.00014
Truepera radiovictrix	332249	S	2236	134	2370	0.00017
Sphaerobacter thermophilus	2057	S	9400	677	10077	0.00073
Thermomicrobium roseum	500	S	1942	49	1991	0.00014
Roseiflexus sp. RS-1	357808	S	2193	476	2669	0.00019
Roseiflexus castenholzii	120962	S	2098	474	2572	0.00019
Chloroflexus aurantiacus	1108	S	811	122	933	0.00007
Chloroflexus aggregans	152260	S	700	154	854	0.00006
Tepidiforma bonchosmolovskayae	2601677	S	5444	259	5703	0.00041
Candidatus Promineofilum breve	1806508	S	4916	111	5027	0.00036
Anaerolinea thermophila	167964	S	1400	155	1555	0.00011
Pelolinea submarina	913107	S	1063	54	1117	0.00008
Brevefilum fermentans	1986204	S	403	16	419	0.00003
Caldilinea aerophila	133453	S	2340	183	2523	0.00018
Dehalogenimonas formicexedens	1839801	S	497	156	653	0.00005
Dehalogenimonas sp. GP	1536648	S	298	93	391	0.00003
Dehalococcoides mccartyi	61435	S	119	308	427	0.00003
Phototrophicus methaneseepsis	2710758	S	1055	13	1068	0.00008
Ktedonosporobacter rubrisoli	2509675	S	1043	38	1081	0.00008
Thermobaculum terrenum	166501	S	960	160	1120	0.00008
Synechococcus sp. CBW1004	1353136	S	933	233	1166	0.00008
Synechococcus sp. RSCCF101	2511069	S	775	181	956	0.00007
Synechococcus sp. CBW1107	2789857	S	698	131	829	0.00006
Synechococcus sp. CBW1108	1353147	S	480	64	544	0.00004
Synechococcus sp. JA-3-3Ab	321327	S	477	112	589	0.00004
Synechococcus sp. SynAce01	1916956	S	446	48	494	0.00004
Synechococcus sp. CB0101	232348	S	424	91	515	0.00004
Synechococcus sp. NB0720_10	2907159	S	359	92	451	0.00003
Synechococcus sp. JA-2-3B'a(2-13)	321332	S	322	68	390	0.00003
Synechococcus sp. LTW-R	2751170	S	292	69	361	0.00003
Synechococcus sp. RS9909	221352	S	292	101	393	0.00003
Synechococcus sp. LA31	2741953	S	283	61	344	0.00002
Synechococcus sp. WH 8101	59932	S	241	78	319	0.00002
Synechococcus sp. PCC 7336	195250	S	240	8	248	0.00002
Synechococcus sp. A10-1-5-1	2936507	S	216	48	264	0.00002
Synechococcus sp. HK01-R	2751171	S	192	31	223	0.00002
Synechococcus sp. KORDI-100	1280380	S	189	13	202	0.00001
Synechococcus sp. Minos11	221341	S	161	11	172	0.00001
Synechococcus sp. NOUM97013	1442555	S	148	22	170	0.00001
Synechococcus sp. PROS-U-1	1400866	S	142	24	166	0.00001
Synechococcus sp. KORDI-52	585425	S	123	36	159	0.00001
Synechococcus sp. BIOS-E4-1	1400864	S	106	10	116	0.00001
Synechococcus sp. BMK-MC-1	1442551	S	106	39	145	0.00001
Synechococcus sp. MEDNS5	1442554	S	100	31	131	0.00001
Synechococcus sp. KORDI-49	585423	S	95	85	180	0.00001
Synechococcus sp. A15-127	1050624	S	93	83	176	0.00001
Synechococcus sp. MIT S9220	166309	S	85	12	97	0.00001
Synechococcus sp. A15-62	1050657	S	80	51	131	0.00001
Synechococcus sp. CBW1006	1353138	S	80	528	608	0.00004
Synechococcus sp. PROS-7-1	1442556	S	71	29	100	0.00001
Synechococcus sp. CC9902	316279	S	66	6	72	0.00001
Synechococcus sp. CBW1002	1353134	S	65	488	553	0.00004
Synechococcus sp. A15-44	1050646	S	64	101	165	0.00001
Synechococcus sp. PCC 6312	195253	S	64	3	67	0.00000
Synechococcus sp. WH 8109	166314	S	62	42	104	0.00001
Synechococcus sp. NIES-970	1827144	S	61	11	72	0.00001
Synechococcus sp. WH 8020	32052	S	57	10	67	0.00000
Synechococcus sp. PCC 7003	374981	S	57	16	73	0.00001
Synechococcus sp. TAK9802	1442558	S	55	118	173	0.00001
Synechococcus sp. ROS8604	1442557	S	51	12	63	0.00000
Synechococcus sp. BIOS-U3-1	1400865	S	50	5	55	0.00000
Synechococcus sp. RS9902	221345	S	42	76	118	0.00001
Synechococcus sp. RS9907	221350	S	39	80	119	0.00001
Synechococcus sp. M16.1	1442553	S	36	95	131	0.00001
Synechococcus sp. PCC 7502	1173263	S	35	2	37	0.00000
Synechococcus sp. CC9311	64471	S	31	7	38	0.00000
Synechococcus sp. SYN20	1050714	S	29	38	67	0.00000
Synechococcus sp. PROS-9-1	1968775	S	25	5	30	0.00000
Synechococcus sp. A18-25c	1866938	S	24	155	179	0.00001
Synechococcus sp. A15-60	1050655	S	22	137	159	0.00001
Synechococcus sp. PCC 11901	2579791	S	14	59	73	0.00001
Synechococcus sp. MVIR-18-1	1386941	S	13	20	33	0.00000
Synechococcus sp. PCC 73109	374982	S	12	48	60	0.00000
Synechococcus sp. PCC 7117	195498	S	10	42	52	0.00000
Synechococcus elongatus	32046	S	351	15	366	0.00003
Dactylococcopsis salina	292566	S	38	15	53	0.00000
Cyanobium sp. NIES-981	1851505	S	837	259	1096	0.00008
Cyanobium sp. NS01	261284	S	704	242	946	0.00007
Cyanobium gracile	59930	S	1058	215	1273	0.00009
Parasynechococcus marenigrum	2881428	S	203	60	263	0.00002
Prochlorococcus marinus	1219	S	114	14	128	0.00001
Acaryochloris marina	155978	S	78	24	102	0.00001
Acaryochloris sp. 'Moss Beach'	2740837	S	37	54	91	0.00001
Synechocystis sp. PCC 6714	1147	S	43	15	58	0.00000
Synechocystis sp. CACIAM 05	1933929	S	10	70	80	0.00001
Chamaesiphon minutus	1173032	S	141	8	149	0.00001
Nostoc sp. UHCC 0702	2814655	S	177	35	212	0.00002
Nostoc sp. NIES-4103	2005458	S	171	36	207	0.00001
Nostoc sp. C052	2576902	S	107	27	134	0.00001
Nostoc sp. TCL26-01	2576904	S	77	11	88	0.00001
Nostoc sp. ATCC 53789	76335	S	72	103	175	0.00001
Nostoc sp. MS1	2764711	S	72	21	93	0.00001
Nostoc sp. PCC 7524	28072	S	69	14	83	0.00001
Nostoc sp. UHCC 0870	2914041	S	63	21	84	0.00001
Nostoc sp. CENA543	1869241	S	62	9	71	0.00001
Nostoc sp. 'Lobaria pulmonaria (5183) cyanobiont'	1618022	S	61	13	74	0.00001
Nostoc sp. 'Peltigera membranacea cyanobiont' N6	1261031	S	61	18	79	0.00001
Nostoc sp. PCC 7107	317936	S	47	24	71	0.00001
Nostoc sp. NIES-2111	1973475	S	45	95	140	0.00001
Nostoc sp. C057	2576903	S	43	64	107	0.00001
Nostoc sp. TCL240-02	2572090	S	38	20	58	0.00000
Nostoc sp. NIES-3756	1751286	S	14	34	48	0.00000
Nostoc linckia	92942	S	102	23	125	0.00001
Nostoc flagelliforme	1306274	S	96	37	133	0.00001
Nostoc edaphicum	264686	S	86	25	111	0.00001
Nostoc sphaeroides	446679	S	86	51	137	0.00001
Nostoc punctiforme	272131	S	81	60	141	0.00001
Nostoc piscinale	224012	S	66	32	98	0.00001
Nostoc commune	1178	S	61	20	81	0.00001
Anabaena sp. WA102	1647413	S	58	112	170	0.00001
Anabaena sp. 90	46234	S	30	250	280	0.00002
Anabaena cylindrica	1165	S	66	20	86	0.00001
Cylindrospermum stagnale	142864	S	106	37	143	0.00001
Trichormus azollae	1164	S	59	11	70	0.00001
Richelia sinica	1357545	S	37	7	44	0.00000
Calothrix sp. NIES-3974	2005462	S	161	13	174	0.00001
Calothrix sp. NIES-2100	1954172	S	138	82	220	0.00002
Calothrix sp. PCC 7716	2853227	S	112	67	179	0.00001
Calothrix sp. PCC 7507	99598	S	108	23	131	0.00001
Calothrix sp. NIES-2098	1954171	S	91	50	141	0.00001
Calothrix sp. PCC 6303	1170562	S	64	17	81	0.00001
Calothrix sp. 336/3	1337936	S	52	13	65	0.00000
Calothrix brevissima	938406	S	133	58	191	0.00001
Calothrix parasitica	1973486	S	100	5	105	0.00001
Scytonema sp. NIES-4073	2005464	S	474	145	619	0.00004
Scytonema sp. HK-05	1137095	S	299	73	372	0.00003
Brasilonema sennae	1397703	S	130	12	142	0.00001
Sphaerospermopsis torques-reginae	984207	S	99	38	137	0.00001
Sphaerospermopsis kisseleviana	289435	S	90	38	128	0.00001
Nodularia sphaerocarpa	137816	S	63	16	79	0.00001
Nodularia spumigena	70799	S	61	28	89	0.00001
Dolichospermum compactum	136073	S	48	65	113	0.00001
Dolichospermum flos-aquae	1166	S	22	191	213	0.00002
Dolichospermum sp. UHCC 0315A	1914871	S	16	117	133	0.00001
Anabaenopsis circularis	109266	S	40	24	64	0.00000
Anabaenopsis elenkinii	156213	S	19	3	22	0.00000
Tolypothrix sp. PCC 7910	2099387	S	118	36	154	0.00001
Tolypothrix tenuis	457083	S	69	29	98	0.00001
Fischerella sp. NIES-4106	2005456	S	67	9	76	0.00001
Fischerella sp. NIES-3754	1752063	S	66	15	81	0.00001
Rivularia sp. PCC 7116	373994	S	41	2	43	0.00000
Gloeobacter kilaueensis	1416614	S	1136	33	1169	0.00008
Gloeobacter morelensis	2907343	S	939	407	1346	0.00010
Gloeobacter violaceus	33072	S	895	426	1321	0.00010
Anthocerotibacter panamensis	2857077	S	355	10	365	0.00003
Leptolyngbya sp. 7M	2812896	S	1227	89	1316	0.00010
Leptolyngbya sp. BL0902	1115757	S	409	26	435	0.00003
Leptolyngbya sp. NIES-3755	1752064	S	78	8	86	0.00001
Leptolyngbya sp. PCC 7376	111781	S	32	2	34	0.00000
Leptolyngbya boryana	1184	S	75	0	75	0.00001
Kovacikia minuta	2931930	S	347	34	381	0.00003
Leptothermofonsia sichuanensis	2917832	S	180	17	197	0.00001
Leptodesmis sichuanensis	2906798	S	169	19	188	0.00001
Thermoleptolyngbya sp. PKUAC-SCTB121	2811482	S	59	497	556	0.00004
Thermosynechococcus sp. NK55a	1394889	S	56	29	85	0.00001
Thermosynechococcus sp. CL-1	2583530	S	27	27	54	0.00000
Thermosynechococcus sp. TA-1	2813673	S	23	22	45	0.00000
Thermosynechococcus vestitus	146786	S	99	42	141	0.00001
Halomicronema hongdechloris	1209493	S	265	11	276	0.00002
Pseudanabaena sp. PCC 7367	82654	S	84	3	87	0.00001
Pseudanabaena sp. ABRG5-3	685565	S	51	3	54	0.00000
Geitlerinema sp. PCC 7407	1173025	S	582	90	672	0.00005
Allocoleopsis franciscana	2886352	S	91	10	101	0.00001
Moorena producens	1155739	S	421	11	432	0.00003
Oscillatoria nigro-viridis	482564	S	151	79	230	0.00002
Oscillatoria acuminata	118323	S	92	6	98	0.00001
Oxynema aestuarii	2874213	S	282	26	308	0.00002
Microcoleus vaginatus	119532	S	105	33	138	0.00001
Planktothrix agardhii	1160	S	21	20	41	0.00000
Planktothrix rubescens	59512	S	17	10	27	0.00000
[Phormidium] sp. ETS-05	222819	S	167	10	177	0.00001
Crinalium epipsammum	241425	S	44	6	50	0.00000
Microcystis aeruginosa	1126	S	148	209	357	0.00003
Microcystis sp. MC19	1967666	S	21	15	36	0.00000
Halothece sp. PCC 7418	65093	S	68	24	92	0.00001
Euhalothece natronophila	577489	S	17	2	19	0.00000
Gloeothece verrucosa	2546359	S	34	6	40	0.00000
Gloeothece citriformis	2546356	S	31	6	37	0.00000
Crocosphaera subtropica	2546360	S	47	3	50	0.00000
Rippkaea orientalis	2546366	S	36	3	39	0.00000
Candidatus Atelocyanobacterium thalassa	713887	S	11	1	12	0.00000
Geminocystis herdmanii	669359	S	39	12	51	0.00000
Geminocystis sp. NIES-3709	1617448	S	17	4	21	0.00000
Geminocystis sp. NIES-3708	1615909	S	14	4	18	0.00000
Gloeocapsa sp. PCC 7428	1173026	S	79	9	88	0.00001
Chondrocystis sp. NIES-4102	2005460	S	38	5	43	0.00000
Cyanobacterium aponinum	379064	S	33	9	42	0.00000
Chroococcidiopsis sp. CCMEE 29	155894	S	296	53	349	0.00003
Chroococcidiopsis sp. CCNUC1	2653189	S	41	42	83	0.00001
Chroococcidiopsis thermalis	54299	S	112	127	239	0.00002
Pleurocapsa sp. PCC 7327	118163	S	112	13	125	0.00001
Stanieria cyanosphaera	102116	S	35	10	45	0.00000
Stanieria sp. NIES-3757	1807358	S	16	11	27	0.00000
Gloeomargarita lithophora	1188228	S	94	3	97	0.00001
Thermostichus lividus	33070	S	63	9	72	0.00001
cyanobacterium endosymbiont of Epithemia turgida	718217	S	15	6	21	0.00000
Fimbriimonas ginsengisoli	1005039	S	2079	12	2091	0.00015
Chthonomonas calidirosea	454171	S	573	5	578	0.00004
Mycoplasma sp. SG1	2810348	S	22	2	24	0.00000
Mycoplasma genitalium	2097	S	10	0	10	0.00000
Candidatus Hepatoplasma crinochetorum	295596	S	13	128	141	0.00001
Alteracholeplasma palmae	38986	S	18	12	30	0.00000
Paracholeplasma brassicae	61635	S	12	7	19	0.00000
Haploplasma axanthum	29552	S	11	16	27	0.00000
Candidatus Izimaplasma sp. HR1	1541959	S	12	8	20	0.00000
Bradyrhizobium sp. 200	2782665	S	6003	1335	7338	0.00053
Bradyrhizobium sp. 170	2782641	S	5579	1428	7007	0.00051
Bradyrhizobium sp. CCBAU 51753	1325100	S	5087	1139	6226	0.00045
Bradyrhizobium sp. CCBAU 051011	858422	S	5041	993	6034	0.00044
Bradyrhizobium sp. BTAi1	288000	S	4603	859	5462	0.00039
Bradyrhizobium sp. ORS 278	114615	S	4598	1068	5666	0.00041
Bradyrhizobium sp. A19	2898149	S	4370	782	5152	0.00037
Bradyrhizobium sp. ORS 285	115808	S	4291	983	5274	0.00038
Bradyrhizobium sp. SK17	2057741	S	3643	1230	4873	0.00035
Bradyrhizobium sp. 186	2782654	S	3528	947	4475	0.00032
Bradyrhizobium sp. CCBAU 53421	1325120	S	2980	953	3933	0.00028
Bradyrhizobium sp. CCBAU 53338	1325111	S	2527	1070	3597	0.00026
Bradyrhizobium sp. 1(2017)	1404888	S	2510	798	3308	0.00024
Bradyrhizobium sp. CCBAU 53340	1325112	S	2382	956	3338	0.00024
Bradyrhizobium sp. 195	2782662	S	2379	859	3238	0.00023
Bradyrhizobium sp. CCBAU 53351	1325114	S	2284	1189	3473	0.00025
Bradyrhizobium sp. CCGE-LA001	1223566	S	2145	821	2966	0.00021
Bradyrhizobium sp. 6(2017)	1197460	S	2021	1026	3047	0.00022
Bradyrhizobium sp. S2-11-2	2840472	S	2003	1477	3480	0.00025
Bradyrhizobium sp. CCBAU 51765	1325102	S	1920	1710	3630	0.00026
Bradyrhizobium sp. 191	2782659	S	1803	1719	3522	0.00025
Bradyrhizobium sp. I71	2590772	S	1790	1519	3309	0.00024
Bradyrhizobium sp. 41S5	1404443	S	1695	1185	2880	0.00021
Bradyrhizobium sp. S2-20-1	2840469	S	1633	1276	2909	0.00021
Bradyrhizobium sp. S2-11-4	2840473	S	1585	1361	2946	0.00021
Bradyrhizobium sp. C-145	574727	S	1020	1053	2073	0.00015
Bradyrhizobium sp.	376	S	819	2801	3620	0.00026
Bradyrhizobium sp. 144S4	2823807	S	700	1763	2463	0.00018
Bradyrhizobium sp. 40	2782674	S	638	1384	2022	0.00015
Bradyrhizobium sp. 323S2	1404649	S	600	1546	2146	0.00016
Bradyrhizobium sp. 4	2782678	S	592	1436	2028	0.00015
Bradyrhizobium sp. 192	2782660	S	513	1274	1787	0.00013
Bradyrhizobium sp. LCT2	2493093	S	368	1075	1443	0.00010
Bradyrhizobium sp. CW1	2782686	S	277	4143	4420	0.00032
Bradyrhizobium sp. 187	2782655	S	233	1129	1362	0.00010
Bradyrhizobium sp. SG09	2599805	S	214	1561	1775	0.00013
Bradyrhizobium sp. TM102	2599819	S	188	1307	1495	0.00011
Bradyrhizobium sp. 38S5	2819348	S	154	1819	1973	0.00014
Bradyrhizobium sp. 172	2782643	S	129	1520	1649	0.00012
Bradyrhizobium sp. 131	2782609	S	94	1486	1580	0.00011
Bradyrhizobium sp. 1S5	2816456	S	92	1000	1092	0.00008
Bradyrhizobium sp. 155	2782629	S	62	1081	1143	0.00008
Bradyrhizobium erythrophlei	1437360	S	14088	1214	15302	0.00111
Bradyrhizobium diazoefficiens	1355477	S	10640	21266	31906	0.00231
Bradyrhizobium icense	1274631	S	5734	856	6590	0.00048
Bradyrhizobium lablabi	722472	S	4786	5858	10644	0.00077
Bradyrhizobium paxllaeri	190148	S	4714	927	5641	0.00041
Bradyrhizobium japonicum	375	S	4191	6283	10474	0.00076
Bradyrhizobium oligotrophicum	44255	S	4085	750	4835	0.00035
Bradyrhizobium genosp. L	83637	S	3980	846	4826	0.00035
Bradyrhizobium canariense	255045	S	3802	6277	10079	0.00073
Bradyrhizobium arachidis	858423	S	3297	991	4288	0.00031
Bradyrhizobium guangdongense	1325090	S	2791	1089	3880	0.00028
Bradyrhizobium vignae	1549949	S	2748	678	3426	0.00025
Bradyrhizobium genosp. B	83627	S	2617	586	3203	0.00023
Bradyrhizobium quebecense	2748629	S	2564	1521	4085	0.00030
Bradyrhizobium cosmicum	1404864	S	2432	829	3261	0.00024
Bradyrhizobium guangzhouense	1325095	S	2370	944	3314	0.00024
Bradyrhizobium guangxiense	1325115	S	2258	1029	3287	0.00024
Bradyrhizobium septentrionale	1404411	S	2102	1344	3446	0.00025
Bradyrhizobium daqingense	993502	S	1904	1078	2982	0.00022
Bradyrhizobium amphicarpaeae	1404768	S	1559	679	2238	0.00016
Bradyrhizobium betae	244734	S	1508	891	2399	0.00017
Bradyrhizobium symbiodeficiens	1404367	S	1391	2187	3578	0.00026
Bradyrhizobium zhanjiangense	1325107	S	1205	1262	2467	0.00018
Bradyrhizobium elkanii	29448	S	788	3330	4118	0.00030
Bradyrhizobium ottawaense	931866	S	533	3493	4026	0.00029
Rhodopseudomonas palustris	1076	S	15746	5506	21252	0.00154
Rhodopseudomonas sp. SK50-23	340268	S	2154	467	2621	0.00019
Rhodopseudomonas boonkerdii	475937	S	2121	599	2720	0.00020
Tardiphaga sp. 37S4	1404741	S	1102	839	1941	0.00014
Tardiphaga sp. vice154	2592814	S	79	1144	1223	0.00009
Tardiphaga sp. vice278	2592815	S	59	1341	1400	0.00010
Tardiphaga sp. vice304	2592817	S	38	674	712	0.00005
Tardiphaga sp. vice352	2592816	S	18	510	528	0.00004
Tardiphaga robiniae	943830	S	1175	798	1973	0.00014
Nitrobacter hamburgensis	912	S	2899	519	3418	0.00025
Nitrobacter winogradskyi	913	S	2647	466	3113	0.00023
Afipia carboxidovorans	40137	S	2882	1279	4161	0.00030
Afipia sp. GAS231	1882747	S	1996	1548	3544	0.00026
Variibacter gotjawalensis	1333996	S	4631	382	5013	0.00036
Rhizobium sp. BG4	2613770	S	2097	396	2493	0.00018
Rhizobium sp. WYJ-E13	2849093	S	1862	234	2096	0.00015
Rhizobium sp. NXC24	2048897	S	1675	234	1909	0.00014
Rhizobium sp. ACO-34A	1571470	S	1499	314	1813	0.00013
Rhizobium sp. WL3	2603277	S	1405	252	1657	0.00012
Rhizobium sp. SL42	2806346	S	1384	247	1631	0.00012
Rhizobium sp. AB2/73	2795216	S	1231	515	1746	0.00013
Rhizobium sp. 11515TR	2028343	S	1157	256	1413	0.00010
Rhizobium sp. CIAT894	2020312	S	1035	426	1461	0.00011
Rhizobium sp. NZLR1	2731096	S	983	319	1302	0.00009
Rhizobium sp. NLR16a	2731112	S	916	378	1294	0.00009
Rhizobium sp. NXC14	1981173	S	904	348	1252	0.00009
Rhizobium sp. K102	2918527	S	825	523	1348	0.00010
Rhizobium sp. C104	2917727	S	757	383	1140	0.00008
Rhizobium sp. L51/94	2819999	S	629	720	1349	0.00010
Rhizobium sp. 007	2785056	S	546	900	1446	0.00010
Rhizobium sp. X9	2815360	S	475	911	1386	0.00010
Rhizobium sp. Kim5	2020311	S	274	557	831	0.00006
Rhizobium sp. IE4771	1301032	S	264	493	757	0.00005
Rhizobium sp. TAL182	2020313	S	214	566	780	0.00006
Rhizobium sp. NIBRBAC000502774	2590777	S	123	333	456	0.00003
Rhizobium sp. ZX09	2291939	S	107	426	533	0.00004
Rhizobium sp. T136	555319	S	73	1893	1966	0.00014
Rhizobium sp. Y9	1914541	S	71	236	307	0.00002
Rhizobium sp. B230/85	2819994	S	68	654	722	0.00005
Rhizobium sp. CCGE531	2364271	S	40	1272	1312	0.00009
Rhizobium sp. N324	1703969	S	33	619	652	0.00005
Rhizobium sp. B21/90	2819993	S	25	782	807	0.00006
Rhizobium sp. CCGE532	2364272	S	17	1143	1160	0.00008
Rhizobium leguminosarum	384	S	9427	11731	21158	0.00153
Rhizobium etli	29449	S	2695	3080	5775	0.00042
Rhizobium pseudoryzae	379684	S	2055	426	2481	0.00018
Rhizobium gallicum	56730	S	2001	2422	4423	0.00032
Rhizobium jaguaris	1312183	S	1801	222	2023	0.00015
Rhizobium phaseoli	396	S	1536	2960	4496	0.00032
Rhizobium bangladeshense	1138189	S	1423	332	1755	0.00013
Rhizobium lentis	1138194	S	1134	340	1474	0.00011
Rhizobium rosettiformans	1368430	S	1125	469	1594	0.00012
Rhizobium tropici	398	S	1087	276	1363	0.00010
Rhizobium rhizoryzae	451876	S	1063	145	1208	0.00009
Rhizobium binae	1138190	S	1051	373	1424	0.00010
Rhizobium daejeonense	240521	S	959	305	1264	0.00009
Rhizobium pusense	648995	S	905	3208	4113	0.00030
Rhizobium indicum	2583231	S	700	582	1282	0.00009
Rhizobium acidisoli	1538158	S	573	446	1019	0.00007
Rhizobium oryzihabitans	2267833	S	359	431	790	0.00006
Rhizobium laguerreae	1076926	S	266	428	694	0.00005
Rhizobium hidalgonense	1538159	S	237	511	748	0.00005
Rhizobium ruizarguesonis	2081791	S	181	1247	1428	0.00010
Rhizobium favelukesii	348824	S	28	877	905	0.00007
Agrobacterium tumefaciens	358	S	17637	10455	28092	0.00203
Agrobacterium fabrum	1176649	S	500	506	1006	0.00007
Agrobacterium fabacearum	1183401	S	126	1028	1154	0.00008
Agrobacterium vitis	373	S	2483	297	2780	0.00020
Agrobacterium sp. T29	2580515	S	912	545	1457	0.00011
Agrobacterium sp. MA01	2664893	S	285	525	810	0.00006
Agrobacterium sp. RAC06	1842536	S	276	519	795	0.00006
Agrobacterium sp. CGMCC 11546	2579248	S	125	193	318	0.00002
Agrobacterium sp. S7/73	2820002	S	79	278	357	0.00003
Agrobacterium vaccinii	2735528	S	968	125	1093	0.00008
Agrobacterium larrymoorei	160699	S	739	126	865	0.00006
Agrobacterium salinitolerans	1183413	S	685	206	891	0.00006
Agrobacterium rubi	28099	S	599	158	757	0.00005
Agrobacterium rhizogenes	359	S	484	875	1359	0.00010
Neorhizobium galegae	399	S	6413	1754	8167	0.00059
Neorhizobium sp. SOG26	2060726	S	1728	357	2085	0.00015
Neorhizobium sp. NCHU2750	1825976	S	1606	333	1939	0.00014
Pseudorhizobium flavum	1335061	S	1331	818	2149	0.00016
Pseudorhizobium banfieldiae	1125847	S	1255	709	1964	0.00014
Sinorhizobium meliloti	382	S	15814	8438	24252	0.00175
Sinorhizobium fredii	380	S	8700	11246	19946	0.00144
Sinorhizobium americanum	194963	S	2925	1079	4004	0.00029
Sinorhizobium sp. BG8	2613773	S	2087	356	2443	0.00018
Sinorhizobium sp. CCBAU 05631	794846	S	517	708	1225	0.00009
Sinorhizobium medicae	110321	S	2528	331	2859	0.00021
Ensifer adhaerens	106592	S	5636	3015	8651	0.00063
Ensifer mexicanus	375549	S	3720	581	4301	0.00031
Ensifer alkalisoli	1752398	S	2589	510	3099	0.00022
Ensifer sojae	716925	S	2473	922	3395	0.00025
Ensifer sp. PDNC004	2811423	S	1865	775	2640	0.00019
Ensifer sp. T173	555315	S	441	1788	2229	0.00016
Shinella sp. HZN7	879274	S	7818	6579	14397	0.00104
Shinella sp. PSBB067	2715959	S	3003	2211	5214	0.00038
Shinella sp. XGS7	2877941	S	1971	1938	3909	0.00028
Shinella sp. H4-D48	2925841	S	1194	460	1654	0.00012
Shinella zoogloeoides	352475	S	3095	4405	7500	0.00054
Shinella oryzae	2871820	S	1615	693	2308	0.00017
Ciceribacter thiooxidans	1969821	S	2178	444	2622	0.00019
Georhizobium profundi	2341112	S	2176	496	2672	0.00019
Peteryoungia desertarenae	1813451	S	731	132	863	0.00006
Liberibacter crescens	1273132	S	28	6	34	0.00000
Candidatus Liberibacter asiaticus	34021	S	25	12	37	0.00000
Candidatus Liberibacter solanacearum	556287	S	11	3	14	0.00000
Mesorhizobium sp. 8	2584466	S	6132	1553	7685	0.00056
Mesorhizobium sp. DCY119	2108445	S	4530	1125	5655	0.00041
Mesorhizobium sp. Pch-S	2082387	S	3480	504	3984	0.00029
Mesorhizobium sp. B1-1-8	2589976	S	3026	808	3834	0.00028
Mesorhizobium sp. M3A.F.Ca.ET.080.04.2.1	2493676	S	3009	968	3977	0.00029
Mesorhizobium sp. J8	2777475	S	2989	1025	4014	0.00029
Mesorhizobium sp. M1B.F.Ca.ET.045.04.1.1	2493673	S	2957	1201	4158	0.00030
Mesorhizobium sp. L-2-11	2744521	S	2927	1188	4115	0.00030
Mesorhizobium sp. M1D.F.Ca.ET.043.01.1.1	2493669	S	2823	1797	4620	0.00033
Mesorhizobium sp. M1E.F.Ca.ET.045.02.1.1	2493672	S	2814	1489	4303	0.00031
Mesorhizobium sp. B2-1-1	2589974	S	2797	672	3469	0.00025
Mesorhizobium sp. 131-2-1	2744518	S	2724	1529	4253	0.00031
Mesorhizobium sp. M1A.F.Ca.IN.022.06.1.1	2493680	S	2697	916	3613	0.00026
Mesorhizobium sp. M9A.F.Ca.ET.002.03.1.2	2493668	S	2650	1288	3938	0.00028
Mesorhizobium sp. B2-8-5	2589903	S	2626	924	3550	0.00026
Mesorhizobium sp. INR15	2654248	S	2531	386	2917	0.00021
Mesorhizobium sp. PAMC28654	2880934	S	2495	496	2991	0.00022
Mesorhizobium sp. M4B.F.Ca.ET.058.02.1.1	2493675	S	2434	1089	3523	0.00025
Mesorhizobium sp. M6A.T.Cr.TU.016.01.1.1	2493677	S	2343	830	3173	0.00023
Mesorhizobium sp. B4-1-4	2589888	S	1936	495	2431	0.00018
Mesorhizobium sp. B2-1-8	2589967	S	1821	592	2413	0.00017
Mesorhizobium sp. L-8-10	2744523	S	1746	5932	7678	0.00055
Mesorhizobium sp. M7D.F.Ca.US.005.01.1.1	2493678	S	1728	625	2353	0.00017
Mesorhizobium sp. M8A.F.Ca.ET.057.01.1.1	2493679	S	1642	662	2304	0.00017
Mesorhizobium sp. L-8-3	2744522	S	1595	5566	7161	0.00052
Mesorhizobium sp. NZP2077	2483404	S	1532	538	2070	0.00015
Mesorhizobium sp. AA22	1854057	S	1529	1016	2545	0.00018
Mesorhizobium sp. M2A.F.Ca.ET.043.05.1.1	2493671	S	1519	1381	2900	0.00021
Mesorhizobium sp. M7A.F.Ce.TU.012.03.2.1	2493681	S	1477	574	2051	0.00015
Mesorhizobium sp. NBSH29	2654249	S	1447	110	1557	0.00011
Mesorhizobium sp. 113-3-3	2744516	S	1390	812	2202	0.00016
Mesorhizobium sp. 113-1-2	2744515	S	1326	692	2018	0.00015
Mesorhizobium sp. NZP2298	2483403	S	1114	706	1820	0.00013
Mesorhizobium sp. 113-3-9	2744517	S	1054	837	1891	0.00014
Mesorhizobium sp. M2A.F.Ca.ET.046.03.2.1	2493674	S	967	2766	3733	0.00027
Mesorhizobium sp. M2A.F.Ca.ET.043.02.1.1	2493670	S	749	2038	2787	0.00020
Mesorhizobium sp. WSM1497	278153	S	353	748	1101	0.00008
Mesorhizobium sp. 131-2-5	2744519	S	269	1914	2183	0.00016
Mesorhizobium sp. 131-3-5	2744520	S	181	589	770	0.00006
Mesorhizobium sp. NZP2234	2483402	S	169	636	805	0.00006
Mesorhizobium terrae	2725666	S	3490	1218	4708	0.00034
Mesorhizobium opportunistum	593909	S	2852	1210	4062	0.00029
Mesorhizobium amorphae	71433	S	2360	599	2959	0.00021
Mesorhizobium ciceri	39645	S	1798	4637	6435	0.00046
Mesorhizobium loti	381	S	1744	14753	16497	0.00119
Mesorhizobium australicum	536018	S	1483	488	1971	0.00014
Mesorhizobium huakuii	28104	S	1401	1062	2463	0.00018
Mesorhizobium erdmanii	1777866	S	1390	415	1805	0.00013
Mesorhizobium japonicum	2066070	S	1241	959	2200	0.00016
Aquibium microcysteis	675281	S	6912	2114	9026	0.00065
Aquibium oceanicum	1670800	S	5115	1292	6407	0.00046
Aminobacter sp. MSH1	374606	S	3554	2337	5891	0.00043
Aminobacter sp. SR38	2774562	S	678	3029	3707	0.00027
Aminobacter sp. MDW-2	2666139	S	488	2455	2943	0.00021
Aminobacter aminovorans	83263	S	430	1574	2004	0.00014
Nitratireductor sp. SY7	2599600	S	4280	875	5155	0.00037
Nitratireductor sp. OM-1	1756988	S	2114	396	2510	0.00018
Nitratireductor kimnyeongensis	430679	S	1200	187	1387	0.00010
Phyllobacterium sp. T1018	555316	S	1297	179	1476	0.00011
Phyllobacterium sp. 628	2718938	S	568	87	655	0.00005
Phyllobacterium sp. T1293	555317	S	540	73	613	0.00004
Phyllobacterium zundukense	1867719	S	1436	220	1656	0.00012
Roseitalea porphyridii	1852022	S	3065	558	3623	0.00026
Hoeflea phototrophica	244596	S	1187	146	1333	0.00010
Hoeflea sp. IMCC20628	1620421	S	1128	113	1241	0.00009
Oricola thermophila	2742145	S	2302	338	2640	0.00019
Salaquimonas pukyongi	2712698	S	834	39	873	0.00006
Lentilitoribacter sp. Alg239-R112	2305987	S	48	1	49	0.00000
Methylobacterium nodulans	114616	S	8255	1159	9414	0.00068
Methylobacterium sp. 17Sr1-1	2202826	S	3487	1792	5279	0.00038
Methylobacterium sp. WL1	2603276	S	3171	702	3873	0.00028
Methylobacterium sp. C1	1479019	S	384	2977	3361	0.00024
Methylobacterium sp. XJLW	739141	S	278	3704	3982	0.00029
Methylobacterium aquaticum	270351	S	6798	3235	10033	0.00072
Methylobacterium durans	2202825	S	5078	805	5883	0.00043
Methylobacterium currus	2051553	S	4620	2094	6714	0.00049
Methylobacterium radiodurans	2202828	S	4436	1194	5630	0.00041
Methylobacterium organophilum	410	S	3819	2305	6124	0.00044
Methylobacterium terrae	2202827	S	3763	1883	5646	0.00041
Methylobacterium brachiatum	269660	S	3377	1319	4696	0.00034
Methylobacterium mesophilicum	39956	S	3215	723	3938	0.00028
Methylobacterium tardum	374432	S	3167	1187	4354	0.00031
Methylobacterium indicum	1775910	S	3038	1630	4668	0.00034
Methylobacterium oryzae	334852	S	2615	3451	6066	0.00044
Methylobacterium radiotolerans	31998	S	1183	6700	7883	0.00057
Methylobacterium phyllosphaerae	418223	S	450	1680	2130	0.00015
Microvirga sp. VF16	2807101	S	20449	3433	23882	0.00173
Microvirga sp. 17 mud 1-3	2082949	S	6276	1427	7703	0.00056
Microvirga ossetica	1882682	S	17904	3389	21293	0.00154
Microvirga thermotolerans	2651334	S	8264	2440	10704	0.00077
Methylorubrum populi	223967	S	5972	2929	8901	0.00064
Methylorubrum extorquens	408	S	4502	7702	12204	0.00088
Methylorubrum sp. B1-46	2897334	S	2168	987	3155	0.00023
Methylorubrum zatmanii	29429	S	105	548	653	0.00005
Pseudolabrys taiwanensis	331696	S	8785	1603	10388	0.00075
Pseudolabrys sp. FHR47	2562284	S	7041	1370	8411	0.00061
Xanthobacter dioxanivorans	2528964	S	5206	1912	7118	0.00051
Xanthobacter sp. YC-JY1	2419844	S	1688	1757	3445	0.00025
Xanthobacter autotrophicus	280	S	1501	1686	3187	0.00023
Starkeya sp. ORNL1	2709380	S	5756	1256	7012	0.00051
Starkeya novella	921	S	4990	2004	6994	0.00051
Ancylobacter sp. TS-1	1850374	S	3641	1629	5270	0.00038
Ancylobacter polymorphus	223390	S	3466	1831	5297	0.00038
Ancylobacter pratisalsi	1745854	S	2830	692	3522	0.00025
Labrys sp. KNU-23	2789216	S	3876	433	4309	0.00031
Azorhizobium caulinodans	7	S	3447	789	4236	0.00031
Bosea sp. Tri-49	1867715	S	9031	2151	11182	0.00081
Bosea sp. F3-2	2599640	S	6229	2045	8274	0.00060
Bosea sp. RAC05	1842539	S	5344	1782	7126	0.00051
Bosea sp. ANAM02	2020412	S	5203	1979	7182	0.00052
Bosea sp. AS-1	2015316	S	4758	1543	6301	0.00046
Bosea sp. PAMC 26642	1792307	S	3778	822	4600	0.00033
Bosea vaviloviae	1526658	S	4405	1077	5482	0.00040
Rhodoplanes sp. Z2-YC6860	674703	S	16704	1785	18489	0.00134
Hyphomicrobium denitrificans	53399	S	3705	476	4181	0.00030
Hyphomicrobium nitrativorans	1427356	S	3225	304	3529	0.00026
Hyphomicrobium sp. MC1	717785	S	1814	144	1958	0.00014
Methyloceanibacter caenitepidi	1384459	S	1924	432	2356	0.00017
Methyloceanibacter sp. wino2	2170729	S	1886	451	2337	0.00017
Aquabacter sp. L1I39	2820278	S	2987	542	3529	0.00026
Methyloligella sp. GL2	2742204	S	2946	391	3337	0.00024
Rhodomicrobium vannielii	1069	S	2207	164	2371	0.00017
Caenibius sp. WL	2872646	S	962	194	1156	0.00008
Caenibius tardaugens	169176	S	658	545	1203	0.00009
Candidatus Filomicrobium marinum	1608628	S	1007	32	1039	0.00008
Devosia sp. A16	1736675	S	7054	897	7951	0.00057
Devosia sp. JXJ CY 41	2917991	S	2342	444	2786	0.00020
Devosia sp. SL43	2806348	S	2304	440	2744	0.00020
Devosia sp. 1566	2499144	S	1922	216	2138	0.00015
Devosia sp. I507	2083786	S	1763	542	2305	0.00017
Devosia sp. MC521	2759954	S	776	129	905	0.00007
Devosia ginsengisoli	400770	S	3300	619	3919	0.00028
Devosia salina	2860336	S	2662	904	3566	0.00026
Devosia oryziradicis	2801335	S	2323	441	2764	0.00020
Devosia beringensis	2657486	S	2198	335	2533	0.00018
Devosia rhizoryzae	2774137	S	1845	204	2049	0.00015
Youhaiella tibetensis	1447062	S	3005	693	3698	0.00027
Paradevosia shaoguanensis	1335043	S	2872	1115	3987	0.00029
Pelagibacterium halotolerans	531813	S	1593	188	1781	0.00013
Maritalea myrionectae	454601	S	279	9	288	0.00002
Aureimonas sp. SA4125	2826993	S	3642	731	4373	0.00032
Aureimonas sp. AU20	1349819	S	3156	491	3647	0.00026
Aureimonas sp. OT7	2816454	S	1602	1409	3011	0.00022
Aureimonas populi	1701758	S	2862	600	3462	0.00025
Aureimonas mangrovi	2758041	S	2485	565	3050	0.00022
Aureimonas altamirensis	370622	S	1625	608	2233	0.00016
Martelella sp. AD-3	686597	S	960	2745	3705	0.00027
Martelella mediterranea	293089	S	1674	640	2314	0.00017
Martelella endophytica	1486262	S	1493	353	1846	0.00013
Martelella lutilitoris	2583532	S	919	794	1713	0.00012
Aurantimonas sp. HBX-1	2906072	S	4827	1559	6386	0.00046
Pseudorhodoplanes sinuspersici	1235591	S	7324	588	7912	0.00057
Nordella sp. HKS 07	2712222	S	6719	403	7122	0.00051
Terrihabitans soli	708113	S	4568	560	5128	0.00037
Candidatus Hodgkinia cicadicola	573658	S	57	0	57	0.00000
Methylocystis bryophila	655015	S	2196	235	2431	0.00018
Methylocystis parvus	134	S	2192	274	2466	0.00018
Methylocystis heyeri	391905	S	1969	232	2201	0.00016
Methylocystis sp. SC2	187303	S	1319	352	1671	0.00012
Methylocystis sp. SB2	743836	S	520	810	1330	0.00010
Methylocystis rosea	173366	S	1444	1096	2540	0.00018
Methylosinus trichosporium	426	S	2964	629	3593	0.00026
Methylosinus sp. C49	2699395	S	2479	515	2994	0.00022
Stappia indica	538381	S	4632	1175	5807	0.00042
Stappia sp. ES.058	1881061	S	2364	315	2679	0.00019
Roseibium aggregatum	187304	S	2451	353	2804	0.00020
Roseibium alexandrii	388408	S	651	62	713	0.00005
Pannonibacter phragmitetus	121719	S	3043	2287	5330	0.00039
Labrenzia sp. VG12	2021862	S	1271	150	1421	0.00010
Labrenzia sp. PHM005	2590016	S	566	42	608	0.00004
Labrenzia sp. THAF82	2587861	S	564	35	599	0.00004
Pseudovibrio sp. FO-BEG1	911045	S	213	82	295	0.00002
Pseudovibrio brasiliensis	1898042	S	188	71	259	0.00002
Phreatobacter stygius	1940610	S	6007	970	6977	0.00050
Phreatobacter cathodiphilus	1868589	S	5237	1662	6899	0.00050
Phreatobacter sp. NMCR1094	2570229	S	3553	718	4271	0.00031
Chelatococcus sp. CO-6	1702325	S	6983	4119	11102	0.00080
Chelatococcus daeguensis	444444	S	3163	1808	4971	0.00036
Kaustia mangrovi	2593653	S	6263	660	6923	0.00050
Parvibaculum lavamentivorans	256618	S	2774	2065	4839	0.00035
Pyruvatibacter mobilis	1712261	S	1772	238	2010	0.00015
Candidatus Phaeomarinobacter ectocarpi	1458461	S	699	38	737	0.00005
Blastochloris tepida	2233851	S	4575	1659	6234	0.00045
Blastochloris viridis	1079	S	4026	1170	5196	0.00038
Methylocella silvestris	199596	S	2161	260	2421	0.00017
Methylocella tundrae	227605	S	1857	189	2046	0.00015
Methylovirgula ligni	569860	S	1771	216	1987	0.00014
Methylovirgula sp. HY1	2822761	S	1329	78	1407	0.00010
Beijerinckia indica	533	S	963	76	1039	0.00008
Acuticoccus sp. I52.16.1	2928472	S	5989	701	6690	0.00048
Kaistia sp. 32K	2795690	S	5434	1460	6894	0.00050
Brucella anthropi	529	S	1051	8403	9454	0.00068
Brucella intermedia	94625	S	996	184	1180	0.00009
Brucella sp. BTU1	2840456	S	132	25	157	0.00001
Brucella sp. 6810	2769351	S	64	96	160	0.00001
Brucella sp. 09RB8910	1844051	S	51	49	100	0.00001
Brucella sp. 10RB9215	1149953	S	46	46	92	0.00001
Brucella sp. BO3	2691913	S	38	57	95	0.00001
Brucella sp. 2280	2592625	S	36	67	103	0.00001
Brucella sp. BO2	693750	S	32	68	100	0.00001
Brucella sp. 458	2821140	S	25	51	76	0.00001
Brucella sp. 09RB8471	1149952	S	24	41	65	0.00000
[Ochrobactrum] quorumnocens	271865	S	332	52	384	0.00003
Brucella pseudogrignonensis	419475	S	229	74	303	0.00002
Brucella pituitosa	571256	S	94	34	128	0.00001
Brucella melitensis	29459	S	47	1229	1276	0.00009
Brucella inopinata	1218315	S	39	42	81	0.00001
Brucella abortus	235	S	16	802	818	0.00006
Brucella ovis	236	S	12	34	46	0.00000
Brucella suis	29461	S	10	788	798	0.00006
Pseudochrobactrum sp. XF203	2879116	S	86	86	172	0.00001
Pseudochrobactrum sp. Wa41.01b-1	2864102	S	65	72	137	0.00001
Pseudochrobactrum algeriensis	2834768	S	83	95	178	0.00001
Hartmannibacter diazotrophicus	1482074	S	3378	657	4035	0.00029
Breoghania sp. L-A4	2304600	S	3299	470	3769	0.00027
Lichenihabitans psoromatis	2528642	S	1013	562	1575	0.00011
Lichenihabitans sp. PAMC28606	2880932	S	895	577	1472	0.00011
Cohaesibacter sp. ES.047	1798205	S	603	26	629	0.00005
Bartonella apis	1686310	S	160	16	176	0.00001
Bartonella sp. HY038	2759660	S	49	13	62	0.00000
Bartonella sp. 46A	2893471	S	10	22	32	0.00000
Bartonella bacilliformis	774	S	18	13	31	0.00000
Bartonella australis	388640	S	16	6	22	0.00000
Bartonella henselae	38323	S	14	34	48	0.00000
Bartonella ancashensis	1318743	S	10	6	16	0.00000
Sphingomonas sp. S8-45	2938948	S	8313	1036	9349	0.00068
Sphingomonas sp. DM2-R-LB4	2899123	S	7598	2634	10232	0.00074
Sphingomonas sp. HDW15A	2714942	S	7526	622	8148	0.00059
Sphingomonas sp. MM-1	745310	S	5396	7005	12401	0.00090
Sphingomonas sp. CL5.1	2653203	S	4723	1644	6367	0.00046
Sphingomonas sp. AK-PDB1-5	2872652	S	4443	746	5189	0.00037
Sphingomonas sp. Cra20	1327635	S	4235	704	4939	0.00036
Sphingomonas sp. AP4-R1	2735134	S	3972	526	4498	0.00033
Sphingomonas sp. LM7	1938607	S	3900	897	4797	0.00035
Sphingomonas sp. S2-65	2903960	S	3581	742	4323	0.00031
Sphingomonas sp. NBWT7	2596913	S	3422	1164	4586	0.00033
Sphingomonas sp. FARSPH	2219696	S	3197	2692	5889	0.00043
Sphingomonas sp. AAP5	1523415	S	3047	821	3868	0.00028
Sphingomonas sp. KC8	1030157	S	2469	325	2794	0.00020
Sphingomonas sp. HMP9	1517554	S	2453	1169	3622	0.00026
Sphingomonas sp. PAMC26645	2565555	S	2434	872	3306	0.00024
Sphingomonas sp. HMP6	1517551	S	2067	432	2499	0.00018
Sphingomonas sp. LK11	1390395	S	1652	1676	3328	0.00024
Sphingomonas sp. NIC1	1961362	S	1357	4255	5612	0.00041
Sphingomonas sp. IC081	304378	S	502	3078	3580	0.00026
Sphingomonas sediminicola	386874	S	14312	1402	15714	0.00114
Sphingomonas daechungensis	1176646	S	12748	1259	14007	0.00101
Sphingomonas lutea	1045317	S	12246	1622	13868	0.00100
Sphingomonas xanthus	2594473	S	12081	2649	14730	0.00106
Sphingomonas rhizophila	2071607	S	11101	2803	13904	0.00100
Sphingomonas ginsengisoli An et al. 2013	363835	S	11074	1548	12622	0.00091
Sphingomonas sabuli	2764186	S	10715	1350	12065	0.00087
Sphingomonas sinipercae	2714944	S	9342	1284	10626	0.00077
Sphingomonas piscis	2714943	S	6851	649	7500	0.00054
Sphingomonas profundi	2681549	S	6191	1006	7197	0.00052
Sphingomonas koreensis	93064	S	5600	4182	9782	0.00071
Sphingomonas alpina	653931	S	5562	468	6030	0.00044
Sphingomonas sanxanigenens	397260	S	5465	2635	8100	0.00059
Sphingomonas changnyeongensis	2698679	S	4084	812	4896	0.00035
Sphingomonas hengshuiensis	1609977	S	3640	478	4118	0.00030
Sphingomonas taxi	1549858	S	3579	1125	4704	0.00034
Sphingomonas panacis	1560345	S	3460	517	3977	0.00029
Sphingomonas suaedae	2599297	S	3440	450	3890	0.00028
Sphingomonas panacisoli	1813879	S	2989	409	3398	0.00025
Sphingomonas radiodurans	2890321	S	2805	377	3182	0.00023
Sphingomonas insulae	424800	S	2405	692	3097	0.00022
Sphingomonas aliaeris	2759526	S	2299	293	2592	0.00019
Sphingomonas paucimobilis	13689	S	2183	1417	3600	0.00026
Sphingomonas sanguinis	33051	S	1772	1564	3336	0.00024
Sphingomonas melonis	152682	S	1463	5199	6662	0.00048
Sphingomonas lacunae	2698828	S	1224	171	1395	0.00010
Sphingomonas paeninsulae	2319844	S	887	40	927	0.00007
Sphingopyxis sp. PAMC25046	2565556	S	7328	3198	10526	0.00076
Sphingopyxis sp. QXT-31	1357916	S	3154	855	4009	0.00029
Sphingopyxis sp. YF1	2482763	S	3106	711	3817	0.00028
Sphingopyxis sp. OPL5	2486273	S	2877	539	3416	0.00025
Sphingopyxis sp. FD7	1914525	S	2821	1151	3972	0.00029
Sphingopyxis sp. 113P3	292913	S	2514	972	3486	0.00025
Sphingopyxis sp. BSN-002	2911495	S	2476	440	2916	0.00021
Sphingopyxis sp. EG6	1874061	S	2146	1033	3179	0.00023
Sphingopyxis sp. MG	1866325	S	155	1288	1443	0.00010
Sphingopyxis macrogoltabida	33050	S	4871	2368	7239	0.00052
Sphingopyxis fribergensis	1515612	S	2658	1009	3667	0.00027
Sphingopyxis terrae	33052	S	2646	1448	4094	0.00030
Sphingopyxis alaskensis	117207	S	2380	529	2909	0.00021
Sphingopyxis lindanitolerans	2054227	S	2375	1139	3514	0.00025
Sphingopyxis granuli	267128	S	2022	5115	7137	0.00052
Sphingobium sp. Cam5-1	2789327	S	4493	1609	6102	0.00044
Sphingobium sp. SYK-6	627192	S	2991	811	3802	0.00027
Sphingobium sp. TKS	1315974	S	1843	2701	4544	0.00033
Sphingobium sp. EP60837	1855519	S	1692	483	2175	0.00016
Sphingobium sp. CAP-1	2676077	S	1642	1026	2668	0.00019
Sphingobium sp. YG1	2082188	S	1637	692	2329	0.00017
Sphingobium sp. RAC03	1843368	S	1527	288	1815	0.00013
Sphingobium sp. SCG-1	2072936	S	1444	112	1556	0.00011
Sphingobium sp. MI1205	407020	S	1242	1761	3003	0.00022
Sphingobium sp. KCTC 72723	2733867	S	1089	194	1283	0.00009
Sphingobium sp. PAMC28499	2565554	S	465	909	1374	0.00010
Sphingobium sp. YBL2	484429	S	215	1373	1588	0.00011
Sphingobium sp. RSMS	520734	S	203	1160	1363	0.00010
Sphingobium sp. LF-16	2185111	S	33	529	562	0.00004
Sphingobium yanoikuyae	13690	S	2886	5490	8376	0.00061
Sphingobium phenoxybenzoativorans	1592790	S	2020	835	2855	0.00021
Sphingobium indicum	332055	S	1953	1534	3487	0.00025
Sphingobium amiense	135719	S	1847	2299	4146	0.00030
Sphingobium cloacae	120107	S	1699	2502	4201	0.00030
Sphingobium xenophagum	121428	S	1479	974	2453	0.00018
Sphingobium chlorophenolicum	46429	S	1420	651	2071	0.00015
Sphingobium baderi	1332080	S	1305	1319	2624	0.00019
Sphingobium herbicidovorans	76947	S	1236	1111	2347	0.00017
Sphingobium fuliginis	336203	S	702	2873	3575	0.00026
Novosphingobium sp. Gsoil 351	2675225	S	3824	337	4161	0.00030
Novosphingobium sp. Sx8-5	2896849	S	3317	484	3801	0.00027
Novosphingobium sp. EMRT-2	2571749	S	2678	1596	4274	0.00031
Novosphingobium sp. P6W	1609758	S	2242	386	2628	0.00019
Novosphingobium sp. ES2-1	2780074	S	1669	909	2578	0.00019
Novosphingobium sp. THN1	1016987	S	1518	581	2099	0.00015
Novosphingobium sp. PP1Y	702113	S	1048	1314	2362	0.00017
Novosphingobium sp. KA1	164608	S	572	2857	3429	0.00025
Novosphingobium resinovorum	158500	S	2819	1404	4223	0.00031
Novosphingobium decolorationis	2698673	S	2258	1238	3496	0.00025
Novosphingobium aromaticivorans	48935	S	2252	1054	3306	0.00024
Novosphingobium ginsenosidimutans	1176536	S	1749	184	1933	0.00014
Novosphingobium pentaromativorans	205844	S	1074	1950	3024	0.00022
Rhizorhabdus wittichii	160791	S	6882	4144	11026	0.00080
Rhizorhabdus dicambivorans	1850238	S	4082	3394	7476	0.00054
Rhizorhabdus phycosphaerae	2711156	S	2957	382	3339	0.00024
Allosphingosinicella indica	941907	S	9071	1147	10218	0.00074
Sphingosinithalassobacter sp. CS137	2762748	S	3582	749	4331	0.00031
Sphingosinithalassobacter tenebrarum	2711215	S	2408	742	3150	0.00023
Parasphingopyxis algicola	2026624	S	3244	218	3462	0.00025
Parasphingopyxis sp. CP4	2724527	S	847	39	886	0.00006
Sphingorhabdus sp. YGSMI21	2077182	S	933	159	1092	0.00008
Sphingorhabdus sp. SMR4y	2584094	S	858	150	1008	0.00007
Sphingorhabdus sp. M41	1806885	S	707	93	800	0.00006
Sphingorhabdus lacus	392610	S	549	24	573	0.00004
Sphingorhabdus lutea	1913578	S	56	4	60	0.00000
Blastomonas sp. RAC04	1842535	S	633	1001	1634	0.00012
Blastomonas fulva	1550728	S	592	1198	1790	0.00013
Hankyongella ginsenosidimutans	1763828	S	2428	475	2903	0.00021
Tardibacter chloracetimidivorans	1921510	S	2298	1825	4123	0.00030
Citromicrobium sp. JL477	1634516	S	1613	729	2342	0.00017
Novosphingopyxis iocasae	2762729	S	1478	810	2288	0.00017
Parasphingorhabdus halotolerans	2725558	S	327	13	340	0.00002
Parasphingorhabdus sp. JHSY0214	2806553	S	279	21	300	0.00002
Parasphingorhabdus litoris	394733	S	274	21	295	0.00002
Aquisediminimonas profunda	1550733	S	802	32	834	0.00006
Erythrobacter sp. HL-111	1798193	S	2201	421	2622	0.00019
Erythrobacter sp. HKB08	2502843	S	1484	324	1808	0.00013
Erythrobacter sp. JK5	2829500	S	1482	445	1927	0.00014
Erythrobacter sp. SDW2	2907154	S	1478	388	1866	0.00013
Erythrobacter sp. THAF29	2587851	S	837	194	1031	0.00007
Erythrobacter sp. 3-20A1M	2653850	S	770	1172	1942	0.00014
Erythrobacter sp. A30-3	2785907	S	752	580	1332	0.00010
Erythrobacter sp. LQ02-29	2920384	S	740	803	1543	0.00011
Erythrobacter sp. KY5	2011159	S	713	56	769	0.00006
Erythrobacter sp. SCSIO 43205	2779361	S	393	73	466	0.00003
Erythrobacter litoralis	39960	S	2646	1126	3772	0.00027
Erythrobacter mangrovi	2739433	S	1146	413	1559	0.00011
Erythrobacter neustonensis	1112	S	1136	260	1396	0.00010
Erythrobacter aureus	2182384	S	922	169	1091	0.00008
Porphyrobacter sp. CACIAM 03H1	2003315	S	2188	632	2820	0.00020
Porphyrobacter sp. LM 6	1896196	S	1242	433	1675	0.00012
Porphyrobacter sp. HT-58-2	2023229	S	1127	264	1391	0.00010
Porphyrobacter sp. GA68	2883480	S	1087	478	1565	0.00011
Qipengyuania flava	192812	S	3143	1738	4881	0.00035
Qipengyuania sediminis	1532023	S	1755	256	2011	0.00015
Qipengyuania soli	2782568	S	1249	232	1481	0.00011
Qipengyuania aurantiaca	2867233	S	1177	391	1568	0.00011
Qipengyuania gelatinilytica	2867231	S	910	174	1084	0.00008
Qipengyuania seohaensis	266951	S	778	166	944	0.00007
Qipengyuania xiapuensis	2867236	S	552	561	1113	0.00008
Qipengyuania psychrotolerans	2867238	S	550	72	622	0.00004
Qipengyuania aquimaris	255984	S	499	512	1011	0.00007
Altererythrobacter sp. B11	2060312	S	2342	1105	3447	0.00025
Altererythrobacter sp. TH136	2067415	S	1783	339	2122	0.00015
Altererythrobacter sp. BO-6	2604537	S	980	155	1135	0.00008
Altererythrobacter sp. ZODW24	2185142	S	438	22	460	0.00003
Altererythrobacter epoxidivorans	361183	S	815	231	1046	0.00008
Altererythrobacter ishigakiensis	476157	S	337	26	363	0.00003
Tsuneonella dongtanensis	692370	S	2245	464	2709	0.00020
Tsuneonella amylolytica	2338327	S	2125	627	2752	0.00020
Tsuneonella mangrovi	1982042	S	1511	238	1749	0.00013
Tsuneonella flava	2055955	S	662	196	858	0.00006
Croceicoccus sp. YJ47	2798724	S	1309	766	2075	0.00015
Croceicoccus sp. Ery5	1703340	S	498	532	1030	0.00007
Croceicoccus sp. Ery15	1703338	S	428	667	1095	0.00008
Croceicoccus marinus	450378	S	2471	1313	3784	0.00027
Croceicoccus naphthovorans	1348774	S	1064	1237	2301	0.00017
Pelagerythrobacter marensis	543877	S	1357	192	1549	0.00011
Aurantiacibacter gangjinensis	502682	S	851	88	939	0.00007
Aurantiacibacter atlanticus	1648404	S	431	142	573	0.00004
Paraurantiacibacter namhicola	645517	S	1229	163	1392	0.00010
Croceibacterium atlanticum	1267766	S	1088	464	1552	0.00011
Sphingosinicella sp. BN140058	1892855	S	8100	767	8867	0.00064
Sphingosinicella flava	2771430	S	4290	647	4937	0.00036
Sphingosinicella microcystinivorans	335406	S	2592	337	2929	0.00021
Polymorphobacter sp. PAMC 29362	2835787	S	1464	994	2458	0.00018
Polymorphobacter sp. PAMC 29334	2862331	S	1386	971	2357	0.00017
Sandaracinobacter sp. M6	2759707	S	2188	160	2348	0.00017
Zymomonas mobilis	542	S	132	96	228	0.00002
Azospirillum brasilense	192	S	11522	10020	21542	0.00156
Azospirillum sp. B510	137722	S	3160	1188	4348	0.00031
Azospirillum sp. TSH100	652764	S	2635	1216	3851	0.00028
Azospirillum sp. TSA2s	709810	S	2635	2002	4637	0.00034
Azospirillum sp. TSH58	664962	S	2141	2823	4964	0.00036
Azospirillum thermophilum	2202148	S	8493	1985	10478	0.00076
Azospirillum thiophilum	528244	S	4139	1364	5503	0.00040
Azospirillum ramasamyi	682998	S	2544	1467	4011	0.00029
Azospirillum oryzae	286727	S	2047	1758	3805	0.00027
Azospirillum lipoferum	193	S	2028	1491	3519	0.00025
Azospirillum humicireducens	1226968	S	2019	1176	3195	0.00023
Azospirillum baldaniorum	1064539	S	1274	2552	3826	0.00028
Skermanella mucosa	1789672	S	4977	3371	8348	0.00060
Skermanella sp. TT6	2775420	S	4791	4820	9611	0.00069
Skermanella rosea	1817965	S	4784	4225	9009	0.00065
Skermanella pratensis	2233999	S	3998	2170	6168	0.00045
Nitrospirillum amazonense	28077	S	4578	560	5138	0.00037
Indioceanicola profundi	2220096	S	3968	576	4544	0.00033
Niveispirillum cyanobacteriorum	1612173	S	1882	213	2095	0.00015
Roseomonas sp. OT10	2897332	S	9547	2375	11922	0.00086
Roseomonas sp. S08	1750527	S	8810	561	9371	0.00068
Roseomonas sp. FDAARGOS_362	2018065	S	605	2953	3558	0.00026
Roseomonas gilardii	257708	S	6259	2761	9020	0.00065
Roseomonas haemaphysalidis	2768162	S	5571	642	6213	0.00045
Roseomonas marmotae	2768161	S	5220	592	5812	0.00042
Roseomonas mucosa	207340	S	613	3491	4104	0.00030
Rhodovastum atsumiense	504468	S	6792	694	7486	0.00054
Roseococcus microcysteis	2771361	S	5775	540	6315	0.00046
Komagataeibacter xylinus	28448	S	1236	2223	3459	0.00025
Komagataeibacter saccharivorans	265959	S	457	169	626	0.00005
Komagataeibacter europaeus	33995	S	373	193	566	0.00004
Komagataeibacter nataicola	265960	S	355	168	523	0.00004
Komagataeibacter oboediens	65958	S	353	175	528	0.00004
Komagataeibacter medellinensis	1177712	S	311	264	575	0.00004
Komagataeibacter rhaeticus	215221	S	17	299	316	0.00002
Acidiphilium multivorum	62140	S	1024	4168	5192	0.00038
Acidiphilium cryptum	524	S	228	1436	1664	0.00012
Sediminicoccus rosea	1225128	S	3661	189	3850	0.00028
Acidibrevibacterium fodinaquatile	1969806	S	2841	258	3099	0.00022
Lichenicola cladoniae	1484109	S	2813	137	2950	0.00021
Acetobacter aceti	435	S	996	373	1369	0.00010
Acetobacter persici	1076596	S	250	35	285	0.00002
Acetobacter sp. KACC 21233	2592655	S	240	51	291	0.00002
Acetobacter ghanensis	431306	S	145	37	182	0.00001
Acetobacter pasteurianus	438	S	125	225	350	0.00003
Acetobacter orientalis	146474	S	72	10	82	0.00001
Acetobacter ascendens	481146	S	68	78	146	0.00001
Acetobacter tropicalis	104102	S	58	58	116	0.00001
Acetobacter senegalensis	446692	S	56	61	117	0.00001
Acetobacter oryzifermentans	1633874	S	19	166	185	0.00001
Acetobacter oryzoeni	2500548	S	18	31	49	0.00000
Gluconacetobacter diazotrophicus	33996	S	1810	389	2199	0.00016
Gluconobacter oxydans	442	S	626	700	1326	0.00010
Gluconobacter albidus	318683	S	296	54	350	0.00003
Gluconobacter sphaericus	574987	S	199	48	247	0.00002
Gluconobacter frateurii	38308	S	126	33	159	0.00001
Gluconobacter thailandicus	257438	S	56	43	99	0.00001
Granulibacter bethesdensis	364410	S	1134	102	1236	0.00009
Neoasaia chiangmaiensis	320497	S	730	153	883	0.00006
Asaia bogorensis	91915	S	711	125	836	0.00006
Kozakia baliensis	153496	S	456	167	623	0.00005
Oecophyllibacter saccharovorans	2558360	S	418	14	432	0.00003
Novacetimonas hansenii	436	S	383	189	572	0.00004
Parasaccharibacter sp. TMW 2.1888	2268025	S	19	100	119	0.00001
Parasaccharibacter apium	1510841	S	18	91	109	0.00001
Swingsia sp. F3b2	2558361	S	166	4	170	0.00001
Swingsia samuiensis	1293412	S	13	2	15	0.00000
Entomobacter blattae	2762277	S	74	5	79	0.00001
Neokomagataea tanensis	661191	S	73	12	85	0.00001
Commensalibacter sp. AMU001	2478912	S	10	27	37	0.00000
Bombella sp. KACC 21507	2697033	S	23	2	25	0.00000
Hypericibacter adhaerens	2602016	S	11050	2164	13214	0.00095
Hypericibacter terrae	2602015	S	8662	1360	10022	0.00072
Magnetospirillum sp. XM-1	1663591	S	2286	745	3031	0.00022
Magnetospirillum sp. ME-1	1639348	S	2066	730	2796	0.00020
Magnetospirillum gryphiswaldense	55518	S	2825	225396	228221	0.01649
Magnetospirillum magneticum	84159	S	2243	245	2488	0.00018
Ferrovibrio terrae	2594003	S	7995	520	8515	0.00062
Rhodospirillum centenum	34018	S	4977	722	5699	0.00041
Rhodospirillum rubrum	1085	S	2283	175	2458	0.00018
Tistrella mobilis	171437	S	5119	2429	7548	0.00055
Defluviicoccus vanus	111831	S	2802	255	3057	0.00022
Pararhodospirillum photometricum	1084	S	1420	110	1530	0.00011
Haematospirillum jordaniae	1549855	S	259	22	281	0.00002
Candidatus Endolissoclinum faulkneri	1263979	S	123	1	124	0.00001
Stella humosa	94	S	11881	850	12731	0.00092
Elioraea tepida	2843330	S	5121	264	5385	0.00039
Thalassospira sp. A40-3	2785908	S	253	101	354	0.00003
Thalassospira sp. B30-1	2785911	S	145	221	366	0.00003
Thalassospira marina	2048283	S	334	21	355	0.00003
Thalassospira indica	1891279	S	297	185	482	0.00003
Thalassospira xiamenensis	220697	S	146	210	356	0.00003
Magnetospira sp. QH-2	1288970	S	1090	37	1127	0.00008
Terasakiella sp. SH-1	2560057	S	116	2	118	0.00001
Paracoccus sp. MC1862	2760307	S	1666	190	1856	0.00013
Paracoccus sp. AK26	2589076	S	1331	242	1573	0.00011
Paracoccus sp. MA	2895796	S	1322	749	2071	0.00015
Paracoccus sp. H4-D09	2812658	S	874	195	1069	0.00008
Paracoccus sp. S8-55	2903900	S	766	110	876	0.00006
Paracoccus sp. Arc7-R13	2500532	S	500	544	1044	0.00008
Paracoccus sanguinis	1545044	S	2515	698	3213	0.00023
Paracoccus yeei	147645	S	1731	2847	4578	0.00033
Paracoccus liaowanqingii	2560053	S	1705	207	1912	0.00014
Paracoccus denitrificans	266	S	1586	780	2366	0.00017
Paracoccus zhejiangensis	1077935	S	1499	379	1878	0.00014
Paracoccus aminovorans	34004	S	1476	447	1923	0.00014
Paracoccus pantotrophus	82367	S	1431	861	2292	0.00017
Paracoccus suum	2259340	S	1295	243	1538	0.00011
Paracoccus jeotgali	2065379	S	1280	260	1540	0.00011
Paracoccus contaminans	1945662	S	1207	290	1497	0.00011
Paracoccus aminophilus	34003	S	998	105	1103	0.00008
Paracoccus tegillarcae	1529068	S	642	40	682	0.00005
Paracoccus kondratievae	135740	S	631	129	760	0.00005
Paracoccus marcusii	59779	S	489	469	958	0.00007
Paracoccus mutanolyticus	1499308	S	183	652	835	0.00006
Cereibacter sphaeroides	1063	S	5298	2408	7706	0.00056
Cereibacter azotoformans	43057	S	550	1953	2503	0.00018
Rhodobacter sp. CZR27	2033869	S	2163	728	2891	0.00021
Rhodobacter sp. N10	2807096	S	1623	206	1829	0.00013
Rhodobacter sp. LPB0142	1850250	S	1472	1086	2558	0.00018
Rhodobacter capsulatus	1061	S	1972	429	2401	0.00017
Rhodovulum sp. P5	1564506	S	1076	125	1201	0.00009
Rhodovulum sp. MB263	308754	S	969	441	1410	0.00010
Rhodovulum sulfidophilum	35806	S	1621	1016	2637	0.00019
Polymorphum gilvum	991904	S	3770	959	4729	0.00034
Paroceanicella profunda	2579971	S	3683	1011	4694	0.00034
Pikeienuella piscinae	2748098	S	2618	259	2877	0.00021
Pontivivens ytuae	2789856	S	2414	193	2607	0.00019
Thioclava electrotropha	1549850	S	1076	274	1350	0.00010
Thioclava nitratireducens	1915078	S	905	317	1222	0.00009
Silicimonas algicola	1826607	S	2162	136	2298	0.00017
Pelagovum pacificum	2588711	S	1996	262	2258	0.00016
Frigidibacter mobilis	1335048	S	1631	724	2355	0.00017
Brevirhabdus pacifica	1267768	S	1368	675	2043	0.00015
Pukyongiella litopenaei	2605946	S	1349	341	1690	0.00012
Fuscovulum blasticum	1075	S	1203	163	1366	0.00010
Gymnodinialimonas ceratoperidinii	2856823	S	1106	111	1217	0.00009
Haematobacter massiliensis	195105	S	1072	447	1519	0.00011
Falsirhodobacter sp. PG104	2692330	S	1053	161	1214	0.00009
Tabrizicola piscis	2494374	S	977	95	1072	0.00008
Pseudopuniceibacterium antarcticum	2613965	S	904	75	979	0.00007
Gemmobacter aquarius	2169400	S	892	195	1087	0.00008
Pacificitalea manganoxidans	1411902	S	874	202	1076	0.00008
Pseudooceanicola algae	1537215	S	839	88	927	0.00007
Monaibacterium sp. h42	2758038	S	784	192	976	0.00007
Roseicitreum antarcticum	564137	S	782	43	825	0.00006
Tritonibacter mobilis	379347	S	540	254	794	0.00006
Yoonia vestfoldensis	245188	S	505	120	625	0.00005
Qingshengfaniella alkalisoli	2599296	S	500	28	528	0.00004
Pseudohalocynthiibacter aestuariivivens	1591409	S	483	101	584	0.00004
Rhodophyticola sp. CCM32	2916397	S	480	15	495	0.00004
Rhodobaca barguzinensis	441209	S	363	17	380	0.00003
Profundibacter amoris	2171755	S	353	13	366	0.00003
Parasedimentitalea marina	2483033	S	304	15	319	0.00002
Pseudorhodobacter turbinis	2500533	S	291	19	310	0.00002
Aestuarium zhoushanense	2820523	S	265	113	378	0.00003
Cognatishimia activa	1715691	S	238	11	249	0.00002
Planktomarina temperata	1284658	S	151	4	155	0.00001
Roseovarius sp. SCSIO 43702	2823043	S	1711	137	1848	0.00013
Roseovarius sp. THAF9	2587847	S	843	205	1048	0.00008
Roseovarius sp. THAF8	2587846	S	353	551	904	0.00007
Roseovarius sp. THAF27	2587850	S	342	570	912	0.00007
Roseovarius sp. TM1035	391613	S	133	269	402	0.00003
Roseovarius indicus	540747	S	2095	663	2758	0.00020
Roseovarius faecimaris	2494550	S	811	35	846	0.00006
Roseovarius mucosus	215743	S	163	333	496	0.00004
Sulfitobacter sp. THAF37	2587855	S	841	352	1193	0.00009
Sulfitobacter sp. JK7-1	2829501	S	817	45	862	0.00006
Sulfitobacter sp. D7	1968541	S	426	161	587	0.00004
Sulfitobacter sp. SK011	1389004	S	317	8	325	0.00002
Sulfitobacter sp. JL08	2070369	S	315	7	322	0.00002
Sulfitobacter sp. DSM 110093	2883127	S	268	80	348	0.00003
Sulfitobacter sp. BSw21498	664426	S	224	34	258	0.00002
Sulfitobacter sp. SK012	1389005	S	183	3	186	0.00001
Sulfitobacter sp. SK025	1389011	S	89	187	276	0.00002
Sulfitobacter sp. CB2047	1525218	S	67	190	257	0.00002
Sulfitobacter sp. B30-2	2785912	S	64	141	205	0.00001
Sulfitobacter alexandrii	1917485	S	1274	637	1911	0.00014
Sulfitobacter mediterraneus	83219	S	541	55	596	0.00004
Sulfitobacter indolifex	225422	S	355	80	435	0.00003
Sulfitobacter dubius	218673	S	304	137	441	0.00003
Sulfitobacter pontiacus	60137	S	133	305	438	0.00003
Salipiger profundus	1229727	S	2343	1046	3389	0.00024
Salipiger abyssi	1250539	S	1713	689	2402	0.00017
Salipiger sp. CCB-MM3	1792508	S	1604	231	1835	0.00013
Roseivivax sp. THAF30	2587852	S	1155	273	1428	0.00010
Roseivivax sp. THAF197b	2588299	S	31	632	663	0.00005
Roseivivax sp. THAF40	2587858	S	19	503	522	0.00004
Roseivivax marinus	1379903	S	2255	365	2620	0.00019
Celeribacter indicus	1208324	S	1861	925	2786	0.00020
Celeribacter ethanolicus	1758178	S	654	234	888	0.00006
Celeribacter baekdonensis	875171	S	328	90	418	0.00003
Celeribacter marinus	1397108	S	232	8	240	0.00002
Phaeobacter gallaeciensis	60890	S	885	1635	2520	0.00018
Phaeobacter inhibens	221822	S	685	219	904	0.00007
Phaeobacter piscinae	1580596	S	300	167	467	0.00003
Phaeobacter porticola	1844006	S	182	37	219	0.00002
Phaeobacter sp. LSS9	681157	S	41	33	74	0.00001
Leisingera aquaemixtae	1396826	S	1091	206	1297	0.00009
Leisingera sp. NJS204	2508307	S	177	283	460	0.00003
Leisingera sp. NJS201	2508306	S	172	260	432	0.00003
Leisingera methylohalidivorans	133924	S	645	151	796	0.00006
Ruegeria sp. TM1040	292414	S	391	67	458	0.00003
Ruegeria sp. THAF33	2587853	S	364	87	451	0.00003
Ruegeria sp. SCSIO 43209	2793010	S	297	53	350	0.00003
Ruegeria sp. AD91A	2293862	S	241	25	266	0.00002
Ruegeria pomeroyi	89184	S	1116	205	1321	0.00010
Sagittula sp. P11	2009329	S	2019	824	2843	0.00021
Sulfitobacter pseudonitzschiae	1402135	S	1378	491	1869	0.00014
Pseudosulfitobacter sp. DSM 107133	2883100	S	489	200	689	0.00005
Yangia pacifica	311180	S	1971	336	2307	0.00017
Mameliella alba	561184	S	1520	281	1801	0.00013
Ponticoccus alexandrii	1943633	S	1481	225	1706	0.00012
Dinoroseobacter shibae	215813	S	1295	469	1764	0.00013
Roseobacter ponti	1891787	S	492	14	506	0.00004
Roseobacter denitrificans	2434	S	336	54	390	0.00003
Roseobacter litoralis	42443	S	296	49	345	0.00002
Ketogulonicigenium vulgare	92945	S	592	108	700	0.00005
Ketogulonicigenium robustum	92947	S	513	74	587	0.00004
Oceanicola sp. D3	2587163	S	1075	56	1131	0.00008
Roseibacterium elongatum	159346	S	1003	86	1089	0.00008
Octadecabacter sp. SW4	2602067	S	374	54	428	0.00003
Octadecabacter arcticus	53946	S	218	24	242	0.00002
Octadecabacter antarcticus	1217908	S	204	18	222	0.00002
Octadecabacter temperatus	1458307	S	161	3	164	0.00001
Actibacterium sp. EMB200-NS6	1609966	S	990	484	1474	0.00011
Maribius sp. THAF1	2587842	S	759	40	799	0.00006
Tateyamaria omphalii	299262	S	738	24	762	0.00006
Thalassococcus sp. S3	2017482	S	735	19	754	0.00005
Antarctobacter heliothermus	74033	S	718	37	755	0.00005
Jannaschia sp. CCS1	290400	S	679	18	697	0.00005
Thalassobius gelatinovorus	53501	S	376	20	396	0.00003
Falsihalocynthiibacter arcticus	1579316	S	166	5	171	0.00001
Caulobacter segnis	88688	S	7378	2412	9790	0.00071
Caulobacter sp. S6	2823693	S	4773	501	5274	0.00038
Caulobacter sp. FWC26	69665	S	1935	722	2657	0.00019
Caulobacter mirabilis	69666	S	4865	844	5709	0.00041
Caulobacter vibrioides	155892	S	4053	3312	7365	0.00053
Caulobacter flavus	1679497	S	3742	914	4656	0.00034
Caulobacter rhizosphaerae	2010972	S	3245	796	4041	0.00029
Caulobacter soli	2708539	S	2893	775	3668	0.00027
Caulobacter henricii	69395	S	1520	226	1746	0.00013
Brevundimonas sp. M20	2591463	S	2270	333	2603	0.00019
Brevundimonas sp. PAMC22021	2861285	S	1854	391	2245	0.00016
Brevundimonas sp. LM2	1938605	S	1825	299	2124	0.00015
Brevundimonas sp. MF30-B	2561924	S	1788	269	2057	0.00015
Brevundimonas sp. AJA228-03	2752515	S	1289	163	1452	0.00010
Brevundimonas sp. SGAir0440	2579977	S	415	396	811	0.00006
Brevundimonas sp. CS1	2813778	S	394	389	783	0.00006
Brevundimonas sp. DS20	1532555	S	329	839	1168	0.00008
Brevundimonas sp. 'scallop'	2562582	S	324	568	892	0.00006
Brevundimonas sp. GW460-12-10-14-LB2	1827469	S	319	555	874	0.00006
Brevundimonas sp. Bb-A	2560058	S	316	674	990	0.00007
Brevundimonas naejangsanensis	588932	S	3208	1058	4266	0.00031
Brevundimonas albigilva	1312364	S	2223	1186	3409	0.00025
Brevundimonas goettingensis	2774190	S	2030	303	2333	0.00017
Brevundimonas subvibrioides	74313	S	1603	274	1877	0.00014
Brevundimonas diminuta	293	S	1229	2272	3501	0.00025
Brevundimonas pondensis	2774189	S	1228	361	1589	0.00011
Brevundimonas vitisensis	2800818	S	1181	138	1319	0.00010
Brevundimonas mediterranea	74329	S	1139	426	1565	0.00011
Brevundimonas nasdae	172043	S	1001	650	1651	0.00012
Brevundimonas vancanneytii	1325724	S	323	1223	1546	0.00011
Brevundimonas vesicularis	41276	S	322	692	1014	0.00007
Phenylobacterium zucineum	284016	S	13563	2680	16243	0.00117
Phenylobacterium parvum	2201350	S	2939	314	3253	0.00024
Terricaulis silvestris	2686094	S	6498	226	6724	0.00049
Asticcacaulis excentricus	78587	S	1261	179	1440	0.00010
Asticcacaulis sp. AND118	2840468	S	1034	139	1173	0.00008
Candidatus Viadribacter manganicus	1759059	S	3427	94	3521	0.00025
Hyphomonas sp. CACIAM 19H1	1873716	S	969	145	1114	0.00008
Hyphomonas sp. Mor2	1906738	S	526	11	537	0.00004
Hyphomonas sp. KY3	2016196	S	486	55	541	0.00004
Hyphomonas neptunium	81032	S	849	94	943	0.00007
Hirschia baltica	2724	S	54	1	55	0.00000
Marinicauda algicola	2029849	S	2789	478	3267	0.00024
Maricaulis maris	74318	S	881	58	939	0.00007
Glycocaulis alkaliphilus	1434191	S	881	47	928	0.00007
Hyphobacterium sp. CCMP332	2749086	S	634	26	660	0.00005
Micavibrio aeruginosavorus	349221	S	3977	59	4036	0.00029
Candidatus Puniceispirillum marinum	767892	S	90	2	92	0.00001
Aquisalinus flavus	1526572	S	1211	58	1269	0.00009
Parvularcula bermudensis	208216	S	467	56	523	0.00004
Anaplasma ovis	142058	S	66	17	83	0.00001
Anaplasma platys	949	S	22	4	26	0.00000
Anaplasma marginale	770	S	16	43	59	0.00000
Anaplasma phagocytophilum	948	S	10	3	13	0.00000
Wolbachia endosymbiont of Oedothorax gibbosus	931100	S	13	67	80	0.00001
Wolbachia endosymbiont of Ctenocephalides felis wCfeT	2732593	S	10	1	11	0.00000
Ehrlichia ruminantium	779	S	17	7	24	0.00000
Ehrlichia canis	944	S	10	7	17	0.00000
Rickettsia tillamookensis	2761623	S	101	45	146	0.00001
Rickettsia conorii	781	S	12	31	43	0.00000
Rickettsia amblyommatis	33989	S	10	10	20	0.00000
Rickettsia endosymbiont of Oedothorax gibbosus	931099	S	11	2	13	0.00000
Orientia tsutsugamushi	784	S	24	1	25	0.00000
Candidatus Phycorickettsia trachydisci	2115978	S	68	3	71	0.00001
Candidatus Midichloria mitochondrii	234827	S	25	3	28	0.00000
Candidatus Fokinia solitaria	1802984	S	15	0	15	0.00000
Candidatus Deianiraea vastatrix	2163644	S	40	0	40	0.00000
Rickettsiales endosymbiont of Stachyamoeba lipophora	2486578	S	23	2	25	0.00000
Luteithermobacter gelatinilyticus	2582913	S	433	77	510	0.00004
Paremcibacter congregatus	2043170	S	337	10	347	0.00003
Candidatus Hydrogenosomobacter endosymbioticus	2558174	S	40	1	41	0.00000
Candidatus Gromoviella agglomerans	2806609	S	23	1	24	0.00000
endosymbiont of Acanthamoeba sp. UWC8	86106	S	22	0	22	0.00000
Candidatus Nesciobacter abundans	2601668	S	13	2	15	0.00000
Candidatus Paracaedibacter acanthamoebae	91604	S	49	2	51	0.00000
Candidatus Nucleicultrix amoebiphila	1509244	S	48	2	50	0.00000
Magnetococcus marinus	1124597	S	177	4	181	0.00001
Candidatus Pelagibacter sp. IMCC9063	1002672	S	13	2	15	0.00000
Candidatus Pelagibacter sp. RS40	1977865	S	12	12	24	0.00000
Candidatus Fonsibacter ubiquis	1925548	S	41	3	44	0.00000
Kordiimonas pumila	2161677	S	86	1	87	0.00001
Burkholderia multivorans	87883	S	4940	15005	19945	0.00144
Burkholderia ubonensis	101571	S	4890	2710	7600	0.00055
Burkholderia cenocepacia	95486	S	3791	19572	23363	0.00169
Burkholderia cepacia	292	S	3236	4361	7597	0.00055
Burkholderia pyrrocinia	60550	S	2126	1052	3178	0.00023
Burkholderia stagnalis	1503054	S	1758	563	2321	0.00017
Burkholderia contaminans	488447	S	1736	986	2722	0.00020
Burkholderia ambifaria	152480	S	1658	2266	3924	0.00028
Burkholderia anthina	179879	S	1514	1343	2857	0.00021
Burkholderia stabilis	95485	S	1443	968	2411	0.00017
Burkholderia lata	482957	S	1401	1113	2514	0.00018
Burkholderia dolosa	152500	S	1342	6800	8142	0.00059
Burkholderia territorii	1503055	S	1079	475	1554	0.00011
Burkholderia vietnamiensis	60552	S	894	2228	3122	0.00023
Burkholderia seminalis	488731	S	891	370	1261	0.00009
Burkholderia metallica	488729	S	725	311	1036	0.00007
Burkholderia diffusa	488732	S	560	249	809	0.00006
Burkholderia pseudomultivorans	1207504	S	453	414	867	0.00006
Burkholderia latens	488446	S	256	443	699	0.00005
Burkholderia aenigmatica	2015348	S	228	446	674	0.00005
Burkholderia pseudomallei	28450	S	2233	16358	18591	0.00134
Burkholderia mayonis	1385591	S	1522	310	1832	0.00013
Burkholderia thailandensis	57975	S	1439	1647	3086	0.00022
Burkholderia oklahomensis	342113	S	1067	651	1718	0.00012
Burkholderia savannae	1637837	S	245	210	455	0.00003
Burkholderia sp. MSMB1588	1636423	S	105	224	329	0.00002
Burkholderia sp. MSMB617WGS	1637831	S	67	113	180	0.00001
Burkholderia mallei	13373	S	61	31959	32020	0.00231
Burkholderia sp. DHOD12	2571746	S	2799	287	3086	0.00022
Burkholderia sp. Bp7605	1740163	S	1387	194	1581	0.00011
Burkholderia sp. NRF60-BP8	1637853	S	590	302	892	0.00006
Burkholderia sp. JP2-270	2217913	S	562	338	900	0.00007
Burkholderia sp. LA-2-3-30-S1-D2	1637862	S	542	288	830	0.00006
Burkholderia sp. MSMB0856	1637869	S	502	291	793	0.00006
Burkholderia sp. PAMC 26561	1795043	S	425	451	876	0.00006
Burkholderia sp. MS455	2811788	S	398	267	665	0.00005
Burkholderia sp. IDO3	1705310	S	247	356	603	0.00004
Burkholderia sp. PAMC 28687	1795874	S	236	386	622	0.00004
Burkholderia sp. KBS0801	1179675	S	108	216	324	0.00002
Burkholderia sp. LAS2	2813843	S	99	467	566	0.00004
Burkholderia sp. MBR-1	2732364	S	49	214	263	0.00002
Burkholderia sp. KJ006	416344	S	48	322	370	0.00003
Burkholderia sp. MS389	2811789	S	33	251	284	0.00002
Burkholderia sp. B21-007	2890407	S	13	462	475	0.00003
Burkholderia gladioli	28095	S	6243	2028	8271	0.00060
Burkholderia glumae	337	S	2224	11661	13885	0.00100
Burkholderia plantarii	41899	S	1626	589	2215	0.00016
Burkholderia perseverans	2615214	S	1444	563	2007	0.00015
Cupriavidus taiwanensis	164546	S	10896	7912	18808	0.00136
Cupriavidus pauculus	82633	S	7862	3326	11188	0.00081
Cupriavidus oxalaticus	96344	S	4518	1912	6430	0.00046
Cupriavidus necator	106590	S	4470	3717	8187	0.00059
Cupriavidus sp. EM10	2839983	S	1810	1000	2810	0.00020
Cupriavidus sp. MP-37	2884455	S	1128	1025	2153	0.00016
Cupriavidus sp. ISTL7	2771360	S	534	2929	3463	0.00025
Cupriavidus sp. KK10	1478019	S	371	930	1301	0.00009
Cupriavidus sp. USMAA2-4	876364	S	215	1346	1561	0.00011
Cupriavidus sp. USMAHM13	1389192	S	215	1293	1508	0.00011
Cupriavidus basilensis	68895	S	4268	2362	6630	0.00048
Cupriavidus campinensis	151783	S	3383	1164	4547	0.00033
Cupriavidus metallidurans	119219	S	2455	8044	10499	0.00076
Cupriavidus gilardii	82541	S	2132	10044	12176	0.00088
Cupriavidus pinatubonensis	248026	S	2086	350	2436	0.00018
Cupriavidus neocaledonicus	1040979	S	858	919	1777	0.00013
Cupriavidus nantongensis	1796606	S	759	1963	2722	0.00020
Cupriavidus malaysiensis	367825	S	221	1232	1453	0.00011
Paraburkholderia sp. SOS3	1926494	S	1987	286	2273	0.00016
Paraburkholderia sp. PGU16	2735433	S	976	541	1517	0.00011
Paraburkholderia sp. PGU19	2735434	S	797	687	1484	0.00011
Paraburkholderia pallida	2547399	S	2773	500	3273	0.00024
Paraburkholderia aromaticivorans	2026199	S	2455	1078	3533	0.00026
Paraburkholderia caribensis	75105	S	2258	1699	3957	0.00029
Paraburkholderia acidisoli	2571748	S	2193	390	2583	0.00019
Paraburkholderia tropica	92647	S	2096	462	2558	0.00018
Paraburkholderia acidiphila	2571747	S	1998	388	2386	0.00017
Paraburkholderia edwinii	2861782	S	1835	247	2082	0.00015
Paraburkholderia phytofirmans	261302	S	1833	752	2585	0.00019
Paraburkholderia terricola	169427	S	1708	505	2213	0.00016
Paraburkholderia atlantica	2654982	S	1694	407	2101	0.00015
Paraburkholderia sprentiae	948107	S	1572	340	1912	0.00014
Paraburkholderia phenoliruptrix	252970	S	1552	443	1995	0.00014
Paraburkholderia phymatum	148447	S	1551	393	1944	0.00014
Paraburkholderia graminis	60548	S	1417	344	1761	0.00013
Paraburkholderia megapolitana	420953	S	1417	133	1550	0.00011
Paraburkholderia fungorum	134537	S	1417	331	1748	0.00013
Paraburkholderia caledonica	134536	S	1243	224	1467	0.00011
Paraburkholderia caffeinilytica	1761016	S	1195	310	1505	0.00011
Paraburkholderia terrae	311230	S	1182	1354	2536	0.00018
Paraburkholderia ginsengisoli	311231	S	1171	353	1524	0.00011
Paraburkholderia hospita	169430	S	1148	1311	2459	0.00018
Paraburkholderia xenovorans	36873	S	1075	1404	2479	0.00018
Paraburkholderia dokdonella	2211211	S	1001	264	1265	0.00009
Paraburkholderia dioscoreae	2604047	S	717	479	1196	0.00009
Ralstonia solanacearum	305	S	5533	10836	16369	0.00118
Ralstonia insidiosa	190721	S	1532	1176	2708	0.00020
Ralstonia mannitolilytica	105219	S	1099	1321	2420	0.00017
Ralstonia sp. 56D2	2842456	S	1020	161	1181	0.00009
blood disease bacterium A2-HR MARDI	1944648	S	15	808	823	0.00006
Ralstonia pickettii	329	S	1005	465	1470	0.00011
Ralstonia syzygii	28097	S	89	398	487	0.00004
Ralstonia pseudosolanacearum	1310165	S	37	971	1008	0.00007
Pandoraea pnomenusa	93220	S	2187	1106	3293	0.00024
Pandoraea thiooxydans	445709	S	1855	156	2011	0.00015
Pandoraea pulmonicola	93221	S	1720	380	2100	0.00015
Pandoraea vervacti	656178	S	1225	359	1584	0.00011
Pandoraea sp. XY-2	2518599	S	1184	644	1828	0.00013
Pandoraea faecigallinarum	656179	S	1175	317	1492	0.00011
Pandoraea norimbergensis	93219	S	1163	187	1350	0.00010
Pandoraea apista	93218	S	960	553	1513	0.00011
Pandoraea fibrosis	1891094	S	948	316	1264	0.00009
Pandoraea oxalativorans	573737	S	894	419	1313	0.00009
Pandoraea sputorum	93222	S	759	335	1094	0.00008
Caballeronia sp. Lep1P3	2878150	S	1606	391	1997	0.00014
Caballeronia sp. TF1N1	2878153	S	1394	166	1560	0.00011
Caballeronia sp. SL2Y3	2878151	S	801	467	1268	0.00009
Caballeronia sp. Sq4a	2878152	S	736	551	1287	0.00009
Caballeronia sp. M1242	2814653	S	715	521	1236	0.00009
Caballeronia sp. SBC2	2705547	S	85	740	825	0.00006
Caballeronia sp. SBC1	2705548	S	71	864	935	0.00007
Caballeronia zhejiangensis	871203	S	1898	462	2360	0.00017
Caballeronia insecticola	758793	S	1692	368	2060	0.00015
Caballeronia grimmiae	1071679	S	1488	801	2289	0.00017
Polynucleobacter sp. MWH-UH24A	2689110	S	70	4	74	0.00001
Polynucleobacter sp. MWH-CaK5	2689107	S	43	2	45	0.00000
Polynucleobacter sp. MWH-P3-07-1	1743173	S	39	5	44	0.00000
Polynucleobacter sp. LimPoW16	1743162	S	36	1	37	0.00000
Polynucleobacter sp. MWH-Braz-FAM2G	1855883	S	34	4	38	0.00000
Polynucleobacter sp. AP-Nino-20-G2	2576917	S	33	7	40	0.00000
Polynucleobacter sp. MWH-Aus1W21	1855880	S	33	7	40	0.00000
Polynucleobacter sp. MWH-UH21B	1743174	S	31	5	36	0.00000
Polynucleobacter sp. MG-6-Vaara-E2	2576932	S	31	5	36	0.00000
Polynucleobacter sp. VK25	1758398	S	31	7	38	0.00000
Polynucleobacter sp. AP-Ainpum-60-G11	2576926	S	29	6	35	0.00000
Polynucleobacter sp. AP-Kolm-20A-A1	2081041	S	28	15	43	0.00000
Polynucleobacter sp. MWH-UH35A	1855619	S	27	4	31	0.00000
Polynucleobacter sp. es-EL-1	1855652	S	26	4	30	0.00000
Polynucleobacter sp. TSB-Sco08W16	1758374	S	25	3	28	0.00000
Polynucleobacter sp. MWH-Spelu-300-X4	2689109	S	25	1	26	0.00000
Polynucleobacter sp. MWH-UH25E	1855616	S	25	4	29	0.00000
Polynucleobacter sp. AP-Titi-500A-B4	2576923	S	24	5	29	0.00000
Polynucleobacter sp. JS-JIR-II-50	2576919	S	23	10	33	0.00000
Polynucleobacter sp. MWH-S4W17	1855910	S	23	11	34	0.00000
Polynucleobacter sp. es-MAR-2	1819725	S	22	4	26	0.00000
Polynucleobacter sp. JS-Mosq-20-D10	2576922	S	21	7	28	0.00000
Polynucleobacter sp. MWH-Svant-W18	1855909	S	19	3	22	0.00000
Polynucleobacter sp. JS-JIR-II-b4	1758390	S	19	10	29	0.00000
Polynucleobacter sp. JS-JIR-5-A7	1758395	S	17	45	62	0.00000
Polynucleobacter sp. MG-Unter2-18	2081052	S	15	10	25	0.00000
Polynucleobacter sp. AP-Sving-400A-A2	2081049	S	14	7	21	0.00000
Polynucleobacter sp. AP-Melu-1000-A1	2081042	S	14	5	19	0.00000
Polynucleobacter sp. Adler-ghost	2770234	S	13	5	18	0.00000
Polynucleobacter sp. AP-Elch-400A-B2	2576930	S	12	5	17	0.00000
Polynucleobacter sp. MWH-UH2A	1855617	S	12	2	14	0.00000
Polynucleobacter sp. AP-Jannik-300A-C4	2576928	S	11	11	22	0.00000
Polynucleobacter necessarius	576610	S	163	27	190	0.00001
Polynucleobacter asymbioticus	576611	S	94	13	107	0.00001
Polynucleobacter difficilis	556054	S	78	6	84	0.00001
Polynucleobacter acidiphobus	556053	S	55	3	58	0.00000
Polynucleobacter paneuropaeus	2527775	S	48	5	53	0.00000
Polynucleobacter wuianus	1743168	S	22	6	28	0.00000
Polynucleobacter duraquae	1835254	S	22	13	35	0.00000
Lautropia mirabilis	47671	S	1577	310	1887	0.00014
Chitinimonas arctica	2594795	S	959	83	1042	0.00008
Mycetohabitans rhizoxinica	412963	S	955	68	1023	0.00007
Mycoavidus sp. HKI	2840467	S	108	11	119	0.00001
Mycoavidus sp. B2-EB	2651972	S	36	7	43	0.00000
Mycoavidus cysteinexigens	1553431	S	78	9	87	0.00001
Limnobacter sp. SAORIC-580	2732163	S	188	9	197	0.00001
Candidatus Vallotia cooleyia	1177211	S	41	5	46	0.00000
Candidatus Vallotia lariciata	2018052	S	36	15	51	0.00000
Candidatus Vallotia sp. (ex Adelges kitamiensis)	2864217	S	28	11	39	0.00000
Candidatus Vallotia tarda	1177213	S	27	5	32	0.00000
Ephemeroptericola cinctiostellae	2268024	S	91	6	97	0.00001
Variovorax sp. HW608	1034889	S	6426	1176	7602	0.00055
Variovorax sp. PBS-H4	434008	S	3761	2537	6298	0.00046
Variovorax sp. WDL1	207745	S	3361	5623	8984	0.00065
Variovorax sp. PBL-H6	434009	S	3341	3315	6656	0.00048
Variovorax sp. RA8	662548	S	3313	2745	6058	0.00044
Variovorax sp. PAMC 28711	1795631	S	2647	487	3134	0.00023
Variovorax sp. RKNM96	2681552	S	2513	1015	3528	0.00025
Variovorax sp. PAMC26660	2762322	S	2088	558	2646	0.00019
Variovorax sp. PAMC28562	2762323	S	2048	191	2239	0.00016
Variovorax sp. SRS16	282217	S	1735	3942	5677	0.00041
Variovorax sp. 38R	2774875	S	1425	1886	3311	0.00024
Variovorax sp. PBL-E5	434014	S	1412	3720	5132	0.00037
Variovorax sp. PDNC026	2811425	S	55	2089	2144	0.00015
Variovorax sp. PMC12	2126319	S	33	1610	1643	0.00012
Variovorax paradoxus	34073	S	13298	12741	26039	0.00188
Variovorax boronicumulans	436515	S	2068	1606	3674	0.00027
Hydrogenophaga sp. PBC	795665	S	3899	4977	8876	0.00064
Hydrogenophaga sp. YM1	2806262	S	3842	2149	5991	0.00043
Hydrogenophaga sp. BA0156	2716225	S	3839	2978	6817	0.00049
Hydrogenophaga sp. BPS33	2651974	S	2890	2460	5350	0.00039
Hydrogenophaga sp. SL48	2806347	S	2433	646	3079	0.00022
Hydrogenophaga sp. RAC07	1842537	S	1949	718	2667	0.00019
Hydrogenophaga sp. PBL-H3	434010	S	1904	1897	3801	0.00027
Hydrogenophaga sp. PAMC20947	2565558	S	948	70	1018	0.00007
Hydrogenophaga sp. NH-16	2184519	S	911	2156	3067	0.00022
Hydrogenophaga taeniospiralis	65656	S	2069	693	2762	0.00020
Hydrogenophaga pseudoflava	47421	S	934	1723	2657	0.00019
Hydrogenophaga crassostreae	1763535	S	837	58	895	0.00006
Acidovorax sp. YS12	2738413	S	2066	1987	4053	0.00029
Acidovorax sp. JMULE5	2518343	S	1603	487	2090	0.00015
Acidovorax sp. KKS102	358220	S	1517	1216	2733	0.00020
Acidovorax sp. RAC01	1842533	S	1434	1298	2732	0.00020
Acidovorax sp. HDW3	2714923	S	1156	928	2084	0.00015
Acidovorax sp. 1608163	2478662	S	1027	239	1266	0.00009
Acidovorax sp. T1	1858609	S	791	3210	4001	0.00029
Acidovorax avenae	80867	S	4274	2836	7110	0.00051
Acidovorax monticola	1926868	S	2652	1156	3808	0.00028
Acidovorax antarcticus	2743470	S	2170	1851	4021	0.00029
Acidovorax carolinensis	553814	S	1501	1337	2838	0.00021
Acidovorax citrulli	80869	S	1236	1864	3100	0.00022
Acidovorax cattleyae	80868	S	1034	763	1797	0.00013
Acidovorax radicis	758826	S	1023	229	1252	0.00009
Ramlibacter tataouinensis	94132	S	21121	9553	30674	0.00222
Comamonas sp. NLF-7-7	2597701	S	1502	1282	2784	0.00020
Comamonas sp. NLF-1-9	2853163	S	1221	788	2009	0.00015
Comamonas sp. B21-038	2918299	S	838	222	1060	0.00008
Comamonas sp. Y33R10-2	2853257	S	238	49	287	0.00002
Comamonas serinivorans	1082851	S	1952	611	2563	0.00019
Comamonas aquatica	225991	S	1934	2105	4039	0.00029
Comamonas testosteroni	285	S	1138	1707	2845	0.00021
Comamonas koreensis	160825	S	843	563	1406	0.00010
Comamonas odontotermitis	379895	S	749	164	913	0.00007
Comamonas piscis	1562974	S	635	133	768	0.00006
Comamonas thiooxydans	363952	S	595	1334	1929	0.00014
Comamonas kerstersii	225992	S	477	287	764	0.00006
Comamonas fluminis	2796366	S	352	168	520	0.00004
Rhodoferax sp. BAB1	2741720	S	2356	721	3077	0.00022
Rhodoferax sp. AJA081-3	2752316	S	795	65	860	0.00006
Rhodoferax sp. PAMC 29310	2822760	S	558	70	628	0.00005
Rhodoferax sp. MIZ03	2798804	S	380	44	424	0.00003
Rhodoferax koreense	1842727	S	3451	2021	5472	0.00040
Rhodoferax sediminis	2509614	S	2546	434	2980	0.00022
Rhodoferax ferrireducens	192843	S	1108	84	1192	0.00009
Rhodoferax saidenbachensis	1484693	S	774	95	869	0.00006
Rhodoferax antarcticus	81479	S	516	44	560	0.00004
Rhodoferax aquaticus	2527691	S	317	35	352	0.00003
Schlegelella thermodepolymerans	215580	S	6751	3605	10356	0.00075
Schlegelella brevitalea	413882	S	5196	824	6020	0.00043
Diaphorobacter sp. HDW4A	2714924	S	1320	1408	2728	0.00020
Diaphorobacter sp. HDW4B	2714925	S	1135	158	1293	0.00009
Diaphorobacter sp. MNS-0	2866628	S	155	1369	1524	0.00011
Diaphorobacter sp. JS3051	2792224	S	122	2134	2256	0.00016
Diaphorobacter sp. JS3050	2735554	S	121	1401	1522	0.00011
Diaphorobacter ruginosibacter	1715720	S	1725	346	2071	0.00015
Diaphorobacter aerolatus	1288495	S	1215	2101	3316	0.00024
Diaphorobacter nitroreducens	164759	S	241	694	935	0.00007
[Acidovorax] ebreus	721785	S	213	1333	1546	0.00011
Delftia tsuruhatensis	180282	S	1707	5056	6763	0.00049
Delftia acidovorans	80866	S	1289	2554	3843	0.00028
Delftia lacustris	558537	S	512	3134	3646	0.00026
Delftia sp. Cs1-4	742013	S	162	391	553	0.00004
Delftia sp. HK171	1920191	S	113	316	429	0.00003
Delftia sp. WY8	2708352	S	10	747	757	0.00005
Polaromonas sp. JS666	296591	S	2875	2098	4973	0.00036
Polaromonas naphthalenivorans	216465	S	1796	307	2103	0.00015
Polaromonas vacuolata	37448	S	196	23	219	0.00002
Kinneretia sp. DAIF2	2714952	S	4691	1873	6564	0.00047
Kinneretia sp. XES5	2877940	S	1646	2315	3961	0.00029
Ottowia sp. 27C	2816950	S	2068	438	2506	0.00018
Ottowia sp. oral taxon 894	1658672	S	829	130	959	0.00007
Ottowia oryzae	2109914	S	1588	385	1973	0.00014
Alicycliphilus denitrificans	179636	S	4137	8228	12365	0.00089
Melaminivora sp. SC2-9	2109913	S	1891	2407	4298	0.00031
Melaminivora jejuensis	1267217	S	1466	1234	2700	0.00020
Serpentinimonas maccroryi	1458426	S	1318	478	1796	0.00013
Serpentinimonas raichei	1458425	S	993	400	1393	0.00010
Verminephrobacter eiseniae	364317	S	1962	263	2225	0.00016
Hylemonella gracilis	80880	S	1742	274	2016	0.00015
Pulveribacter suum	2116657	S	1560	882	2442	0.00018
Simplicispira suum	2109915	S	1218	499	1717	0.00012
Limnohabitans sp. 63ED37-2	1678128	S	609	70	679	0.00005
Limnohabitans sp. 103DPR2	1678129	S	179	14	193	0.00001
Curvibacter sp. AEP1-3	1844971	S	622	48	670	0.00005
Candidatus Symbiobacter mobilis	1436290	S	609	23	632	0.00005
Massilia sp. WG5	1707785	S	3973	1912	5885	0.00043
Massilia sp. HC52	2852099	S	3468	1066	4534	0.00033
Massilia sp. LPB0304	2769491	S	3266	907	4173	0.00030
Massilia sp. DM-R-R2A-13	2899220	S	3038	755	3793	0.00027
Massilia sp. YMA4	1593482	S	2642	1458	4100	0.00030
Massilia sp. NP310	2861282	S	2551	1793	4344	0.00031
Massilia sp. PAMC28688	2861283	S	1990	336	2326	0.00017
Massilia sp. NR 4-1	1678028	S	425	1465	1890	0.00014
Massilia sp. MB5	2919578	S	380	1355	1735	0.00013
Massilia sp. Dwa41.01b	2709302	S	57	2069	2126	0.00015
Massilia sp. Se16.2.3	2709303	S	39	1429	1468	0.00011
Massilia violaceinigra	2045208	S	4492	1362	5854	0.00042
Massilia putida	1141883	S	4267	1475	5742	0.00041
Massilia flava	871742	S	4241	1124	5365	0.00039
Massilia albidiflava	321983	S	2780	1179	3959	0.00029
Massilia lutea	321985	S	2658	871	3529	0.00025
Massilia umbonata	864828	S	2541	1088	3629	0.00026
Massilia plicata	321984	S	2344	665	3009	0.00022
Massilia armeniaca	2072590	S	2309	1287	3596	0.00026
Massilia oculi	945844	S	2142	1444	3586	0.00026
Massilia antarctica	2765360	S	1873	741	2614	0.00019
Duganella sp. GN2-R2	2728020	S	3095	1435	4530	0.00033
Duganella sp. AF9R3	2728021	S	2032	470	2502	0.00018
Herbaspirillum robiniae	2014887	S	2264	950	3214	0.00023
Herbaspirillum seropedicae	964	S	1623	812	2435	0.00018
Herbaspirillum hiltneri	341045	S	1601	311	1912	0.00014
Herbaspirillum frisingense	92645	S	1597	591	2188	0.00016
Herbaspirillum rubrisubalbicans	80842	S	1467	775	2242	0.00016
Herbaspirillum huttiense	863372	S	1035	488	1523	0.00011
Herbaspirillum sp. meg3	2025949	S	995	131	1126	0.00008
Janthinobacterium sp. 17J80-10	2497863	S	1750	290	2040	0.00015
Janthinobacterium sp. 1_2014MBL_MicDiv	1644131	S	1321	525	1846	0.00013
Janthinobacterium sp. Marseille	375286	S	620	177	797	0.00006
Janthinobacterium sp. LM6	1938606	S	584	387	971	0.00007
Janthinobacterium sp. PAMC25594	2861284	S	500	331	831	0.00006
Janthinobacterium sp. HH102	1537274	S	241	409	650	0.00005
Janthinobacterium sp. B9-8	1236179	S	112	35	147	0.00001
Janthinobacterium agaricidamnosum	55508	S	1805	3102	4907	0.00035
Janthinobacterium tructae	2590869	S	422	239	661	0.00005
Janthinobacterium lividum	29581	S	420	463	883	0.00006
Janthinobacterium svalbardensis	368607	S	398	219	617	0.00004
Collimonas fungivorans	158899	S	2217	673	2890	0.00021
Collimonas arenae	279058	S	1658	231	1889	0.00014
Collimonas pratensis	279113	S	1482	325	1807	0.00013
Noviherbaspirillum sp. UKPF54	2601898	S	4462	846	5308	0.00038
Undibacterium sp. YM2	2058625	S	209	105	314	0.00002
Undibacterium sp. KW1	2058624	S	162	81	243	0.00002
Undibacterium parvum	401471	S	259	40	299	0.00002
Herminiimonas arsenitoxidans	1809410	S	361	64	425	0.00003
Glaciimonas sp. PAMC28666	2807626	S	271	19	290	0.00002
Oxalobacter formigenes	847	S	150	15	165	0.00001
Achromobacter xylosoxidans	85698	S	6705	11992	18697	0.00135
Achromobacter sp. AONIH1	1758194	S	2067	2951	5018	0.00036
Achromobacter sp. MFA1 R4	1881016	S	1958	612	2570	0.00019
Achromobacter sp. 77	2756133	S	377	915	1292	0.00009
Achromobacter sp. B7	2282475	S	254	587	841	0.00006
Achromobacter sp. ES-001	2860286	S	231	755	986	0.00007
Achromobacter spanius	217203	S	3366	1485	4851	0.00035
Achromobacter denitrificans	32002	S	3106	2374	5480	0.00040
Achromobacter deleyi	1353891	S	2354	1722	4076	0.00029
Achromobacter insolitus	217204	S	1618	478	2096	0.00015
Achromobacter pestifer	1353889	S	1303	947	2250	0.00016
Achromobacter mucicolens	1389922	S	738	1099	1837	0.00013
Achromobacter ruhlandii	72557	S	35	1559	1594	0.00012
Bordetella sp. H567	1697043	S	2072	268	2340	0.00017
Bordetella sp. N	1746199	S	1976	246	2222	0.00016
Bordetella genomosp. 13	463040	S	3070	2457	5527	0.00040
Bordetella bronchialis	463025	S	2938	428	3366	0.00024
Bordetella petrii	94624	S	2508	3814	6322	0.00046
Bordetella genomosp. 8	1416806	S	2319	298	2617	0.00019
Bordetella flabilis	463014	S	2243	208	2451	0.00018
Bordetella genomosp. 9	1416803	S	2078	591	2669	0.00019
Bordetella hinzii	103855	S	1888	895	2783	0.00020
Bordetella trematum	123899	S	1454	695	2149	0.00016
Bordetella pseudohinzii	1331258	S	1109	538	1647	0.00012
Bordetella bronchiseptica	518	S	1102	4246	5348	0.00039
Bordetella holmesii	35814	S	724	255	979	0.00007
Bordetella avium	521	S	620	89	709	0.00005
Bordetella genomosp. 6	463024	S	368	664	1032	0.00007
Bordetella pertussis	520	S	234	8647	8881	0.00064
Bordetella parapertussis	519	S	119	1296	1415	0.00010
Pigmentiphaga sp. H8	2488560	S	3790	547	4337	0.00031
Pigmentiphaga aceris	1940612	S	1069	84	1153	0.00008
Castellaniella defragrans	75697	S	2540	1942	4482	0.00032
Orrella dioscoreae	1851544	S	1984	785	2769	0.00020
Orrella marina	2163011	S	294	54	348	0.00003
Orrella sp. f23	2782176	S	132	8	140	0.00001
Alcaligenes faecalis	511	S	571	507	1078	0.00008
Alcaligenes sp. SORT26	2813780	S	117	22	139	0.00001
Alcaligenes sp. DN25	1367435	S	21	46	67	0.00000
Alcaligenes aquatilis	323284	S	81	295	376	0.00003
Alcaligenes ammonioxydans	2582914	S	13	140	153	0.00001
Pusillimonas thiosulfatoxidans	2028345	S	635	190	825	0.00006
Pusillimonas sp. T7-7	1007105	S	400	70	470	0.00003
Pusillimonas sp. DMV24BSW_D	2716226	S	161	12	173	0.00001
Paralcaligenes sp. KSB-10	2901142	S	753	34	787	0.00006
Kerstersia gyiorum	206506	S	626	147	773	0.00006
Advenella kashmirensis	310575	S	296	15	311	0.00002
Advenella mimigardefordensis	302406	S	239	12	251	0.00002
Oligella ureolytica	90244	S	49	40	89	0.00001
Oligella urethralis	90245	S	38	6	44	0.00000
Paenalcaligenes hominis	643674	S	59	3	62	0.00000
Basilea psittacipulmonis	1472345	S	25	2	27	0.00000
Pelistega ratti	2652177	S	22	3	25	0.00000
Rhizobacter sp. AJA081-3	2753607	S	6547	1917	8464	0.00061
Rhizobacter gummiphilus	946333	S	6057	1372	7429	0.00054
Sphaerotilus sp. FB-5	2914710	S	4018	2908	6926	0.00050
Sphaerotilus natans	34103	S	3569	1603	5172	0.00037
Methylibium sp. Pch-M	2082386	S	2172	2090	4262	0.00031
Methylibium petroleiphilum	105560	S	2089	2202	4291	0.00031
Rubrivivax gelatinosus	28068	S	6347	2275	8622	0.00062
Aquincola tertiaricarbonis	391953	S	5455	2168	7623	0.00055
Mitsuaria sp. 7	1658665	S	4798	1094	5892	0.00043
Thiomonas sp. X19	1050370	S	1841	684	2525	0.00018
Thiomonas intermedia	926	S	1172	176	1348	0.00010
Thiomonas arsenitoxydans	426114	S	431	755	1186	0.00009
Leptothrix cholodnii	34029	S	4296	1567	5863	0.00042
Xylophilus rhododendri	2697032	S	2998	995	3993	0.00029
Ideonella dechloratans	36863	S	2464	1693	4157	0.00030
Tepidimonas taiwanensis	307486	S	2329	961	3290	0.00024
Aquabacterium olei	1296669	S	2106	636	2742	0.00020
Roseateles depolymerans	76731	S	1996	438	2434	0.00018
Inhella inkyongensis	392593	S	1471	267	1738	0.00013
Paucibacter sp. KCTC 42545	1768242	S	1186	230	1416	0.00010
Candidatus Ichthyocystis hellenicum	1561003	S	17	0	17	0.00000
Sutterella megalosphaeroides	2494234	S	713	145	858	0.00006
Sutterella faecalis	2584944	S	520	89	609	0.00004
Sutterella wadsworthensis	40545	S	226	32	258	0.00002
Turicimonas muris	1796652	S	105	9	114	0.00001
Thauera sp. MZ1T	85643	S	3429	3812	7241	0.00052
Thauera sp. K11	2005884	S	3108	2046	5154	0.00037
Thauera humireducens	1134435	S	2145	1382	3527	0.00025
Thauera chlorobenzoica	96773	S	1761	1744	3505	0.00025
Thauera aromatica	59405	S	1497	2272	3769	0.00027
Thauera hydrothermalis	2184083	S	899	286	1185	0.00009
Azoarcus sp. KH32C	748247	S	3598	717	4315	0.00031
Azoarcus sp. DD4	2027405	S	2619	1847	4466	0.00032
Azoarcus olearius	418699	S	2954	1189	4143	0.00030
Azoarcus communis	41977	S	2131	905	3036	0.00022
Nitrogeniibacter mangrovi	2016596	S	2690	614	3304	0.00024
Nitrogeniibacter aestuarii	2815343	S	1212	143	1355	0.00010
Aromatoleum petrolei	76116	S	3346	883	4229	0.00031
Aromatoleum aromaticum	551760	S	2699	2026	4725	0.00034
Aromatoleum bremense	76115	S	2466	1474	3940	0.00028
Aromatoleum pumilum	2067960	S	2362	967	3329	0.00024
Azospira restricta	404405	S	5712	3205	8917	0.00064
Azospira inquinata	2785627	S	496	46	542	0.00004
Azospira sp. I09	1765049	S	410	1292	1702	0.00012
Azospira oryzae	146939	S	357	919	1276	0.00009
Niveibacterium microcysteis	2811415	S	1986	313	2299	0.00017
Oryzomicrobium terrae	1735038	S	1473	413	1886	0.00014
Rugosibacter aromaticivorans	1565605	S	397	75	472	0.00003
Dechloromonas denitrificans	281362	S	2136	569	2705	0.00020
Dechloromonas sp. HYN0024	2231055	S	594	129	723	0.00005
Dechloromonas sp. TW-R-39-2	2654218	S	340	160	500	0.00004
Ferribacterium limneticum	76259	S	2731	500	3231	0.00023
Quatrionicoccus australiensis	138118	S	1137	359	1496	0.00011
Fluviibacter phosphoraccumulans	1751046	S	191	72	263	0.00002
Usitatibacter rugosus	2732067	S	8896	1131	10027	0.00072
Usitatibacter palustris	2732487	S	6985	945	7930	0.00057
Nitrosospira multiformis	1231	S	6672	227	6899	0.00050
Nitrosospira lacus	1288494	S	540	19	559	0.00004
Nitrosospira sp. NRS527	155925	S	238	157	395	0.00003
Nitrosospira briensis	35799	S	208	147	355	0.00003
Nitrosomonas communis	44574	S	2877	71	2948	0.00021
Nitrosomonas ureae	44577	S	259	8	267	0.00002
Nitrosomonas europaea	915	S	156	24	180	0.00001
Nitrosomonas eutropha	916	S	100	61	161	0.00001
Nitrosomonas stercoris	1444684	S	45	27	72	0.00001
Denitratisoma sp. DHT3	1981880	S	2101	1729	3830	0.00028
Denitratisoma oestradiolicum	311182	S	1051	190	1241	0.00009
Sulfuritalea hydrogenivorans	748811	S	2404	398	2802	0.00020
Methyloversatilis sp. RAC08	1842540	S	2044	306	2350	0.00017
Sterolibacterium denitrificans	157592	S	1606	504	2110	0.00015
Thiobacillus denitrificans	36861	S	3059	669	3728	0.00027
Sulfuritortus calidifontis	1914471	S	2210	1055	3265	0.00024
Sideroxydans sp. MIZ01	2764705	S	1071	232	1303	0.00009
Sideroxydans lithotrophicus	63745	S	840	132	972	0.00007
Ferrigenium kumadai	1682490	S	1389	310	1699	0.00012
Candidatus Nitrotoga arctica	453162	S	196	73	269	0.00002
Candidatus Nitrotoga sp. AM1P	2559597	S	123	49	172	0.00001
Ferriphaselus amnicola	1188319	S	412	59	471	0.00003
Gallionella capsiferriformans	370405	S	323	31	354	0.00003
Sulfuriferula plumbiphila	171865	S	953	179	1132	0.00008
Sulfuriferula sp. AH1	1985873	S	473	101	574	0.00004
Sulfuriferula nivalis	2675298	S	89	7	96	0.00001
Sulfurimicrobium lacus	2715678	S	1511	215	1726	0.00012
Sulfuricella denitrificans	649841	S	844	86	930	0.00007
Methylovorus glucosotrophus	266009	S	144	126	270	0.00002
Methylovorus sp. MP688	887061	S	119	115	234	0.00002
Methylobacillus flagellatus	405	S	398	111	509	0.00004
Methylophilus sp. TWE2	1662285	S	90	6	96	0.00001
Methylophilus medardicus	2588534	S	86	7	93	0.00001
Candidatus Methylopumilus turicensis	1581680	S	37	5	42	0.00000
Candidatus Methylopumilus universalis	2588536	S	33	16	49	0.00000
Candidatus Methylopumilus planktonicus	1581557	S	21	11	32	0.00000
Candidatus Methylopumilus rimovensis	2588535	S	18	3	21	0.00000
Methylotenera mobilis	359408	S	84	10	94	0.00001
Methylotenera versatilis	1055487	S	29	3	32	0.00000
Methyloradius palustris	2778876	S	93	8	101	0.00001
Chromobacterium sp. ATCC 53434	2059672	S	1359	514	1873	0.00014
Chromobacterium sp. Rain0013	2292447	S	257	326	583	0.00004
Chromobacterium sp. Beijing	2735795	S	238	691	929	0.00007
Chromobacterium vaccinii	1108595	S	1343	626	1969	0.00014
Chromobacterium violaceum	536	S	1331	859	2190	0.00016
Chromobacterium phragmitis	2202141	S	807	382	1189	0.00009
Chromobacterium paludis	2605945	S	784	334	1118	0.00008
Chromobacterium rhizoryzae	1778675	S	213	1148	1361	0.00010
Chromobacterium haemolyticum	394935	S	135	905	1040	0.00008
Iodobacter ciconiae	2496266	S	76	20	96	0.00001
Iodobacter fluviatilis	537	S	52	16	68	0.00000
Jeongeupia sp. USM3	1906741	S	1910	561	2471	0.00018
Jeongeupia sp. HS-3	1009682	S	876	194	1070	0.00008
Paludibacterium paludis	1225769	S	948	204	1152	0.00008
Paludibacterium yongneupense	400061	S	877	136	1013	0.00007
Paludibacterium sp. B53371	2806263	S	627	142	769	0.00006
Pseudogulbenkiania sp. NH8B	748280	S	2045	750	2795	0.00020
Vogesella sp. LIG4	1192162	S	1094	314	1408	0.00010
Vogesella sp. XCS3	2877939	S	520	154	674	0.00005
Aquitalea aquatilis	1537400	S	376	122	498	0.00004
Aquitalea denitrificans	519081	S	229	116	345	0.00002
Aquitalea sp. USM4	1590041	S	218	117	335	0.00002
Aquitalea magnusonii	332411	S	214	120	334	0.00002
Microvirgula aerodenitrificans	57480	S	1209	252	1461	0.00011
Laribacter hongkongensis	168471	S	983	983	1966	0.00014
Aquaspirillum sp. LM1	1938604	S	631	102	733	0.00005
Chitinibacter bivalviorum	2739434	S	111	95	206	0.00001
Chitinibacter fontanus	1737446	S	105	16	121	0.00001
Deefgea sp. D25	2865840	S	69	11	80	0.00001
Deefgea sp. D17	2739061	S	60	26	86	0.00001
Deefgea sp. D13	2864875	S	54	20	74	0.00001
Neisseria sp. KEM232	655307	S	231	29	260	0.00002
Neisseria sp. oral taxon 014	641148	S	130	47	177	0.00001
Neisseria sp. ZJ785	2709396	S	75	8	83	0.00001
Neisseria sp. Dent CA1/247	2912675	S	51	17	68	0.00000
Neisseria bacilliformis	267212	S	305	69	374	0.00003
Neisseria shayeganii	607712	S	253	36	289	0.00002
Neisseria meningitidis	487	S	229	1383	1612	0.00012
Neisseria chenwenguii	1853278	S	226	28	254	0.00002
Neisseria elongata	495	S	186	84	270	0.00002
Neisseria dentiae	194197	S	175	21	196	0.00001
Neisseria musculi	1815583	S	132	12	144	0.00001
Neisseria gonorrhoeae	485	S	98	252	350	0.00003
Neisseria lactamica	486	S	85	77	162	0.00001
Neisseria animalis	492	S	84	12	96	0.00001
Neisseria weaveri	28091	S	78	30	108	0.00001
Neisseria brasiliensis	2666100	S	60	61	121	0.00001
Neisseria canis	493	S	60	12	72	0.00001
Neisseria animaloris	326522	S	57	10	67	0.00000
Neisseria zalophi	640030	S	55	6	61	0.00000
Neisseria wadsworthii	607711	S	52	9	61	0.00000
Neisseria sicca	490	S	49	80	129	0.00001
Neisseria weixii	1853276	S	49	5	54	0.00000
Neisseria dumasiana	1931275	S	48	16	64	0.00000
Neisseria mucosa	488	S	45	87	132	0.00001
Neisseria arctica	1470200	S	39	4	43	0.00000
Neisseria macacae	496	S	32	58	90	0.00001
Neisseria zoodegmatis	326523	S	28	13	41	0.00000
Neisseria cinerea	483	S	21	10	31	0.00000
Neisseria subflava	28449	S	18	11	29	0.00000
Neisseria flavescens	484	S	14	8	22	0.00000
Crenobacter cavernae	2290923	S	2254	805	3059	0.00022
Chitinolyticbacter meiyuanensis	682798	S	1582	212	1794	0.00013
Vitreoscilla filiformis	63	S	629	126	755	0.00005
Vitreoscilla massiliensis	1689272	S	73	19	92	0.00001
Kingella potus	265175	S	174	23	197	0.00001
Kingella denitrificans	502	S	121	79	200	0.00001
Kingella oralis	505	S	115	18	133	0.00001
Kingella kingae	504	S	44	7	51	0.00000
Eikenella corrodens	539	S	217	148	365	0.00003
Eikenella exigua	2528037	S	58	46	104	0.00001
Uruburuella suis	252130	S	174	27	201	0.00001
Uruburuella testudinis	1282863	S	150	29	179	0.00001
Paralysiella testudinis	2809020	S	163	36	199	0.00001
Alysiella crassa	153491	S	43	13	56	0.00000
Alysiella filiformis	194196	S	23	7	30	0.00000
Conchiformibius steedae	153493	S	66	11	77	0.00001
Neisseriaceae bacterium CCUG 44465	2917790	S	38	6	44	0.00000
Snodgrassella alvi	1196083	S	38	13	51	0.00000
Morococcus cerebrosus	1056807	S	31	132	163	0.00001
Aquella oligotrophica	2067065	S	23	1	24	0.00000
Simonsiella muelleri	72	S	19	3	22	0.00000
Casimicrobium huifangae	2591109	S	1533	805	2338	0.00017
Candidatus Kinetoplastibacterium sorsogonicusi	1576550	S	11	2	13	0.00000
Lysobacter sp. CECT 30171	2822368	S	5414	1412	6826	0.00049
Lysobacter sp. KIS68-7	2904252	S	4757	991	5748	0.00042
Lysobacter sp. 5GHs7-4	2904253	S	4340	1413	5753	0.00042
Lysobacter sp. TY2-98	2290922	S	4314	740	5054	0.00037
Lysobacter sp. S4-A87	2925843	S	3986	1385	5371	0.00039
Lysobacter sp. CW239	2762611	S	3247	1906	5153	0.00037
Lysobacter sp. K5869	2820808	S	2478	1237	3715	0.00027
Lysobacter sp. H21R4	2781021	S	758	1522	2280	0.00016
Lysobacter sp. CJ11	2764185	S	453	42	495	0.00004
Lysobacter sp. H23M47	2781024	S	380	1908	2288	0.00017
Lysobacter sp. HDW10	2714936	S	313	93	406	0.00003
Lysobacter soli	453783	S	16435	3653	20088	0.00145
Lysobacter enzymogenes	69	S	10421	3986	14407	0.00104
Lysobacter solisilvae (ex Woo and Kim 2022)	2865112	S	6909	2182	9091	0.00066
Lysobacter capsici	435897	S	6203	6607	12810	0.00093
Lysobacter solisilvae (ex Kim et al. 2021)	2763317	S	5771	1247	7018	0.00051
Lysobacter maris	1605891	S	4700	1220	5920	0.00043
Lysobacter antibioticus	84531	S	4463	987	5450	0.00039
Lysobacter arenosi	2795387	S	3840	1303	5143	0.00037
Lysobacter lycopersici	1324796	S	3667	845	4512	0.00033
Lysobacter alkalisoli	2591633	S	3543	684	4227	0.00031
Lysobacter oculi	2698682	S	2653	785	3438	0.00025
Lysobacter ciconiae	2781022	S	640	1174	1814	0.00013
Lysobacter gummosus	262324	S	464	3849	4313	0.00031
Lysobacter avium	2781023	S	355	1609	1964	0.00014
Stenotrophomonas maltophilia	40324	S	8496	12996	21492	0.00155
Stenotrophomonas sp. ESTM1D_MKCIP4_1	2072414	S	564	250	814	0.00006
Stenotrophomonas sp. SAU14A_NAIMI4_5	2072413	S	512	346	858	0.00006
Stenotrophomonas sp. ZAC14D2_NAIMI4_7	2072405	S	255	297	552	0.00004
Stenotrophomonas sp. ZAC14A_NAIMI4_1	2072412	S	227	462	689	0.00005
Stenotrophomonas sp. ZAC14D2_NAIMI4_6	2072406	S	171	363	534	0.00004
Stenotrophomonas sp. YAU14D1_LEIMI4_1	2072407	S	168	314	482	0.00003
Stenotrophomonas sp. YAU14A_MKIMI4_1	2072408	S	67	414	481	0.00003
Stenotrophomonas sp. SAU14A_NAIMI4_8	2072409	S	66	408	474	0.00003
Stenotrophomonas sp. LM091	1904944	S	1123	463	1586	0.00011
Stenotrophomonas sp. 169	2770322	S	983	173	1156	0.00008
Stenotrophomonas sp. 364	2691571	S	717	295	1012	0.00007
Stenotrophomonas sp. NA06056	2742129	S	387	201	588	0.00004
Stenotrophomonas sp. WZN-1	2005046	S	212	267	479	0.00003
Stenotrophomonas sp. DR822	2871174	S	112	195	307	0.00002
Stenotrophomonas sp. Pemsol	2040586	S	108	343	451	0.00003
Stenotrophomonas sp. ASS1	2282124	S	68	332	400	0.00003
Stenotrophomonas sp. SI-NJAU-1	2886359	S	60	278	338	0.00002
Stenotrophomonas sp. CW117	2775920	S	60	1421	1481	0.00011
Stenotrophomonas sp. pho	2211160	S	55	269	324	0.00002
Stenotrophomonas sp. G4	2303750	S	53	238	291	0.00002
Stenotrophomonas sp. MYb57	1827305	S	47	214	261	0.00002
Stenotrophomonas sp. NY11291	2939415	S	34	401	435	0.00003
Stenotrophomonas sp. SXG-1	2682487	S	31	371	402	0.00003
Stenotrophomonas rhizophila	216778	S	3397	1079	4476	0.00032
Stenotrophomonas acidaminiphila	128780	S	2137	5347	7484	0.00054
Stenotrophomonas indicatrix	2045451	S	100	421	521	0.00004
Xanthomonas translucens	343	S	3270	4412	7682	0.00056
Xanthomonas campestris	339	S	2475	1870	4345	0.00031
Xanthomonas sacchari	56458	S	1892	710	2602	0.00019
Xanthomonas sp. SS	2724122	S	367	612	979	0.00007
Xanthomonas sp. GW	2724121	S	327	471	798	0.00006
Xanthomonas sp. SI	2724123	S	300	504	804	0.00006
Xanthomonas sp. MLO165	2081477	S	95	152	247	0.00002
Xanthomonas arboricola	56448	S	1410	1618	3028	0.00022
Xanthomonas theicola	56464	S	1263	451	1714	0.00012
Xanthomonas oryzae	347	S	1140	519	1659	0.00012
Xanthomonas citri	346	S	992	7273	8265	0.00060
Xanthomonas hyacinthi	56455	S	948	628	1576	0.00011
Xanthomonas albilineans	29447	S	811	117	928	0.00007
Xanthomonas vesicatoria	56460	S	767	483	1250	0.00009
Xanthomonas hortorum	56454	S	731	599	1330	0.00010
Xanthomonas fragariae	48664	S	708	157	865	0.00006
Xanthomonas cucurbitae	56453	S	655	130	785	0.00006
Xanthomonas vasicola	56459	S	511	205	716	0.00005
Xanthomonas cassavae	56450	S	497	139	636	0.00005
Xanthomonas axonopodis	53413	S	402	306	708	0.00005
Xanthomonas euroxanthea	2259622	S	385	490	875	0.00006
Xanthomonas perforans	442694	S	368	3955	4323	0.00031
Xanthomonas hydrangeae	2775159	S	367	141	508	0.00004
Xanthomonas euvesicatoria	456327	S	249	1715	1964	0.00014
Xanthomonas phaseoli	1985254	S	235	727	962	0.00007
Luteimonas sp. MC1750	2799326	S	2925	1168	4093	0.00030
Luteimonas sp. S4-F44	2925842	S	2490	526	3016	0.00022
Luteimonas sp. JM171	1896164	S	2487	548	3035	0.00022
Luteimonas sp. MC1572	2799325	S	2283	1203	3486	0.00025
Luteimonas sp. YGD11-2	2508168	S	2254	1043	3297	0.00024
Luteimonas sp. D4P002	2901869	S	2161	616	2777	0.00020
Luteimonas sp. MC1825	2761107	S	2039	1104	3143	0.00023
Luteimonas granuli	1176533	S	2811	1054	3865	0.00028
Luteimonas yindakuii	2565782	S	2139	892	3031	0.00022
Luteimonas chenhongjianii	2006110	S	1870	436	2306	0.00017
Pseudoxanthomonas suwonensis	314722	S	5763	3173	8936	0.00065
Pseudoxanthomonas mexicana	128785	S	4875	5281	10156	0.00073
Pseudoxanthomonas sp. X-1	2571115	S	2381	2313	4694	0.00034
Pseudoxanthomonas sp. F37	2932492	S	114	4879	4993	0.00036
Pseudoxanthomonas daejeonensis	266062	S	2058	550	2608	0.00019
Pseudoxanthomonas spadix	415229	S	1555	623	2178	0.00016
Thermomonas sp. XSG	2771436	S	2096	1011	3107	0.00022
Thermomonas sp. HDW16	2714945	S	1421	426	1847	0.00013
Thermomonas brevis	215691	S	2921	1320	4241	0.00031
Thermomonas aquatica	2202149	S	2793	1615	4408	0.00032
Thermomonas carbonis	1463158	S	1973	458	2431	0.00018
Arenimonas daejeonensis	370777	S	5161	1145	6306	0.00046
Pseudolysobacter antarcticus	2511995	S	1305	38	1343	0.00010
Xylella fastidiosa	2371	S	216	45	261	0.00002
Xylella taiwanensis	1444770	S	160	9	169	0.00001
Luteibacter sp. 321	2911537	S	1792	555	2347	0.00017
Luteibacter sp. EIF3	2780091	S	1270	210	1480	0.00011
Luteibacter sp. 335	2911538	S	1101	250	1351	0.00010
Luteibacter sp. 353	2911539	S	1066	336	1402	0.00010
Luteibacter pinisoli	2589080	S	1308	364	1672	0.00012
Luteibacter rhizovicinus	242606	S	1296	194	1490	0.00011
Luteibacter anthropi	564369	S	1092	213	1305	0.00009
Rhodanobacter denitrificans	666685	S	2738	1166	3904	0.00028
Rhodanobacter sp. FDAARGOS 1247	2778082	S	1663	617	2280	0.00016
Rhodanobacter thiooxydans	416169	S	1549	780	2329	0.00017
Rhodanobacter glycinis	582702	S	1193	239	1432	0.00010
Dyella thiooxydans	445710	S	2120	723	2843	0.00021
Dyella japonica	231455	S	1237	403	1640	0.00012
Dyella telluris	2763498	S	1149	331	1480	0.00011
Dyella terrae	522259	S	785	120	905	0.00007
Dyella caseinilytica	1849581	S	689	58	747	0.00005
Dyella sp. M7H15-1	2501295	S	464	51	515	0.00004
Frateuria sp. 5GH9-34	2898793	S	1993	691	2684	0.00019
Frateuria sp. 5GH9-11	1542730	S	1824	810	2634	0.00019
Frateuria aurantia	81475	S	643	91	734	0.00005
Dokdonella koreensis	323415	S	4113	779	4892	0.00035
Aerosticca soli	2010829	S	2053	2949	5002	0.00036
Ahniella affigens	2021234	S	1032	29	1061	0.00008
Pseudomonas sp. LPB0260	2614442	S	1129	248	1377	0.00010
Pseudomonas sp. ATCC 13867	1294143	S	1124	419	1543	0.00011
Pseudomonas sp. TCU-HL1	1856685	S	1057	162	1219	0.00009
Pseudomonas sp. SCB32	2653853	S	1026	233	1259	0.00009
Pseudomonas sp. CC6-YY-74	1930532	S	1009	130	1139	0.00008
Pseudomonas sp. DY-1	1755504	S	998	137	1135	0.00008
Pseudomonas sp. PDNC002	2811422	S	986	241	1227	0.00009
Pseudomonas sp. KNUC1026	2893890	S	863	89	952	0.00007
Pseudomonas sp. MTM4	2705472	S	775	147	922	0.00007
Pseudomonas sp. Ost2	2678260	S	754	119	873	0.00006
Pseudomonas sp. ABC1	2748080	S	687	106	793	0.00006
Pseudomonas sp. SK	2729423	S	663	632	1295	0.00009
Pseudomonas sp. MM211	2866808	S	648	64	712	0.00005
Pseudomonas sp. p1(2021b)	2874628	S	620	363	983	0.00007
Pseudomonas sp. L5B5	2883205	S	603	118	721	0.00005
Pseudomonas sp. StFLB209	1028989	S	588	163	751	0.00005
Pseudomonas sp. Pc102	2678261	S	564	333	897	0.00006
Pseudomonas sp. OIL-1	2706126	S	552	119	671	0.00005
Pseudomonas sp. 7SR1	1881017	S	544	108	652	0.00005
Pseudomonas sp. B11D7D	2735906	S	502	105	607	0.00004
Pseudomonas sp. CMR5c	658630	S	482	150	632	0.00005
Pseudomonas sp. MSPm1	2726956	S	465	111	576	0.00004
Pseudomonas sp. HN2-3	2886360	S	443	108	551	0.00004
Pseudomonas sp. gcc21	2726989	S	434	209	643	0.00005
Pseudomonas sp. MPC6	2498848	S	405	95	500	0.00004
Pseudomonas sp. Marseille-Q3773	2866592	S	392	141	533	0.00004
Pseudomonas sp. LAB-08	143813	S	382	77	459	0.00003
Pseudomonas sp. HLS-6	2049589	S	358	117	475	0.00003
Pseudomonas sp. S09G 359	2054919	S	351	93	444	0.00003
Pseudomonas sp. Leaf58	1736226	S	342	71	413	0.00003
Pseudomonas sp. 15A4	2804761	S	332	93	425	0.00003
Pseudomonas sp. DG56-2	2320270	S	329	39	368	0.00003
Pseudomonas sp. URMO17WK12:I11	1283291	S	327	244	571	0.00004
Pseudomonas sp. ADAK13	2730847	S	321	82	403	0.00003
Pseudomonas sp. M1	95619	S	318	814	1132	0.00008
Pseudomonas sp. ADPe	2774873	S	314	836	1150	0.00008
Pseudomonas sp. S34	1573718	S	293	76	369	0.00003
Pseudomonas sp. RtIB026	2749999	S	291	187	478	0.00003
Pseudomonas sp. MM213	2866807	S	273	65	338	0.00002
Pseudomonas sp. R5-89-07	658644	S	260	89	349	0.00003
Pseudomonas sp. 2hn	2866626	S	260	191	451	0.00003
Pseudomonas sp. Tri1	2823875	S	257	68	325	0.00002
Pseudomonas sp. S35	1573719	S	250	74	324	0.00002
Pseudomonas sp. 31-12	2201356	S	236	66	302	0.00002
Pseudomonas sp. DTU12.3	2073078	S	234	65	299	0.00002
Pseudomonas sp. RC3H12	2834406	S	232	155	387	0.00003
Pseudomonas sp. NIBR-H-19	2901380	S	232	56	288	0.00002
Pseudomonas sp. M30-35	1981174	S	226	14	240	0.00002
Pseudomonas sp. Seg1	2678259	S	224	56	280	0.00002
Pseudomonas sp. LG1E9	2219057	S	209	68	277	0.00002
Pseudomonas sp. PP3	2815936	S	201	85	286	0.00002
Pseudomonas sp. HN11	1344094	S	201	51	252	0.00002
Pseudomonas sp. LS.1a	2920387	S	200	94	294	0.00002
Pseudomonas sp. NS1(2017)	2025658	S	200	58	258	0.00002
Pseudomonas sp. DR48	2871095	S	200	147	347	0.00003
Pseudomonas sp. OE 28.3	2745519	S	200	53	253	0.00002
Pseudomonas sp. HS6	2850559	S	196	58	254	0.00002
Pseudomonas sp. ADAK18	2730848	S	196	38	234	0.00002
Pseudomonas sp. DNDY-54	2870860	S	193	105	298	0.00002
Pseudomonas sp. ACM7	2052956	S	185	36	221	0.00002
Pseudomonas sp. R2A2	2213057	S	178	227	405	0.00003
Pseudomonas sp. NIBRBAC000502773	2590776	S	174	99	273	0.00002
Pseudomonas sp. SCA2728.1_7	2825975	S	168	101	269	0.00002
Pseudomonas sp. MRSN12121	1611770	S	166	260	426	0.00003
Pseudomonas sp. HS-18	2879114	S	161	365	526	0.00004
Pseudomonas sp. 14181154	2662033	S	159	193	352	0.00003
Pseudomonas sp. St316	2678257	S	157	57	214	0.00002
Pseudomonas sp. LPH1	1898684	S	156	158	314	0.00002
Pseudomonas sp. R76	1573711	S	155	85	240	0.00002
Pseudomonas sp. CYM-20-01	2870750	S	149	82	231	0.00002
Pseudomonas sp. IzPS59	2774459	S	148	78	226	0.00002
Pseudomonas sp. R84	1573712	S	136	70	206	0.00001
Pseudomonas sp. CCOS 191	1649877	S	135	124	259	0.00002
Pseudomonas sp. 02C 26	2054914	S	128	315	443	0.00003
Pseudomonas sp. LTJR-52	2479392	S	128	47	175	0.00001
Pseudomonas sp. SK3(2021)	2841064	S	128	92	220	0.00002
Pseudomonas sp. UW4	1207075	S	127	93	220	0.00002
Pseudomonas sp. RBPA9	2746321	S	123	292	415	0.00003
Pseudomonas sp. Z003-0.4C(8344-21)	1855380	S	122	96	218	0.00002
Pseudomonas sp. AO-1	2855434	S	121	129	250	0.00002
Pseudomonas sp. THAF7b	2587845	S	121	264	385	0.00003
Pseudomonas sp. FIT81	2837969	S	119	78	197	0.00001
Pseudomonas sp. phDV1	253237	S	113	428	541	0.00004
Pseudomonas sp. S07E 245	2866278	S	112	292	404	0.00003
Pseudomonas sp. SDM007	2812000	S	107	75	182	0.00001
Pseudomonas sp. B10	118613	S	107	87	194	0.00001
Pseudomonas sp. FGI182	1259844	S	101	125	226	0.00002
Pseudomonas sp. Cab53	2678258	S	100	177	277	0.00002
Pseudomonas sp. BIGb0427	2724470	S	98	245	343	0.00002
Pseudomonas sp. Y5-11	2749808	S	90	305	395	0.00003
Pseudomonas sp. 3-2	2867408	S	84	123	207	0.00001
Pseudomonas sp. SORT22	2813842	S	81	215	296	0.00002
Pseudomonas sp. FDAARGOS_380	2018067	S	81	73	154	0.00001
Pseudomonas sp. DR 5-09	1534110	S	79	121	200	0.00001
Pseudomonas sp. 09C 129	2054915	S	76	104	180	0.00001
Pseudomonas sp. AN-B15	2697023	S	75	234	309	0.00002
Pseudomonas sp. GR 6-02	1659194	S	74	203	277	0.00002
Pseudomonas sp. ArH3a	2862945	S	74	206	280	0.00002
Pseudomonas sp. MPFS	2795724	S	72	136	208	0.00002
Pseudomonas sp. RU47	2005388	S	66	188	254	0.00002
Pseudomonas sp. S150	2559074	S	65	113	178	0.00001
Pseudomonas sp. ATCC 43928	676210	S	65	180	245	0.00002
Pseudomonas sp. HN2	2884805	S	63	62	125	0.00001
Pseudomonas sp. C27(2019)	2604941	S	62	10	72	0.00001
Pseudomonas sp. SC3(2021)	2871493	S	62	74	136	0.00001
Pseudomonas sp. PONIH3	1636610	S	60	366	426	0.00003
Pseudomonas sp. St29	1500687	S	54	244	298	0.00002
Pseudomonas sp. BIOMIG1BAC	1758730	S	54	192	246	0.00002
Pseudomonas sp. MYb193	1827300	S	51	61	112	0.00001
Pseudomonas sp. BC42	2933816	S	50	275	325	0.00002
Pseudomonas sp. SWI36	2083052	S	50	156	206	0.00001
Pseudomonas sp. J380	2605424	S	49	69	118	0.00001
Pseudomonas sp. LBUM920	2126069	S	48	133	181	0.00001
Pseudomonas sp. ADAK22	2730851	S	48	134	182	0.00001
Pseudomonas sp. S49	1573720	S	46	132	178	0.00001
Pseudomonas sp. CFSAN084952	2664899	S	42	138	180	0.00001
Pseudomonas sp. A214	1855331	S	42	136	178	0.00001
Pseudomonas sp. A2	107445	S	42	251	293	0.00002
Pseudomonas sp. R3-18-08	1173283	S	41	131	172	0.00001
Pseudomonas sp. Os17	1500686	S	41	225	266	0.00002
Pseudomonas sp. R32	1573704	S	39	111	150	0.00001
Pseudomonas sp. PS1(2021)	2866282	S	37	1198	1235	0.00009
Pseudomonas sp. DR208	2870840	S	37	99	136	0.00001
Pseudomonas sp. R1-43-08	1173270	S	35	227	262	0.00002
Pseudomonas sp. HN8-3	2886361	S	34	75	109	0.00001
Pseudomonas sp. Y39-6	2749807	S	34	122	156	0.00001
Pseudomonas sp. CFA	2651048	S	33	173	206	0.00001
Pseudomonas sp. MPDS	2762896	S	32	138	170	0.00001
Pseudomonas sp. NC02	2067572	S	30	105	135	0.00001
Pseudomonas sp. 7-41	2898483	S	29	142	171	0.00001
Pseudomonas sp. R4-39-08	1173288	S	29	187	216	0.00002
Pseudomonas sp. Colony2	2861799	S	28	126	154	0.00001
Pseudomonas sp. LG1D9	2083054	S	28	115	143	0.00001
Pseudomonas sp. R2-37-08W	1173273	S	28	145	173	0.00001
Pseudomonas sp. DTU12.1	2654238	S	28	123	151	0.00001
Pseudomonas sp. SXM-1	2169583	S	28	92	120	0.00001
Pseudomonas sp. SWI44	2083053	S	27	249	276	0.00002
Pseudomonas sp. CIP-10	2892442	S	26	260	286	0.00002
Pseudomonas sp. IAC-BECa141	2793103	S	25	57	82	0.00001
Pseudomonas sp. B14-6	2738843	S	25	75	100	0.00001
Pseudomonas sp. Eqa60	2799184	S	24	152	176	0.00001
Pseudomonas sp. XWY-1	2069256	S	22	140	162	0.00001
Pseudomonas sp. St290	1602166	S	21	90	111	0.00001
Pseudomonas sp. LH1G9	2083055	S	21	80	101	0.00001
Pseudomonas sp. SW-3	147212	S	21	87	108	0.00001
Pseudomonas sp. TKP	1415630	S	21	80	101	0.00001
Pseudomonas sp. So3.2b	2864101	S	20	71	91	0.00001
Pseudomonas sp. R2-60-08W	1173280	S	20	153	173	0.00001
Pseudomonas sp. TMW 2.1634	1886807	S	20	57	77	0.00001
Pseudomonas sp. R4-35-07	658643	S	18	133	151	0.00001
Pseudomonas sp. SWI7	2587597	S	18	125	143	0.00001
Pseudomonas sp. IB20	1702250	S	18	116	134	0.00001
Pseudomonas sp. VLB120	69328	S	17	259	276	0.00002
Pseudomonas sp. BJP69	2597770	S	17	111	128	0.00001
Pseudomonas sp. R11-23-07	658632	S	17	166	183	0.00001
Pseudomonas sp. R3-52-08	1173284	S	16	106	122	0.00001
Pseudomonas sp. R4-34-07	658642	S	16	101	117	0.00001
Pseudomonas sp. OST1909	2777367	S	16	54	70	0.00001
Pseudomonas sp. SK2	2841063	S	15	298	313	0.00002
Pseudomonas sp. I3-I5	2926671	S	15	65	80	0.00001
Pseudomonas sp. LTGT-11-2Z	2479393	S	14	423	437	0.00003
Pseudomonas sp. St386	2678256	S	13	119	132	0.00001
Pseudomonas sp. SWI6	2083051	S	12	219	231	0.00002
Pseudomonas sp. R2-7-07	658641	S	11	113	124	0.00001
Pseudomonas sp. BYT-1	2816906	S	11	102	113	0.00001
Pseudomonas aeruginosa	287	S	6071	52122	58193	0.00420
Pseudomonas mendocina	300	S	2999	1142	4141	0.00030
Pseudomonas alcaligenes	43263	S	2522	1779	4301	0.00031
Pseudomonas furukawaii	1149133	S	1632	522	2154	0.00016
Pseudomonas oleovorans	301	S	297	894	1191	0.00009
Pseudomonas resinovorans	53412	S	1473	341	1814	0.00013
Pseudomonas multiresinivorans	95301	S	641	227	868	0.00006
Pseudomonas nitroreducens	46680	S	194	434	628	0.00005
Pseudomonas citronellolis	53408	S	676	1049	1725	0.00012
Pseudomonas fluorescens	294	S	5529	4687	10216	0.00074
Pseudomonas protegens	380021	S	1347	6401	7748	0.00056
Pseudomonas orientalis	76758	S	962	270	1232	0.00009
Pseudomonas azotoformans	47878	S	813	331	1144	0.00008
Pseudomonas synxantha	47883	S	664	449	1113	0.00008
Pseudomonas rhodesiae	76760	S	513	209	722	0.00005
Pseudomonas tolaasii	29442	S	434	84	518	0.00004
Pseudomonas poae	200451	S	431	224	655	0.00005
Pseudomonas trivialis	200450	S	417	151	568	0.00004
Pseudomonas mediterranea	183795	S	416	107	523	0.00004
Pseudomonas corrugata	47879	S	362	80	442	0.00003
Pseudomonas migulae	78543	S	347	194	541	0.00004
Pseudomonas cedrina	651740	S	289	76	365	0.00003
Pseudomonas mucidolens	46679	S	289	44	333	0.00002
Pseudomonas congelans	200452	S	213	67	280	0.00002
Pseudomonas brenneri	129817	S	201	79	280	0.00002
Pseudomonas ogarae	1114970	S	158	121	279	0.00002
Pseudomonas mandelii	75612	S	147	401	548	0.00004
Pseudomonas veronii	76761	S	144	397	541	0.00004
Pseudomonas libanensis	75588	S	126	140	266	0.00002
Pseudomonas extremorientalis	169669	S	20	49	69	0.00001
Pseudomonas stutzeri	316	S	10139	6923	17062	0.00123
Pseudomonas chloritidismutans	203192	S	121	172	293	0.00002
Pseudomonas balearica	74829	S	1629	2129	3758	0.00027
Pseudomonas xanthomarina	271420	S	476	83	559	0.00004
Pseudomonas luteola	47886	S	127	62	189	0.00001
Pseudomonas putida	303	S	7231	9871	17102	0.00124
Pseudomonas oryzihabitans	47885	S	2424	550	2974	0.00021
Pseudomonas fulva	47880	S	1611	4448	6059	0.00044
Pseudomonas plecoglossicida	70775	S	475	395	870	0.00006
Pseudomonas mosselii	78327	S	250	477	727	0.00005
Pseudomonas monteilii	76759	S	245	526	771	0.00006
Pseudomonas sp. SGAir0191	2217867	S	105	69	174	0.00001
Pseudomonas shirazica	1940636	S	21	291	312	0.00002
Pseudomonas syringae	317	S	1630	6459	8089	0.00058
Pseudomonas viridiflava	33069	S	1158	147	1305	0.00009
Pseudomonas cichorii	36746	S	616	59	675	0.00005
Pseudomonas asturiensis	1190415	S	413	45	458	0.00003
Pseudomonas amygdali	47877	S	175	816	991	0.00007
Pseudomonas savastanoi	29438	S	77	243	320	0.00002
Pseudomonas syringae group genomosp. 7	251699	S	308	40	348	0.00003
Pseudomonas fuscovaginae	50340	S	185	112	297	0.00002
Pseudomonas avellanae	46257	S	77	113	190	0.00001
Pseudomonas coronafaciens	53409	S	70	202	272	0.00002
Pseudomonas syringae group genomosp. 3	251701	S	56	708	764	0.00006
Pseudomonas sp. Lz4W	1206777	S	31	57	88	0.00001
Pseudomonas tremae	200454	S	23	52	75	0.00001
Pseudomonas chlororaphis	587753	S	3913	3788	7701	0.00056
Pseudomonas lundensis	86185	S	351	47	398	0.00003
Pseudomonas fragi	296	S	191	162	353	0.00003
Pseudomonas otitidis	319939	S	2407	583	2990	0.00022
Pseudomonas lalkuanensis	2604832	S	2378	477	2855	0.00021
Pseudomonas knackmussii	65741	S	2103	1783	3886	0.00028
Pseudomonas psychrotolerans	237610	S	2081	488	2569	0.00019
Pseudomonas oryzae	1392877	S	1987	702	2689	0.00019
Pseudomonas cavernae	2320867	S	1610	280	1890	0.00014
Pseudomonas entomophila	312306	S	1548	710	2258	0.00016
Pseudomonas guangdongensis	1245526	S	1305	470	1775	0.00013
Pseudomonas campi	2731681	S	946	143	1089	0.00008
Pseudomonas eucalypticola	2599595	S	828	114	942	0.00007
Pseudomonas qingdaonensis	2056231	S	790	172	962	0.00007
Pseudomonas parafulva	157782	S	741	223	964	0.00007
Pseudomonas vanderleydeniana	2745495	S	694	103	797	0.00006
Pseudomonas nanhaiensis	2830842	S	677	86	763	0.00006
Pseudomonas rhizosphaerae	216142	S	655	87	742	0.00005
Pseudomonas alkylphenolica	237609	S	641	134	775	0.00006
Pseudomonas tohonis	2725477	S	622	525	1147	0.00008
Pseudomonas saudiphocaensis	1499686	S	617	143	760	0.00005
Pseudomonas cremoricolorata	157783	S	611	99	710	0.00005
Pseudomonas zhaodongensis	1176257	S	605	285	890	0.00006
Pseudomonas argentinensis	289370	S	594	144	738	0.00005
Pseudomonas frederiksbergensis	104087	S	586	180	766	0.00006
Pseudomonas brassicacearum	930166	S	585	1115	1700	0.00012
Pseudomonas umsongensis	198618	S	547	92	639	0.00005
Pseudomonas muyukensis	2842357	S	520	161	681	0.00005
Pseudomonas pohangensis	364197	S	507	41	548	0.00004
Pseudomonas palleroniana	191390	S	484	81	565	0.00004
Pseudomonas phragmitis	1931241	S	479	42	521	0.00004
Pseudomonas yamanorum	515393	S	479	110	589	0.00004
Pseudomonas alvandae	2842348	S	467	77	544	0.00004
Pseudomonas koreensis	198620	S	422	169	591	0.00004
Pseudomonas xantholysinigenes	2745490	S	405	116	521	0.00004
Pseudomonas marincola	437900	S	399	66	465	0.00003
Pseudomonas vancouverensis	95300	S	395	65	460	0.00003
Pseudomonas tructae	2518644	S	382	70	452	0.00003
Pseudomonas silesiensis	1853130	S	366	81	447	0.00003
Pseudomonas thivervalensis	86265	S	362	79	441	0.00003
Pseudomonas prosekii	1148509	S	351	60	411	0.00003
Pseudomonas xanthosomae	2842356	S	350	116	466	0.00003
Pseudomonas fakonensis	2842355	S	348	114	462	0.00003
Pseudomonas wenzhouensis	2906062	S	345	139	484	0.00004
Pseudomonas sediminis	1691904	S	344	103	447	0.00003
Pseudomonas hamedanensis	2745504	S	338	64	402	0.00003
Pseudomonas extremaustralis	359110	S	336	77	413	0.00003
Pseudomonas agarici	46677	S	323	16	339	0.00002
Pseudomonas promysalinigenes	485898	S	322	52	374	0.00003
Pseudomonas antarctica	219572	S	317	82	399	0.00003
Pseudomonas granadensis	1421430	S	301	147	448	0.00003
Pseudomonas toyotomiensis	554344	S	297	281	578	0.00004
Pseudomonas asgharzadehiana	2842349	S	295	71	366	0.00003
Pseudomonas arsenicoxydans	702115	S	294	64	358	0.00003
Pseudomonas graminis	158627	S	283	81	364	0.00003
Pseudomonas maumuensis	2842354	S	278	139	417	0.00003
Pseudomonas simiae	321846	S	277	70	347	0.00003
Pseudomonas anuradhapurensis	485870	S	262	240	502	0.00004
Pseudomonas lurida	244566	S	260	60	320	0.00002
Pseudomonas versuta	1788301	S	260	43	303	0.00002
Pseudomonas viciae	2505979	S	254	63	317	0.00002
Pseudomonas taetrolens	47884	S	245	33	278	0.00002
Pseudomonas lini	163011	S	224	45	269	0.00002
Pseudomonas alcaliphila	101564	S	205	232	437	0.00003
Pseudomonas psychrophila	122355	S	204	29	233	0.00002
Pseudomonas reinekei	395598	S	199	58	257	0.00002
Pseudomonas kribbensis	1628086	S	194	190	384	0.00003
Pseudomonas sihuiensis	1274359	S	186	254	440	0.00003
Pseudomonas khazarica	2502979	S	179	226	405	0.00003
Pseudomonas allokribbensis	2774460	S	177	71	248	0.00002
Pseudomonas oryziphila	2894079	S	175	143	318	0.00002
Pseudomonas chengduensis	489632	S	174	367	541	0.00004
Pseudomonas tritici	2745518	S	159	51	210	0.00002
Pseudomonas asplenii	53407	S	155	98	253	0.00002
Pseudomonas gozinkensis	2774461	S	152	72	224	0.00002
Pseudomonas kunmingensis	1211807	S	140	212	352	0.00003
Pseudomonas moraviensis	321662	S	136	229	365	0.00003
Pseudomonas atacamensis	2565368	S	131	130	261	0.00002
Pseudomonas azerbaijanoriens	2842350	S	130	89	219	0.00002
Pseudomonas germanica	2815720	S	112	62	174	0.00001
Pseudomonas zeae	2745510	S	107	55	162	0.00001
Pseudomonas zarinae	2745498	S	103	79	182	0.00001
Pseudomonas tensinigenes	2745511	S	96	53	149	0.00001
Pseudomonas iranensis	2745503	S	92	71	163	0.00001
Pseudomonas sessilinigenes	658629	S	79	206	285	0.00002
Pseudomonas monsensis	2745509	S	78	85	163	0.00001
Pseudomonas soli	1306993	S	78	308	386	0.00003
Pseudomonas lactis	1615674	S	78	58	136	0.00001
Pseudomonas juntendi	2666183	S	76	711	787	0.00006
Pseudomonas salmasensis	2745514	S	67	44	111	0.00001
Pseudomonas donghuensis	1163398	S	63	180	243	0.00002
Pseudomonas glycinae	1785145	S	47	85	132	0.00001
Pseudomonas bijieensis	2681983	S	45	172	217	0.00002
Pseudomonas taiwanensis	470150	S	31	395	426	0.00003
Pseudomonas asiatica	2219225	S	29	165	194	0.00001
Pseudomonas cerasi	1583341	S	28	60	88	0.00001
Pseudomonas shahriarae	2745512	S	22	87	109	0.00001
Pseudomonas rhizophila	2045200	S	22	58	80	0.00001
Candidatus Pseudomonas adelgestsugas	1302376	S	14	0	14	0.00000
Azotobacter chroococcum	353	S	1911	1281	3192	0.00023
Azotobacter vinelandii	354	S	1212	0	1212	0.00009
Azotobacter salinestris	69964	S	1170	678	1848	0.00013
Halopseudomonas xinjiangensis	487184	S	569	66	635	0.00005
Halopseudomonas sp. RR6	2918528	S	478	82	560	0.00004
Halopseudomonas sabulinigri	472181	S	475	48	523	0.00004
Halopseudomonas aestusnigri	857252	S	424	328	752	0.00005
Halopseudomonas litoralis	797277	S	375	105	480	0.00003
Halopseudomonas salegens	1434072	S	304	25	329	0.00002
Permianibacter aggregans	1510150	S	508	17	525	0.00004
Thiopseudomonas alkaliphila	1697053	S	62	14	76	0.00001
Entomomonas sp. F2A	2785331	S	13	1	14	0.00000
Marinobacter sp. CA1	2817656	S	618	51	669	0.00005
Marinobacter sp. Arc7-DN-1	2304594	S	377	56	433	0.00003
Marinobacter sp. NP-4(2019)	2488665	S	328	66	394	0.00003
Marinobacter sp. LPB0319	2769486	S	327	23	350	0.00003
Marinobacter sp. LV10R510-11A	1415568	S	184	9	193	0.00001
Marinobacter sp. LQ44	1749259	S	168	272	440	0.00003
Marinobacter sp. JH2	2547598	S	139	43	182	0.00001
Marinobacter sp. es.042	1761794	S	133	137	270	0.00002
Marinobacter sp. CP1	1671721	S	123	252	375	0.00003
Marinobacter sp. BSs20148	490759	S	102	66	168	0.00001
Marinobacter fonticola	2603215	S	495	27	522	0.00004
Marinobacter salarius	1420917	S	397	57	454	0.00003
Marinobacter nauticus	2743	S	388	142	530	0.00004
Marinobacter similis	1420916	S	293	28	321	0.00002
Marinobacter salsuginis	418719	S	284	43	327	0.00002
Marinobacter salinus	1874317	S	237	17	254	0.00002
Marinobacter adhaerens	1033846	S	114	185	299	0.00002
Marinobacter psychrophilus	330734	S	56	36	92	0.00001
Klebsiella pneumoniae	573	S	741	35884	36625	0.00265
Klebsiella quasipneumoniae	1463165	S	477	1696	2173	0.00016
Klebsiella aerogenes	548	S	315	199	514	0.00004
Klebsiella oxytoca	571	S	313	234	547	0.00004
Klebsiella sp. A52	2834819	S	12	258	270	0.00002
Klebsiella variicola	244366	S	216	970	1186	0.00009
Klebsiella michiganensis	1134687	S	176	748	924	0.00007
Klebsiella quasivariicola	2026240	S	87	104	191	0.00001
Klebsiella huaxiensis	2153354	S	81	85	166	0.00001
Klebsiella africana	2489010	S	73	49	122	0.00001
Klebsiella grimontii	2058152	S	48	363	411	0.00003
Raoultella sp. HC6	2923366	S	220	162	382	0.00003
Raoultella planticola	575	S	157	176	333	0.00002
Raoultella ornithinolytica	54291	S	118	972	1090	0.00008
Raoultella terrigena	577	S	81	170	251	0.00002
Raoultella electrica	1259973	S	75	205	280	0.00002
Enterobacter cloacae	550	S	887	2138	3025	0.00022
Enterobacter hormaechei	158836	S	263	4552	4815	0.00035
Enterobacter asburiae	61645	S	230	1199	1429	0.00010
Enterobacter cancerogenus	69218	S	221	86	307	0.00002
Enterobacter roggenkampii	1812935	S	161	743	904	0.00007
Enterobacter ludwigii	299767	S	112	303	415	0.00003
Enterobacter chengduensis	2494701	S	98	76	174	0.00001
Enterobacter cloacae complex sp.	2027919	S	34	984	1018	0.00007
Enterobacter sp. BIDMC 29	1329841	S	30	115	145	0.00001
Enterobacter kobei	208224	S	73	940	1013	0.00007
Enterobacter chuandaensis	2497875	S	56	41	97	0.00001
Enterobacter sichuanensis	2071710	S	53	55	108	0.00001
Enterobacter sp. JUb54	2724468	S	219	50	269	0.00002
Enterobacter sp. SA187	1914861	S	211	43	254	0.00002
Enterobacter sp. E76	2596949	S	95	210	305	0.00002
Enterobacter sp. RHBSTW-00994	2742676	S	74	21	95	0.00001
Enterobacter sp. RHBSTW-00175	2742639	S	64	68	132	0.00001
Enterobacter sp. Colony194	2866201	S	45	65	110	0.00001
Enterobacter sp. JBIWA008	2831892	S	35	25	60	0.00000
Enterobacter sp. JBIWA003	2831890	S	33	49	82	0.00001
Enterobacter sp. JBIWA005	2831891	S	29	63	92	0.00001
Enterobacter sp. SGAir0187	2836161	S	25	33	58	0.00000
Enterobacter sp. E20	1560339	S	20	200	220	0.00002
Enterobacter sp. SES19	2705458	S	13	14	27	0.00000
Enterobacter sp. N18-03635	2500132	S	13	38	51	0.00000
Enterobacter huaxiensis	2494702	S	128	43	171	0.00001
Enterobacter mori	539813	S	92	135	227	0.00002
Enterobacter oligotrophicus	2478464	S	75	26	101	0.00001
Enterobacter bugandensis	881260	S	63	129	192	0.00001
Enterobacter soli	885040	S	61	18	79	0.00001
Citrobacter freundii	546	S	239	1218	1457	0.00011
Citrobacter werkmanii	67827	S	50	138	188	0.00001
Citrobacter braakii	57706	S	41	363	404	0.00003
Citrobacter sedlakii	67826	S	34	118	152	0.00001
Citrobacter freundii complex sp. CFNIH2	2066049	S	24	31	55	0.00000
Citrobacter portucalensis	1639133	S	28	331	359	0.00003
Citrobacter youngae	133448	S	15	54	69	0.00000
Citrobacter sp. R56	1573676	S	92	33	125	0.00001
Citrobacter sp. RHB25-C09	2742624	S	78	27	105	0.00001
Citrobacter sp. BDA59-3	2781952	S	19	9	28	0.00000
Citrobacter sp. MGH 55	1439319	S	10	67	77	0.00001
Citrobacter rodentium	67825	S	190	0	190	0.00001
Citrobacter amalonaticus	35703	S	133	716	849	0.00006
Citrobacter farmeri	67824	S	127	72	199	0.00001
Citrobacter koseri	545	S	75	116	191	0.00001
Citrobacter tructae	2562449	S	48	25	73	0.00001
Citrobacter pasteurii	1563222	S	46	44	90	0.00001
Citrobacter arsenatis	2546350	S	30	12	42	0.00000
Citrobacter cronae	1748967	S	11	99	110	0.00001
Cronobacter universalis	535744	S	609	419	1028	0.00007
Cronobacter sakazakii	28141	S	338	290	628	0.00005
Cronobacter dublinensis	413497	S	268	96	364	0.00003
Cronobacter condimenti	1163710	S	183	53	236	0.00002
Cronobacter malonaticus	413503	S	91	120	211	0.00002
Cronobacter muytjensii	413501	S	38	127	165	0.00001
Cronobacter sp. JZ38	1906275	S	37	94	131	0.00001
Leclercia adecarboxylata	83655	S	420	866	1286	0.00009
Leclercia sp. 29361	2714951	S	147	66	213	0.00002
Leclercia sp. W17	2282309	S	33	101	134	0.00001
Leclercia sp. J807	2681307	S	32	52	84	0.00001
Leclercia sp. W6	2282310	S	22	45	67	0.00000
Leclercia sp. 119287	2681308	S	21	73	94	0.00001
Leclercia sp. G3L	2898725	S	21	121	142	0.00001
Leclercia pneumoniae	2815358	S	133	68	201	0.00001
Kosakonia sp. SMBL-WEM22	2725560	S	138	63	201	0.00001
Kosakonia sp. CCTCC M2018092	2492396	S	74	71	145	0.00001
Kosakonia sp. MUSA4	2067958	S	56	29	85	0.00001
Kosakonia cowanii	208223	S	261	215	476	0.00003
Kosakonia sacchari	1158459	S	193	94	287	0.00002
Kosakonia radicincitans	283686	S	75	72	147	0.00001
Kosakonia pseudosacchari	1646340	S	68	38	106	0.00001
Kosakonia oryzae	497725	S	67	49	116	0.00001
Kosakonia arachidis	551989	S	60	17	77	0.00001
Salmonella enterica	28901	S	838	41944	42782	0.00309
Salmonella bongori	54736	S	103	1317	1420	0.00010
Pluralibacter gergoviae	61647	S	723	208	931	0.00007
[Enterobacter] lignolyticus	1334193	S	330	94	424	0.00003
Escherichia coli	562	S	556	21382	21938	0.00159
Escherichia albertii	208962	S	102	92	194	0.00001
Escherichia fergusonii	564	S	50	83	133	0.00001
Escherichia marmotae	1499973	S	37	22	59	0.00000
Escherichia sp. E4742	2044467	S	32	22	54	0.00000
Cedecea neteri	158822	S	525	119	644	0.00005
Cedecea lapagei	158823	S	128	36	164	0.00001
Cedecea sp. FDAARGOS_727	2545798	S	115	25	140	0.00001
Lelliottia amnigena	61646	S	362	113	475	0.00003
Lelliottia sp. AC1	2067959	S	59	77	136	0.00001
Lelliottia sp. WB101	2153385	S	42	64	106	0.00001
Kluyvera ascorbata	51288	S	145	123	268	0.00002
Kluyvera intermedia	61648	S	96	78	174	0.00001
Kluyvera sp. CRP	2873269	S	24	67	91	0.00001
Kluyvera genomosp. 3	2774055	S	17	44	61	0.00000
Candidatus Symbiopectobacterium sp. SyEd1	2871826	S	117	16	133	0.00001
Candidatus Hamiltonella defensa	138072	S	35	8	43	0.00000
secondary endosymbiont of Ctenarytaina eucalypti	1199245	S	21	0	21	0.00000
Blochmannia endosymbiont of Camponotus sp.	700220	S	11	13	24	0.00000
Candidatus Doolittlea endobia	1778262	S	22	1	23	0.00000
Candidatus Mikella endobia	1778264	S	20	5	25	0.00000
Candidatus Hoaglandella endobia	1778263	S	16	1	17	0.00000
Candidatus Tachikawaea gelatinosa	1410383	S	10	2	12	0.00000
Jejubacter calystegiae	2579935	S	270	33	303	0.00002
Pseudescherichia vulneris	566	S	229	15	244	0.00002
Buttiauxella agrestis	82977	S	87	18	105	0.00001
Buttiauxella ferragutiae	82989	S	25	78	103	0.00001
Plesiomonas shigelloides	703	S	184	65	249	0.00002
Shimwellia blattae	563	S	180	40	220	0.00002
Atlantibacter hermannii	565	S	174	41	215	0.00002
Yokenella regensburgei	158877	S	147	69	216	0.00002
Scandinavium goeteborgense	1851514	S	136	28	164	0.00001
Pseudocitrobacter sp. G163CM	2891570	S	125	34	159	0.00001
Phytobacter ursingii	1972431	S	94	144	238	0.00002
Candidatus Moranella endobia	1048758	S	32	0	32	0.00000
Shigella boydii	621	S	12	223	235	0.00002
Shigella flexneri	623	S	12	687	699	0.00005
Candidatus Ishikawaella capsulata	168169	S	14	1	15	0.00000
Serratia marcescens	615	S	1323	3400	4723	0.00034
Serratia plymuthica	82996	S	495	281	776	0.00006
Serratia sp. ATCC 39006	104623	S	90	11	101	0.00001
Serratia sp. FGI94	671990	S	76	89	165	0.00001
Serratia sp. FDAARGOS_506	2420306	S	75	80	155	0.00001
Serratia sp. 1D1416	2447890	S	43	156	199	0.00001
Serratia sp. MYb239	2033438	S	36	331	367	0.00003
Serratia sp. P2ACOL2	2482769	S	21	70	91	0.00001
Serratia sp. 3ACOL1	2448483	S	20	31	51	0.00000
Serratia sp. FS14	1327989	S	18	96	114	0.00001
Serratia sp. JSRIV004	2831895	S	11	66	77	0.00001
Serratia entomophila	42906	S	388	108	496	0.00004
Serratia rubidaea	61652	S	337	418	755	0.00005
Serratia odorifera	618	S	245	47	292	0.00002
Serratia proteamaculans	28151	S	242	61	303	0.00002
Serratia fonticola	47917	S	169	162	331	0.00002
Serratia surfactantfaciens	2741499	S	157	99	256	0.00002
Serratia liquefaciens	614	S	119	173	292	0.00002
Serratia quinivorans	137545	S	113	47	160	0.00001
Serratia rhizosphaerae	2597702	S	96	98	194	0.00001
Serratia inhibens	2338073	S	90	53	143	0.00001
Serratia symbiotica	138074	S	84	15	99	0.00001
Serratia grimesii	82995	S	78	10	88	0.00001
Serratia ureilytica	300181	S	46	651	697	0.00005
Serratia ficaria	61651	S	28	139	167	0.00001
Serratia nematodiphila	458197	S	10	107	117	0.00001
Rahnella aquatilis	34038	S	198	298	496	0.00004
Rahnella inusitata	58169	S	142	43	185	0.00001
Rahnella victoriana	1510570	S	137	23	160	0.00001
Rahnella sp. ERMR1:05	1805933	S	137	22	159	0.00001
Rahnella aceris	2703885	S	23	52	75	0.00001
Yersinia enterocolitica	630	S	81	58	139	0.00001
Yersinia similis	367190	S	23	4	27	0.00000
Yersinia pseudotuberculosis	633	S	20	121	141	0.00001
Yersinia ruckeri	29486	S	62	13	75	0.00001
Yersinia entomophaga	935293	S	48	9	57	0.00000
Yersinia mollaretii	33060	S	38	9	47	0.00000
Yersinia frederiksenii	29484	S	37	34	71	0.00001
Yersinia canariae	2607663	S	32	12	44	0.00000
Yersinia kristensenii	28152	S	31	89	120	0.00001
Yersinia rohdei	29485	S	30	6	36	0.00000
Yersinia aleksiciae	263819	S	29	8	37	0.00000
Yersinia aldovae	29483	S	26	6	32	0.00000
Yersinia intermedia	631	S	21	69	90	0.00001
Yersinia hibernica	2339259	S	11	18	29	0.00000
Nissabacter sp. SGAir0207	2126321	S	601	101	702	0.00005
Gibbsiella quercinecans	929813	S	336	52	388	0.00003
Rouxiella badensis	1646377	S	174	18	192	0.00001
Ewingella americana	41202	S	168	27	195	0.00001
Chania multitudinisentens	1639108	S	110	14	124	0.00001
Candidatus Fukatsuia symbiotica	1878942	S	27	1	28	0.00000
Pantoea sp. Z09	2886821	S	494	169	663	0.00005
Pantoea sp. SO10	2575375	S	227	47	274	0.00002
Pantoea sp. MSR2	2052056	S	155	21	176	0.00001
Pantoea sp. CCBC3-3-1	2490851	S	127	27	154	0.00001
Pantoea sp. At-9b	592316	S	123	27	150	0.00001
Pantoea sp. SM3640	2787629	S	18	119	137	0.00001
Pantoea agglomerans	549	S	1050	332	1382	0.00010
Pantoea dispersa	59814	S	850	244	1094	0.00008
Pantoea deleyi	470932	S	284	70	354	0.00003
Pantoea vagans	470934	S	280	465	745	0.00005
Pantoea ananatis	553	S	275	104	379	0.00003
Pantoea cypripedii	55209	S	181	11	192	0.00001
Pantoea alhagi	1891675	S	154	52	206	0.00001
Pantoea stewartii	66269	S	151	43	194	0.00001
Pantoea rwandensis	1076550	S	112	26	138	0.00001
Pantoea eucalypti	470933	S	13	84	97	0.00001
Erwinia sp. E602	2675378	S	422	81	503	0.00004
Erwinia sp. J780	2681984	S	82	16	98	0.00001
Erwinia sp. Ejp617	215689	S	26	45	71	0.00001
Erwinia sp. QL-Z3	2547962	S	26	75	101	0.00001
Erwinia gerundensis	1619313	S	241	49	290	0.00002
Erwinia persicina	55211	S	189	42	231	0.00002
Erwinia rhapontici	55212	S	158	32	190	0.00001
Candidatus Erwinia haradaeae	1922217	S	107	2	109	0.00001
Erwinia billingiae	182337	S	106	196	302	0.00002
Erwinia tasmaniensis	338565	S	105	23	128	0.00001
Erwinia tracheiphila	65700	S	102	15	117	0.00001
Erwinia amylovora	552	S	100	54	154	0.00001
[Pantoea] beijingensis	1324864	S	71	15	86	0.00001
Erwinia pyrifoliae	79967	S	28	46	74	0.00001
Mixta gaviniae	665914	S	325	135	460	0.00003
Mixta calida	665913	S	244	142	386	0.00003
Mixta theicola	1458355	S	225	77	302	0.00002
Mixta sp. X22927	2872648	S	137	78	215	0.00002
Mixta intestinalis	1615494	S	130	39	169	0.00001
Buchnera aphidicola	9	S	178	25	203	0.00001
Tatumella ptyseos	82987	S	63	12	75	0.00001
Tatumella citrea	53336	S	48	8	56	0.00000
Wigglesworthia glossinidia	51229	S	14	1	15	0.00000
Dickeya dadantii	204038	S	351	183	534	0.00004
Dickeya chrysanthemi	556	S	268	69	337	0.00002
Dickeya zeae	204042	S	245	165	410	0.00003
Dickeya dianthicola	204039	S	191	103	294	0.00002
Dickeya fangzhongdai	1778540	S	114	279	393	0.00003
Dickeya poaceiphila	568768	S	97	13	110	0.00001
Dickeya sp. NCPPB 3274	568766	S	88	32	120	0.00001
Dickeya solani	1089444	S	86	1045	1131	0.00008
Dickeya parazeae	2893572	S	14	31	45	0.00000
Pectobacterium carotovorum	554	S	156	346	502	0.00004
Pectobacterium brasiliense	180957	S	133	156	289	0.00002
Pectobacterium sp. LJ1	2878098	S	57	15	72	0.00001
Pectobacterium sp. PL64	2738983	S	32	21	53	0.00000
Pectobacterium polaris	2042057	S	79	57	136	0.00001
Pectobacterium atrosepticum	29471	S	77	26	103	0.00001
Pectobacterium parmentieri	1905730	S	59	20	79	0.00001
Pectobacterium punjabense	2108399	S	48	12	60	0.00000
Pectobacterium odoriferum	78398	S	46	34	80	0.00001
Pectobacterium wasabiae	55208	S	43	13	56	0.00000
Pectobacterium versatile	2488639	S	37	83	120	0.00001
Pectobacterium quasiaquaticum	2774015	S	36	35	71	0.00001
Pectobacterium aroidearum	1201031	S	18	28	46	0.00000
Pectobacterium parvum	2778550	S	14	20	34	0.00000
Pectobacterium aquaticum	2204145	S	10	12	22	0.00000
Brenneria izadpanahii	2722756	S	226	260	486	0.00004
Brenneria goodwinii	1109412	S	163	181	344	0.00002
Brenneria rubrifaciens	55213	S	162	66	228	0.00002
Lonsdalea populi	1172565	S	213	60	273	0.00002
Lonsdalea britannica	1082704	S	176	47	223	0.00002
Musicola paradisiaca	69223	S	266	15	281	0.00002
Edwardsiella tarda	636	S	344	329	673	0.00005
Edwardsiella hoshinae	93378	S	201	58	259	0.00002
Edwardsiella ictaluri	67780	S	140	98	238	0.00002
Edwardsiella piscicida	1263550	S	32	602	634	0.00005
Hafnia alvei	569	S	87	111	198	0.00001
Hafnia paralvei	546367	S	34	15	49	0.00000
Obesumbacterium proteus	82983	S	25	21	46	0.00000
Morganella morganii	582	S	349	340	689	0.00005
Providencia rettgeri	587	S	83	127	210	0.00002
Providencia alcalifaciens	126385	S	47	21	68	0.00000
Providencia heimbachae	333962	S	17	7	24	0.00000
Providencia rustigianii	158850	S	16	6	22	0.00000
Providencia sp. R33	2828763	S	15	4	19	0.00000
Providencia stuartii	588	S	12	79	91	0.00001
Xenorhabdus bovienii	40576	S	87	19	106	0.00001
Xenorhabdus doucetiae	351671	S	52	8	60	0.00000
Xenorhabdus budapestensis	290110	S	34	4	38	0.00000
Xenorhabdus nematophila	628	S	31	5	36	0.00000
Xenorhabdus poinarii	40577	S	29	5	34	0.00000
Xenorhabdus hominickii	351679	S	29	4	33	0.00000
Photorhabdus thracensis	230089	S	96	16	112	0.00001
Photorhabdus akhurstii	171438	S	37	6	43	0.00000
Photorhabdus asymbiotica	291112	S	29	3	32	0.00000
Photorhabdus laumondii	2218628	S	26	4	30	0.00000
Proteus mirabilis	584	S	95	161	256	0.00002
Proteus vulgaris	585	S	25	55	80	0.00001
Proteus hauseri	183417	S	11	2	13	0.00000
Moellerella wisconsensis	158849	S	19	16	35	0.00000
Sodalis sp. dw_23	2697027	S	425	31	456	0.00003
Sodalis endosymbiont of Henestaris halophilus	1929246	S	17	0	17	0.00000
Sodalis praecaptivus	1239307	S	208	145	353	0.00003
Sodalis glossinidius	63612	S	166	25	191	0.00001
Candidatus Sodalis pierantonius	1486991	S	88	65	153	0.00001
Leminorella richardii	158841	S	124	18	142	0.00001
Pragia fontium	82985	S	39	5	44	0.00000
Jinshanibacter zhutongyuii	2498113	S	36	5	41	0.00000
Limnobaculum parvum	2172103	S	33	6	39	0.00000
Thioalkalivibrio sulfidiphilus	1033854	S	1793	1186	2979	0.00022
Thioalkalivibrio paradoxus	108010	S	1718	558	2276	0.00016
Thioalkalivibrio nitratireducens	186931	S	1716	505	2221	0.00016
Thioalkalivibrio versutus	106634	S	1291	192	1483	0.00011
Thioalkalivibrio sp. K90mix	396595	S	1278	182	1460	0.00011
Spiribacter sp. E85	2182432	S	3638	390	4028	0.00029
Spiribacter sp. 2438	2666185	S	680	74	754	0.00005
Spiribacter curvatus	1335757	S	785	49	834	0.00006
Spiribacter salinus	1335746	S	500	43	543	0.00004
Acidihalobacter aeolianus	2792603	S	1469	226	1695	0.00012
Acidihalobacter ferrooxydans	1765967	S	1126	129	1255	0.00009
Acidihalobacter yilgarnensis	2819280	S	884	67	951	0.00007
Halorhodospira halophila	1053	S	1648	218	1866	0.00013
Halorhodospira halochloris	1052	S	276	14	290	0.00002
Alkalilimnicola ehrlichii	351052	S	1719	252	1971	0.00014
Aquisalimonas sp. 2447	2740807	S	1567	125	1692	0.00012
Ectothiorhodospira haloalkaliphila	421628	S	621	217	838	0.00006
Ectothiorhodospira sp. BSL-9	1442136	S	613	204	817	0.00006
Ectothiorhodosinus mongolicus	233100	S	205	15	220	0.00002
Candidatus Thiodictyon syntrophicum	1166950	S	2924	177	3101	0.00022
Allochromatium vinosum	1049	S	1157	494	1651	0.00012
Allochromatium tepidum	553982	S	1155	609	1764	0.00013
Thioflavicoccus mobilis	80679	S	2689	275	2964	0.00021
Marichromatium purpuratum	37487	S	2532	550	3082	0.00022
Thiocapsa bogorovii	521689	S	1991	120	2111	0.00015
Thiocystis violascens	73141	S	1433	136	1569	0.00011
Thermochromatium tepidum	1050	S	985	256	1241	0.00009
Caldichromatium japonicum	2699430	S	714	88	802	0.00006
Nitrosococcus halophilus	133539	S	200	31	231	0.00002
Nitrosococcus wardiae	1814290	S	192	28	220	0.00002
Nitrosococcus oceani	1229	S	111	30	141	0.00001
Nitrosococcus watsonii	473531	S	104	30	134	0.00001
Rheinheimera sp. F8	1763998	S	110	6	116	0.00001
Rheinheimera sp. D18	2545632	S	39	36	75	0.00001
Rheinheimera mangrovi	2498451	S	58	5	63	0.00000
Candidatus Nitrosacidococcus tergens	553981	S	36	1	37	0.00000
Candidatus Nitrosoglobus terrae	1630141	S	30	2	32	0.00000
Wenzhouxiangella marina	1579979	S	1664	126	1790	0.00013
Wenzhouxiangella sp. AB-CW3	2771012	S	1064	56	1120	0.00008
Thiohalobacter sp. COW1	2795687	S	435	946	1381	0.00010
Thiohalobacter thiocyanaticus	585455	S	313	842	1155	0.00008
Guyparkeria halophila	47960	S	1722	468	2190	0.00016
Sulfurivermis fontis	1972068	S	1600	696	2296	0.00017
Halothiobacillus sp. LS2	1860122	S	675	66	741	0.00005
Halothiobacillus neapolitanus	927	S	211	24	235	0.00002
Woeseia oceani	1548547	S	838	16	854	0.00006
Sulfuriflexus mobilis	1811807	S	360	12	372	0.00003
Granulosicoccus antarcticus	437505	S	327	6	333	0.00002
Halomonas sp. THAF5a	2587844	S	1469	613	2082	0.00015
Halomonas sp. 1513	1883416	S	1051	261	1312	0.00009
Halomonas sp. HG01	1609967	S	1011	462	1473	0.00011
Halomonas sp. THAF12	2587849	S	989	646	1635	0.00012
Halomonas sp. YLGW01	2773308	S	924	171	1095	0.00008
Halomonas sp. MCCC 1A13316	2733487	S	863	126	989	0.00007
Halomonas sp. JS92-SW72	2306583	S	860	995	1855	0.00013
Halomonas sp. PGE1	2730360	S	655	937	1592	0.00012
Halomonas sp. Y2R2	2562282	S	342	21	363	0.00003
Halomonas sp. A40-4	2785909	S	272	79	351	0.00003
Halomonas sp. SH5A2	2749040	S	224	43	267	0.00002
Halomonas sp. R57-5	1610576	S	182	84	266	0.00002
Halomonas sp. KO116	1504981	S	159	72	231	0.00002
Halomonas sp. FeN2	2832500	S	152	74	226	0.00002
Halomonas sp. 18071143	2855441	S	145	358	503	0.00004
Halomonas sp. GFAJ-1	1118153	S	101	21	122	0.00001
Halomonas sp. SS10-MC5	2854257	S	96	972	1068	0.00008
Halomonas sp. SF2003	2136172	S	95	406	501	0.00004
Halomonas sp. NyZ770	2883106	S	94	445	539	0.00004
Halomonas sp. hl-4	1761789	S	59	375	434	0.00003
Halomonas sp. TD01	999141	S	50	29	79	0.00001
Halomonas sp. HL-93	1666906	S	45	295	340	0.00002
Halomonas sp. GT	1971364	S	34	26	60	0.00000
Halomonas sp. N3-2A	2014541	S	28	39	67	0.00000
Halomonas sp. A3H3	1346287	S	18	546	564	0.00004
Halomonas beimenensis	475662	S	1677	367	2044	0.00015
Halomonas aestuarii	1897729	S	1231	288	1519	0.00011
Halomonas socia	1081866	S	1066	229	1295	0.00009
Halomonas tianxiuensis	2497861	S	934	232	1166	0.00008
Halomonas sulfidivorans	2733488	S	904	206	1110	0.00008
Halomonas elongata	2746	S	860	98	958	0.00007
Halomonas chromatireducens	507626	S	680	60	740	0.00005
Halomonas subglaciescola	29571	S	487	60	547	0.00004
Halomonas meridiana	29570	S	464	421	885	0.00006
Halomonas huangheensis	1178482	S	393	25	418	0.00003
Halomonas piezotolerans	2609667	S	270	165	435	0.00003
Halomonas profundi	2852117	S	140	22	162	0.00001
Halomonas sulfidoxydans	2733484	S	120	1195	1315	0.00010
Halomonas titanicae	664683	S	105	602	707	0.00005
Halomonas hydrothermalis	115561	S	86	283	369	0.00003
Halomonas venusta	44935	S	56	80	136	0.00001
Halomonas campaniensis	213554	S	17	91	108	0.00001
Cobetia sp. L2A1	2686360	S	316	41	357	0.00003
Cobetia sp. cqz5-12	2609415	S	196	258	454	0.00003
Cobetia sp. 4B	2758724	S	95	389	484	0.00004
Cobetia sp. AM6	2661553	S	70	376	446	0.00003
Cobetia pacifica	1055101	S	97	273	370	0.00003
Cobetia amphilecti	1055104	S	75	436	511	0.00004
Cobetia marina	28258	S	20	244	264	0.00002
Halotalea alkalilenta	376489	S	1444	312	1756	0.00013
Salinicola tamaricis	1771309	S	1374	171	1545	0.00011
Kushneria phosphatilytica	657387	S	350	15	365	0.00003
Kushneria konosiri	698828	S	324	62	386	0.00003
Kushneria marisflavi	157779	S	312	58	370	0.00003
Chromohalobacter salexigens	158080	S	1047	124	1171	0.00008
Pistricoccus aurantiacus	1883414	S	754	56	810	0.00006
Zymobacter palmae	33074	S	176	26	202	0.00001
Candidatus Portiera aleyrodidarum	91844	S	20	14	34	0.00000
Alcanivorax sp. N3-2A	2014542	S	1152	1303	2455	0.00018
Alcanivorax sp. NBRC 101098	1113728	S	16	230	246	0.00002
Alcanivorax pacificus	1306787	S	838	334	1172	0.00008
Alcanivorax xenomutans	1094342	S	499	271	770	0.00006
Alcanivorax dieselolei	285091	S	489	161	650	0.00005
Ketobacter alkanivorans	1917421	S	220	19	239	0.00002
Marinobacterium aestuarii	1821621	S	610	52	662	0.00005
Marinobacterium sediminicola	518898	S	260	38	298	0.00002
Marinobacterium georgiense	48076	S	221	75	296	0.00002
Marinobacterium sp. LSUCC0821	2668067	S	46	3	49	0.00000
Marinomonas sp. A3A	2065312	S	29	4	33	0.00000
Marinomonas sp. FW-1	2071621	S	21	5	26	0.00000
Marinomonas sp. CT5	2066133	S	20	1	21	0.00000
Marinomonas primoryensis	178399	S	46	6	52	0.00000
Marinomonas posidonica	936476	S	44	6	50	0.00000
Marinomonas profundi	2726122	S	42	12	54	0.00000
Marinomonas algicola	2773454	S	35	7	42	0.00000
Marinomonas mediterranea	119864	S	29	2	31	0.00000
Marinomonas arctica	383750	S	26	5	31	0.00000
Marinomonas foliarum	491950	S	20	6	26	0.00000
Venatorbacter cucullus	2661630	S	190	51	241	0.00002
Thalassolituus sp. C2-1	2597518	S	141	11	152	0.00001
Thalassolituus oleivorans	187493	S	47	14	61	0.00000
Bacterioplanes sanyensis	1249553	S	134	8	142	0.00001
Neptunomonas concharum	1031538	S	45	6	51	0.00000
Neptunomonas japonica	417574	S	44	5	49	0.00000
Neptunomonas phycophila	1572645	S	24	3	27	0.00000
Nitrincola iocasae	2614693	S	95	18	113	0.00001
Amphritea japonica	452627	S	56	5	61	0.00000
Bermanella marisrubri	207949	S	35	1	36	0.00000
Hahella sp. KA22	1628392	S	333	52	385	0.00003
Hahella chejuensis	158327	S	325	43	368	0.00003
Saccharospirillum mangrovi	2161747	S	365	24	389	0.00003
Reinekea forsetii	1336806	S	152	8	160	0.00001
Gynuella sunshinyii	1445505	S	138	4	142	0.00001
Litoricola lipolytica	418701	S	244	13	257	0.00002
Spartinivicinus ruber	2683272	S	184	6	190	0.00001
Oleiphilus messinensis	141451	S	96	8	104	0.00001
Endozoicomonas montiporae	1027273	S	76	4	80	0.00001
Methylococcus sp. EFPC2	2812648	S	1469	116	1585	0.00011
Methylococcus sp. Mc7	2860258	S	1363	444	1807	0.00013
Methylococcus capsulatus	414	S	1335	335	1670	0.00012
Methylococcus geothermalis	2681310	S	1135	322	1457	0.00011
Methylomonas sp. LL1	2785785	S	358	18	376	0.00003
Methylomonas sp. DH-1	1727196	S	157	292	449	0.00003
Methylomonas sp. EFPC1	2812647	S	142	80	222	0.00002
Methylomonas sp. LW13	107637	S	131	69	200	0.00001
Methylomonas koyamae	702114	S	381	382	763	0.00006
Methylomonas rhizoryzae	2608981	S	368	16	384	0.00003
Methylomonas denitrificans	1538553	S	343	25	368	0.00003
Methylomonas methanica	421	S	288	16	304	0.00002
Methylomonas paludis	1173101	S	97	4	101	0.00001
Methylomagnum ishizawai	1760988	S	1709	84	1793	0.00013
Methylocaldum marinum	1432792	S	1567	104	1671	0.00012
Methylogaea oryzae	1295382	S	1375	120	1495	0.00011
Methylomicrobium album	39775	S	1164	51	1215	0.00009
Methylomicrobium sp. wino1	2049332	S	196	208	404	0.00003
Candidatus Methylospira mobilis	1808979	S	497	24	521	0.00004
Methylotuvimicrobium buryatense	95641	S	101	135	236	0.00002
Methylotuvimicrobium alcaliphilum	271065	S	101	159	260	0.00002
Methylovulum psychrotolerans	1704499	S	172	4	176	0.00001
Methylobacter sp. S3L5C	2839024	S	98	6	104	0.00001
Aeromonas sp. FDAARGOS 1415	2778064	S	251	148	399	0.00003
Aeromonas sp. CA23	2033032	S	203	95	298	0.00002
Aeromonas sp. FDAARGOS 1409	2778058	S	103	157	260	0.00002
Aeromonas sp. CU5	2033033	S	101	46	147	0.00001
Aeromonas sp. ASNIH3	1636608	S	53	2678	2731	0.00020
Aeromonas sp. 1805	2560028	S	42	123	165	0.00001
Aeromonas sp. FDAARGOS 1407	2778056	S	42	138	180	0.00001
Aeromonas sp. ASNIH4	1636609	S	38	198	236	0.00002
Aeromonas sp. FDAARGOS 1403	2778052	S	31	99	130	0.00001
Aeromonas sp. FDAARGOS 1410	2778059	S	29	73	102	0.00001
Aeromonas sp. FDAARGOS 1405	2778054	S	29	50	79	0.00001
Aeromonas sp. 2692-1	2560029	S	27	140	167	0.00001
Aeromonas sp. ASNIH1	1636606	S	25	522	547	0.00004
Aeromonas sp. FDAARGOS 1408	2778057	S	23	139	162	0.00001
Aeromonas sp. FDAARGOS 1419	2778068	S	19	57	76	0.00001
Aeromonas sp. FDAARGOS 1404	2778053	S	18	67	85	0.00001
Aeromonas sp. ASNIH2	1636607	S	18	258	276	0.00002
Aeromonas sp. FDAARGOS 1411	2778060	S	17	56	73	0.00001
Aeromonas sp. FDAARGOS 1417	2778066	S	17	51	68	0.00000
Aeromonas sp. FDAARGOS 1402	2778051	S	15	167	182	0.00001
Aeromonas sp. FDAARGOS 1414	2778063	S	14	46	60	0.00000
Aeromonas sp. ASNIH5	1758179	S	12	218	230	0.00002
Aeromonas sp. FDAARGOS 1416	2778065	S	10	30	40	0.00000
Aeromonas hydrophila	644	S	1211	2952	4163	0.00030
Aeromonas veronii	654	S	822	1956	2778	0.00020
Aeromonas media	651	S	613	1202	1815	0.00013
Aeromonas schubertii	652	S	591	191	782	0.00006
Aeromonas salmonicida	645	S	580	2786	3366	0.00024
Aeromonas encheleia	73010	S	550	210	760	0.00005
Aeromonas simiae	218936	S	527	571	1098	0.00008
Aeromonas caviae	648	S	384	3324	3708	0.00027
Aeromonas rivuli	648794	S	330	102	432	0.00003
Aeromonas enteropelogenes	29489	S	309	269	578	0.00004
Aeromonas dhakensis	196024	S	269	569	838	0.00006
Aeromonas jandaei	650	S	214	230	444	0.00003
Aeromonas sanarellii	633415	S	82	444	526	0.00004
Aeromonas allosaccharophila	656	S	50	84	134	0.00001
Aeromonas rivipollensis	948519	S	48	80	128	0.00001
Zobellella denitrificans	347534	S	1281	316	1597	0.00012
Oceanimonas sp. GK1	511062	S	462	103	565	0.00004
Dongshaea marina	2047966	S	140	14	154	0.00001
Oceanisphaera profunda	1416627	S	67	8	75	0.00001
Oceanisphaera avium	1903694	S	36	5	41	0.00000
Tolumonas auensis	43948	S	83	39	122	0.00001
Succinivibrio dextrinosolvens	83771	S	26	1	27	0.00000
Cellvibrio sp. PSBB006	1987723	S	4333	151	4484	0.00032
Cellvibrio sp. PSBB023	1945512	S	351	44	395	0.00003
Cellvibrio sp. KY-GH-1	2303332	S	349	35	384	0.00003
Cellvibrio sp. KY-YJ-3	454662	S	279	53	332	0.00002
Cellvibrio japonicus	155077	S	477	34	511	0.00004
Teredinibacter turnerae	2426	S	222	11	233	0.00002
Teredinibacter haidensis	2731755	S	91	10	101	0.00001
Teredinibacter purpureus	2731756	S	57	5	62	0.00000
Simiduia agarivorans	447471	S	322	17	339	0.00002
Saccharophagus degradans	86304	S	89	3	92	0.00001
Marinagarivorans sp. GE09	2721545	S	65	5	70	0.00001
Agarilytica rhodophyticola	1737490	S	46	1	47	0.00000
Microbulbifer sp. YPW16	2904242	S	695	70	765	0.00006
Microbulbifer sp. SH-1	2681547	S	479	82	561	0.00004
Microbulbifer sp. YPW1	2745199	S	386	77	463	0.00003
Microbulbifer sp. ALW1	1516059	S	319	60	379	0.00003
Microbulbifer sp. A4B17	359370	S	139	36	175	0.00001
Microbulbifer sp. GL-2	2591606	S	117	22	139	0.00001
Microbulbifer sp. THAF38	2587856	S	115	44	159	0.00001
Microbulbifer aggregans	1769779	S	458	60	518	0.00004
Microbulbifer celer	435905	S	370	50	420	0.00003
Microbulbifer thermotolerans	252514	S	352	23	375	0.00003
Microbulbifer hydrolyticus	48074	S	338	68	406	0.00003
Microbulbifer elongatus	86173	S	309	56	365	0.00003
Microbulbifer agarilyticus	260552	S	197	24	221	0.00002
Microbulbifer variabilis	266805	S	79	32	111	0.00001
Kineobactrum salinum	2708301	S	947	39	986	0.00007
Halioglobus japonicus	930805	S	377	19	396	0.00003
Halioglobus maricola	2601894	S	264	11	275	0.00002
Congregibacter litoralis	393662	S	333	142	475	0.00003
Aequoribacter fuscus	2518989	S	85	12	97	0.00001
Spongiibacter nanhainus	2794344	S	305	37	342	0.00002
Spongiibacter taiwanensis	1748242	S	293	15	308	0.00002
Spongiibacter sp. IMCC21906	1620392	S	86	24	110	0.00001
Zhongshania aliphaticivorans	1470434	S	100	7	107	0.00001
Oceanicoccus sagamiensis	716816	S	85	1	86	0.00001
Solimonas sp. K1W22B-7	2303331	S	6002	696	6698	0.00048
Flagellatimonas centrodinii	2806210	S	1664	135	1799	0.00013
Sinimarinibacterium sp. NLF-5-8	2698684	S	800	495	1295	0.00009
Steroidobacter denitrificans	465721	S	5210	1632	6842	0.00049
Sulfurifustis variabilis	1675686	S	7213	491	7704	0.00056
Sulfuricaulis limicola	1620215	S	2495	205	2700	0.00020
Acidiferrobacter sp. SPIII_3	1281578	S	806	215	1021	0.00007
Acidiferrobacter thiooxydans	163359	S	597	161	758	0.00005
Shewanella sp. FJAT-54031	2864209	S	58	96	154	0.00001
Shewanella sp. FJAT-53764	2864207	S	57	98	155	0.00001
Shewanella sp. FJAT-52076	2864202	S	49	74	123	0.00001
Shewanella sp. FJAT-53555	2864204	S	44	42	86	0.00001
Shewanella sp. FJAT-53532	2864203	S	41	77	118	0.00001
Shewanella sp. KX20019	2803864	S	33	4	37	0.00000
Shewanella sp. FJAT-53681	2864205	S	32	57	89	0.00001
Shewanella sp. FJAT-51860	2864212	S	28	4	32	0.00000
Shewanella sp. MR-4	60480	S	25	30	55	0.00000
Shewanella sp. Scap07	2589987	S	25	3	28	0.00000
Shewanella sp. SNU WT4	2590015	S	24	6	30	0.00000
Shewanella sp. FJAT-52072	2864213	S	23	33	56	0.00000
Shewanella sp. Arc9-LZ	2698686	S	21	9	30	0.00000
Shewanella sp. WE21	2029986	S	19	11	30	0.00000
Shewanella sp. FJAT-53749	2864206	S	19	4	23	0.00000
Shewanella sp. FJAT-53870	2864208	S	17	3	20	0.00000
Shewanella sp. FJAT-51754	2864211	S	14	22	36	0.00000
Shewanella sp. OM3-2	2908650	S	13	2	15	0.00000
Shewanella sp. Pdp11	2059264	S	10	33	43	0.00000
Shewanella khirikhana	1965282	S	178	31	209	0.00002
Shewanella algae	38313	S	175	171	346	0.00003
Shewanella cyperi	2814292	S	152	95	247	0.00002
Shewanella litorisediminis	1173586	S	94	25	119	0.00001
Shewanella putrefaciens	24	S	88	331	419	0.00003
Shewanella glacialimarina	2590884	S	87	12	99	0.00001
Shewanella marisflavi	260364	S	83	17	100	0.00001
Shewanella baltica	62322	S	82	68	150	0.00001
Shewanella sedimentimangrovi	2814293	S	77	67	144	0.00001
Shewanella amazonensis	60478	S	63	17	80	0.00001
Shewanella avicenniae	2814294	S	60	10	70	0.00001
Shewanella dokdonensis	712036	S	58	6	64	0.00000
Shewanella yunxiaonensis	2829809	S	57	9	66	0.00000
Shewanella sediminis	271097	S	57	8	65	0.00000
Shewanella violacea	60217	S	45	9	54	0.00000
Shewanella benthica	43661	S	43	10	53	0.00000
Shewanella loihica	359303	S	43	85	128	0.00001
Shewanella psychropiezotolerans	2593655	S	39	8	47	0.00000
Shewanella psychrophila	225848	S	37	5	42	0.00000
Shewanella halifaxensis	271098	S	36	5	41	0.00000
Shewanella oneidensis	70863	S	35	11	46	0.00000
Shewanella pealeana	70864	S	32	6	38	0.00000
Shewanella maritima	2520507	S	31	3	34	0.00000
Shewanella denitrificans	192073	S	30	4	34	0.00000
Shewanella woodyi	60961	S	29	3	32	0.00000
Shewanella decolorationis	256839	S	28	36	64	0.00000
Shewanella psychromarinicola	2487742	S	28	4	32	0.00000
Shewanella chilikensis	558541	S	23	76	99	0.00001
Shewanella donghaensis	238836	S	22	2	24	0.00000
Shewanella indica	768528	S	21	34	55	0.00000
Shewanella livingstonensis	150120	S	21	5	26	0.00000
Shewanella xiamenensis	332186	S	21	124	145	0.00001
Shewanella carassii	1987584	S	20	25	45	0.00000
Shewanella piezotolerans	404011	S	16	1	17	0.00000
Shewanella inventionis	1738770	S	14	7	21	0.00000
Shewanella vesiculosa	518738	S	14	4	18	0.00000
Shewanella frigidimarina	56812	S	14	8	22	0.00000
Shewanella aestuarii	1028752	S	13	5	18	0.00000
Parashewanella spongiae	342950	S	26	2	28	0.00000
Parashewanella tropica	2547970	S	12	1	13	0.00000
Alteromonas sp. RKMC-009	2267264	S	82	23	105	0.00001
Alteromonas sp. BL110	1714845	S	17	25	42	0.00000
Alteromonas sp. 76-1	2358187	S	12	12	24	0.00000
Alteromonas macleodii	28108	S	130	52	182	0.00001
Alteromonas mediterranea	314275	S	43	13	56	0.00000
Alteromonas pelagimontana	1858656	S	39	5	44	0.00000
Alteromonas australica	589873	S	19	33	52	0.00000
Alteromonas stellipolaris	233316	S	10	29	39	0.00000
Alteromonas naphthalenivorans	715451	S	10	5	15	0.00000
Salinimonas marina	2785918	S	71	8	79	0.00001
Salinimonas lutimaris	914153	S	59	12	71	0.00001
Salinimonas iocasae	2572577	S	54	12	66	0.00000
Salinimonas sediminis	2303538	S	51	13	64	0.00000
Hydrocarboniclastica marina	2259620	S	405	62	467	0.00003
Agarivorans sp. TSD2052	2937286	S	28	4	32	0.00000
Agarivorans gilvus	680279	S	33	3	36	0.00000
Agarivorans aestuarii	1563703	S	19	10	29	0.00000
Agarivorans albus	182262	S	11	13	24	0.00000
Saliniradius amylolyticus	2183582	S	118	12	130	0.00001
Lacimicrobium alkaliphilum	1526571	S	114	9	123	0.00001
Paraglaciecola sp. L1A13	2686359	S	24	2	26	0.00000
Paraglaciecola sp. L3A3	2686358	S	13	1	14	0.00000
Paraglaciecola mesophila	197222	S	32	4	36	0.00000
Paraglaciecola psychrophila	326544	S	23	2	25	0.00000
Paraneptunicella aestuarii	2831148	S	44	2	46	0.00000
Glaciecola nitratireducens	300231	S	40	3	43	0.00000
Catenovulum sediminis	1740262	S	24	1	25	0.00000
Saccharobesus litoralis	2172099	S	24	1	25	0.00000
Pseudoalteromonas sp. R3	1709477	S	56	23	79	0.00001
Pseudoalteromonas sp. A25	116092	S	14	11	25	0.00000
Pseudoalteromonas rubra	43658	S	127	15	142	0.00001
Pseudoalteromonas viridis	339617	S	86	26	112	0.00001
Pseudoalteromonas luteoviolacea	43657	S	82	12	94	0.00001
Pseudoalteromonas shioyasakiensis	1190813	S	39	16	55	0.00000
Pseudoalteromonas piscicida	43662	S	38	35	73	0.00001
Pseudoalteromonas xiamenensis	882626	S	32	3	35	0.00000
Pseudoalteromonas spongiae	298657	S	30	7	37	0.00000
Pseudoalteromonas ulvae	107327	S	26	1	27	0.00000
Pseudoalteromonas tunicata	314281	S	21	3	24	0.00000
Pseudoalteromonas prydzensis	182141	S	19	3	22	0.00000
Pseudoalteromonas mariniglutinosa	206042	S	19	35	54	0.00000
Pseudoalteromonas ruthenica	151081	S	17	17	34	0.00000
Pseudoalteromonas espejiana	28107	S	15	3	18	0.00000
Pseudoalteromonas translucida	166935	S	14	49	63	0.00000
Pseudoalteromonas carrageenovora	227	S	12	3	15	0.00000
Pseudoalteromonas piratica	1348114	S	12	1	13	0.00000
Pseudoalteromonas donghaensis	621376	S	11	89	100	0.00001
Pseudoalteromonas phenolica	161398	S	11	1	12	0.00000
Pseudoalteromonas arctica	394751	S	10	6	16	0.00000
Pseudoalteromonas agarivorans	176102	S	10	29	39	0.00000
Pseudoalteromonas aliena	247523	S	10	3	13	0.00000
Psychrosphaera ytuae	2820710	S	22	4	26	0.00000
Psychrosphaera aestuarii	1266052	S	13	2	15	0.00000
Flocculibacter collagenilyticus	2744479	S	15	1	16	0.00000
Ferrimonas balearica	44012	S	451	62	513	0.00004
Ferrimonas lipolytica	2724191	S	57	8	65	0.00000
Thalassotalea sp. PS06	2594005	S	37	5	42	0.00000
Thalassotalea sp. HSM 43	2552945	S	30	4	34	0.00000
Thalassotalea sp. LPB0316	2769490	S	25	8	33	0.00000
Thalassotalea crassostreae	1763536	S	18	3	21	0.00000
Colwellia sp. 20A7	2689569	S	20	2	22	0.00000
Colwellia sp. PAMC 20917	1816218	S	16	1	17	0.00000
Colwellia sp. Arc7-635	2497879	S	12	2	14	0.00000
Colwellia sp. MT41	58049	S	11	1	12	0.00000
Cognaticolwellia beringensis	1967665	S	17	3	20	0.00000
Litorilituus sediminis	718192	S	12	1	13	0.00000
Idiomarina sp. OT37-5b	2100422	S	73	21	94	0.00001
Idiomarina sp. X4	2055892	S	17	19	36	0.00000
Idiomarina loihiensis	135577	S	36	0	36	0.00000
Idiomarina abyssalis	86102	S	24	5	29	0.00000
Idiomarina piscisalsi	1096243	S	20	22	42	0.00000
Moritella sp. 24	2746230	S	13	22	35	0.00000
Moritella yayanosii	69539	S	20	10	30	0.00000
Moritella marina	90736	S	16	7	23	0.00000
Psychromonas ingrahamii	357794	S	43	5	48	0.00000
Psychromonas sp. CNPT3	314282	S	16	3	19	0.00000
Vibrio parahaemolyticus	670	S	144	59	203	0.00001
Vibrio harveyi	669	S	49	23	72	0.00001
Vibrio alginolyticus	663	S	47	149	196	0.00001
Vibrio owensii	696485	S	45	45	90	0.00001
Vibrio diabolicus	50719	S	27	42	69	0.00000
Vibrio campbellii	680	S	36	67	103	0.00001
Vibrio natriegens	691	S	29	63	92	0.00001
Vibrio rotiferianus	190895	S	23	12	35	0.00000
Vibrio azureus	512649	S	21	3	24	0.00000
Vibrio sp. OG9-811	2841925	S	113	22	135	0.00001
Vibrio sp. B1FLJ16	2751178	S	42	11	53	0.00000
Vibrio sp. HDW18	2714948	S	33	7	40	0.00000
Vibrio sp. VB16	2785746	S	24	2	26	0.00000
Vibrio sp. THAF190c	2587865	S	24	4	28	0.00000
Vibrio sp. SCSIO 43132	2779363	S	19	16	35	0.00000
Vibrio sp. ED004	2785124	S	17	12	29	0.00000
Vibrio sp. Scap24	2589990	S	15	10	25	0.00000
Vibrio sp. SS-MA-C1-2	2908646	S	11	2	13	0.00000
Vibrio fluvialis	676	S	228	57	285	0.00002
Vibrio furnissii	29494	S	213	91	304	0.00002
Vibrio vulnificus	672	S	157	46	203	0.00001
Vibrio sinaloensis	379097	S	53	9	62	0.00000
Vibrio tubiashii	29498	S	38	13	51	0.00000
Vibrio europaeus	300876	S	26	6	32	0.00000
Vibrio navarrensis	29495	S	113	53	166	0.00001
Vibrio cholerae	666	S	85	108	193	0.00001
Vibrio mimicus	674	S	68	26	94	0.00001
Vibrio anguillarum	55601	S	67	26	93	0.00001
Vibrio nigripulchritudo	28173	S	55	25	80	0.00001
Vibrio cyclitrophicus	47951	S	53	24	77	0.00001
Vibrio alfacsensis	1074311	S	48	37	85	0.00001
Vibrio coralliilyticus	190893	S	48	36	84	0.00001
Vibrio breoganii	553239	S	40	5	45	0.00000
Vibrio panuliri	1381081	S	40	6	46	0.00000
Vibrio mediterranei	689	S	40	5	45	0.00000
Vibrio penaeicida	104609	S	39	5	44	0.00000
Vibrio gazogenes	687	S	39	6	45	0.00000
Vibrio neptunius	170651	S	39	8	47	0.00000
Vibrio scophthalmi	45658	S	36	8	44	0.00000
Vibrio maritimus	990268	S	35	4	39	0.00000
Vibrio algicola	2662262	S	34	6	40	0.00000
Vibrio astriarenae	1481923	S	33	5	38	0.00000
Vibrio tapetis	52443	S	32	2	34	0.00000
Vibrio taketomensis	2572923	S	32	5	37	0.00000
Vibrio splendidus	29497	S	30	16	46	0.00000
Vibrio metoecus	1481663	S	29	17	46	0.00000
Vibrio tritonius	1435069	S	28	4	32	0.00000
Vibrio metschnikovii	28172	S	28	6	34	0.00000
Vibrio zhugei	2479546	S	27	7	34	0.00000
Vibrio cidicii	1763883	S	25	17	42	0.00000
Vibrio spartinae	1918945	S	24	3	27	0.00000
Vibrio cincinnatiensis	675	S	24	5	29	0.00000
Vibrio ziniensis	2711221	S	24	3	27	0.00000
Vibrio kanaloae	170673	S	23	8	31	0.00000
Vibrio ponticus	265668	S	21	2	23	0.00000
Vibrio crassostreae	246167	S	20	18	38	0.00000
Vibrio aquimaris	2587862	S	19	2	21	0.00000
Vibrio casei	673372	S	19	6	25	0.00000
Vibrio chagasii	170679	S	17	4	21	0.00000
Vibrio rumoiensis	76258	S	16	11	27	0.00000
Vibrio aphrogenes	1891186	S	16	2	18	0.00000
Vibrio gigantis	296199	S	14	6	20	0.00000
Vibrio bathopelagicus	2777577	S	12	4	16	0.00000
Photobacterium sp. GJ3	2829502	S	123	20	143	0.00001
Photobacterium sp. TLY01	2907534	S	105	23	128	0.00001
Photobacterium gaetbulicola	1295392	S	140	15	155	0.00001
Photobacterium ganghwense	320778	S	123	34	157	0.00001
Photobacterium damselae	38293	S	87	55	142	0.00001
Photobacterium profundum	74109	S	24	3	27	0.00000
Salinivibrio kushneri	1908198	S	77	14	91	0.00001
Salinivibrio sp. YCSC6	2003370	S	15	33	48	0.00000
Salinivibrio costicola	51367	S	12	27	39	0.00000
Grimontia hollisae	673	S	98	15	113	0.00001
Thaumasiovibrio subtropicus	1891207	S	37	5	42	0.00000
Aliivibrio fischeri	668	S	14	4	18	0.00000
Paraphotobacterium marinum	1755811	S	11	2	13	0.00000
Legionella sp. PC1000	2746060	S	228	26	254	0.00002
Legionella sp. MW5194	2662448	S	89	10	99	0.00001
Legionella sp. PC997	2755562	S	53	6	59	0.00000
Legionella pneumophila	446	S	261	126	387	0.00003
Legionella anisa	28082	S	237	35	272	0.00002
Legionella sainthelensi	28087	S	175	19	194	0.00001
Legionella geestiana	45065	S	124	8	132	0.00001
Legionella longbeachae	450	S	114	35	149	0.00001
Legionella spiritensis	452	S	97	7	104	0.00001
Legionella israelensis	454	S	67	3	70	0.00001
Legionella lansingensis	45067	S	67	4	71	0.00001
Legionella oakridgensis	29423	S	43	3	46	0.00000
Legionella waltersii	66969	S	39	4	43	0.00000
Legionella cherrii	28084	S	38	2	40	0.00000
Legionella fallonii	96230	S	37	2	39	0.00000
Legionella clemsonensis	1867846	S	33	3	36	0.00000
Legionella antarctica	2708020	S	32	1	33	0.00000
Legionella jordanis	456	S	30	3	33	0.00000
Legionella hackeliae	449	S	23	2	25	0.00000
Legionella adelaidensis	45056	S	22	1	23	0.00000
Fluoribacter dumoffii	463	S	53	15	68	0.00000
Tatlockia micdadei	451	S	38	2	40	0.00000
Aquicella siphonis	254247	S	176	45	221	0.00002
Aquicella lusitana	254246	S	167	45	212	0.00002
Coxiella burnetii	777	S	152	39	191	0.00001
Coxiella endosymbiont of Amblyomma sculptum	2487929	S	49	14	63	0.00000
Coxiella endosymbiont of Amblyomma nuttalli	2749996	S	26	2	28	0.00000
Candidatus Coxiella mudrowiae	2054173	S	32	2	34	0.00000
Candidatus Rickettsiella viridis	676208	S	17	12	29	0.00000
Rickettsiella endosymbiont of Dermanyssus gallinae	2856608	S	16	10	26	0.00000
Immundisolibacter cernigliae	1810504	S	2746	554	3300	0.00024
Acinetobacter sp. WCHAc010034	1879049	S	156	81	237	0.00002
Acinetobacter sp. 10FS3-1	2563897	S	30	24	54	0.00000
Acinetobacter sp. TTH0-4	1646498	S	28	7	35	0.00000
Acinetobacter sp. CS-2	2798861	S	21	14	35	0.00000
Acinetobacter sp. ASP199	2773709	S	17	10	27	0.00000
Acinetobacter sp. TGL-Y2	1407071	S	15	1	16	0.00000
Acinetobacter sp. Marseille-Q1620	2714110	S	14	1	15	0.00000
Acinetobacter sp. LoGeW2-3	1808001	S	13	4	17	0.00000
Acinetobacter sp. F9	2853158	S	10	6	16	0.00000
Acinetobacter baumannii	470	S	283	1421	1704	0.00012
Acinetobacter pittii	48296	S	31	52	83	0.00001
Acinetobacter calcoaceticus	471	S	15	2	17	0.00000
Acinetobacter seifertii	1530123	S	15	7	22	0.00000
Acinetobacter nosocomialis	106654	S	12	5	17	0.00000
Acinetobacter indicus	756892	S	81	74	155	0.00001
Acinetobacter soli	487316	S	61	6	67	0.00000
Acinetobacter johnsonii	40214	S	54	57	111	0.00001
Acinetobacter lwoffii	28090	S	36	61	97	0.00001
Acinetobacter radioresistens	40216	S	34	8	42	0.00000
Acinetobacter bouvetii	202951	S	31	6	37	0.00000
Acinetobacter schindleri	108981	S	29	29	58	0.00000
Acinetobacter junii	40215	S	24	10	34	0.00000
Acinetobacter cumulans	2136182	S	22	10	32	0.00000
Acinetobacter haemolyticus	29430	S	20	12	32	0.00000
Acinetobacter shaoyimingii	2715164	S	19	2	21	0.00000
Acinetobacter variabilis	70346	S	19	29	48	0.00000
Acinetobacter larvae	1789224	S	18	1	19	0.00000
Acinetobacter tandoii	202954	S	16	1	17	0.00000
Acinetobacter dispersus	70348	S	14	1	15	0.00000
Acinetobacter gyllenbergii	134534	S	13	1	14	0.00000
Acinetobacter guillouiae	106649	S	13	5	18	0.00000
Acinetobacter baylyi	202950	S	12	1	13	0.00000
Acinetobacter portensis	1839785	S	11	13	24	0.00000
Acinetobacter defluvii	1871111	S	11	9	20	0.00000
Acinetobacter pseudolwoffii	2053287	S	10	27	37	0.00000
Psychrobacter sp. DAB_AL43B	1028416	S	22	7	29	0.00000
Psychrobacter sp. 28M-43	2772254	S	14	33	47	0.00000
Psychrobacter sp. WY6	2708350	S	10	44	54	0.00000
Psychrobacter arenosus	256326	S	32	3	35	0.00000
Psychrobacter urativorans	45610	S	20	5	25	0.00000
Psychrobacter cryohalolentis	330922	S	10	100	110	0.00001
Psychrobacter sanguinis	861445	S	10	6	16	0.00000
Moraxella osloensis	34062	S	77	13	90	0.00001
Moraxella bovis	476	S	33	11	44	0.00000
Moraxella bovoculi	386891	S	25	53	78	0.00001
Moraxella catarrhalis	480	S	24	5	29	0.00000
Moraxella cuniculi	34061	S	21	2	23	0.00000
Moraxella sp. ZY201115	2904121	S	17	2	19	0.00000
Moraxella nonliquefaciens	478	S	12	3	15	0.00000
Aquirhabdus parva	2283318	S	73	3	76	0.00001
Candidatus Endoriftia persephone	393765	S	801	42	843	0.00006
Candidatus Vesicomyosocius sp. SY067_SCS001	2732590	S	14	13	27	0.00000
Bathymodiolus thermophilus thioautotrophic gill symbiont	2360	S	16	1	17	0.00000
Bathymodiolus septemdierum thioautotrophic gill symbiont	113267	S	12	2	14	0.00000
Sedimenticola thiotaurini	1543721	S	551	25	576	0.00004
Candidatus Reidiella endopervernicosa	2738883	S	367	8	375	0.00003
Thiolapillus brandeum	1076588	S	293	7	300	0.00002
Pseudohongiella spirulinae	1249552	S	170	5	175	0.00001
Gallaecimonas mangrovi	2291597	S	124	10	134	0.00001
Celerinatantimonas diazotrophica	412034	S	36	3	39	0.00000
Candidatus Thioglobus autotrophicus	1705394	S	18	1	19	0.00000
Ignatzschineria sp. HR5S32	2923279	S	23	2	25	0.00000
Candidatus Pseudothioglobus singularis	1427364	S	14	2	16	0.00000
endosymbiont of Sipalinus gigas	1972134	S	10	4	14	0.00000
Thiomicrorhabdus xiamenensis	2739063	S	95	6	101	0.00001
Thiomicrorhabdus aquaedulcis	2211106	S	61	3	64	0.00000
Thiomicrorhabdus sediminis	2580412	S	35	2	37	0.00000
Thiomicrorhabdus indica	2267253	S	16	0	16	0.00000
Thiomicrorhabdus sp. Am19	2791037	S	12	0	12	0.00000
Methylophaga frappieri	754477	S	60	34	94	0.00001
Methylophaga sp. TMB456	2881052	S	56	23	79	0.00001
Methylophaga nitratireducenticrescens	754476	S	45	9	54	0.00000
Thiomicrospira sp. S5	1803865	S	60	51	111	0.00001
Thiomicrospira aerophila	92245	S	36	4	40	0.00000
Thiomicrospira microaerophila	406020	S	35	5	40	0.00000
Thiomicrospira cyclica	147268	S	22	1	23	0.00000
Hydrogenovibrio thermophilus	265883	S	68	57	125	0.00001
Hydrogenovibrio marinus	28885	S	33	1	34	0.00000
Hydrogenovibrio crunogenus	39765	S	28	1	29	0.00000
Thiosulfatimonas sediminis	2675054	S	56	4	60	0.00000
Piscirickettsia salmonis	1238	S	54	4	58	0.00000
Thiosulfativibrio zosterae	2675053	S	29	1	30	0.00000
Thiothrix litoralis	2891210	S	208	16	224	0.00002
Thiothrix subterranea	2735563	S	137	41	178	0.00001
Thiothrix sp. CT3	96472	S	113	40	153	0.00001
Candidatus Thiothrix anitrata	2823902	S	84	53	137	0.00001
Thiothrix unzii	111769	S	75	42	117	0.00001
Beggiatoa leptomitoformis	288004	S	60	1	61	0.00000
Francisella tularensis	263	S	19	38	57	0.00000
Francisella frigiditurris	1542390	S	18	3	21	0.00000
Francisella uliginis	573570	S	11	3	14	0.00000
Allofrancisella guangzhouensis	594679	S	15	5	20	0.00000
Salinisphaera sp. LB1	2183911	S	1644	74	1718	0.00012
endosymbiont of unidentified scaly snail isolate Monju	1248727	S	1507	140	1647	0.00012
Aggregatibacter actinomycetemcomitans	714	S	64	11	75	0.00001
Aggregatibacter aphrophilus	732	S	43	23	66	0.00000
Aggregatibacter sp. 2125159857	2820817	S	18	9	27	0.00000
Aggregatibacter sp. Marseille-P9115	2866570	S	10	10	20	0.00000
Haemophilus influenzae	727	S	42	24	66	0.00000
Haemophilus parainfluenzae	729	S	41	15	56	0.00000
Haemophilus parahaemolyticus	735	S	18	3	21	0.00000
Haemophilus haemolyticus	726	S	16	6	22	0.00000
[Haemophilus] ducreyi	730	S	11	6	17	0.00000
Actinobacillus sp. GY-402	2774188	S	51	28	79	0.00001
Actinobacillus pleuropneumoniae	715	S	21	80	101	0.00001
Actinobacillus suis	716	S	13	5	18	0.00000
Mannheimia granulomatis	85402	S	33	8	41	0.00000
Mannheimia varigena	85404	S	27	28	55	0.00000
Mannheimia haemolytica	75985	S	17	9	26	0.00000
Pasteurella multocida	747	S	67	192	259	0.00002
Avibacterium paragallinarum	728	S	28	10	38	0.00000
Avibacterium volantium	762	S	20	8	28	0.00000
Glaesserella parasuis	738	S	31	17	48	0.00000
Glaesserella sp. 15-184	2030797	S	18	5	23	0.00000
Rodentibacter heylii	1906744	S	19	2	21	0.00000
Rodentibacter haemolyticus	2778911	S	17	2	19	0.00000
Gallibacterium anatis	750	S	26	8	34	0.00000
Bibersteinia trehalosi	47735	S	14	4	18	0.00000
Histophilus somni	731	S	12	4	16	0.00000
Frederiksenia canicola	123824	S	12	3	15	0.00000
Cardiobacterium hominis	2718	S	494	105	599	0.00004
Cardiobacterium sp. Marseille-Q4385	2866573	S	273	52	325	0.00002
Suttonella sp. R2A3	2908648	S	43	2	45	0.00000
Dichelobacter nodosus	870	S	41	11	52	0.00000
Kangiella koreensis	261964	S	53	7	60	0.00000
Kangiella profundi	1561924	S	36	8	44	0.00000
Kangiella geojedonensis	914150	S	27	2	29	0.00000
Kangiella sediminilitoris	1144748	S	24	1	25	0.00000
Gilliamella sp. ESL0441	2704654	S	12	10	22	0.00000
Gilliamella sp. ESL0443	2704655	S	12	3	15	0.00000
Gilliamella apicola	1196095	S	15	3	18	0.00000
Zophobihabitans entericus	1635327	S	11	1	12	0.00000
Archangium violaceum	83451	S	38744	4596	43340	0.00313
Archangium gephyra	48	S	26447	3577	30024	0.00217
Cystobacter fuscus	43	S	34458	5160	39618	0.00286
Stigmatella aurantiaca	41	S	6872	448	7320	0.00053
Melittangium boletus	83453	S	6706	949	7655	0.00055
Anaeromyxobacter sp. Red232	2918170	S	18641	2062	20703	0.00150
Anaeromyxobacter sp. Fw109-5	404589	S	15525	2090	17615	0.00127
Anaeromyxobacter sp. Red630	2918171	S	11163	1529	12692	0.00092
Anaeromyxobacter sp. K	447217	S	2843	5540	8383	0.00061
Anaeromyxobacter dehalogenans	161493	S	9274	6423	15697	0.00113
Myxococcus xanthus	34	S	7583	35031	42614	0.00308
Myxococcus hansupus	1297742	S	4173	323	4496	0.00032
Myxococcus stipitatus	83455	S	3513	352	3865	0.00028
Myxococcus sp. SCHIC003	2813577	S	3094	313	3407	0.00025
Corallococcus coralloides	184914	S	7233	2735	9968	0.00072
Corallococcus macrosporus	35	S	4903	774	5677	0.00041
Corallococcus sp. EGB	1521117	S	4307	1540	5847	0.00042
Pyxidicoccus sp. SCPEA002	2813578	S	12250	545	12795	0.00092
Vulgatibacter incomptus	1391653	S	5476	435	5911	0.00043
Sorangium cellulosum	56	S	68985	8156	77141	0.00557
Polyangium aurulentum	2567896	S	16587	1486	18073	0.00131
Chondromyces crocatus	52	S	8674	384	9058	0.00065
Pajaroellobacter abortibovis	1882918	S	114	3	117	0.00001
Sandaracinus amylolyticus	927083	S	27022	1475	28497	0.00206
Labilithrix luteola	1391654	S	9233	405	9638	0.00070
Haliangium ochraceum	80816	S	11141	600	11741	0.00085
Geomonas sp. RF6	2897342	S	2389	308	2697	0.00019
Geomonas paludis	2740185	S	1738	883	2621	0.00019
Geomonas nitrogeniifigens	2847991	S	1580	824	2404	0.00017
Geomonas subterranea	2847989	S	1444	679	2123	0.00015
Geomonas oryzisoli	2847992	S	1400	775	2175	0.00016
Geobacter sp. FeAm09	2597769	S	1533	193	1726	0.00012
Geobacter sp. SVR	2495594	S	1118	161	1279	0.00009
Geobacter sp. DSM 9736	1277350	S	671	49	720	0.00005
Geobacter sulfurreducens	35554	S	1822	438	2260	0.00016
Geobacter pickeringii	345632	S	1712	440	2152	0.00016
Geobacter metallireducens	28232	S	1068	251	1319	0.00010
Geobacter benzoatilyticus	2815309	S	686	152	838	0.00006
Citrifermentans bremense	60035	S	1444	584	2028	0.00015
Citrifermentans bemidjiense	225194	S	1308	485	1793	0.00013
Geotalea uraniireducens	351604	S	860	67	927	0.00007
Geotalea daltonii	1203471	S	479	39	518	0.00004
Geoalkalibacter subterraneus	483547	S	735	647	1382	0.00010
Trichlorobacter lovleyi	313985	S	438	60	498	0.00004
Desulfuromonas versatilis	2802975	S	2888	518	3406	0.00025
Desulfuromonas sp. DDH964	1823759	S	1880	353	2233	0.00016
Desulfuromonas sp. AOP6	1566351	S	585	67	652	0.00005
Desulfuromonas soudanensis	1603606	S	1712	194	1906	0.00014
Pelobacter propionicus	29543	S	1118	406	1524	0.00011
Syntrophotalea acetylenica	29542	S	578	117	695	0.00005
Syntrophotalea carbinolica	19	S	421	34	455	0.00003
Syntrophotalea acetylenivorans	1842532	S	300	46	346	0.00003
Pseudodesulfovibrio mercurii	641491	S	1333	311	1644	0.00012
Pseudodesulfovibrio indicus	1716143	S	1220	253	1473	0.00011
Pseudodesulfovibrio aespoeensis	182210	S	933	653	1586	0.00011
Pseudodesulfovibrio cashew	2678688	S	794	154	948	0.00007
Pseudodesulfovibrio sp. SF6	2810563	S	338	32	370	0.00003
Pseudodesulfovibrio sp. zrk46	2725288	S	298	49	347	0.00003
Pseudodesulfovibrio tunisiensis	463192	S	583	60	643	0.00005
Pseudodesulfovibrio profundus	57320	S	206	203	409	0.00003
Pseudodesulfovibrio piezophilus	879567	S	93	12	105	0.00001
Desulfovibrio sp. IOR2	2583823	S	850	161	1011	0.00007
Desulfovibrio sp. 86	2666132	S	261	70	331	0.00002
Desulfovibrio sp. G11	631220	S	208	163	371	0.00003
Desulfovibrio vulgaris	881	S	1040	45	1085	0.00008
Desulfovibrio sulfodismutans	63561	S	936	229	1165	0.00008
Desulfovibrio desulfuricans	876	S	770	186	956	0.00007
Desulfovibrio piger	901	S	699	144	843	0.00006
Desulfovibrio fairfieldensis	44742	S	526	48	574	0.00004
Desulfovibrio ferrophilus	241368	S	341	28	369	0.00003
Candidatus Desulfovibrio trichonymphae	1725232	S	115	10	125	0.00001
Solidesulfovibrio carbinoliphilus	345370	S	1729	217	1946	0.00014
Solidesulfovibrio magneticus	184917	S	733	437	1170	0.00008
Solidesulfovibrio carbinolicus	296842	S	676	543	1219	0.00009
Oceanidesulfovibrio marinus	370038	S	1724	108	1832	0.00013
Desulfolutivibrio sulfoxidireducens	2773299	S	1301	345	1646	0.00012
Desulfocurvibacter africanus	873	S	1274	97	1371	0.00010
Megalodesulfovibrio gigas	879	S	914	45	959	0.00007
Oleidesulfovibrio alaskensis	58180	S	322	443	765	0.00006
Maridesulfovibrio salexigens	880	S	97	10	107	0.00001
Maridesulfovibrio hydrothermalis	191026	S	69	7	76	0.00001
Paradesulfovibrio bizertensis	376490	S	121	12	133	0.00001
Lawsonia intracellularis	29546	S	45	0	45	0.00000
Desulfomicrobium baculatum	899	S	850	70	920	0.00007
Desulfomicrobium orale	132132	S	491	128	619	0.00004
Desulfohalobium retbaense	45663	S	366	19	385	0.00003
Desulfosarcina alkanivorans	571177	S	1077	449	1526	0.00011
Desulfosarcina ovata	83564	S	979	48	1027	0.00007
Desulfosarcina widdelii	947919	S	793	88	881	0.00006
Desulfococcus multivorans	897	S	734	133	867	0.00006
Desulfatibacillum aliphaticivorans	218208	S	575	18	593	0.00004
Desulfoluna sp. ASN36	2810562	S	484	24	508	0.00004
Desulfobacter hydrogenophilus	2291	S	140	25	165	0.00001
Desulfobacter postgatei	2293	S	119	20	139	0.00001
Desulfonema magnum	45655	S	190	4	194	0.00001
Desulfonema limicola	45656	S	57	4	61	0.00000
Desulforapulum autotrophicum	2296	S	191	20	211	0.00002
Desulfobacula toluolica	28223	S	61	4	65	0.00000
Desulfobulbus propionicus	894	S	828	47	875	0.00006
Desulfobulbus oralis	1986146	S	621	134	755	0.00005
Desulfobulbus oligotrophicus	1909699	S	169	143	312	0.00002
Desulfurivibrio alkaliphilus	427923	S	668	32	700	0.00005
Desulfomarina profundi	2772557	S	84	7	91	0.00001
Desulfosudis oleivorans	181663	S	623	32	655	0.00005
Desulfosediminicola ganghwensis	2569540	S	172	17	189	0.00001
Desulfosediminicola flagellatus	2569541	S	77	6	83	0.00001
Desulfotalea psychrophila	84980	S	89	14	103	0.00001
Desulfocapsa sulfexigens	65555	S	51	2	53	0.00000
Persicimonas caeni	2292766	S	4275	145	4420	0.00032
Bradymonas sediminis	1548548	S	1415	110	1525	0.00011
Bradymonadales bacterium V1718	2600177	S	511	25	536	0.00004
Desulfarculus baarsii	453230	S	2042	1187	3229	0.00023
Syntrophobacter fumaroxidans	119484	S	1041	432	1473	0.00011
Desulfoglaeba alkanexedens	361111	S	873	50	923	0.00007
Desulfomonile tiedjei	2358	S	470	4	474	0.00003
Desulfobacca acetoxidans	60893	S	386	10	396	0.00003
Syntrophus aciditrophicus	316277	S	280	18	298	0.00002
Dissulfurimicrobium hydrothermale	1750598	S	191	12	203	0.00001
Candidatus Desulfofervidus auxilii	1621989	S	184	4	188	0.00001
Hippea maritima	84405	S	44	2	46	0.00000
Campylobacter gracilis	824	S	120	8	128	0.00001
Campylobacter showae	204	S	114	14	128	0.00001
Campylobacter curvus	200	S	87	9	96	0.00001
Campylobacter concisus	199	S	85	12	97	0.00001
Campylobacter sp. 19-13652	2840180	S	14	1	15	0.00000
Campylobacter sp. CCUG 57310	2517362	S	13	5	18	0.00000
Campylobacter rectus	203	S	59	10	69	0.00001
Campylobacter jejuni	197	S	17	98	115	0.00001
Campylobacter fetus	196	S	16	21	37	0.00000
Campylobacter coli	195	S	14	16	30	0.00000
Campylobacter hyointestinalis	198	S	13	6	19	0.00000
Campylobacter blaseri	2042961	S	13	1	14	0.00000
Campylobacter lanienae	75658	S	11	3	14	0.00000
Campylobacter pinnipediorum	1965231	S	11	1	12	0.00000
Candidatus Campylobacter infans	2561898	S	10	1	11	0.00000
Sulfurimonas sp. HSL-3221	2894755	S	458	39	497	0.00004
Sulfurimonas sp. SWIR-19	2878390	S	50	43	93	0.00001
Sulfurimonas sp. H1576	2672570	S	12	1	13	0.00000
Sulfurimonas gotlandica	1176482	S	16	1	17	0.00000
Sulfurimonas hydrogeniphila	2509341	S	15	4	19	0.00000
Sulfurimonas paralvinellae	317658	S	14	2	16	0.00000
Sulfuricurvum kujiense	148813	S	42	3	45	0.00000
Helicobacter pylori	210	S	160	68	228	0.00002
Helicobacter sp. NHP19-0003	2849641	S	37	12	49	0.00000
Helicobacter sp. NHP19-0012	2849642	S	13	7	20	0.00000
Helicobacter heilmannii	35817	S	20	13	33	0.00000
Helicobacter cinaedi	213	S	17	8	25	0.00000
Helicobacter felis	214	S	13	2	15	0.00000
Helicobacter bilis	37372	S	10	7	17	0.00000
Helicobacter suis	104628	S	10	4	14	0.00000
Wolinella succinogenes	844	S	40	23	63	0.00000
Nitratifractor salsuginis	269261	S	270	25	295	0.00002
Sulfurovum sp. NBC37-1	387093	S	39	28	67	0.00000
Sulfurovum sp. HSL1-3	2893889	S	33	10	43	0.00000
Sulfurovum sp. XGS-02	2925411	S	12	1	13	0.00000
Sulfurovum indicum	2779528	S	30	4	34	0.00000
Sulfurovum lithotrophicum	206403	S	23	19	42	0.00000
Hydrogenimonas urashimensis	2740515	S	215	24	239	0.00002
Arcobacter sp. FWKO B	2593672	S	11	7	18	0.00000
Aliarcobacter butzleri	28197	S	12	32	44	0.00000
Pseudoarcobacter acticola	1849015	S	10	8	18	0.00000
Sulfurospirillum cavolei	366522	S	46	5	51	0.00000
Sulfurospirillum sp. UCH001	1581011	S	10	9	19	0.00000
Sulfurospirillum deleyianum	65553	S	17	2	19	0.00000
Sulfurospirillum multivorans	66821	S	13	12	25	0.00000
Sulfurospirillum halorespirans	194424	S	10	8	18	0.00000
Nitrosophilus alvini	2714855	S	95	34	129	0.00001
Nitrosophilus labii	2706014	S	25	19	44	0.00000
Nitratiruptor sp. YY09-18	2724901	S	31	29	60	0.00000
Nitratiruptor sp. SB155-2	387092	S	20	27	47	0.00000
Caminibacter pacificus	1424653	S	32	23	55	0.00000
Caminibacter mediatlanticus	291048	S	18	15	33	0.00000
Nautilia profundicola	244787	S	15	9	24	0.00000
Nautilia sp. PV-1	2579250	S	12	7	19	0.00000
Acidithiobacillus caldus	33059	S	536	90	626	0.00005
Acidithiobacillus ferrivorans	160808	S	358	79	437	0.00003
Acidithiobacillus ferrooxidans	920	S	211	204	415	0.00003
Acidithiobacillus ferriphilus	1689834	S	115	26	141	0.00001
Acidithiobacillus thiooxidans	930	S	114	7	121	0.00001
Acidithiobacillus ferridurans	1232575	S	16	154	170	0.00001
Acidithiobacillus sp. 'AMD consortium'	2614801	S	10	151	161	0.00001
Bdellovibrio bacteriovorus	959	S	312	41	353	0.00003
Bdellovibrio sp. LBG001	2835041	S	68	8	76	0.00001
Bdellovibrio sp. NC01	2220073	S	50	5	55	0.00000
Bdellovibrio sp. ZAP7	2231053	S	40	13	53	0.00000
Bdellovibrio sp. KM01	2748865	S	38	13	51	0.00000
Pseudobdellovibrio exovorus	453816	S	65	4	69	0.00001
Bacteriovorax stolpii	960	S	93	19	112	0.00001
Halobacteriovorax marinus	97084	S	29	12	41	0.00000
Halobacteriovorax sp. BALOs_7	2109558	S	20	5	25	0.00000
Silvanigrella aquatica	1915309	S	18	3	21	0.00000
Fluviispira sanaruensis	2493639	S	18	3	21	0.00000
Hydrogenophilus thermoluteolus	297	S	612	127	739	0.00005
Mariprofundus ferrinatatus	1921087	S	190	24	214	0.00002
Mariprofundus aestuarium	1921086	S	124	18	142	0.00001
Gemmata obscuriglobus	114	S	21330	3266	24596	0.00178
Gemmata massiliana	1210884	S	8491	3779	12270	0.00089
Gemmata sp. SH-PL17	1630693	S	7587	3805	11392	0.00082
Urbifossiella limnaea	2528023	S	38685	3722	42407	0.00306
Frigoriglobus tundricola	2774151	S	24102	4137	28239	0.00204
Limnoglobus roseus	2598579	S	18845	971	19816	0.00143
Tuwongella immobilis	692036	S	1600	77	1677	0.00012
Telmatocola sphagniphila	1123043	S	1465	16	1481	0.00011
Lacipirellula parvula	2650471	S	10732	1313	12045	0.00087
Lacipirellula limnantheis	2528024	S	10637	1513	12150	0.00088
Pirellulimonas nuda	2528009	S	6847	793	7640	0.00055
Botrimarina mediterranea	2528022	S	6249	624	6873	0.00050
Aeoliella mucimassa	2527972	S	2260	199	2459	0.00018
Adhaeretor mobilis	1930276	S	1352	138	1490	0.00011
Bythopirellula goksoeyrii	1400387	S	1224	93	1317	0.00010
Lignipirellula cremea	2528010	S	4235	539	4774	0.00034
Stieleria maiorica	2795974	S	1907	424	2331	0.00017
Stieleria neptunia	2527979	S	1798	212	2010	0.00015
Rosistilla oblonga	2527990	S	1096	527	1623	0.00012
Rosistilla carotiformis	2528017	S	726	316	1042	0.00008
Rosistilla ulvae	1930277	S	689	403	1092	0.00008
Anatilimnocola aggregata	2528021	S	3273	404	3677	0.00027
Bremerella volcania	2527984	S	2625	220	2845	0.00021
Pirellula staleyi	125	S	1947	79	2026	0.00015
Pirellula sp. SH-Sr6A	1632865	S	620	18	638	0.00005
Roseimaritima ulvae	980254	S	1682	114	1796	0.00013
Roseimaritima multifibrata	1930274	S	475	56	531	0.00004
Rubripirellula lacrimiformis	1930273	S	906	197	1103	0.00008
Mariniblastus fucicola	980251	S	603	12	615	0.00004
Aureliella helgolandensis	2527968	S	593	51	644	0.00005
Rhodopirellula baltica	265606	S	559	43	602	0.00004
Thermogutta terrifontis	1331910	S	725	24	749	0.00005
Tautonia plasticadhaerens	2527974	S	22717	2239	24956	0.00180
Aquisphaera giovannonii	406548	S	15867	3067	18934	0.00137
Paludisphaera borealis	1387353	S	9705	2449	12154	0.00088
Singulisphaera acidiphila	466153	S	6979	1179	8158	0.00059
Isosphaera pallida	128	S	1774	146	1920	0.00014
Planctomyces sp. SH-PL62	1636152	S	9567	3992	13559	0.00098
Planctomyces sp. SH-PL14	1632864	S	7702	554	8256	0.00060
Caulifigura coniformis	2527983	S	6106	464	6570	0.00047
Gimesia panareensis	2527978	S	1594	206	1800	0.00013
Gimesia chilikensis	2605989	S	870	534	1404	0.00010
Gimesia maris	122	S	610	101	711	0.00005
Gimesia alba	2527973	S	382	72	454	0.00003
Gimesia fumaroli	2527976	S	375	79	454	0.00003
Gimesia algae	2527971	S	352	93	445	0.00003
Gimesia benthica	2608982	S	274	389	663	0.00005
Gimesia aquarii	2527964	S	263	19	282	0.00002
Maioricimonas rarisocia	2528026	S	5159	760	5919	0.00043
Alienimonas californiensis	2527989	S	4871	415	5286	0.00038
Symmachiella dynata	2527995	S	1832	126	1958	0.00014
Rubinisphaera brasiliensis	119	S	1112	128	1240	0.00009
Calycomorphotria hydatis	2528027	S	1084	47	1131	0.00008
Fuerstiella marisgermanici	1891926	S	1031	21	1052	0.00008
Planctopirus limnophila	120	S	343	145	488	0.00004
Planctopirus ephydatiae	2528019	S	337	152	489	0.00004
Crateriforma conspicua	2527996	S	820	199	1019	0.00007
Polystyrenella longa	2528007	S	367	37	404	0.00003
Thalassoglobus polymorphus	2527994	S	364	22	386	0.00003
Humisphaera borealis	2807512	S	7327	199	7526	0.00054
Phycisphaera mikurensis	547188	S	3424	303	3727	0.00027
Mucisphaera calidilacus	2527982	S	1676	102	1778	0.00013
Poriferisphaera corsica	2528020	S	219	1	220	0.00002
Anaerohalosphaera lusitana	1936003	S	306	12	318	0.00002
Limihaloglobus sulfuriphilus	1851148	S	133	8	141	0.00001
Sedimentisphaera salicampi	1941349	S	66	14	80	0.00001
Sedimentisphaera cyanobacteriorum	1940790	S	38	45	83	0.00001
Candidatus Kuenenia stuttgartiensis	174633	S	127	0	127	0.00001
Candidatus Uabimicrobium amorphum	2596890	S	63	1	64	0.00000
Opitutus terrae	107709	S	4796	225	5021	0.00036
Opitutus sp. GAS368	1882749	S	4719	698	5417	0.00039
Lacunisphaera limnophila	1838286	S	4622	647	5269	0.00038
Nibricoccus aquaticus	2576891	S	2211	98	2309	0.00017
Oleiharenicola sp. KSB-15	2862869	S	2072	110	2182	0.00016
Ereboglobus luteus	1796921	S	1475	72	1547	0.00011
Ruficoccus sp. ZRK36	2866311	S	753	116	869	0.00006
Coraliomargarita akajimensis	395922	S	178	4	182	0.00001
Luteolibacter luteus	2728835	S	2561	102	2663	0.00019
Luteolibacter ambystomatis	2824561	S	1601	97	1698	0.00012
Verrucomicrobium sp. GAS474	1882831	S	2243	235	2478	0.00018
Verrucomicrobium spinosum	2736	S	1410	69	1479	0.00011
Roseimicrobium sp. ORNL1	2711231	S	3586	106	3692	0.00027
Sulfuriroseicoccus oceanibius	2707525	S	422	36	458	0.00003
Akkermansia muciniphila	239935	S	851	90	941	0.00007
Akkermansia glycaniphila	1679444	S	304	18	322	0.00002
Methylacidimicrobium sp. AP8	2730359	S	605	85	690	0.00005
Methylacidimicrobium sp. B4	2796139	S	507	95	602	0.00004
Methylacidiphilum sp. IT6	2795386	S	17	1	18	0.00000
Methylacidiphilum sp. IT5	2795384	S	11	23	34	0.00000
Methylacidiphilum infernorum	511746	S	15	30	45	0.00000
Candidatus Xiphinematobacter sp. Idaho Grape	1704307	S	81	5	86	0.00001
Kiritimatiella glycovorans	1307763	S	902	1067	1969	0.00014
Tichowtungia aerotolerans	2697043	S	298	12	310	0.00002
Candidatus Protochlamydia naegleriophila	389348	S	37	26	63	0.00000
Candidatus Protochlamydia amoebophila	362787	S	17	11	28	0.00000
Parachlamydia acanthamoebae	83552	S	44	14	58	0.00000
Neochlamydia sp. S13	1353976	S	32	6	38	0.00000
Candidatus Rhabdochlamydia oedothoracis	2720720	S	12	17	29	0.00000
Candidatus Rhabdochlamydia porcellionis	225148	S	10	18	28	0.00000
Waddlia chondrophila	71667	S	49	9	58	0.00000
Simkania negevensis	83561	S	34	3	37	0.00000
Chlamydia trachomatis	813	S	12	50	62	0.00000
Candidatus Velamenicoccus archaeovorus	1930593	S	285	1	286	0.00002
Hymenobacter sp. PAMC 26628	1484118	S	826	203	1029	0.00007
Hymenobacter sp. 5317J-9	2932250	S	817	190	1007	0.00007
Hymenobacter sp. PAMC 26554	1484116	S	697	70	767	0.00006
Hymenobacter sp. APR13	1356852	S	682	264	946	0.00007
Hymenobacter sp. BRD128	2675878	S	669	90	759	0.00005
Hymenobacter sp. 5116S-27	2932249	S	502	76	578	0.00004
Hymenobacter sp. 5116S-3	2932248	S	487	71	558	0.00004
Hymenobacter sp. BT18	2835648	S	432	55	487	0.00004
Hymenobacter sp. NBH84	2596915	S	402	58	460	0.00003
Hymenobacter sp. DG01	2584940	S	394	100	494	0.00004
Hymenobacter sp. 5413J-13	2932251	S	360	50	410	0.00003
Hymenobacter sp. 5420S-77	2932254	S	345	48	393	0.00003
Hymenobacter sp. S2-20-2	2761579	S	340	51	391	0.00003
Hymenobacter sp. DG25B	1385664	S	280	94	374	0.00003
Hymenobacter sp. BRD67	2675877	S	258	250	508	0.00004
Hymenobacter sp. DG25A	1385663	S	235	81	316	0.00002
Hymenobacter sp. HDW8	2714932	S	124	403	527	0.00004
Hymenobacter sp. 5516S-25	2933777	S	123	453	576	0.00004
Hymenobacter sp. 5516J-16	2932253	S	115	449	564	0.00004
Hymenobacter busanensis	2607656	S	849	94	943	0.00007
Hymenobacter monticola	1705399	S	796	149	945	0.00007
Hymenobacter sedentarius	1411621	S	690	106	796	0.00006
Hymenobacter nivis	1850093	S	603	156	759	0.00005
Hymenobacter jejuensis	2502781	S	548	43	591	0.00004
Hymenobacter oligotrophus	2319843	S	546	61	607	0.00004
Hymenobacter swuensis	1446467	S	372	83	455	0.00003
Hymenobacter tibetensis	497967	S	342	53	395	0.00003
Hymenobacter baengnokdamensis	2615203	S	306	333	639	0.00005
Hymenobacter qilianensis	1385715	S	286	52	338	0.00002
Hymenobacter radiodurans	2496028	S	136	462	598	0.00004
Pontibacter russatus	2694929	S	1138	118	1256	0.00009
Pontibacter actiniarum	323450	S	552	134	686	0.00005
Pontibacter pudoricolor	2694930	S	550	66	616	0.00004
Pontibacter akesuensis	388950	S	417	64	481	0.00003
Pontibacter korlensis	400092	S	257	37	294	0.00002
Pontibacter sp. SGAir0037	2571030	S	219	38	257	0.00002
Rufibacter radiotolerans	1379910	S	307	34	341	0.00002
Rufibacter sp. DG15C	1379909	S	184	108	292	0.00002
Rufibacter tibetensis	512763	S	172	28	200	0.00001
Adhaeribacter swui	2086471	S	164	25	189	0.00001
Adhaeribacter radiodurans	2745197	S	112	14	126	0.00001
Nibribacter ruber	2698458	S	158	93	251	0.00002
Spirosoma sp. CJU-R4	2728024	S	458	35	493	0.00004
Spirosoma sp. KUDC1026	2745947	S	329	29	358	0.00003
Spirosoma sp. KCTC 42546	2520506	S	197	25	222	0.00002
Spirosoma sp. RHs26	2898794	S	172	12	184	0.00001
Spirosoma sp. KCTC 72228	2710596	S	140	18	158	0.00001
Spirosoma rigui	564064	S	368	25	393	0.00003
Spirosoma taeanense	2735870	S	357	31	388	0.00003
Spirosoma montaniterrae	1178516	S	298	17	315	0.00002
Spirosoma radiotolerans	1379870	S	206	14	220	0.00002
Spirosoma aerolatum	1211326	S	205	9	214	0.00002
Spirosoma pollinicola	2057025	S	186	21	207	0.00002
Spirosoma endbachense	2666025	S	176	81	257	0.00002
Spirosoma aureum	2692134	S	131	73	204	0.00001
Rhodocytophaga rosea	2704465	S	171	5	176	0.00001
Aquirufa sp. 9H-EGSE	2696560	S	35	19	54	0.00000
Aquirufa nivalisilvae	2516557	S	30	13	43	0.00000
Cytophaga hutchinsonii	985	S	70	5	75	0.00001
Dyadobacter fermentans	94254	S	1124	96	1220	0.00009
Dyadobacter sp. LJ419	2906456	S	160	10	170	0.00001
Dyadobacter sp. NIV53	2861765	S	80	4	84	0.00001
Dyadobacter sandarakinus	2747268	S	223	19	242	0.00002
Fibrella aestuarina	651143	S	662	55	717	0.00005
Fibrella sp. ES10-3-2-2	1834519	S	296	22	318	0.00002
Runella slithyformis	106	S	181	14	195	0.00001
Runella rosea	2259595	S	138	13	151	0.00001
Runella sp. SP2	2268026	S	117	6	123	0.00001
Larkinella sp. IE-0392	2907205	S	196	13	209	0.00002
Leadbetterella byssophila	316068	S	47	22	69	0.00000
Arcticibacterium luteifluviistationis	1784714	S	29	1	30	0.00000
Chryseolinea soli	2321403	S	1738	52	1790	0.00013
Fulvivirga sp. SS9-22	2904245	S	84	9	93	0.00001
Fulvivirga sp. SW1-E11	2904247	S	45	27	72	0.00001
Fulvivirga sp. W9P-11	2904246	S	44	19	63	0.00000
Fulvivirga lutea	2810512	S	57	8	65	0.00000
Echinicola strongylocentroti	1795355	S	68	11	79	0.00001
Echinicola sp. SCS 3-6	2859768	S	39	17	56	0.00000
Echinicola sp. 20G	2781961	S	25	3	28	0.00000
Echinicola vietnamensis	390884	S	65	31	96	0.00001
Echinicola rosea	1807691	S	63	27	90	0.00001
Echinicola soli	2591634	S	43	4	47	0.00000
Algoriphagus sp. Y33	2772483	S	69	6	75	0.00001
Algoriphagus sp. NBT04N3	2705473	S	38	16	54	0.00000
Algoriphagus sanaruensis	1727163	S	62	5	67	0.00000
Algoriphagus machipongonensis	388413	S	36	2	38	0.00000
Cyclobacterium amurskyense	320787	S	25	2	27	0.00000
Cyclobacterium marinum	104	S	21	5	26	0.00000
Aquiflexum balticum	280473	S	44	9	53	0.00000
Mongoliitalea daihaiensis	2782006	S	41	5	46	0.00000
Belliella baltica	232259	S	17	9	26	0.00000
Candidatus Amoebophilus asiaticus	281120	S	55	2	57	0.00000
Cardinium endosymbiont of Oedothorax gibbosus	931101	S	15	33	48	0.00000
Flammeovirga yaeyamensis	367791	S	18	32	50	0.00000
Flammeovirga pectinis	2494373	S	18	5	23	0.00000
Marivirga tractuosa	1006	S	70	23	93	0.00001
Mangrovivirga cuniculi	2715131	S	40	2	42	0.00000
Bernardetia litoralis	999	S	30	2	32	0.00000
Pseudobacter ginsenosidimutans	661488	S	3095	205	3300	0.00024
Chitinophaga sp. XS-30	2604421	S	683	167	850	0.00006
Chitinophaga sp. KRA15-503	2829818	S	233	93	326	0.00002
Chitinophaga oryzae	2725414	S	490	70	560	0.00004
Chitinophaga alhagiae	2203219	S	487	10	497	0.00004
Chitinophaga filiformis	104663	S	270	41	311	0.00002
Chitinophaga agri	2703787	S	170	43	213	0.00002
Chitinophaga pinensis	79329	S	157	33	190	0.00001
Chitinophaga caeni	2029983	S	129	19	148	0.00001
Niastella koreensis	354356	S	1309	104	1413	0.00010
Flavisolibacter tropicus	1492898	S	578	71	649	0.00005
Flavisolibacter ginsenosidimutans	661481	S	546	27	573	0.00004
Pseudocnuella soli	2502779	S	700	66	766	0.00006
Paraflavitalea soli	2315862	S	590	34	624	0.00005
Flavihumibacter sp. IMCC34838	2838156	S	352	26	378	0.00003
Flavihumibacter sp. IMCC34837	2838157	S	217	12	229	0.00002
Niabella ginsenosidivorans	1176587	S	229	17	246	0.00002
Niabella soli	446683	S	205	18	223	0.00002
Arachidicoccus sp. 5GH13-10	2875539	S	85	12	97	0.00001
Arachidicoccus sp. BS20	1850526	S	83	25	108	0.00001
Arachidicoccus sp. B3-10	2545455	S	47	2	49	0.00000
Arachidicoccus ginsenosidivorans	496057	S	47	6	53	0.00000
Arachidicoccus soli	2341117	S	40	3	43	0.00000
Lacibacter sp. S13-6-6	2760713	S	267	9	276	0.00002
Phnomibacter ginsenosidimutans	2676868	S	266	25	291	0.00002
Filimonas lacunae	477680	S	217	20	237	0.00002
Ferruginibacter sp. KIS38-8	2875540	S	89	7	96	0.00001
Ferruginibacter lapsinanis	563172	S	74	5	79	0.00001
Panacibacter ginsenosidivorans	1813871	S	155	5	160	0.00001
Rhodocaloribacter litoris	2558931	S	4931	537	5468	0.00040
Rhodothermus marinus	29549	S	4137	245	4382	0.00032
Salinibacter ruber	146919	S	2640	45	2685	0.00019
Alistipes communis	2585118	S	615	428	1043	0.00008
Alistipes dispar	2585119	S	532	67	599	0.00004
Alistipes onderdonkii	328813	S	510	585	1095	0.00008
Alistipes finegoldii	214856	S	441	410	851	0.00006
Alistipes megaguti	2364787	S	417	48	465	0.00003
Alistipes senegalensis	1288121	S	416	93	509	0.00004
Alistipes shahii	328814	S	326	190	516	0.00004
Alistipes sp. dk3624	2662363	S	311	64	375	0.00003
Alistipes indistinctus	626932	S	277	54	331	0.00002
Prevotella sp. E13-17	2913616	S	87	29	116	0.00001
Prevotella sp. Rep29	2691580	S	62	8	70	0.00001
Prevotella sp. oral taxon 475	712471	S	58	5	63	0.00000
Prevotella sp. E15-22	2937774	S	46	31	77	0.00001
Prevotella sp. E2-28	2913620	S	32	17	49	0.00000
Prevotella sp. E9-3	2913621	S	26	12	38	0.00000
Prevotella dentalis	52227	S	209	42	251	0.00002
Prevotella denticola	28129	S	95	28	123	0.00001
Prevotella multiformis	282402	S	89	35	124	0.00001
Prevotella intermedia	28131	S	71	31	102	0.00001
Prevotella melaninogenica	28132	S	63	20	83	0.00001
Prevotella ruminicola	839	S	51	1	52	0.00000
Prevotella buccalis	28127	S	49	49	98	0.00001
Prevotella copri	165179	S	43	19	62	0.00000
Prevotella enoeca	76123	S	34	6	40	0.00000
Prevotella nigrescens	28133	S	20	12	32	0.00000
Prevotella veroralis	28137	S	18	3	21	0.00000
Prevotella oris	28135	S	17	2	19	0.00000
Prevotella jejuni	1177574	S	17	6	23	0.00000
Prevotella bryantii	77095	S	16	1	17	0.00000
Prevotella fusca	589436	S	14	2	16	0.00000
Pseudoprevotella muciniphila	2133944	S	63	6	69	0.00001
Paraprevotella xylaniphila	454155	S	55	44	99	0.00001
Bacteroides sp. CBA7301	2715212	S	50	20	70	0.00001
Bacteroides sp. M10	2763022	S	18	40	58	0.00000
Bacteroides cellulosilyticus	246787	S	68	22	90	0.00001
Bacteroides fragilis	817	S	62	101	163	0.00001
Bacteroides eggerthii	28111	S	56	56	112	0.00001
Bacteroides thetaiotaomicron	818	S	52	31	83	0.00001
Bacteroides stercoris	46506	S	46	41	87	0.00001
Bacteroides zoogleoformans	28119	S	40	9	49	0.00000
Bacteroides salyersiae	291644	S	39	34	73	0.00001
Bacteroides caccae	47678	S	34	9	43	0.00000
Bacteroides heparinolyticus	28113	S	33	7	40	0.00000
Bacteroides intestinalis	329854	S	32	5	37	0.00000
Bacteroides xylanisolvens	371601	S	30	68	98	0.00001
Bacteroides helcogenes	290053	S	28	1	29	0.00000
Bacteroides uniformis	820	S	28	83	111	0.00001
Bacteroides ovatus	28116	S	24	44	68	0.00000
Bacteroides nordii	291645	S	21	14	35	0.00000
Bacteroides faecis	674529	S	20	14	34	0.00000
Bacteroides zhangwenhongii	2650157	S	20	12	32	0.00000
Bacteroides luhongzhouii	2650158	S	12	5	17	0.00000
Bacteroides coprosuis	151276	S	11	0	11	0.00000
Phocaeicola salanitronis	376805	S	62	24	86	0.00001
Phocaeicola dorei	357276	S	39	63	102	0.00001
Phocaeicola coprophilus	387090	S	36	18	54	0.00000
Phocaeicola vulgatus	821	S	27	29	56	0.00000
Tannerella serpentiformis	712710	S	306	15	321	0.00002
Tannerella forsythia	28112	S	76	6	82	0.00001
Parabacteroides merdae	46503	S	88	89	177	0.00001
Parabacteroides goldsteinii	328812	S	84	20	104	0.00001
Parabacteroides johnsonii	387661	S	38	28	66	0.00000
Parabacteroides distasonis	823	S	32	135	167	0.00001
Sodaliphilus pleomorphus	2606626	S	250	113	363	0.00003
Duncaniella dubosii	2518971	S	93	13	106	0.00001
Muribaculum gordoncarteri	2530390	S	79	8	87	0.00001
Muribaculum intestinale	1796646	S	73	7	80	0.00001
Porphyromonas sp. oral taxon 275	712435	S	268	24	292	0.00002
Porphyromonas asaccharolytica	28123	S	86	6	92	0.00001
Porphyromonas gingivalis	837	S	69	9	78	0.00001
Porphyromonas cangingivalis	36874	S	37	4	41	0.00000
Porphyromonas somerae	322095	S	28	6	34	0.00000
Porphyromonas crevioricanis	393921	S	19	3	22	0.00000
Porphyromonas endodontalis	28124	S	15	1	16	0.00000
Petrimonas mucosa	1642646	S	117	7	124	0.00001
Proteiniphilum saccharofermentans	1642647	S	48	3	51	0.00000
Proteiniphilum sp. JNU-WLY501	2829812	S	35	1	36	0.00000
Barnesiella viscericola	397865	S	116	138	254	0.00002
Coprobacter secundus	1501392	S	19	15	34	0.00000
Butyricimonas virosa	544645	S	29	9	38	0.00000
Butyricimonas faecalis	2093856	S	27	31	58	0.00000
Odoribacter splanchnicus	28118	S	46	6	52	0.00000
Salinivirga cyanobacteriivorans	1307839	S	39	0	39	0.00000
Paludibacter propionicigenes	185300	S	34	1	35	0.00000
Tenuifilum thalassicum	2590900	S	33	0	33	0.00000
Draconibacterium orientale	1168034	S	56	4	60	0.00000
Draconibacterium halophilum	2706887	S	32	1	33	0.00000
Maribellus comscasis	2681766	S	35	2	37	0.00000
Alkalitalea saponilacus	889453	S	35	2	37	0.00000
Labilibaculum antarcticum	1717717	S	33	2	35	0.00000
Flavobacterium sp. HJ-32-4	1160795	S	201	14	215	0.00002
Flavobacterium sp. MDT1-60	1979344	S	77	14	91	0.00001
Flavobacterium sp. KSM-R2A25	2895947	S	69	17	86	0.00001
Flavobacterium sp. CJ74	2294119	S	63	5	68	0.00000
Flavobacterium sp. KSM-R2A30	2897181	S	55	17	72	0.00001
Flavobacterium sp. KBS0721	1179672	S	42	11	53	0.00000
Flavobacterium sp. CLA17	2724135	S	42	7	49	0.00000
Flavobacterium sp. F-29	2893883	S	38	8	46	0.00000
Flavobacterium sp. F-323	2893885	S	33	7	40	0.00000
Flavobacterium sp. I3-2	2748319	S	32	44	76	0.00001
Flavobacterium sp. B183	907046	S	32	6	38	0.00000
Flavobacterium sp. IGB 4-14	1871076	S	31	2	33	0.00000
Flavobacterium sp. KK2020170	2830782	S	31	9	40	0.00000
Flavobacterium sp. F-70	2893884	S	27	5	32	0.00000
Flavobacterium sp. 140616W15	2478552	S	26	5	31	0.00000
Flavobacterium sp. WSW3-B6	2856519	S	26	3	29	0.00000
Flavobacterium sp. K5-23	2746225	S	26	6	32	0.00000
Flavobacterium sp. SLB02	2665645	S	26	4	30	0.00000
Flavobacterium sp. LPB0248	2614441	S	25	12	37	0.00000
Flavobacterium sp. MMS21-Er5	2937442	S	24	9	33	0.00000
Flavobacterium sp. M31R6	2739062	S	22	3	25	0.00000
Flavobacterium sp. CECT 9288	2845819	S	22	19	41	0.00000
Flavobacterium sp. CS20	2775246	S	22	10	32	0.00000
Flavobacterium sp. Sr18	935222	S	21	3	24	0.00000
Flavobacterium sp. GENT5	1751095	S	20	4	24	0.00000
Flavobacterium sp. F-340	2893886	S	19	5	24	0.00000
Flavobacterium sp. xlx-214	2654325	S	17	3	20	0.00000
Flavobacterium sp. CHNK8	2871165	S	11	9	20	0.00000
Flavobacterium sp. SHINM13	1751056	S	10	18	28	0.00000
Flavobacterium album	2175091	S	126	9	135	0.00001
Flavobacterium magnum	2162713	S	112	12	124	0.00001
Flavobacterium oreochromis	2906078	S	90	35	125	0.00001
Flavobacterium alkalisoli	2602769	S	77	6	83	0.00001
Flavobacterium pallidum	2172098	S	75	7	82	0.00001
Flavobacterium columnare	996	S	72	104	176	0.00001
Flavobacterium covae	2906076	S	67	81	148	0.00001
Flavobacterium davisii	2906077	S	55	22	77	0.00001
Flavobacterium nackdongense	2547394	S	53	4	57	0.00000
Flavobacterium psychrophilum	96345	S	52	10	62	0.00000
Flavobacterium inviolabile	2748320	S	46	7	53	0.00000
Flavobacterium commune	1306519	S	42	6	48	0.00000
Flavobacterium gilvum	1492737	S	39	5	44	0.00000
Flavobacterium enshiense	1341165	S	38	4	42	0.00000
Flavobacterium sangjuense	2518177	S	38	4	42	0.00000
Flavobacterium anhuiense	459526	S	37	13	50	0.00000
Flavobacterium sediminilitoris	2024526	S	36	5	41	0.00000
Flavobacterium fluviale	2249356	S	32	11	43	0.00000
Flavobacterium endoglycinae	2816357	S	31	6	37	0.00000
Flavobacterium jumunjinense	998845	S	31	5	36	0.00000
Flavobacterium branchiophilum	55197	S	30	3	33	0.00000
Flavobacterium johnsoniae	986	S	30	14	44	0.00000
Flavobacterium haoranii	683124	S	30	12	42	0.00000
Flavobacterium indicum	312277	S	28	4	32	0.00000
Flavobacterium kingsejongi	1678728	S	27	4	31	0.00000
Flavobacterium arcticum	1784713	S	24	2	26	0.00000
Flavobacterium sediminis	2201181	S	22	19	41	0.00000
Flavobacterium faecale	1355330	S	20	2	22	0.00000
Flavobacterium crassostreae	1763534	S	16	4	20	0.00000
Flavobacterium crocinum	2183896	S	15	4	19	0.00000
Flavobacterium nitrogenifigens	1617283	S	15	7	22	0.00000
Muricauda sp. SCSIO 65647	2908843	S	60	2	62	0.00000
Muricauda sp. SCSIO 64092	2908842	S	49	1	50	0.00000
Muricauda lutaonensis	516051	S	68	19	87	0.00001
Muricauda aquimarina	254955	S	57	31	88	0.00001
Muricauda ruestringensis	111501	S	54	4	58	0.00000
Muricauda oceani	2698672	S	47	26	73	0.00001
Muricauda aurantiaca	1383885	S	23	2	25	0.00000
Capnocytophaga sp. oral taxon 878	1316596	S	19	8	27	0.00000
Capnocytophaga sp. oral taxon 902	2748316	S	10	33	43	0.00000
Capnocytophaga gingivalis	1017	S	44	6	50	0.00000
Capnocytophaga haemolytica	45243	S	44	4	48	0.00000
Capnocytophaga sputigena	1019	S	33	13	46	0.00000
Capnocytophaga canimorsus	28188	S	28	8	36	0.00000
Capnocytophaga ochracea	1018	S	17	31	48	0.00000
Capnocytophaga endodontalis	2708117	S	10	6	16	0.00000
Robiginitalea biformata	252307	S	269	17	286	0.00002
Gramella sp. GC03-9	2920386	S	50	15	65	0.00000
Gramella sp. MAR_2010_147	1250205	S	19	2	21	0.00000
Gramella sp. MT6	2705471	S	16	2	18	0.00000
Gramella flava	1486245	S	47	16	63	0.00000
Gramella fulva	2126553	S	42	4	46	0.00000
Gramella echinicola	279359	S	21	2	23	0.00000
Gramella forsetii	411153	S	16	4	20	0.00000
Gramella salexigens	1913577	S	15	1	16	0.00000
Nonlabens sp. Hel1_33_55	1336802	S	20	4	24	0.00000
Nonlabens sp. Ci31	2608253	S	18	7	25	0.00000
Nonlabens spongiae	331648	S	29	17	46	0.00000
Nonlabens ponticola	2496866	S	26	4	30	0.00000
Nonlabens marinus	930802	S	20	9	29	0.00000
Nonlabens dokdonensis	328515	S	14	4	18	0.00000
Polaribacter sp. Hel1_33_78	1336804	S	15	9	24	0.00000
Polaribacter sp. SM13	2818493	S	11	14	25	0.00000
Polaribacter sp. G4M1	2808900	S	11	10	21	0.00000
Polaribacter litorisediminis	1908341	S	11	4	15	0.00000
Antarcticibacterium flavum	2058175	S	49	11	60	0.00000
Antarcticibacterium sp. 1MA-6-2	2908210	S	46	6	52	0.00000
Antarcticibacterium arcticum	2585771	S	30	3	33	0.00000
Winogradskyella sp. PC-19	754417	S	12	4	16	0.00000
Winogradskyella sp. J14-2	1936080	S	12	1	13	0.00000
Winogradskyella sp. MH6	2929510	S	10	1	11	0.00000
Winogradskyella forsetii	2686077	S	22	9	31	0.00000
Winogradskyella schleiferi	2686078	S	15	10	25	0.00000
Winogradskyella sediminis	1382466	S	13	5	18	0.00000
Aequorivita sublithincola	101385	S	38	35	73	0.00001
Aequorivita sp. H23M31	2494375	S	24	10	34	0.00000
Tenacibaculum sp. SZ-18	754423	S	11	10	21	0.00000
Tenacibaculum jejuense	584609	S	16	1	17	0.00000
Tenacibaculum singaporense	2358479	S	15	5	20	0.00000
Tenacibaculum mesophilum	104268	S	14	6	20	0.00000
Tenacibaculum dicentrarchi	669041	S	11	5	16	0.00000
Tenacibaculum todarodis	1850252	S	11	4	15	0.00000
Sinomicrobium sp. HD2P242	2900738	S	99	4	103	0.00001
Maribacter sp. HTCC2170	313603	S	24	3	27	0.00000
Maribacter sp. MJ134	2496865	S	18	3	21	0.00000
Maribacter cobaltidurans	1178778	S	18	19	37	0.00000
Maribacter hydrothermalis	1836467	S	15	8	23	0.00000
Kordia antarctica	1218801	S	69	5	74	0.00001
Kordia sp. SMS9	2282170	S	12	0	12	0.00000
Salegentibacter mishustinae	270918	S	27	28	55	0.00000
Salegentibacter sp. T436	1729720	S	23	26	49	0.00000
Salegentibacter salegens	143223	S	22	3	25	0.00000
Formosa sp. Hel1_33_131	1336794	S	13	1	14	0.00000
Formosa sp. Hel3_A1_48	1336795	S	12	4	16	0.00000
Formosa agariphila	320324	S	15	6	21	0.00000
Formosa sediminum	2594004	S	14	5	19	0.00000
Aquimarina sp. TRL1	2736252	S	23	2	25	0.00000
Aquimarina sp. AD10	1714849	S	21	1	22	0.00000
Aquimarina sp. AD1	1714848	S	14	1	15	0.00000
Aquimarina sp. BL5	1714860	S	10	0	10	0.00000
Myroides odoratus	256	S	13	21	34	0.00000
Cellulophaga sp. HaHaR_3_176	1942464	S	10	10	20	0.00000
Cellulophaga lytica	979	S	16	11	27	0.00000
Dokdonia sp. Dokd-P16	2173169	S	12	20	32	0.00000
Leeuwenhoekiella sp. ZYFB001	2719912	S	16	19	35	0.00000
Leeuwenhoekiella palythoae	573501	S	10	14	24	0.00000
Zunongwangia sp. SCSIO 43204	2779359	S	27	21	48	0.00000
Zunongwangia profunda	398743	S	20	19	39	0.00000
Aggregatimonas sangjinii	2583587	S	48	2	50	0.00000
Flagellimonas sp. CMM7	2654676	S	27	2	29	0.00000
Flagellimonas sp. HMM57	2905121	S	18	1	19	0.00000
Arenibacter algicola	616991	S	43	16	59	0.00000
Zobellia galactanivorans	63186	S	37	2	39	0.00000
Pukyongia salina	2094025	S	34	2	36	0.00000
Algibacter sp. L3A6	2686366	S	15	8	23	0.00000
Seonamhaeicola sp. S2-3	1936081	S	17	4	21	0.00000
Seonamhaeicola sp. ML3	2937786	S	15	1	16	0.00000
Muriicola soli	2507538	S	31	2	33	0.00000
Mariniflexile sp. TRM1-10	2027857	S	31	3	34	0.00000
Lutibacter profundi	1622118	S	19	2	21	0.00000
Lacinutrix sp. WUR7	2653681	S	10	3	13	0.00000
Euzebyella marina	1761453	S	28	18	46	0.00000
Constantimarinum furrinae	2562285	S	27	2	29	0.00000
Gilvibacter sp. SZ-19	754429	S	26	3	29	0.00000
Tamlana carrageenivorans	2069432	S	13	4	17	0.00000
Galbibacter sp. BG1	1170699	S	21	2	23	0.00000
Sediminicola sp. YIK13	1453352	S	21	2	23	0.00000
Flavivirga eckloniae	1803846	S	21	2	23	0.00000
Bizionia sp. M204	2675331	S	21	5	26	0.00000
Flavobacteriaceae bacterium 10Alg115	2584122	S	20	1	21	0.00000
Zhouia spongiae	2202721	S	20	5	25	0.00000
Mesoflavibacter sp. SCSIO 43206	2779362	S	12	9	21	0.00000
Costertonia aggregata	343403	S	15	3	18	0.00000
Urechidicola croceus	1850246	S	14	8	22	0.00000
Aegicerativicinus sediminis	2893202	S	14	0	14	0.00000
Gillisia sp. Hel1_33_143	1336796	S	14	5	19	0.00000
Changchengzhania lutea	2049305	S	12	1	13	0.00000
Amniculibacterium sp. G2-70	2767188	S	11	12	23	0.00000
Marixanthomonas sp. SCSIO 43207	2779360	S	10	3	13	0.00000
Wenyingzhuangia fucanilytica	1790137	S	10	2	12	0.00000
Croceibacter atlanticus	313588	S	10	2	12	0.00000
Chryseobacterium sp. Y16C	2920939	S	84	59	143	0.00001
Chryseobacterium sp. SC2-2	2929800	S	53	33	86	0.00001
Chryseobacterium sp.	1871047	S	42	18	60	0.00000
Chryseobacterium sp. 6424	2039166	S	34	8	42	0.00000
Chryseobacterium sp. C-17	2898076	S	29	15	44	0.00000
Chryseobacterium sp. POL2	2713414	S	29	22	51	0.00000
Chryseobacterium sp. G0201	2487065	S	28	7	35	0.00000
Chryseobacterium sp. ZHDP1	2838877	S	27	24	51	0.00000
Chryseobacterium sp. IHB B 17019	1721091	S	22	4	26	0.00000
Chryseobacterium sp. F4	2852098	S	22	1	23	0.00000
Chryseobacterium sp. MEBOG07	2879939	S	21	6	27	0.00000
Chryseobacterium sp. LJ668	2864040	S	19	3	22	0.00000
Chryseobacterium sp. ADR-1	2929799	S	19	6	25	0.00000
Chryseobacterium sp. cx-624	2758037	S	18	3	21	0.00000
Chryseobacterium sp. DH-B6	2759528	S	18	8	26	0.00000
Chryseobacterium sp. 3008163	2478663	S	16	8	24	0.00000
Chryseobacterium sp. MEBOG06	2879938	S	16	3	19	0.00000
Chryseobacterium sp. SNU WT5	2594269	S	14	5	19	0.00000
Chryseobacterium sp. G0186	2487064	S	14	9	23	0.00000
Chryseobacterium sp. T16E-39	2015076	S	14	1	15	0.00000
Chryseobacterium sp. PCH239	2825845	S	12	8	20	0.00000
Chryseobacterium gleum	250	S	95	129	224	0.00002
Chryseobacterium indologenes	253	S	81	40	121	0.00001
Chryseobacterium indoltheticum	254	S	58	13	71	0.00001
Chryseobacterium taklimakanense	536441	S	48	28	76	0.00001
Chryseobacterium shandongense	1493872	S	39	26	65	0.00000
Chryseobacterium camelliae	1265445	S	38	25	63	0.00000
Chryseobacterium arthrosphaerae	651561	S	36	20	56	0.00000
Chryseobacterium balustinum	246	S	34	11	45	0.00000
Chryseobacterium nepalense	1854498	S	29	4	33	0.00000
Chryseobacterium cucumeris	1813611	S	29	15	44	0.00000
Chryseobacterium gallinarum	1324352	S	27	10	37	0.00000
Chryseobacterium aureum	2497456	S	23	5	28	0.00000
Chryseobacterium daecheongense	192389	S	22	3	25	0.00000
Chryseobacterium lactis	1241981	S	21	24	45	0.00000
Chryseobacterium salivictor	2547600	S	21	2	23	0.00000
Chryseobacterium glaciei	1685010	S	17	3	20	0.00000
Chryseobacterium piperi	558152	S	16	1	17	0.00000
Chryseobacterium manosquense	2754694	S	15	12	27	0.00000
Chryseobacterium carnipullorum	1124835	S	14	5	19	0.00000
Chryseobacterium nakagawai	1241982	S	11	17	28	0.00000
Chryseobacterium bernardetii	1241978	S	11	90	101	0.00001
Kaistella sp. 97-N-M2	2908645	S	29	3	32	0.00000
Kaistella sp. GW4-15	2878534	S	16	1	17	0.00000
Kaistella daneshvariae	2487074	S	40	3	43	0.00000
Kaistella jeonii	266749	S	26	1	27	0.00000
Kaistella carnis	1241979	S	23	6	29	0.00000
Kaistella flava (ex Peng et al. 2021)	2038776	S	23	3	26	0.00000
Kaistella antarctica	266748	S	22	2	24	0.00000
Candidatus Kaistella beijingensis	2820270	S	10	3	13	0.00000
Epilithonimonas vandammei	2487072	S	24	37	61	0.00000
Epilithonimonas zeae	1416779	S	16	1	17	0.00000
Elizabethkingia anophelis	1117645	S	28	37	65	0.00000
Elizabethkingia meningoseptica	238	S	22	1	23	0.00000
Elizabethkingia sp. JS20170427COW	2583851	S	12	2	14	0.00000
Elizabethkingia miricola	172045	S	13	8	21	0.00000
Cruoricaptor ignavus	1118202	S	59	9	68	0.00000
Apibacter raozihei	2500547	S	10	22	32	0.00000
Empedobacter falsenii	343874	S	19	17	36	0.00000
Empedobacter brevis	247	S	14	7	21	0.00000
Ornithobacterium rhinotracheale	28251	S	37	29	66	0.00000
Cloacibacterium caeni	2004710	S	17	18	35	0.00000
Cloacibacterium normanense	237258	S	10	7	17	0.00000
Riemerella anatipestifer	34085	S	31	13	44	0.00000
Weeksella virosa	1014	S	16	7	23	0.00000
Bergeyella cardium	1585976	S	15	3	18	0.00000
Blattabacterium cuenoti	1653831	S	79	35	114	0.00001
Owenweeksia hongkongensis	253245	S	41	5	46	0.00000
Croceimicrobium hydrocarbonivorans	2761580	S	39	10	49	0.00000
Fluviicola taffensis	191579	S	45	3	48	0.00000
Crocinitomix sp. GM2_3_6_6	2862509	S	20	1	21	0.00000
Candidatus Sulcia muelleri	336810	S	22	6	28	0.00000
Mucilaginibacter sp. 14171R-50	2703789	S	127	7	134	0.00001
Mucilaginibacter sp. SMC90	2929803	S	97	5	102	0.00001
Mucilaginibacter sp. 21P	2778902	S	80	4	84	0.00001
Mucilaginibacter sp. F39-2	2728022	S	52	3	55	0.00000
Mucilaginibacter mali	2740462	S	196	7	203	0.00001
Mucilaginibacter ginsenosidivorans	398053	S	180	6	186	0.00001
Mucilaginibacter daejeonensis	398049	S	152	9	161	0.00001
Mucilaginibacter gotjawali	1550579	S	121	3	124	0.00001
Mucilaginibacter paludis	423351	S	112	5	117	0.00001
Mucilaginibacter celer	2305508	S	112	4	116	0.00001
Mucilaginibacter ginsenosidivorax	862126	S	95	4	99	0.00001
Mucilaginibacter ginkgonis	2682091	S	88	4	92	0.00001
Mucilaginibacter xinganensis	1234841	S	87	4	91	0.00001
Mucilaginibacter mallensis	652787	S	77	2	79	0.00001
Mucilaginibacter rubeus	2027860	S	75	204	279	0.00002
Mucilaginibacter gossypii	551996	S	44	36	80	0.00001
Sphingobacterium sp. DR205	2713573	S	47	5	52	0.00000
Sphingobacterium sp. CZ-2	2557994	S	38	10	48	0.00000
Sphingobacterium sp. UDSM-2020	2795738	S	23	9	32	0.00000
Sphingobacterium sp. dk4302	2662364	S	21	2	23	0.00000
Sphingobacterium sp. PCS056	2931400	S	21	6	27	0.00000
Sphingobacterium sp. ML3W	1538644	S	17	7	24	0.00000
Sphingobacterium sp. SRCM116780	2907623	S	12	2	14	0.00000
Sphingobacterium thalpophilum	259	S	174	192	366	0.00003
Sphingobacterium spiritivorum	258	S	73	51	124	0.00001
Sphingobacterium lactis	797291	S	56	48	104	0.00001
Sphingobacterium hotanense	649196	S	52	16	68	0.00000
Sphingobacterium mizutaii	1010	S	37	5	42	0.00000
Sphingobacterium multivorum	28454	S	36	89	125	0.00001
Sphingobacterium daejeonense	371142	S	33	9	42	0.00000
Sphingobacterium psychroaquaticum	561061	S	31	6	37	0.00000
Sphingobacterium paramultivorum	2886510	S	11	15	26	0.00000
Pedobacter sp. KBS0701	2578106	S	40	12	52	0.00000
Pedobacter sp. SW-16	2766984	S	40	7	47	0.00000
Pedobacter sp. D749	2856523	S	40	12	52	0.00000
Pedobacter sp. G11	2482728	S	39	5	44	0.00000
Pedobacter sp. HDW13	2714940	S	38	5	43	0.00000
Pedobacter sp. PACM 27299	1727164	S	36	5	41	0.00000
Pedobacter sp. Q8-18	2895286	S	29	2	31	0.00000
Pedobacter heparinus	984	S	80	7	87	0.00001
Pedobacter endophyticus	2789740	S	58	6	64	0.00000
Pedobacter schmidteae	2201271	S	56	5	61	0.00000
Pedobacter steynii	430522	S	49	5	54	0.00000
Pedobacter suwonensis	332999	S	43	9	52	0.00000
Pedobacter roseus	336820	S	41	13	54	0.00000
Pedobacter cryoconitis	188932	S	37	4	41	0.00000
Pedobacter ginsengisoli	363852	S	28	3	31	0.00000
Pedobacter aquae	2605747	S	24	2	26	0.00000
Olivibacter sp. LS-1	2592345	S	302	15	317	0.00002
Olivibacter sp. SDN3	2764720	S	40	5	45	0.00000
Anseongella ginsenosidimutans	496056	S	240	9	249	0.00002
Solitalea canadensis	995	S	55	7	62	0.00000
Solitalea sp. S2-8	2911172	S	44	8	52	0.00000
Pseudopedobacter saltans	151895	S	38	31	69	0.00000
Haliscomenobacter hydrossis	2350	S	258	5	263	0.00002
Saprospira grandis	1008	S	46	2	48	0.00000
Candidatus Sulfidibacterium hydrothermale	2875962	S	67	2	69	0.00001
Chlorobaculum limnaeum	274537	S	725	120	845	0.00006
Chlorobaculum tepidum	1097	S	437	125	562	0.00004
Chlorobaculum parvum	274539	S	422	82	504	0.00004
Prosthecochloris sp. GSB1	281093	S	376	27	403	0.00003
Prosthecochloris sp. CIB 2401	1868325	S	121	33	154	0.00001
Prosthecochloris sp. HL-130-GSB	1974213	S	106	21	127	0.00001
Prosthecochloris aestuarii	1102	S	129	13	142	0.00001
Pelodictyon luteolum	1100	S	349	62	411	0.00003
Pelodictyon phaeoclathratiforme	34090	S	67	4	71	0.00001
Chlorobium limicola	1092	S	143	9	152	0.00001
Chlorobium phaeovibrioides	1094	S	90	19	109	0.00001
Chlorobium phaeobacteroides	1096	S	80	9	89	0.00001
Chloroherpeton thalassium	100716	S	174	3	177	0.00001
Candidatus Cyclonatronum proteinivorum	1457365	S	247	24	271	0.00002
Melioribacter roseus	1134405	S	100	5	105	0.00001
Ignavibacterium album	591197	S	96	6	102	0.00001
Gemmatirosa kalamazoonesis	861299	S	47859	4795	52654	0.00380
Gemmatimonas groenlandica	2732249	S	6253	797	7050	0.00051
Gemmatimonas aurantiaca	173480	S	4837	552	5389	0.00039
Gemmatimonas phototrophica	1379270	S	3945	612	4557	0.00033
Fibrobacter succinogenes	833	S	153	3	156	0.00001
Candidatus Cloacimonas acidaminovorans	456827	S	69	1	70	0.00001
Luteitalea sp. TBR-22	2802971	S	31191	5599	36790	0.00266
Luteitalea pratensis	1855912	S	25549	2961	28510	0.00206
Granulicella sp. WH15	2602070	S	2293	430	2723	0.00020
Granulicella sp. 5B5	1617967	S	1666	276	1942	0.00014
Granulicella mallensis	940614	S	1500	188	1688	0.00012
Granulicella tundricola	940615	S	1086	150	1236	0.00009
Terriglobus roseus	392734	S	1743	389	2132	0.00015
Terriglobus albidus	1592106	S	1381	135	1516	0.00011
Terriglobus saanensis	870903	S	872	117	989	0.00007
Acidobacterium capsulatum	33075	S	1820	220	2040	0.00015
Acidobacterium sp. 4Y35	2763107	S	1424	96	1520	0.00011
Candidatus Koribacter versatilis	658062	S	2525	87	2612	0.00019
Edaphobacter sp. 12200R-103	2703788	S	1272	218	1490	0.00011
Edaphobacter sp. 4G125	2763071	S	611	89	700	0.00005
Acidisarcina polymorpha	2211140	S	1125	83	1208	0.00009
Paludibaculum fermentans	1473598	S	5290	164	5454	0.00039
Chloracidobacterium aggregatum	2851959	S	918	675	1593	0.00012
Chloracidobacterium validum	2821543	S	739	14	753	0.00005
Chloracidobacterium sp. D	2821536	S	73	305	378	0.00003
Chloracidobacterium thermophilum	458033	S	68	262	330	0.00002
Sulfidibacter corallicola	2818388	S	1953	49	2002	0.00014
Thermotomaculum hydrothermale	981385	S	96	5	101	0.00001
Nitrospira moscoviensis	42253	S	4939	433	5372	0.00039
Nitrospira japonica	1325564	S	2987	356	3343	0.00024
Nitrospira sp. KM1	1936990	S	2337	218	2555	0.00018
Candidatus Nitrospira inopinata	1715989	S	1819	158	1977	0.00014
Leptospirillum ferrooxidans	180	S	107	2	109	0.00001
Leptospirillum sp. Group II 'CF-1'	1660083	S	55	109	164	0.00001
Leptospirillum ferriphilum	178606	S	45	73	118	0.00001
Thermodesulfovibrio yellowstonii	28262	S	105	3	108	0.00001
Dissulfurispira thermophila	2715679	S	76	4	80	0.00001
Spirochaeta thermophila	154	S	649	15	664	0.00005
Spirochaeta africana	46355	S	181	10	191	0.00001
Sediminispirochaeta smaragdinae	55206	S	90	2	92	0.00001
Salinispira pacifica	1307761	S	83	2	85	0.00001
Oceanispirochaeta crateris	2518645	S	34	1	35	0.00000
Thiospirochaeta perfilievii	252967	S	15	1	16	0.00000
Treponema brennaborense	81028	S	125	44	169	0.00001
Treponema azotonutricium	150829	S	122	4	126	0.00001
Treponema primitia	88058	S	119	6	125	0.00001
Treponema sp. Marseille-Q4132	2766701	S	58	33	91	0.00001
Treponema sp. OMZ 838	1539298	S	13	16	29	0.00000
Treponema socranskii	53419	S	59	34	93	0.00001
Treponema caldarium	215591	S	55	6	61	0.00000
Treponema succinifaciens	167	S	38	30	68	0.00000
Treponema parvum	138851	S	37	2	39	0.00000
Treponema medium	58231	S	33	50	83	0.00001
Treponema vincentii	69710	S	30	37	67	0.00000
Treponema phagedenis	162	S	20	8	28	0.00000
Treponema denticola	158	S	19	7	26	0.00000
Treponema pedis	409322	S	14	3	17	0.00000
Treponema peruense	2787628	S	11	1	12	0.00000
Sphaerochaeta associata	1129264	S	91	12	103	0.00001
Sphaerochaeta coccoides	273376	S	85	4	89	0.00001
Sphaerochaeta globosa	1131703	S	60	9	69	0.00001
Sphaerochaeta pleomorpha	1131707	S	33	5	38	0.00000
Breznakiella homolactica	2798577	S	165	12	177	0.00001
Borrelia coriaceae	144	S	10	91	101	0.00001
Leptospira santarosai	28183	S	84	1	85	0.00001
Leptospira kmetyi	408139	S	55	0	55	0.00000
Leptospira tipperaryensis	2564040	S	41	0	41	0.00000
Leptospira noguchii	28182	S	30	0	30	0.00000
Leptospira kobayashii	1917830	S	29	0	29	0.00000
Leptospira weilii	28184	S	28	0	28	0.00000
Leptospira borgpetersenii	174	S	17	0	17	0.00000
Leptospira mayottensis	1137606	S	15	0	15	0.00000
Leptospira interrogans	173	S	10	105	115	0.00001
Turneriella parva	29510	S	297	3	300	0.00002
Pyramidobacter piscolens	638849	S	654	50	704	0.00005
Fretibacterium fastidiosum	651822	S	548	8	556	0.00004
Aminomonas paucivorans	81412	S	500	74	574	0.00004
Thermanaerovibrio acidaminovorans	81462	S	251	100	351	0.00003
Thermanaerovibrio velox	108007	S	152	40	192	0.00001
Cloacibacillus porcorum	1197717	S	402	89	491	0.00004
Jonquetella anthropi	428712	S	292	49	341	0.00002
Acetomicrobium mobile	97477	S	122	4	126	0.00001
Aminobacterium colombiense	81468	S	77	5	82	0.00001
Thermovirga lienii	336261	S	53	47	100	0.00001
Candidatus Bipolaricaulis anaerobius	2026885	S	707	31	738	0.00005
Candidatus Nanosynbacter featherlites	2572088	S	45	22	67	0.00000
Candidatus Nanosynbacter lyticus	2093824	S	25	72	97	0.00001
Nanosynbacter sp. HMT-352	2899133	S	25	76	101	0.00001
Candidatus Nanosynbacter sp. HMT352	2902423	S	10	39	49	0.00000
Candidatus Saccharimonas aalborgensis	1332188	S	103	1	104	0.00001
Candidatus Babela massiliensis	673862	S	65	1	66	0.00000
Candidatus Chazhemtobacterium aquaticus	2715735	S	54	0	54	0.00000
Candidatus Absconditicoccus praedator	2735562	S	47	0	47	0.00000
Thermotoga caldifontis	1508419	S	100	182	282	0.00002
Thermotoga profunda	1508420	S	11	5	16	0.00000
Pseudothermotoga hypogea	57487	S	45	34	79	0.00001
Pseudothermotoga thermarum	119394	S	15	7	22	0.00000
Fervidobacterium pennivorans	93466	S	16	47	63	0.00000
Fervidobacterium nodosum	2424	S	14	18	32	0.00000
Thermosipho ferrireducens	2571116	S	20	16	36	0.00000
Kosmotoga pacifica	1330330	S	26	81	107	0.00001
Kosmotoga olearia	651457	S	14	41	55	0.00000
Mesotoga infera	1236046	S	73	9	82	0.00001
Mesotoga prima	1184387	S	32	5	37	0.00000
Defluviitoga tunisiensis	1006576	S	19	34	53	0.00000
Tepiditoga spiralis	2108365	S	17	5	22	0.00000
Athalassotoga saccharophila	1441386	S	62	3	65	0.00000
Thermocrinis minervae	381751	S	126	13	139	0.00001
Thermocrinis albus	136094	S	19	1	20	0.00000
Thermocrinis ruber	75906	S	11	1	12	0.00000
Hydrogenobacter sp. T-8	1632019	S	95	24	119	0.00001
Hydrogenobacter thermophilus	940	S	10	3	13	0.00000
Aquifex aeolicus	63363	S	72	4	76	0.00001
Persephonella marina	309805	S	66	7	73	0.00001
Sulfurihydrogenibium azorense	309806	S	47	8	55	0.00000
Thermosulfidibacter takaii	412593	S	113	4	117	0.00001
Thermovibrio ammonificans	228745	S	86	26	112	0.00001
Desulfurobacterium thermolithotrophum	64160	S	34	8	42	0.00000
Thermosulfurimonas marina	2047767	S	189	34	223	0.00002
Thermosulfuriphilus ammonigenes	1936021	S	130	7	137	0.00001
Thermodesulfatator indicus	171695	S	83	15	98	0.00001
Thermodesulfobacterium commune	1741	S	19	12	31	0.00000
Thermodesulfobacterium sp. TA1	2234087	S	14	7	21	0.00000
Thermodesulfobacterium geofontis	1295609	S	10	5	15	0.00000
Caldimicrobium thiodismutans	1653476	S	21	5	26	0.00000
Caldithrix abyssi	187145	S	319	3	322	0.00002
Geovibrio thiophilus	139438	S	67	16	83	0.00001
Flexistipes sinusarabici	2352	S	51	7	58	0.00000
Calditerrivibrio nitroreducens	477976	S	42	7	49	0.00000
Denitrovibrio acetiphilus	118000	S	36	6	42	0.00000
Deferribacter desulfuricans	197162	S	27	6	33	0.00000
Mucispirillum schaedleri	248039	S	19	2	21	0.00000
Desulfurispirillum indicum	936456	S	263	124	387	0.00003
Pseudoleptotrichia goodfellowii	157692	S	20	6	26	0.00000
Sebaldella termitidis	826	S	19	1	20	0.00000
Fusobacterium ulcerans	861	S	14	4	18	0.00000
Fusobacterium gonidiaformans	849	S	11	6	17	0.00000
Fusobacterium nucleatum	851	S	11	36	47	0.00000
Endomicrobium proavitum	1408281	S	31	18	49	0.00000
Candidatus Endomicrobium trichonymphae	1408204	S	25	14	39	0.00000
Elusimicrobium minutum	423605	S	87	0	87	0.00001
Coprothermobacter proteolyticus	35786	S	129	28	157	0.00001
Caldisericum exile	693075	S	112	0	112	0.00001
Dictyoglomus thermophilum	14	S	15	83	98	0.00001
Atribacter laminatus	2847778	S	77	2	79	0.00001
Fusarium acuminatum	5515	S	3389	238	3627	0.00026
Fusarium avenaceum	40199	S	101	5	106	0.00001
Fusarium oxysporum	5507	S	963	487	1450	0.00010
Fusarium longipes	694270	S	170	8	178	0.00001
Fusarium sambucinum	5128	S	165	64	229	0.00002
Fusarium poae	36050	S	117	38	155	0.00001
Fusarium sporotrichioides	5514	S	107	9	116	0.00001
Fusarium pseudograminearum	101028	S	88	32	120	0.00001
Fusarium venenatum	56646	S	63	114	177	0.00001
Fusarium graminearum	5518	S	38	127	165	0.00001
Fusarium culmorum	5516	S	35	30	65	0.00000
Fusarium decemcellulare	57161	S	514	12	526	0.00004
Fusarium dimerum	57145	S	436	14	450	0.00003
Fusarium nygamai	42673	S	108	42	150	0.00001
Fusarium fujikuroi	5127	S	73	9	82	0.00001
Fusarium pseudonygamai	47755	S	70	21	91	0.00001
Fusarium thapsinum	120644	S	61	17	78	0.00001
Fusarium verticillioides	117187	S	25	52	77	0.00001
Fusarium equiseti	61235	S	161	36	197	0.00001
Fusarium scirpi	2211609	S	151	30	181	0.00001
Fusarium graminum	86546	S	92	19	111	0.00001
Fusarium heterosporum	42747	S	84	17	101	0.00001
Fusarium nelsonii	77846	S	98	21	119	0.00001
Fusarium chlamydosporum	86545	S	80	16	96	0.00001
Fusarium lateritium	5523	S	196	6	202	0.00001
Fusarium musae	1042133	S	21	43	64	0.00000
Trichoderma citrinoviride	58853	S	294	41	335	0.00002
Trichoderma reesei	51453	S	280	30	310	0.00002
Trichoderma pleuroti	500994	S	167	22	189	0.00001
Trichoderma atroviride	63577	S	152	44	196	0.00001
Trichoderma asperellum	101201	S	149	13	162	0.00001
Trichoderma afroharzianum	1567482	S	141	39	180	0.00001
Trichoderma hamatum	49224	S	136	13	149	0.00001
Trichoderma erinaceum	202914	S	120	23	143	0.00001
Trichoderma gamsii	398673	S	105	18	123	0.00001
Trichoderma koningiopsis	337941	S	100	18	118	0.00001
Trichoderma harzianum	5544	S	74	20	94	0.00001
Trichoderma virens	29875	S	26	365	391	0.00003
Trichoderma longibrachiatum	5548	S	24	330	354	0.00003
Trichoderma koningii	97093	S	13	173	186	0.00001
Metarhizium album	92629	S	374	13	387	0.00003
Metarhizium guizhouense	169041	S	299	172	471	0.00003
Metarhizium rileyi	1649241	S	253	38	291	0.00002
Metarhizium acridum	92637	S	162	120	282	0.00002
Metarhizium anisopliae	5530	S	103	161	264	0.00002
Metarhizium majus	1650735	S	96	46	142	0.00001
Metarhizium brunneum	500148	S	82	72	154	0.00001
Metarhizium humberi	2596975	S	80	52	132	0.00001
Metarhizium robertsii	568076	S	39	29	68	0.00000
Ustilaginoidea virens	1159556	S	602	33	635	0.00005
Pochonia chlamydosporia	280754	S	156	12	168	0.00001
Beauveria felina	37994	S	600	35	635	0.00005
Beauveria pseudobassiana	931006	S	247	36	283	0.00002
Beauveria brongniartii	118266	S	197	49	246	0.00002
Beauveria rudraprayagi	1481906	S	159	192	351	0.00003
Beauveria bassiana	176275	S	117	149	266	0.00002
Cordyceps fumosorosea	114497	S	735	54	789	0.00006
Purpureocillium lilacinum	33203	S	925	75	1000	0.00007
Drechmeria coniospora	98403	S	676	36	712	0.00005
Clonostachys rosea	29856	S	341	27	368	0.00003
Colletotrichum higginsianum	80884	S	985	234	1219	0.00009
Thermothielavioides terrestris	2587410	S	1702	164	1866	0.00013
Thermothelomyces thermophilus	78579	S	1568	110	1678	0.00012
Neurospora crassa	5141	S	583	39	622	0.00004
Pyricularia oryzae	318829	S	368	109	477	0.00003
Pyricularia pennisetigena	1578925	S	333	58	391	0.00003
Pyricularia grisea	148305	S	225	38	263	0.00002
Neopestalotiopsis clavispora	289240	S	138	151	289	0.00002
Neopestalotiopsis rosae	1562205	S	124	125	249	0.00002
Botrytis cinerea	40559	S	155	1	156	0.00001
Aspergillus chevalieri	182096	S	4030	324	4354	0.00031
Aspergillus luchuensis	1069201	S	1624	93	1717	0.00012
Aspergillus oryzae	5062	S	76	189	265	0.00002
Aspergillus flavus	5059	S	23	62	85	0.00001
Aspergillus puulaauensis	1220207	S	287	9	296	0.00002
Aspergillus fumigatus	746128	S	230	9	239	0.00002
Penicillium citrinum	5077	S	128	13	141	0.00001
Penicillium aurantiogriseum	36655	S	117	45	162	0.00001
Penicillium chrysogenum	5076	S	114	24	138	0.00001
Penicillium expansum	27334	S	85	41	126	0.00001
Penicillium digitatum	36651	S	82	19	101	0.00001
Penicillium italicum	40296	S	71	31	102	0.00001
Paecilomyces variotii	264951	S	119	13	132	0.00001
Paecilomyces niveus	5093	S	116	7	123	0.00001
Talaromyces rugulosus	121627	S	154	8	162	0.00001
Paraphaeosphaeria minitans	565426	S	381	124	505	0.00004
Ampelomyces quisqualis	50730	S	332	34	366	0.00003
Zymoseptoria tritici	1047171	S	199	4	203	0.00001
Cercospora beticola	122368	S	138	1	139	0.00001
Eremothecium gossypii	33169	S	125	108	233	0.00002
Eremothecium cymbalariae	45285	S	20	0	20	0.00000
Eremothecium sinecaudum	45286	S	10	6	16	0.00000
Lachancea thermotolerans	381046	S	67	4	71	0.00001
Naumovozyma dairenensis	27289	S	41	1	42	0.00000
Naumovozyma castellii	27288	S	24	1	25	0.00000
Tetrapisispora phaffii	113608	S	29	0	29	0.00000
Tetrapisispora blattae	1071379	S	20	1	21	0.00000
Saccharomyces eubayanus	1080349	S	17	1	18	0.00000
Saccharomyces cerevisiae	4932	S	15	4	19	0.00000
Kluyveromyces marxianus	4911	S	27	8	35	0.00000
Kazachstania naganishii	588726	S	30	1	31	0.00000
Torulaspora globosa	48254	S	25	1	26	0.00000
[Candida] glabrata	5478	S	23	1	24	0.00000
Zygosaccharomyces rouxii	4956	S	20	1	21	0.00000
Zygotorulaspora mrakii	42260	S	17	2	19	0.00000
Brettanomyces nanus	13502	S	29	5	34	0.00000
Brettanomyces bruxellensis	5007	S	24	2	26	0.00000
Ogataea parapolymorpha	1005962	S	54	2	56	0.00000
Pichia kudriavzevii	4909	S	21	1	22	0.00000
Yarrowia lipolytica	4952	S	107	1	108	0.00001
Candida dubliniensis	42374	S	38	2	40	0.00000
Candida orthopsilosis	273371	S	21	0	21	0.00000
Candida albicans	5476	S	19	1	20	0.00000
Debaryomyces hansenii	4959	S	14	0	14	0.00000
Scheffersomyces stipitis	4924	S	10	0	10	0.00000
Sugiyamaella lignohabitans	796027	S	58	5	63	0.00000
Saccharomycodes ludwigii	36035	S	18	2	20	0.00000
Komagataella phaffii	460519	S	13	0	13	0.00000
Schizosaccharomyces pombe	4896	S	65	1	66	0.00000
Pseudozyma flocculosa	84751	S	1323	14	1337	0.00010
Sporisorium graminicola	280036	S	313	55	368	0.00003
Ustilago maydis	5270	S	288	8	296	0.00002
Malassezia restricta	76775	S	125	24	149	0.00001
Phlebiopsis gigantea	82310	S	351	4	355	0.00003
Rhizoctonia solani	456999	S	80	5	85	0.00001
Marasmius oreades	181124	S	65	3	68	0.00000
Cryptococcus neoformans	5207	S	67	2	69	0.00001
Cryptococcus gattii VGI	37769	S	36	23	59	0.00000
Phytophthora cinnamomi	4785	S	792	133	925	0.00007
Phytophthora fragariae	53985	S	559	80	639	0.00005
Phytophthora cryptogea	4786	S	388	32	420	0.00003
Phytophthora infestans	4787	S	285	502	787	0.00006
Phytophthora cactorum	29920	S	266	40	306	0.00002
Phytophthora boehmeriae	109152	S	209	26	235	0.00002
Phytophthora parasitica	4792	S	155	20	175	0.00001
Pythium aphanidermatum	65070	S	557	14	571	0.00004
